,Game,Date,Team,Location,Opp,Result,Pass_cmp,Pass_att,Pass_pct,Pass_yds,Pass_TD,Rush_att,Rush_yds,Rush_avg,Rush_TD,TO_plays,TO_yds,TO_avg,FD_pass,FD_rush,FD_pen,FD_tot,Pen_num,Pen_yds,Turn_fum,Turn_int,Turn_tot
0,1,2014-08-30,florida-state,N,Oklahoma State,W (37-31),25,40,62.5,370,1,31,106,3.4,2,71,476,6.7,12,7,4,23,8,71,0,2,2
1,2,2014-09-06,florida-state,,Citadel,W (37-12),25,32,78.1,284,2,35,210,6.0,2,67,494,7.4,13,15,0,28,3,20,0,0,0
2,3,2014-09-20,florida-state,,Clemson,W (23-17),21,39,53.8,304,1,27,13,0.5,2,66,317,4.8,11,5,1,17,8,41,0,2,2
3,4,2014-09-27,florida-state,@,North Carolina State,W (56-41),26,38,68.4,365,4,33,166,5.0,4,71,531,7.5,18,7,3,28,9,58,2,2,4
4,5,2014-10-04,florida-state,,Wake Forest,W (43-3),24,41,58.5,304,1,33,171,5.2,2,74,475,6.4,12,9,2,23,5,48,1,1,2
5,6,2014-10-11,florida-state,@,Syracuse,W (38-20),30,36,83.3,317,3,36,165,4.6,2,72,482,6.7,16,9,4,29,6,36,2,0,2
6,7,2014-10-18,florida-state,,Notre Dame,W (31-27),23,31,74.2,273,2,26,50,1.9,2,57,323,5.7,12,4,2,18,9,84,0,1,1
7,8,2014-10-30,florida-state,@,Louisville,W (42-31),25,48,52.1,401,3,30,173,5.8,3,78,574,7.4,18,7,0,25,7,53,0,3,3
8,9,2014-11-08,florida-state,,Virginia,W (34-20),22,35,62.9,261,1,39,115,2.9,3,74,376,5.1,13,5,2,20,6,46,1,2,3
9,10,2014-11-15,florida-state,@,Miami (FL),W (30-26),25,42,59.5,304,1,19,114,6.0,2,61,418,6.9,13,6,1,20,2,15,2,1,3
10,11,2014-11-22,florida-state,,Boston College,W (20-17),22,32,68.8,281,1,29,110,3.8,1,61,391,6.4,15,7,0,22,5,40,0,1,1
11,12,2014-11-29,florida-state,,Florida,W (24-19),12,24,50.0,125,2,41,181,4.4,0,65,306,4.7,6,8,3,17,8,63,0,4,4
12,13,2014-12-06,florida-state,N,Georgia Tech,W (37-35),21,30,70.0,309,3,33,179,5.4,1,63,488,7.7,11,12,1,24,5,45,0,0,0
13,14,2015-01-01,florida-state,N,Oregon*,L (20-59),29,48,60.4,348,1,39,180,4.6,1,87,528,6.1,17,10,1,28,6,48,4,1,5
14,,14 Games,florida-state,,,,330,516,64.0,4246,26,451,1933,4.3,27,967,6179,6.4,187,111,24,322,87,668,12,20,32
15,1,2015-09-05,florida-state,,Texas State,W (59-16),25,32,78.1,370,5,41,266,6.5,3,73,636,8.7,16,14,0,30,5,35,1,0,1
16,2,2015-09-12,florida-state,,South Florida,W (34-14),14,26,53.8,163,1,46,278,6.0,3,72,441,6.1,10,10,1,21,7,50,0,0,0
17,3,2015-09-18,florida-state,@,Boston College,W (14-0),15,24,62.5,119,1,33,98,3.0,0,57,217,3.8,7,5,3,15,4,26,0,0,0
18,4,2015-10-03,florida-state,@,Wake Forest,W (24-16),20,31,64.5,202,1,21,127,6.0,2,52,329,6.3,7,6,1,14,10,100,0,0,0
19,5,2015-10-10,florida-state,,Miami (FL),W (29-24),25,33,75.8,291,1,36,248,6.9,2,69,539,7.8,13,10,2,25,7,43,0,0,0
20,6,2015-10-17,florida-state,,Louisville,W (41-21),27,39,69.2,377,3,32,133,4.2,2,71,510,7.2,13,7,4,24,10,75,0,0,0
21,7,2015-10-24,florida-state,@,Georgia Tech,L (16-22),20,31,64.5,210,0,24,70,2.9,1,55,280,5.1,11,4,2,17,6,45,0,1,1
22,8,2015-10-31,florida-state,,Syracuse,W (45-21),25,38,65.8,354,3,34,221,6.5,3,72,575,8.0,11,12,0,23,9,77,0,0,0
23,9,2015-11-07,florida-state,@,Clemson,L (13-23),16,29,55.2,164,0,30,197,6.6,1,59,361,6.1,6,7,1,14,9,65,1,1,2
24,10,2015-11-14,florida-state,,North Carolina State,W (34-17),23,37,62.2,283,2,38,196,5.2,2,75,479,6.4,15,11,2,28,6,38,2,3,5
25,11,2015-11-21,florida-state,,Chattanooga,W (52-13),17,23,73.9,235,2,37,193,5.2,5,60,428,7.1,11,11,3,25,3,30,1,0,1
26,12,2015-11-28,florida-state,@,Florida,W (27-2),14,28,50.0,160,1,30,144,4.8,2,58,304,5.2,5,9,1,15,7,52,0,0,0
27,13,2015-12-31,florida-state,N,Houston*,L (24-38),23,48,47.9,397,2,23,16,0.7,1,71,413,5.8,16,1,0,17,6,66,1,4,5
28,,13 Games,florida-state,,,,264,419,63.0,3325,22,425,2187,5.1,27,844,5512,6.5,141,107,20,268,89,702,6,9,15
29,1,2016-09-05,florida-state,N,Mississippi,W (45-34),33,52,63.5,419,2,41,161,3.9,2,93,580,6.2,17,12,3,32,15,127,0,0,0
30,2,2016-09-10,florida-state,,Charleston Southern,W (52-8),26,35,74.3,269,3,36,169,4.7,3,71,438,6.2,11,13,2,26,6,60,0,1,1
31,3,2016-09-17,florida-state,@,Louisville,L (20-63),8,24,33.3,113,2,43,171,4.0,0,67,284,4.2,6,12,2,20,8,84,1,1,2
32,4,2016-09-24,florida-state,@,South Florida,W (55-35),11,19,57.9,169,1,63,478,7.6,6,82,647,7.9,8,20,3,31,4,50,1,0,1
33,5,2016-10-01,florida-state,,North Carolina,L (35-37),20,32,62.5,372,0,43,223,5.2,5,75,595,7.9,15,12,3,30,13,120,0,0,0
34,6,2016-10-08,florida-state,@,Miami (FL),W (20-19),21,33,63.6,240,2,43,167,3.9,0,76,407,5.4,10,10,2,22,8,77,0,1,1
35,7,2016-10-15,florida-state,,Wake Forest,W (17-6),22,37,59.5,319,1,38,123,3.2,1,75,442,5.9,13,13,1,27,4,42,3,1,4
36,8,2016-10-29,florida-state,,Clemson,L (34-37),17,35,48.6,286,1,28,163,5.8,4,63,449,7.1,13,6,4,23,13,111,0,1,1
37,9,2016-11-05,florida-state,@,North Carolina State,W (24-20),22,39,56.4,330,1,24,63,2.6,2,63,393,6.2,12,7,1,20,6,59,1,0,1
38,10,2016-11-11,florida-state,,Boston College,W (45-7),21,31,67.7,236,5,39,180,4.6,1,70,416,5.9,11,11,2,24,4,33,0,0,0
39,11,2016-11-19,florida-state,@,Syracuse,W (45-14),19,31,61.3,320,2,45,334,7.4,4,76,654,8.6,16,16,1,33,9,85,3,1,4
40,12,2016-11-26,florida-state,,Florida,W (31-13),15,26,57.7,138,1,40,249,6.2,3,66,387,5.9,6,10,2,18,3,35,2,1,3
41,13,2016-12-30,florida-state,N,Michigan*,W (33-32),9,27,33.3,222,2,35,149,4.3,2,62,371,6.0,5,7,3,15,7,65,1,1,2
42,,13 Games,florida-state,,,,244,421,58.0,3433,23,518,2630,5.1,33,939,6063,6.5,143,149,29,321,100,948,12,8,20
43,1,2017-09-02,florida-state,N,Alabama,L (7-24),19,33,57.6,210,1,27,40,1.5,0,60,250,4.2,10,4,1,15,4,30,1,2,3
44,2,2017-09-23,florida-state,,North Carolina State,L (21-27),22,39,56.4,278,1,26,104,4.0,0,65,382,5.9,9,6,0,15,11,93,1,0,1
45,3,2017-09-30,florida-state,@,Wake Forest,W (26-19),11,21,52.4,121,1,43,149,3.5,1,64,270,4.2,4,8,3,15,8,70,1,0,1
46,4,2017-10-07,florida-state,,Miami (FL),L (20-24),17,28,60.7,203,2,43,203,4.7,0,71,406,5.7,9,12,1,22,7,65,0,2,2
47,5,2017-10-14,florida-state,@,Duke,W (17-10),18,21,85.7,197,1,40,228,5.7,1,61,425,7.0,10,12,1,23,7,51,0,2,2
48,6,2017-10-21,florida-state,,Louisville,L (28-31),16,28,57.1,248,2,38,155,4.1,0,66,403,6.1,12,10,1,23,4,40,1,2,3
49,7,2017-10-27,florida-state,@,Boston College,L (3-35),12,27,44.4,149,0,29,64,2.2,0,56,213,3.8,7,3,0,10,7,71,2,1,3
50,8,2017-11-04,florida-state,,Syracuse,W (27-24),12,19,63.2,136,1,37,207,5.6,2,56,343,6.1,5,7,1,13,4,34,1,0,1
51,9,2017-11-11,florida-state,@,Clemson,L (14-31),13,32,40.6,208,1,24,21,0.9,1,56,229,4.1,6,3,3,12,4,55,1,1,2
52,10,2017-11-18,florida-state,,Delaware State,W (77-6),18,24,75.0,236,4,32,246,7.7,5,56,482,8.6,9,14,0,23,5,45,0,0,0
53,11,2017-11-25,florida-state,@,Florida,W (38-22),10,21,47.6,128,2,34,88,2.6,1,55,216,3.9,5,5,2,12,7,55,0,1,1
54,12,2017-12-02,florida-state,,Louisiana-Monroe,W (42-10),15,23,65.2,199,1,45,305,6.8,5,68,504,7.4,10,16,0,26,4,30,0,2,2
55,13,2017-12-27,florida-state,N,Southern Mississippi*,W (42-13),19,29,65.5,238,4,45,214,4.8,1,74,452,6.1,14,10,1,25,6,60,0,0,0
56,,13 Games,florida-state,,,,202,345,58.6,2551,21,463,2024,4.4,17,808,4575,5.7,110,110,14,234,78,699,8,13,21
57,1,2018-09-03,florida-state,,Virginia Tech,L (3-24),22,35,62.9,233,0,28,94,3.4,0,63,327,5.2,8,3,1,12,7,36,2,3,5
58,2,2018-09-08,florida-state,,Samford,W (36-26),31,46,67.4,320,3,35,134,3.8,1,81,454,5.6,16,6,3,25,9,69,1,0,1
59,3,2018-09-15,florida-state,@,Syracuse,L (7-30),18,37,48.6,178,0,23,62,2.7,1,60,240,4.0,7,3,1,11,11,90,0,1,1
60,4,2018-09-22,florida-state,,Northern Illinois,W (37-19),23,32,71.9,352,2,57,121,2.1,2,89,473,5.3,13,10,0,23,9,60,3,1,4
61,5,2018-09-29,florida-state,@,Louisville,W (28-24),16,27,59.3,294,4,31,76,2.5,0,58,370,6.4,10,5,1,16,7,55,1,0,1
62,6,2018-10-06,florida-state,@,Miami (FL),L (27-28),16,32,50.0,130,2,33,70,2.1,0,65,200,3.1,9,5,0,14,7,80,1,1,2
63,7,2018-10-20,florida-state,,Wake Forest,W (38-17),28,41,68.3,341,2,28,130,4.6,3,69,471,6.8,13,4,2,19,6,55,1,0,1
64,8,2018-10-27,florida-state,,Clemson,L (10-59),20,40,50.0,268,1,35,-21,-0.6,0,75,247,3.3,11,1,2,14,16,134,1,1,2
65,9,2018-11-03,florida-state,@,North Carolina State,L (28-47),29,48,60.4,421,4,20,24,1.2,0,68,445,6.5,13,3,1,17,16,121,1,1,2
66,10,2018-11-10,florida-state,@,Notre Dame,L (13-42),23,48,47.9,216,0,30,106,3.5,2,78,322,4.1,11,6,3,20,5,35,1,1,2
67,11,2018-11-17,florida-state,,Boston College,W (22-21),19,39,48.7,322,1,36,156,4.3,1,75,478,6.4,11,7,1,19,7,56,0,2,2
68,,11 Games,florida-state,,,,245,425,57.6,3075,19,356,952,2.7,10,781,4027,5.2,122,53,15,190,100,791,12,11,23
69,1,2014-08-30,virginia-tech,,William & Mary,W (34-9),24,31,77.4,266,2,42,222,5.3,2,73,488,6.7,9,12,3,24,10,75,1,1,2
70,2,2014-09-06,virginia-tech,@,Ohio State,W (35-21),23,36,63.9,199,2,41,125,3.0,2,77,324,4.2,12,7,2,21,10,107,1,2,3
71,3,2014-09-13,virginia-tech,,East Carolina,L (21-28),30,56,53.6,298,3,33,91,2.8,0,89,389,4.4,17,6,3,26,8,64,0,2,2
72,4,2014-09-20,virginia-tech,,Georgia Tech,L (24-27),28,39,71.8,297,0,33,127,3.8,2,72,424,5.9,17,7,0,24,12,79,0,3,3
73,5,2014-09-27,virginia-tech,,Western Michigan,W (35-17),14,32,43.8,178,2,47,308,6.6,1,79,486,6.2,9,13,4,26,9,69,0,2,2
74,6,2014-10-04,virginia-tech,@,North Carolina,W (34-17),18,27,66.7,186,1,57,171,3.0,2,84,357,4.3,9,9,2,20,8,45,0,1,1
75,7,2014-10-16,virginia-tech,@,Pittsburgh,L (16-21),26,45,57.8,265,1,22,26,1.2,0,67,291,4.3,12,2,2,16,8,45,1,0,1
76,8,2014-10-23,virginia-tech,,Miami (FL),L (6-30),18,28,64.3,142,1,31,120,3.9,0,59,262,4.4,6,7,2,15,4,40,3,0,3
77,9,2014-11-01,virginia-tech,,Boston College,L (31-33),31,49,63.3,345,2,29,69,2.4,2,78,414,5.3,12,5,0,17,6,40,1,0,1
78,10,2014-11-15,virginia-tech,@,Duke,W (17-16),13,24,54.2,148,2,49,145,3.0,0,73,293,4.0,5,10,1,16,7,75,0,1,1
79,11,2014-11-22,virginia-tech,@,Wake Forest,L (3-6),16,29,55.2,143,0,39,111,2.8,0,68,254,3.7,7,8,2,17,4,25,2,1,3
80,12,2014-11-28,virginia-tech,,Virginia,W (24-20),15,35,42.9,235,2,40,198,5.0,0,75,433,5.8,10,9,2,21,8,71,2,1,3
81,13,2014-12-27,virginia-tech,N,Cincinnati*,W (33-17),15,25,60.0,124,1,44,210,4.8,1,69,334,4.8,5,10,3,18,4,35,0,1,1
82,,13 Games,virginia-tech,,,,271,456,59.4,2826,19,507,1923,3.8,12,963,4749,4.9,130,105,26,261,98,770,11,15,26
83,1,2015-09-07,virginia-tech,,Ohio State,L (24-42),15,25,60.0,192,3,44,128,2.9,0,69,320,4.6,7,10,1,18,5,50,1,1,2
84,2,2015-09-12,virginia-tech,,Furman,W (42-3),19,31,61.3,284,2,41,299,7.3,3,72,583,8.1,10,14,1,25,11,114,0,0,0
85,3,2015-09-19,virginia-tech,@,Purdue,W (51-24),16,26,61.5,233,2,56,238,4.3,2,82,471,5.7,9,11,0,20,11,87,1,0,1
86,4,2015-09-26,virginia-tech,@,East Carolina,L (28-35),20,35,57.1,281,1,42,158,3.8,3,77,439,5.7,10,8,2,20,11,89,0,1,1
87,5,2015-10-03,virginia-tech,,Pittsburgh,L (13-17),9,20,45.0,91,1,33,9,0.3,0,53,100,1.9,6,4,2,12,5,40,0,3,3
88,6,2015-10-09,virginia-tech,,North Carolina State,W (28-13),14,29,48.3,158,3,36,200,5.6,1,65,358,5.5,6,9,5,20,7,48,0,0,0
89,7,2015-10-17,virginia-tech,@,Miami (FL),L (20-30),17,27,63.0,201,2,35,160,4.6,0,62,361,5.8,8,11,1,20,8,69,1,3,4
90,8,2015-10-24,virginia-tech,,Duke,L (43-45),24,47,51.1,270,3,53,182,3.4,2,100,452,4.5,15,13,0,28,5,35,0,0,0
91,9,2015-10-31,virginia-tech,@,Boston College,W (26-10),16,23,69.6,194,1,46,81,1.8,0,69,275,4.0,9,6,2,17,11,98,1,1,2
92,10,2015-11-12,virginia-tech,@,Georgia Tech,W (23-21),15,29,51.7,178,1,39,165,4.2,2,68,343,5.0,7,9,1,17,8,58,1,1,2
93,11,2015-11-21,virginia-tech,,North Carolina,L (27-30),20,35,57.1,273,2,47,130,2.8,1,82,403,4.9,13,7,2,22,6,54,1,2,3
94,12,2015-11-28,virginia-tech,@,Virginia,W (23-20),15,29,51.7,237,2,30,67,2.2,0,59,304,5.2,7,4,1,12,3,35,0,1,1
95,13,2015-12-26,virginia-tech,N,Tulsa*,W (55-52),23,38,60.5,344,1,43,254,5.9,5,81,598,7.4,16,12,2,30,5,40,1,1,2
96,,13 Games,virginia-tech,,,,223,394,56.6,2936,24,545,2071,3.8,19,939,5007,5.3,123,118,20,261,96,817,7,14,21
97,1,2016-09-03,virginia-tech,,Liberty,W (36-13),25,41,61.0,252,4,48,206,4.3,0,89,458,5.1,15,8,1,24,4,33,4,0,4
98,2,2016-09-10,virginia-tech,N,Tennessee,L (24-45),20,28,71.4,214,1,45,186,4.1,2,73,400,5.5,11,7,3,21,8,101,5,0,5
99,3,2016-09-17,virginia-tech,,Boston College,W (49-0),16,27,59.3,253,5,50,223,4.5,2,77,476,6.2,10,12,3,25,7,55,0,1,1
100,4,2016-09-24,virginia-tech,,East Carolina,W (54-17),15,23,65.2,295,3,45,167,3.7,3,68,462,6.8,11,6,1,18,4,28,0,0,0
101,5,2016-10-08,virginia-tech,@,North Carolina,W (34-3),7,17,41.2,75,2,66,189,2.9,2,83,264,3.2,4,12,2,18,5,29,2,0,2
102,6,2016-10-15,virginia-tech,@,Syracuse,L (17-31),20,33,60.6,307,2,39,161,4.1,0,72,468,6.5,15,6,0,21,7,53,1,1,2
103,7,2016-10-20,virginia-tech,,Miami (FL),W (37-16),22,34,64.7,272,3,44,251,5.7,1,78,523,6.7,14,11,3,28,2,25,0,0,0
104,8,2016-10-27,virginia-tech,@,Pittsburgh,W (39-36),24,43,55.8,406,2,39,150,3.8,1,82,556,6.8,19,8,2,29,4,35,0,0,0
105,9,2016-11-05,virginia-tech,@,Duke,W (24-21),15,27,55.6,192,0,52,207,4.0,2,79,399,5.1,9,13,1,23,6,58,0,0,0
106,10,2016-11-12,virginia-tech,,Georgia Tech,L (20-30),32,47,68.1,316,1,33,121,3.7,2,80,437,5.5,16,9,0,25,4,35,2,2,4
107,11,2016-11-19,virginia-tech,@,Notre Dame,W (34-31),22,29,75.9,267,2,47,152,3.2,2,76,419,5.5,9,13,3,25,5,35,1,1,2
108,12,2016-11-26,virginia-tech,,Virginia,W (52-10),18,30,60.0,290,3,51,289,5.7,3,81,579,7.1,13,15,1,29,3,35,2,0,2
109,13,2016-12-03,virginia-tech,N,Clemson,L (35-42),22,36,61.1,284,1,35,102,2.9,4,71,386,5.4,12,5,2,19,8,89,0,2,2
110,14,2016-12-29,virginia-tech,N,Arkansas*,W (35-24),21,34,61.8,243,2,41,170,4.1,3,75,413,5.5,14,9,2,26,4,55,1,1,2
111,,14 Games,virginia-tech,,,,279,449,62.1,3666,31,635,2574,4.1,27,1084,6240,5.8,172,134,24,331,71,666,18,8,26
112,1,2017-09-03,virginia-tech,N,West Virginia,W (31-24),15,27,55.6,235,1,45,234,5.2,3,72,469,6.5,8,11,2,21,5,34,0,0,0
113,2,2017-09-09,virginia-tech,,Delaware,W (27-0),16,28,57.1,222,2,27,81,3.0,0,55,303,5.5,9,4,2,15,2,10,1,0,1
114,3,2017-09-16,virginia-tech,@,East Carolina,W (64-17),25,33,75.8,388,5,62,287,4.6,3,95,675,7.1,16,16,2,34,7,69,0,0,0
115,4,2017-09-23,virginia-tech,,Old Dominion,W (38-0),21,32,65.6,311,3,57,271,4.8,2,89,582,6.5,16,14,2,32,2,25,0,1,1
116,5,2017-09-30,virginia-tech,,Clemson,L (17-31),30,45,66.7,252,1,28,90,3.2,1,73,342,4.7,11,6,0,17,4,31,1,2,3
117,6,2017-10-07,virginia-tech,@,Boston College,W (23-10),22,33,66.7,322,1,48,109,2.3,1,81,431,5.3,14,6,0,20,9,67,0,1,1
118,7,2017-10-21,virginia-tech,,North Carolina,W (59-7),15,27,55.6,202,4,46,181,3.9,1,73,383,5.2,11,7,3,21,7,60,0,0,0
119,8,2017-10-28,virginia-tech,,Duke,W (24-3),13,27,48.1,200,1,48,187,3.9,2,75,387,5.2,9,11,3,23,3,40,0,0,0
120,9,2017-11-04,virginia-tech,@,Miami (FL),L (10-28),20,32,62.5,197,0,43,102,2.4,1,75,299,4.0,11,8,3,22,4,60,2,2,4
121,10,2017-11-11,virginia-tech,@,Georgia Tech,L (22-28),14,26,53.8,153,0,36,105,2.9,2,62,258,4.2,7,6,1,14,4,42,0,0,0
122,11,2017-11-18,virginia-tech,,Pittsburgh,W (20-14),17,37,45.9,218,1,40,157,3.9,1,77,375,4.9,11,7,0,18,4,25,0,1,1
123,12,2017-11-24,virginia-tech,@,Virginia,W (10-0),14,21,66.7,143,1,53,202,3.8,0,74,345,4.7,7,12,1,20,4,20,0,1,1
124,13,2017-12-28,virginia-tech,N,Oklahoma State*,L (21-30),23,42,54.8,270,1,50,248,5.0,2,92,518,5.6,12,18,1,31,5,65,1,1,2
125,,13 Games,virginia-tech,,,,245,410,59.8,3113,21,583,2254,3.9,19,993,5367,5.4,142,126,20,288,60,548,5,9,14
126,1,2018-09-03,virginia-tech,@,Florida State,W (24-3),16,26,61.5,207,2,37,112,3.0,0,63,319,5.1,8,7,0,15,5,55,0,0,0
127,2,2018-09-08,virginia-tech,,William & Mary,W (62-17),16,23,69.6,281,1,46,305,6.6,7,69,586,8.5,14,16,2,32,2,20,1,0,1
128,3,2018-09-22,virginia-tech,@,Old Dominion,L (35-49),17,34,50.0,282,3,49,318,6.5,2,83,600,7.2,11,15,0,26,7,95,0,1,1
129,4,2018-09-29,virginia-tech,@,Duke,W (31-14),17,28,60.7,332,3,41,81,2.0,1,69,413,6.0,13,4,0,17,4,26,0,0,0
130,5,2018-10-06,virginia-tech,,Notre Dame,L (23-45),31,52,59.6,309,2,33,132,4.0,0,85,441,5.2,18,6,1,25,6,41,1,1,2
131,6,2018-10-13,virginia-tech,@,North Carolina,W (22-19),20,36,55.6,221,2,41,154,3.8,1,77,375,4.9,12,8,0,20,8,59,0,2,2
132,7,2018-10-25,virginia-tech,,Georgia Tech,L (28-49),15,22,68.2,201,2,25,122,4.9,2,47,323,6.9,8,7,1,16,8,87,1,0,1
133,8,2018-11-03,virginia-tech,,Boston College,L (21-31),25,43,58.1,281,3,36,111,3.1,0,79,392,5.0,14,8,1,23,8,59,1,1,2
134,9,2018-11-10,virginia-tech,@,Pittsburgh,L (22-52),23,38,60.5,240,3,48,192,4.0,0,86,432,5.0,10,15,3,28,3,34,0,0,0
135,10,2018-11-17,virginia-tech,,Miami (FL),L (14-38),18,36,50.0,216,1,33,119,3.6,1,69,335,4.9,12,8,2,22,3,35,1,2,3
136,,10 Games,virginia-tech,,,,198,338,58.6,2570,22,389,1646,4.2,14,727,4216,5.8,120,94,10,224,54,511,5,7,12
137,1,2014-09-01,miami-fl,@,Louisville,L (13-31),17,29,58.6,174,1,27,70,2.6,0,56,244,4.4,6,4,2,12,7,46,1,2,3
138,2,2014-09-06,miami-fl,,Florida A&M,W (41-7),17,30,56.7,218,2,33,198,6.0,3,63,416,6.6,10,10,1,21,4,40,1,2,3
139,3,2014-09-13,miami-fl,,Arkansas State,W (41-20),16,26,61.5,342,4,35,146,4.2,2,61,488,8.0,9,8,3,20,11,93,1,1,2
140,4,2014-09-20,miami-fl,@,Nebraska,L (31-41),28,42,66.7,359,3,23,76,3.3,1,65,435,6.7,16,6,2,24,9,82,1,2,3
141,5,2014-09-27,miami-fl,,Duke,W (22-10),20,34,58.8,223,2,41,203,5.0,1,75,426,5.7,9,12,0,21,8,93,2,0,2
142,6,2014-10-04,miami-fl,@,Georgia Tech,L (17-28),16,25,64.0,245,1,19,107,5.6,1,44,352,8.0,11,6,2,19,5,38,0,2,2
143,7,2014-10-11,miami-fl,,Cincinnati,W (55-34),17,25,68.0,286,3,35,335,9.6,3,60,621,10.4,9,9,2,20,13,155,1,0,1
144,8,2014-10-23,miami-fl,@,Virginia Tech,W (30-6),7,16,43.8,92,1,53,364,6.9,3,69,456,6.6,5,16,1,22,4,28,0,0,0
145,9,2014-11-01,miami-fl,,North Carolina,W (47-20),12,19,63.2,199,3,49,295,6.0,3,68,494,7.3,9,14,0,23,6,45,1,0,1
146,10,2014-11-15,miami-fl,,Florida State,L (26-30),16,34,47.1,316,2,40,176,4.4,1,74,492,6.6,9,10,0,19,5,51,2,1,3
147,11,2014-11-22,miami-fl,@,Virginia,L (13-30),20,33,60.6,263,1,23,64,2.8,0,56,327,5.8,10,4,1,15,9,59,1,1,2
148,12,2014-11-29,miami-fl,,Pittsburgh,L (23-35),22,45,48.9,296,2,28,125,4.5,0,73,421,5.8,14,5,2,21,7,57,0,0,0
149,13,2014-12-27,miami-fl,N,South Carolina*,L (21-24),19,33,57.6,236,1,40,186,4.7,1,73,422,5.8,10,10,1,21,5,40,1,1,2
150,,13 Games,miami-fl,,,,227,391,58.1,3249,26,446,2345,5.3,19,837,5594,6.7,127,114,17,258,93,827,12,12,24
151,1,2015-09-05,miami-fl,,Bethune-Cookman,W (45-0),17,31,54.8,184,2,26,195,7.5,3,57,379,6.6,10,9,1,20,4,30,1,0,1
152,2,2015-09-11,miami-fl,@,Florida Atlantic,W (44-20),22,34,64.7,300,1,44,226,5.1,4,78,526,6.7,13,12,2,27,8,64,0,0,0
153,3,2015-09-19,miami-fl,,Nebraska,W (36-33),25,42,59.5,379,2,33,132,4.0,1,75,511,6.8,18,4,2,24,13,114,0,1,1
154,4,2015-10-01,miami-fl,@,Cincinnati,L (23-34),25,40,62.5,281,0,32,146,4.6,2,72,427,5.9,12,7,2,21,6,50,0,0,0
155,5,2015-10-10,miami-fl,@,Florida State,L (24-29),29,49,59.2,405,3,19,20,1.1,0,68,425,6.3,17,2,0,19,7,73,0,0,0
156,6,2015-10-17,miami-fl,,Virginia Tech,W (30-20),19,30,63.3,296,2,39,99,2.5,1,69,395,5.7,12,5,3,20,9,81,0,0,0
157,7,2015-10-24,miami-fl,,Clemson,L (0-58),13,32,40.6,93,0,29,53,1.8,0,61,146,2.4,2,4,0,6,7,88,0,3,3
158,8,2015-10-31,miami-fl,@,Duke,W (30-27),20,29,69.0,272,2,39,119,3.1,0,68,391,5.8,12,7,2,21,23,194,1,1,2
159,9,2015-11-07,miami-fl,,Virginia,W (27-21),20,26,76.9,286,2,33,143,4.3,1,59,429,7.3,9,7,2,18,7,52,0,1,1
160,10,2015-11-14,miami-fl,@,North Carolina,L (21-59),24,43,55.8,326,1,32,99,3.1,2,75,425,5.7,17,6,2,25,12,103,1,1,2
161,11,2015-11-21,miami-fl,,Georgia Tech,W (38-21),16,26,61.5,300,1,28,86,3.1,3,54,386,7.1,11,4,0,15,9,76,0,0,0
162,12,2015-11-27,miami-fl,@,Pittsburgh,W (29-24),21,35,60.0,261,1,40,116,2.9,1,75,377,5.0,10,8,2,20,7,64,0,0,0
163,13,2015-12-26,miami-fl,N,Washington State*,L (14-20),17,32,53.1,219,1,30,125,4.2,1,62,344,5.5,9,4,0,13,9,105,1,2,3
164,,13 Games,miami-fl,,,,268,449,59.7,3602,18,424,1559,3.7,19,873,5161,5.9,152,79,18,249,121,1094,4,9,13
165,1,2016-09-03,miami-fl,,Florida A&M,W (70-3),13,21,61.9,150,4,36,373,10.4,5,57,523,9.2,8,13,1,22,6,54,1,0,1
166,2,2016-09-10,miami-fl,,Florida Atlantic,W (38-10),17,31,54.8,191,0,39,279,7.2,5,70,470,6.7,8,13,0,21,9,90,0,2,2
167,3,2016-09-17,miami-fl,@,Appalachian State,W (45-10),22,28,78.6,385,3,31,164,5.3,3,59,549,9.3,15,3,0,18,9,73,0,1,1
168,4,2016-10-01,miami-fl,@,Georgia Tech,W (35-21),13,19,68.4,241,1,27,114,4.2,2,46,355,7.7,10,7,1,18,4,39,0,0,0
169,5,2016-10-08,miami-fl,,Florida State,L (19-20),19,32,59.4,214,2,28,62,2.2,0,60,276,4.6,10,5,5,20,10,110,0,1,1
170,6,2016-10-15,miami-fl,,North Carolina,L (13-20),16,32,50.0,224,0,36,139,3.9,1,68,363,5.3,10,6,1,17,4,43,1,0,1
171,7,2016-10-20,miami-fl,@,Virginia Tech,L (16-37),23,38,60.5,323,2,29,42,1.4,0,67,365,5.4,12,3,0,15,6,62,0,1,1
172,8,2016-10-29,miami-fl,@,Notre Dame,L (27-30),26,42,61.9,288,1,35,18,0.5,1,77,306,4.0,15,3,2,20,10,86,0,1,1
173,9,2016-11-05,miami-fl,,Pittsburgh,W (51-28),32,47,68.1,356,4,36,178,4.9,2,83,534,6.4,15,7,0,22,8,71,0,0,0
174,10,2016-11-12,miami-fl,@,Virginia,W (34-14),14,29,48.3,228,2,42,222,5.3,2,71,450,6.3,6,12,2,20,7,45,1,1,2
175,11,2016-11-19,miami-fl,@,North Carolina State,W (27-13),22,38,57.9,286,0,32,129,4.0,3,70,415,5.9,14,8,2,24,6,45,0,0,0
176,12,2016-11-26,miami-fl,,Duke,W (40-21),22,35,62.9,396,4,30,172,5.7,0,65,568,8.7,11,11,2,24,8,69,0,0,0
177,13,2016-12-28,miami-fl,N,West Virginia*,W (31-14),24,34,70.6,282,4,34,81,2.4,0,68,363,5.3,14,4,2,20,8,89,0,0,0
178,,13 Games,miami-fl,,,,263,426,61.7,3564,27,435,1973,4.5,24,861,5537,6.4,148,95,18,261,95,876,3,7,10
179,1,2017-09-02,miami-fl,,Bethune-Cookman,W (41-13),18,31,58.1,233,3,34,317,9.3,2,65,550,8.5,11,15,2,28,7,68,0,0,0
180,2,2017-09-23,miami-fl,,Toledo,W (52-30),27,36,75.0,333,3,26,254,9.8,4,62,587,9.5,13,12,2,27,8,75,0,1,1
181,3,2017-09-29,miami-fl,@,Duke,W (31-6),15,26,57.7,270,2,35,139,4.0,2,61,409,6.7,9,8,2,19,5,59,0,1,1
182,4,2017-10-07,miami-fl,@,Florida State,W (24-20),19,44,43.2,254,3,29,83,2.9,0,73,337,4.6,12,6,2,20,6,79,0,1,1
183,5,2017-10-14,miami-fl,,Georgia Tech,W (25-24),23,38,60.5,297,1,36,184,5.1,1,74,481,6.5,12,12,0,24,6,45,0,0,0
184,6,2017-10-21,miami-fl,,Syracuse,W (27-19),26,43,60.5,344,2,32,136,4.3,1,75,480,6.4,14,7,1,22,5,42,1,0,1
185,7,2017-10-28,miami-fl,@,North Carolina,W (24-19),17,41,41.5,356,3,32,59,1.8,0,73,415,5.7,10,4,2,16,5,60,1,1,2
186,8,2017-11-04,miami-fl,,Virginia Tech,W (28-10),12,24,50.0,219,2,33,211,6.4,2,57,430,7.5,11,7,3,21,7,66,0,3,3
187,9,2017-11-11,miami-fl,,Notre Dame,W (41-8),15,24,62.5,137,1,42,237,5.6,3,66,374,5.7,6,11,1,18,1,5,0,0,0
188,10,2017-11-18,miami-fl,,Virginia,W (44-28),15,28,53.6,210,3,32,148,4.6,2,60,358,6.0,10,5,0,15,4,40,0,2,2
189,11,2017-11-24,miami-fl,@,Pittsburgh,L (14-24),15,36,41.7,187,2,23,45,2.0,0,59,232,3.9,9,4,1,14,6,52,1,0,1
190,12,2017-12-02,miami-fl,N,Clemson,L (3-38),14,29,48.3,110,0,30,104,3.5,0,59,214,3.6,3,7,0,10,4,30,1,2,3
191,13,2017-12-30,miami-fl,,Wisconsin*,L (24-34),11,26,42.3,203,1,29,174,6.0,2,55,377,6.9,8,8,1,17,4,20,0,3,3
192,,13 Games,miami-fl,,,,227,426,53.3,3153,26,413,2091,5.1,19,839,5244,6.3,128,106,17,251,68,641,4,14,18
193,1,2018-09-02,miami-fl,N,Louisiana State,L (17-33),15,35,42.9,259,1,34,83,2.4,1,69,342,5.0,9,6,3,18,11,85,0,2,2
194,2,2018-09-08,miami-fl,,Savannah State,W (77-0),19,31,61.3,255,5,37,239,6.5,5,68,494,7.3,8,11,1,20,1,15,1,1,2
195,3,2018-09-15,miami-fl,@,Toledo,W (49-24),13,23,56.5,205,2,53,268,5.1,5,76,473,6.2,7,16,1,24,0,0,0,0,0
196,4,2018-09-22,miami-fl,,Florida International,W (31-17),20,29,69.0,240,3,49,248,5.1,1,78,488,6.3,11,15,1,27,6,60,1,1,2
197,5,2018-09-27,miami-fl,,North Carolina,W (47-10),8,12,66.7,125,1,34,229,6.7,2,46,354,7.7,4,10,0,14,7,65,1,1,2
198,6,2018-10-06,miami-fl,,Florida State,W (28-27),13,32,40.6,204,4,46,102,2.2,0,78,306,3.9,8,9,3,20,6,50,1,0,1
199,7,2018-10-13,miami-fl,@,Virginia,L (13-16),15,29,51.7,190,0,29,149,5.1,1,58,339,5.8,9,6,1,16,8,71,0,3,3
200,8,2018-10-26,miami-fl,@,Boston College,L (14-27),19,39,48.7,150,1,36,155,4.3,1,75,305,4.1,8,10,1,19,6,28,0,2,2
201,9,2018-11-03,miami-fl,,Duke,L (12-20),13,28,46.4,111,0,44,300,6.8,2,72,411,5.7,5,10,1,16,6,73,2,0,2
202,10,2018-11-10,miami-fl,@,Georgia Tech,L (21-27),14,23,60.9,165,0,30,134,4.5,3,53,299,5.6,6,7,0,13,7,49,3,0,3
203,11,2018-11-17,miami-fl,@,Virginia Tech,W (38-14),21,34,61.8,171,2,32,168,5.3,2,66,339,5.1,7,8,2,17,11,71,0,0,0
204,,11 Games,miami-fl,,,,170,315,54.0,2075,19,424,2075,4.9,23,739,4150,5.6,82,108,14,204,69,567,9,10,19
205,1,2014-08-30,clemson,@,Georgia,L (21-45),18,33,54.5,203,1,43,88,2.0,2,76,291,3.8,7,6,2,15,3,40,0,1,1
206,2,2014-09-06,clemson,,South Carolina State,W (73-7),32,42,76.2,467,4,51,268,5.3,4,93,735,7.9,17,15,0,32,1,5,1,0,1
207,3,2014-09-20,clemson,@,Florida State,L (17-23),22,33,66.7,306,0,40,101,2.5,2,73,407,5.6,12,4,1,17,3,30,1,0,1
208,4,2014-09-27,clemson,,North Carolina,W (50-35),28,39,71.8,436,6,44,92,2.1,0,83,528,6.4,16,6,5,27,4,19,0,1,1
209,5,2014-10-04,clemson,,North Carolina State,W (41-0),17,30,56.7,267,2,50,226,4.5,2,80,493,6.2,11,13,1,25,9,103,0,0,0
210,6,2014-10-11,clemson,,Louisville,W (23-17),22,39,56.4,157,0,33,72,2.2,0,72,229,3.2,7,5,0,12,3,14,0,2,2
211,7,2014-10-18,clemson,@,Boston College,W (17-13),29,46,63.0,285,0,35,113,3.2,2,81,398,4.9,16,6,0,22,4,30,0,0,0
212,8,2014-10-25,clemson,,Syracuse,W (16-6),24,35,68.6,209,1,48,166,3.5,0,83,375,4.5,12,10,1,23,2,15,2,2,4
213,9,2014-11-06,clemson,@,Wake Forest,W (34-20),27,42,64.3,282,3,37,145,3.9,1,79,427,5.4,11,7,2,20,8,75,1,1,2
214,10,2014-11-15,clemson,@,Georgia Tech,L (6-28),11,21,52.4,59,0,33,131,4.0,0,54,190,3.5,3,7,0,10,3,21,0,3,3
215,11,2014-11-22,clemson,,Georgia State,W (28-0),21,33,63.6,148,1,43,209,4.9,3,76,357,4.7,10,11,1,22,4,40,1,1,2
216,12,2014-11-29,clemson,,South Carolina,W (35-17),15,21,71.4,266,2,40,225,5.6,3,61,491,8.0,9,10,1,20,4,44,0,1,1
217,13,2014-12-29,clemson,N,Oklahoma*,W (40-6),26,37,70.3,319,3,42,68,1.6,1,79,387,4.9,14,5,3,22,4,20,0,0,0
218,,13 Games,clemson,,,,292,451,64.7,3404,23,539,1904,3.5,20,990,5308,5.4,145,105,17,267,52,456,6,12,18
219,1,2015-09-05,clemson,,Wofford,W (49-10),30,37,81.1,311,2,43,222,5.2,5,80,533,6.7,14,12,1,27,6,55,2,0,2
220,2,2015-09-12,clemson,,Appalachian State,W (41-10),21,31,67.7,252,3,44,140,3.2,1,75,392,5.2,12,8,2,22,9,75,0,2,2
221,3,2015-09-17,clemson,@,Louisville,W (20-17),21,30,70.0,199,2,40,202,5.1,0,70,401,5.7,10,10,0,20,6,53,0,2,2
222,4,2015-10-03,clemson,,Notre Dame,W (24-22),11,22,50.0,97,2,42,199,4.7,1,64,296,4.6,6,8,1,15,5,44,0,1,1
223,5,2015-10-10,clemson,,Georgia Tech,W (43-24),23,33,69.7,336,2,41,201,4.9,3,74,537,7.3,15,7,2,24,4,45,2,1,3
224,6,2015-10-17,clemson,,Boston College,W (34-17),27,42,64.3,420,3,36,112,3.1,1,78,532,6.8,15,5,4,24,6,45,0,2,2
225,7,2015-10-24,clemson,@,Miami (FL),W (58-0),17,25,68.0,151,1,63,416,6.6,6,88,567,6.4,10,19,4,33,4,29,1,0,1
226,8,2015-10-31,clemson,@,North Carolina State,W (56-41),23,30,76.7,383,5,50,240,4.8,2,80,623,7.8,15,12,0,27,6,39,1,0,1
227,9,2015-11-07,clemson,,Florida State,W (23-13),28,43,65.1,297,1,42,215,5.1,1,85,512,6.0,16,10,3,29,3,32,0,0,0
228,10,2015-11-14,clemson,@,Syracuse,W (37-27),34,47,72.3,360,2,37,210,5.7,2,84,570,6.8,15,10,4,29,8,69,2,1,3
229,11,2015-11-21,clemson,,Wake Forest,W (33-13),28,40,70.0,381,3,42,171,4.1,1,82,552,6.7,16,6,2,24,6,56,1,3,4
230,12,2015-11-28,clemson,@,South Carolina,W (37-32),20,27,74.1,279,1,47,236,5.0,4,74,515,7.0,11,14,0,25,1,5,3,0,3
231,13,2015-12-05,clemson,N,North Carolina,W (45-37),26,42,61.9,289,3,56,319,5.7,3,98,608,6.2,13,18,2,33,11,80,0,1,1
232,14,2015-12-31,clemson,N,Oklahoma*,W (37-17),17,32,53.1,218,1,58,312,5.4,3,90,530,5.9,10,17,3,30,5,40,0,1,1
233,15,2016-01-11,clemson,N,Alabama*,L (40-45),30,47,63.8,405,4,38,145,3.8,1,85,550,6.5,20,9,2,31,4,27,0,1,1
234,,15 Games,clemson,,,,356,528,67.4,4378,35,679,3340,4.9,34,1207,7718,6.4,198,165,30,393,84,694,12,15,27
235,1,2016-09-03,clemson,@,Auburn,W (19-13),19,34,55.9,248,1,44,151,3.4,1,78,399,5.1,9,7,3,19,6,55,1,1,2
236,2,2016-09-10,clemson,,Troy,W (30-24),27,53,50.9,292,3,32,122,3.8,0,85,414,4.9,13,8,3,24,7,71,1,2,3
237,3,2016-09-17,clemson,,South Carolina State,W (59-0),27,35,77.1,328,5,43,227,5.3,2,78,555,7.1,15,10,2,27,7,59,0,0,0
238,4,2016-09-22,clemson,@,Georgia Tech,W (26-7),32,48,66.7,304,2,34,138,4.1,1,82,442,5.4,15,9,0,24,10,80,0,1,1
239,5,2016-10-01,clemson,,Louisville,W (42-36),20,31,64.5,306,5,31,201,6.5,1,62,507,8.2,15,8,3,26,6,59,2,3,5
240,6,2016-10-07,clemson,@,Boston College,W (56-10),16,26,61.5,278,4,35,230,6.6,3,61,508,8.3,11,7,3,21,4,18,1,0,1
241,7,2016-10-15,clemson,,North Carolina State,W (24-17),39,52,75.0,378,2,38,126,3.3,1,90,504,5.6,20,7,3,30,5,40,3,1,4
242,8,2016-10-29,clemson,@,Florida State,W (37-34),27,43,62.8,378,2,38,133,3.5,2,81,511,6.3,16,7,2,25,9,84,0,2,2
243,9,2016-11-05,clemson,,Syracuse,W (54-0),27,40,67.5,370,4,44,195,4.4,2,84,565,6.7,16,11,1,28,3,30,0,0,0
244,10,2016-11-12,clemson,,Pittsburgh,L (42-43),52,70,74.3,580,3,25,50,2.0,3,95,630,6.6,31,0,2,33,9,101,0,3,3
245,11,2016-11-19,clemson,@,Wake Forest,W (35-13),23,33,69.7,202,1,42,254,6.0,4,75,456,6.1,9,11,1,21,6,33,1,0,1
246,12,2016-11-26,clemson,,South Carolina,W (56-7),30,36,83.3,372,6,53,250,4.7,2,89,622,7.0,20,17,3,41,7,75,0,1,1
247,13,2016-12-03,clemson,N,Virginia Tech,W (42-35),23,34,67.6,288,3,41,182,4.4,3,75,470,6.3,14,11,5,30,8,65,0,1,1
248,14,2016-12-31,clemson,N,Ohio State,W (31-0),24,37,64.9,265,1,48,205,4.3,3,85,470,5.5,12,12,0,24,5,60,0,2,2
249,15,2017-01-09,clemson,N,Alabama,W (35-31),36,57,63.2,420,3,42,91,2.2,2,99,511,5.2,19,8,4,31,3,35,2,0,2
250,,15 Games,clemson,,,,422,629,67.1,5009,45,590,2555,4.3,30,1219,7564,6.2,235,133,35,404,95,865,11,17,28
251,1,2017-09-02,clemson,,Kent State,W (56-3),25,34,73.5,312,2,42,366,8.7,6,76,678,8.9,14,15,5,34,4,45,0,1,1
252,2,2017-09-09,clemson,,Auburn,W (14-6),20,31,64.5,185,0,36,96,2.7,2,67,281,4.2,10,6,2,18,8,60,2,0,2
253,3,2017-09-16,clemson,@,Louisville,W (47-21),23,33,69.7,316,1,48,297,6.2,4,81,613,7.6,12,13,0,25,4,30,0,0,0
254,4,2017-09-23,clemson,,Boston College,W (34-7),17,26,65.4,140,0,58,342,5.9,5,84,482,5.7,8,19,0,27,2,10,0,2,2
255,5,2017-09-30,clemson,@,Virginia Tech,W (31-17),12,21,57.1,186,1,43,146,3.4,2,64,332,5.2,5,8,1,14,4,20,0,0,0
256,6,2017-10-07,clemson,,Wake Forest,W (28-14),29,41,70.7,263,2,48,190,4.0,2,89,453,5.1,13,12,0,25,9,79,1,1,2
257,7,2017-10-13,clemson,@,Syracuse,L (24-27),22,32,68.8,204,0,25,113,4.5,2,57,317,5.6,11,4,1,16,11,119,0,0,0
258,8,2017-10-28,clemson,,Georgia Tech,W (24-10),22,33,66.7,207,2,45,221,4.9,1,78,428,5.5,9,12,0,21,5,45,1,0,1
259,9,2017-11-04,clemson,@,North Carolina State,W (38-31),20,38,52.6,191,1,35,224,6.4,3,73,415,5.7,10,5,4,19,3,23,0,1,1
260,10,2017-11-11,clemson,,Florida State,W (31-14),20,30,66.7,151,0,52,227,4.4,4,82,378,4.6,10,12,2,24,7,80,2,0,2
261,11,2017-11-18,clemson,,Citadel,W (61-3),31,41,75.6,479,5,26,183,7.0,3,67,662,9.9,19,7,1,27,4,30,0,0,0
262,12,2017-11-25,clemson,@,South Carolina,W (34-10),25,38,65.8,285,2,45,184,4.1,2,83,469,5.7,12,12,3,27,2,25,0,2,2
263,13,2017-12-02,clemson,N,Miami (FL),W (38-3),25,34,73.5,254,1,41,77,1.9,4,75,331,4.4,13,5,0,18,2,13,1,0,1
264,14,2018-01-01,clemson,N,Alabama*,L (6-24),18,37,48.6,124,0,33,64,1.9,0,70,188,2.7,8,5,0,14,4,29,0,2,2
265,,14 Games,clemson,,,,309,469,65.9,3297,17,577,2730,4.7,40,1046,6027,5.8,154,135,19,309,69,608,7,9,16
266,1,2018-09-01,clemson,,Furman,W (48-7),22,35,62.9,277,4,34,266,7.8,2,69,543,7.9,15,8,0,23,0,0,0,0,0
267,2,2018-09-08,clemson,@,Texas A&M,W (28-26),17,27,63.0,298,2,32,115,3.6,2,59,413,7.0,7,6,1,14,4,49,0,0,0
268,3,2018-09-15,clemson,,Georgia Southern,W (38-7),21,31,67.7,286,1,46,309,6.7,4,77,595,7.7,14,13,0,27,7,65,1,2,3
269,4,2018-09-22,clemson,@,Georgia Tech,W (49-21),19,30,63.3,232,4,36,248,6.9,2,66,480,7.3,10,14,1,25,6,68,0,2,2
270,5,2018-09-29,clemson,,Syracuse,W (27-23),17,29,58.6,176,0,53,293,5.5,3,82,469,5.7,8,19,1,28,3,16,2,1,3
271,6,2018-10-06,clemson,@,Wake Forest,W (63-3),25,30,83.3,227,3,40,471,11.8,6,70,698,10.0,8,12,2,22,3,28,1,0,1
272,7,2018-10-20,clemson,,North Carolina State,W (41-7),32,48,66.7,380,1,32,91,2.8,4,80,471,5.9,19,4,1,24,8,67,1,0,1
273,8,2018-10-27,clemson,@,Florida State,W (59-10),24,44,54.5,404,5,33,120,3.6,3,77,524,6.8,16,6,3,25,5,50,0,1,1
274,9,2018-11-03,clemson,,Louisville,W (77-16),14,20,70.0,169,5,37,492,13.3,5,57,661,11.6,8,17,2,28,3,15,1,1,2
275,10,2018-11-10,clemson,@,Boston College,W (27-7),29,41,70.7,295,1,30,129,4.3,1,71,424,6.0,13,5,1,19,2,15,1,1,2
276,11,2018-11-17,clemson,,Duke,W (35-6),21,39,53.8,251,2,36,208,5.8,3,75,459,6.1,12,12,1,25,7,54,0,0,0
277,,11 Games,clemson,,,,241,374,64.4,2995,28,409,2742,6.7,35,783,5737,7.3,130,116,13,260,48,427,7,8,15
278,1,2014-09-01,louisville,,Miami (FL),W (31-13),20,28,71.4,206,2,43,130,3.0,1,71,336,4.7,10,11,0,21,7,57,2,0,2
279,2,2014-09-06,louisville,,Murray State,W (66-21),25,39,64.1,278,3,49,325,6.6,6,88,603,6.9,13,15,3,31,3,19,0,0,0
280,3,2014-09-13,louisville,@,Virginia,L (21-23),20,43,46.5,203,2,27,79,2.9,1,70,282,4.0,9,6,2,17,7,50,2,2,4
281,4,2014-09-20,louisville,@,Florida International,W (34-3),20,36,55.6,324,2,35,12,0.3,1,71,336,4.7,9,6,1,16,7,36,2,0,2
282,5,2014-09-27,louisville,,Wake Forest,W (20-10),16,32,50.0,206,0,49,215,4.4,2,81,421,5.2,9,11,1,21,11,89,3,0,3
283,6,2014-10-03,louisville,@,Syracuse,W (28-6),12,22,54.5,174,1,48,178,3.7,2,70,352,5.0,6,11,1,18,9,75,1,1,2
284,7,2014-10-11,louisville,@,Clemson,L (17-23),15,30,50.0,212,1,38,52,1.4,1,68,264,3.9,6,3,1,10,11,65,2,0,2
285,8,2014-10-18,louisville,,North Carolina State,W (30-18),21,36,58.3,203,2,33,166,5.0,1,69,369,5.3,10,11,0,21,4,33,0,0,0
286,9,2014-10-30,louisville,,Florida State,L (31-42),20,38,52.6,330,1,33,158,4.8,3,71,488,6.9,14,9,1,24,3,14,1,1,2
287,10,2014-11-08,louisville,@,Boston College,W (38-19),17,24,70.8,257,2,40,166,4.2,3,64,423,6.6,10,9,2,21,10,87,1,0,1
288,11,2014-11-22,louisville,@,Notre Dame,W (31-28),8,21,38.1,180,1,50,229,4.6,3,71,409,5.8,7,14,2,23,8,57,0,1,1
289,12,2014-11-29,louisville,,Kentucky,W (44-40),22,35,62.9,389,3,39,83,2.1,3,74,472,6.4,16,4,2,22,3,15,2,2,4
290,13,2014-12-30,louisville,N,Georgia*,L (14-37),21,44,47.7,314,1,27,62,2.3,1,71,376,5.3,14,6,0,20,7,44,0,3,3
291,,13 Games,louisville,,,,237,428,55.4,3276,21,511,1855,3.6,28,939,5131,5.5,133,116,16,265,90,641,16,10,26
292,1,2015-09-05,louisville,N,Auburn,L (24-31),17,33,51.5,167,0,48,238,5.0,3,81,405,5.0,9,17,1,27,5,35,1,1,2
293,2,2015-09-12,louisville,,Houston,L (31-34),27,45,60.0,325,2,26,70,2.7,2,71,395,5.6,15,7,3,25,9,80,2,2,4
294,3,2015-09-17,louisville,,Clemson,L (17-20),20,35,57.1,253,0,28,19,0.7,1,63,272,4.3,10,3,3,16,2,15,0,2,2
295,4,2015-09-26,louisville,,Samford,W (45-3),18,28,64.3,274,2,46,288,6.3,4,74,562,7.6,13,12,0,25,9,89,0,2,2
296,5,2015-10-03,louisville,@,North Carolina State,W (20-13),10,27,37.0,103,1,45,203,4.5,1,72,306,4.3,7,10,3,20,6,50,0,0,0
297,6,2015-10-17,louisville,@,Florida State,L (21-41),20,35,57.1,307,3,30,99,3.3,0,65,406,6.2,13,6,1,20,9,84,1,1,2
298,7,2015-10-24,louisville,,Boston College,W (17-14),15,26,57.7,230,0,48,135,2.8,1,74,365,4.9,10,8,0,18,8,49,2,2,4
299,8,2015-10-30,louisville,@,Wake Forest,W (20-19),23,32,71.9,249,2,42,68,1.6,0,74,317,4.3,12,3,2,17,10,89,1,0,1
300,9,2015-11-07,louisville,,Syracuse,W (41-17),24,36,66.7,362,3,31,217,7.0,1,67,579,8.6,12,11,0,23,9,84,3,1,4
301,10,2015-11-14,louisville,,Virginia,W (38-31),11,22,50.0,159,2,37,266,7.2,3,59,425,7.2,9,11,3,23,5,53,2,0,2
302,11,2015-11-21,louisville,@,Pittsburgh,L (34-45),20,38,52.6,355,3,24,-1,0.0,1,62,354,5.7,13,2,2,17,8,50,0,1,1
303,12,2015-11-28,louisville,@,Kentucky,W (38-24),10,26,38.5,175,1,40,314,7.9,4,66,489,7.4,6,13,1,20,7,46,0,3,3
304,13,2015-12-30,louisville,N,Texas A&M*,W (27-21),12,26,46.2,227,2,46,307,6.7,2,72,534,7.4,7,12,2,21,10,90,0,0,0
305,,13 Games,louisville,,,,227,409,55.5,3186,21,491,2223,4.5,23,900,5409,6.0,136,115,21,272,97,814,12,15,27
306,1,2016-09-01,louisville,,UNC Charlotte,W (70-14),26,35,74.3,391,8,35,272,7.8,2,70,663,9.5,20,14,4,38,10,49,2,1,3
307,2,2016-09-09,louisville,@,Syracuse,W (62-28),21,40,52.5,431,1,41,414,10.1,7,81,845,10.4,16,13,1,30,9,100,2,1,3
308,3,2016-09-17,louisville,,Florida State,W (63-20),13,20,65.0,216,1,46,314,6.8,7,66,530,8.0,8,13,3,24,5,56,0,1,1
309,4,2016-09-24,louisville,@,Marshall,W (59-28),24,44,54.5,417,5,41,273,6.7,3,85,690,8.1,14,15,4,33,12,143,2,1,3
310,5,2016-10-01,louisville,@,Clemson,L (36-42),27,44,61.4,295,1,55,273,5.0,3,99,568,5.7,12,16,3,31,11,104,2,1,3
311,6,2016-10-14,louisville,,Duke,W (24-14),13,26,50.0,181,1,35,288,8.2,2,61,469,7.7,6,14,1,21,4,32,1,0,1
312,7,2016-10-22,louisville,,North Carolina State,W (54-13),21,36,58.3,390,3,44,163,3.7,3,80,553,6.9,12,10,2,24,12,94,2,0,2
313,8,2016-10-29,louisville,@,Virginia,W (32-25),24,41,58.5,361,4,34,147,4.3,0,75,508,6.8,16,10,1,27,7,68,1,1,2
314,9,2016-11-05,louisville,@,Boston College,W (52-7),19,29,65.5,305,4,36,210,5.8,3,65,515,7.9,13,6,3,22,0,0,2,1,3
315,10,2016-11-12,louisville,,Wake Forest,W (44-12),14,26,53.8,145,1,37,346,9.4,4,63,491,7.8,7,13,0,20,4,55,3,0,3
316,11,2016-11-17,louisville,@,Houston,L (10-36),20,43,46.5,211,1,40,101,2.5,0,83,312,3.8,8,10,0,18,15,114,3,0,3
317,12,2016-11-26,louisville,,Kentucky,L (38-41),16,25,64.0,281,2,46,280,6.1,3,71,561,7.9,12,14,0,26,4,48,1,3,4
318,13,2016-12-31,louisville,N,Louisiana State*,L (9-29),10,27,37.0,153,0,35,67,1.9,0,62,220,3.5,6,4,1,11,8,56,1,0,1
319,,13 Games,louisville,,,,248,436,56.9,3777,32,525,3148,6.0,37,961,6925,7.2,150,152,23,325,101,919,22,10,32
320,1,2017-09-02,louisville,N,Purdue,W (35-28),30,46,65.2,378,2,33,146,4.4,1,79,524,6.6,16,8,3,27,16,110,3,0,3
321,2,2017-09-09,louisville,@,North Carolina,W (47-35),25,39,64.1,393,3,44,312,7.1,3,83,705,8.5,18,15,2,35,6,61,0,0,0
322,3,2017-09-16,louisville,,Clemson,L (21-47),21,42,50.0,317,3,27,116,4.3,0,69,433,6.3,13,7,1,21,4,35,0,1,1
323,4,2017-09-23,louisville,,Kent State,W (42-3),23,30,76.7,374,2,27,165,6.1,3,57,539,9.5,12,9,2,23,4,30,2,2,4
324,5,2017-09-30,louisville,,Murray State,W (55-10),32,45,71.1,364,4,46,312,6.8,3,91,676,7.4,18,16,4,38,7,69,2,0,2
325,6,2017-10-05,louisville,@,North Carolina State,L (25-39),26,48,54.2,354,1,29,116,4.0,2,77,470,6.1,12,12,1,25,10,69,0,1,1
326,7,2017-10-14,louisville,,Boston College,L (42-45),19,39,48.7,332,2,36,293,8.1,4,75,625,8.3,12,13,0,25,4,30,1,1,2
327,8,2017-10-21,louisville,@,Florida State,W (31-28),13,21,61.9,156,1,44,293,6.7,3,65,449,6.9,7,14,1,22,2,13,1,0,1
328,9,2017-10-28,louisville,@,Wake Forest,L (32-42),28,46,60.9,332,1,42,191,4.5,3,88,523,5.9,19,10,1,30,0,0,0,1,1
329,10,2017-11-11,louisville,,Virginia,W (38-21),15,26,57.7,195,3,43,298,6.9,2,69,493,7.1,9,15,3,27,6,65,2,0,2
330,11,2017-11-18,louisville,,Syracuse,W (56-10),17,30,56.7,316,3,42,411,9.8,5,72,727,10.1,12,15,0,27,11,85,0,0,0
331,12,2017-11-25,louisville,@,Kentucky,W (44-17),15,21,71.4,216,2,43,346,8.0,3,64,562,8.8,11,16,5,32,6,55,0,0,0
332,13,2017-12-30,louisville,N,Mississippi State*,L (27-31),13,31,41.9,171,2,39,187,4.8,1,70,358,5.1,9,7,4,20,6,42,0,4,4
333,,13 Games,louisville,,,,277,464,59.7,3898,29,495,3186,6.4,33,959,7084,7.4,168,157,27,352,82,664,11,10,21
334,1,2018-09-01,louisville,N,Alabama,L (14-51),20,39,51.3,252,2,25,27,1.1,0,64,279,4.4,13,1,5,19,11,93,0,2,2
335,2,2018-09-08,louisville,,Indiana State,W (31-7),14,22,63.6,164,1,38,199,5.2,2,60,363,6.1,6,12,1,19,7,75,1,1,2
336,3,2018-09-15,louisville,,Western Kentucky,W (20-17),10,21,47.6,88,0,38,204,5.4,2,59,292,4.9,4,11,2,17,5,40,0,1,1
337,4,2018-09-22,louisville,@,Virginia,L (3-27),16,28,57.1,148,0,29,66,2.3,0,57,214,3.8,11,3,0,14,6,52,1,2,3
338,5,2018-09-29,louisville,,Florida State,L (24-28),24,45,53.3,306,2,38,115,3.0,1,83,421,5.1,11,11,2,24,8,75,1,2,3
339,6,2018-10-05,louisville,,Georgia Tech,L (31-66),27,44,61.4,370,3,23,113,4.9,1,67,483,7.2,14,7,2,23,4,35,2,1,3
340,7,2018-10-13,louisville,@,Boston College,L (20-38),17,35,48.6,170,0,32,47,1.5,3,67,217,3.2,10,4,1,15,4,33,0,1,1
341,8,2018-10-27,louisville,,Wake Forest,L (35-56),30,54,55.6,358,1,36,174,4.8,4,90,532,5.9,19,11,1,31,5,31,1,0,1
342,9,2018-11-03,louisville,@,Clemson,L (16-77),17,34,50.0,231,0,36,81,2.3,1,70,312,4.5,8,8,0,16,10,100,1,2,3
343,10,2018-11-09,louisville,@,Syracuse,L (23-54),14,31,45.2,210,1,39,203,5.2,2,70,413,5.9,7,9,2,18,17,125,2,2,4
344,11,2018-11-17,louisville,,North Carolina State,L (10-52),13,25,52.0,157,0,38,254,6.7,1,63,411,6.5,8,11,0,19,12,68,1,1,2
345,,11 Games,louisville,,,,202,378,53.4,2454,10,372,1483,4.0,17,750,3937,5.2,111,88,16,215,89,727,10,15,25
346,1,2014-08-30,georgia-tech,,Wofford,W (38-19),11,16,68.8,282,2,43,226,5.3,3,59,508,8.6,9,12,0,21,5,50,0,0,0
347,2,2014-09-06,georgia-tech,@,Tulane,W (38-21),3,8,37.5,15,0,57,344,6.0,4,65,359,5.5,2,20,2,24,4,35,2,1,3
348,3,2014-09-13,georgia-tech,,Georgia Southern,W (42-38),11,24,45.8,188,4,53,348,6.6,2,77,536,7.0,7,19,2,28,4,55,0,0,0
349,4,2014-09-20,georgia-tech,@,Virginia Tech,W (27-24),7,18,38.9,125,1,44,250,5.7,1,62,375,6.0,6,12,1,19,8,60,1,0,1
350,5,2014-10-04,georgia-tech,,Miami (FL),W (28-17),4,7,57.1,53,0,65,318,4.9,4,72,371,5.2,2,18,1,21,7,69,0,0,0
351,6,2014-10-11,georgia-tech,,Duke,L (25-31),14,26,53.8,201,0,46,282,6.1,3,72,483,6.7,9,17,0,26,8,69,1,2,3
352,7,2014-10-18,georgia-tech,@,North Carolina,L (43-48),8,18,44.4,235,3,51,376,7.4,3,69,611,8.9,7,22,0,29,5,32,1,0,1
353,8,2014-10-25,georgia-tech,@,Pittsburgh,W (56-28),5,12,41.7,147,1,64,465,7.3,7,76,612,8.1,4,23,0,27,3,15,1,0,1
354,9,2014-11-01,georgia-tech,,Virginia,W (35-10),7,13,53.8,141,3,63,268,4.3,2,76,409,5.4,6,15,2,23,4,30,0,1,1
355,10,2014-11-08,georgia-tech,@,North Carolina State,W (56-23),7,8,87.5,70,1,64,479,7.5,5,72,549,7.6,4,24,2,30,8,62,2,0,2
356,11,2014-11-15,georgia-tech,,Clemson,W (28-6),8,11,72.7,102,1,50,251,5.0,0,61,353,5.8,6,9,1,16,2,10,2,0,2
357,12,2014-11-29,georgia-tech,@,Georgia,W (30-24),6,16,37.5,64,1,70,399,5.7,3,86,463,5.4,4,27,1,32,5,24,2,0,2
358,13,2014-12-06,georgia-tech,N,Florida State,L (35-37),8,14,57.1,134,1,59,331,5.6,4,73,465,6.4,8,19,1,28,3,20,0,1,1
359,14,2014-12-31,georgia-tech,N,Mississippi State*,W (49-34),7,12,58.3,125,1,61,452,7.4,6,73,577,7.9,4,22,0,26,3,45,0,1,1
360,,14 Games,georgia-tech,,,,106,203,52.2,1882,19,790,4789,6.1,47,993,6671,6.7,78,259,13,350,69,576,12,6,18
361,1,2015-09-03,georgia-tech,,Alcorn State,W (69-6),4,5,80.0,77,1,52,476,9.2,9,57,553,9.7,4,20,2,26,0,0,1,0,1
362,2,2015-09-12,georgia-tech,,Tulane,W (65-10),8,10,80.0,132,3,56,439,7.8,6,66,571,8.7,7,21,0,28,2,24,1,0,1
363,3,2015-09-19,georgia-tech,@,Notre Dame,L (22-30),8,24,33.3,121,2,47,216,4.6,1,71,337,4.7,6,12,3,21,4,30,1,0,1
364,4,2015-09-26,georgia-tech,@,Duke,L (20-34),6,22,27.3,143,1,60,173,2.9,1,82,316,3.9,5,11,0,16,1,5,1,1,2
365,5,2015-10-03,georgia-tech,,North Carolina,L (31-38),12,21,57.1,162,1,59,255,4.3,3,80,417,5.2,8,17,2,27,4,39,1,1,2
366,6,2015-10-10,georgia-tech,@,Clemson,L (24-43),6,14,42.9,159,2,42,71,1.7,0,56,230,4.1,5,6,1,12,5,50,0,1,1
367,7,2015-10-17,georgia-tech,,Pittsburgh,L (28-31),6,15,40.0,106,1,40,376,9.4,3,55,482,8.8,3,15,1,19,5,54,1,1,2
368,8,2015-10-24,georgia-tech,,Florida State,W (22-16),4,10,40.0,67,0,49,261,5.3,1,59,328,5.6,2,12,1,15,5,41,0,2,2
369,9,2015-10-31,georgia-tech,@,Virginia,L (21-27),13,31,41.9,251,2,33,144,4.4,1,64,395,6.2,12,6,0,18,6,42,2,0,2
370,10,2015-11-12,georgia-tech,,Virginia Tech,L (21-23),4,13,30.8,97,0,47,161,3.4,2,60,258,4.3,4,6,5,15,3,26,3,0,3
371,11,2015-11-21,georgia-tech,@,Miami (FL),L (21-38),4,9,44.4,59,0,57,314,5.5,3,66,373,5.7,3,16,0,19,1,5,2,2,4
372,12,2015-11-28,georgia-tech,,Georgia,L (7-13),6,18,33.3,82,1,41,194,4.7,0,59,276,4.7,4,11,2,17,2,13,1,2,3
373,,12 Games,georgia-tech,,,,81,192,42.2,1456,14,583,3080,5.3,30,775,4536,5.9,63,153,17,233,38,329,14,10,24
374,1,2016-09-03,georgia-tech,N,Boston College,W (17-14),8,15,53.3,119,0,44,119,2.7,2,59,238,4.0,4,7,1,12,3,28,1,0,1
375,2,2016-09-10,georgia-tech,,Mercer,W (35-10),5,10,50.0,80,0,52,364,7.0,5,62,444,7.2,3,20,2,25,1,10,2,0,2
376,3,2016-09-17,georgia-tech,,Vanderbilt,W (38-7),8,16,50.0,222,2,46,289,6.3,3,62,511,8.2,5,14,2,21,4,55,0,1,1
377,4,2016-09-22,georgia-tech,,Clemson,L (7-26),4,14,28.6,29,0,38,95,2.5,1,52,124,2.4,1,7,3,11,2,15,0,1,1
378,5,2016-10-01,georgia-tech,,Miami (FL),L (21-35),11,19,57.9,94,1,54,267,4.9,2,73,361,4.9,5,17,0,22,4,41,2,1,3
379,6,2016-10-08,georgia-tech,@,Pittsburgh,L (34-37),7,10,70.0,130,1,45,241,5.4,2,55,371,6.7,5,13,0,18,5,46,0,0,0
380,7,2016-10-15,georgia-tech,,Georgia Southern,W (35-24),7,11,63.6,172,1,44,265,6.0,4,55,437,7.9,7,11,1,19,3,30,0,0,0
381,8,2016-10-29,georgia-tech,,Duke,W (38-35),10,14,71.4,264,2,47,341,7.3,3,61,605,9.9,9,11,0,20,8,46,2,0,2
382,9,2016-11-05,georgia-tech,@,North Carolina,L (20-48),4,9,44.4,144,1,59,374,6.3,1,68,518,7.6,4,19,1,24,4,26,2,0,2
383,10,2016-11-12,georgia-tech,@,Virginia Tech,W (30-20),2,7,28.6,34,0,58,309,5.3,3,65,343,5.3,1,12,2,15,7,35,1,0,1
384,11,2016-11-19,georgia-tech,,Virginia,W (31-17),5,10,50.0,122,1,31,199,6.4,2,41,321,7.8,4,4,0,8,4,50,0,0,0
385,12,2016-11-26,georgia-tech,@,Georgia,W (28-27),6,10,60.0,164,0,42,226,5.4,4,52,390,7.5,5,10,0,15,4,45,1,1,2
386,13,2016-12-31,georgia-tech,N,Kentucky*,W (33-18),6,14,42.9,105,0,51,266,5.2,2,65,371,5.7,4,15,2,21,8,74,0,0,0
387,,13 Games,georgia-tech,,,,83,159,52.2,1679,9,611,3355,5.5,34,770,5034,6.5,57,160,14,231,57,501,11,4,15
388,1,2017-09-04,georgia-tech,N,Tennessee,L (41-42),5,10,50.0,120,0,86,535,6.2,6,96,655,6.8,4,29,0,33,4,37,2,0,2
389,2,2017-09-09,georgia-tech,,Jacksonville State,W (37-10),5,7,71.4,112,3,49,210,4.3,2,56,322,5.8,5,8,4,17,8,70,0,0,0
390,3,2017-09-23,georgia-tech,,Pittsburgh,W (35-17),4,7,57.1,48,0,67,436,6.5,5,74,484,6.5,2,21,2,25,4,18,4,0,4
391,4,2017-09-30,georgia-tech,,North Carolina,W (33-7),5,10,50.0,53,1,66,403,6.1,3,76,456,6.0,3,18,1,22,1,5,2,0,2
392,5,2017-10-14,georgia-tech,@,Miami (FL),L (24-25),3,7,42.9,55,1,53,226,4.3,1,60,281,4.7,1,14,1,16,1,6,1,0,1
393,6,2017-10-21,georgia-tech,,Wake Forest,W (38-24),5,11,45.5,68,0,66,427,6.5,5,77,495,6.4,5,21,3,29,5,45,0,0,0
394,7,2017-10-28,georgia-tech,@,Clemson,L (10-24),3,13,23.1,32,0,43,198,4.6,1,56,230,4.1,2,7,1,10,2,20,1,0,1
395,8,2017-11-04,georgia-tech,@,Virginia,L (36-40),6,22,27.3,179,1,52,220,4.2,3,74,399,5.4,5,11,0,16,6,45,0,2,2
396,9,2017-11-11,georgia-tech,,Virginia Tech,W (28-22),2,8,25.0,140,2,57,261,4.6,2,65,401,6.2,2,15,2,19,5,45,0,1,1
397,10,2017-11-18,georgia-tech,@,Duke,L (20-43),3,14,21.4,82,1,47,277,5.9,2,61,359,5.9,2,13,0,15,5,63,0,1,1
398,11,2017-11-25,georgia-tech,,Georgia,L (7-38),2,9,22.2,38,1,46,188,4.1,0,55,226,4.1,1,11,0,12,3,40,0,1,1
399,,11 Games,georgia-tech,,,,43,118,36.4,927,10,632,3381,5.3,30,750,4308,5.7,32,168,14,214,44,394,10,5,15
400,1,2018-09-01,georgia-tech,,Alcorn State,W (41-0),9,18,50.0,104,1,54,439,8.1,4,72,543,7.5,4,20,1,25,3,30,2,1,3
401,2,2018-09-08,georgia-tech,@,South Florida,L (38-49),9,18,50.0,183,1,57,419,7.4,4,75,602,8.0,6,19,2,27,8,80,1,2,3
402,3,2018-09-15,georgia-tech,@,Pittsburgh,L (19-24),6,15,40.0,66,0,56,320,5.7,3,71,386,5.4,4,16,2,22,5,35,1,1,2
403,4,2018-09-22,georgia-tech,,Clemson,L (21-49),3,8,37.5,57,1,56,146,2.6,2,64,203,3.2,2,10,3,15,4,30,1,0,1
404,5,2018-09-29,georgia-tech,,Bowling Green State,W (63-17),5,7,71.4,160,0,49,372,7.6,7,56,532,9.5,5,16,2,23,3,54,0,0,0
405,6,2018-10-05,georgia-tech,@,Louisville,W (66-31),1,2,50.0,12,0,65,542,8.3,8,67,554,8.3,1,27,0,28,4,50,0,0,0
406,7,2018-10-13,georgia-tech,,Duke,L (14-28),7,17,41.2,125,1,61,229,3.8,1,78,354,4.5,5,14,1,20,3,18,3,0,3
407,8,2018-10-25,georgia-tech,@,Virginia Tech,W (49-28),0,1,0.0,0,0,78,465,6.0,7,79,465,5.9,0,31,4,35,6,50,0,0,0
408,9,2018-11-03,georgia-tech,@,North Carolina,W (38-28),2,2,100.0,104,1,74,461,6.2,4,76,565,7.4,2,24,1,27,3,20,3,0,3
409,10,2018-11-10,georgia-tech,,Miami (FL),W (27-21),3,4,75.0,73,1,53,231,4.4,2,57,304,5.3,3,12,0,15,3,35,1,0,1
410,11,2018-11-17,georgia-tech,,Virginia,W (30-27),1,8,12.5,37,0,52,268,5.2,1,60,305,5.1,1,11,1,13,3,25,0,0,0
411,,11 Games,georgia-tech,,,,46,100,46.0,921,6,655,3892,5.9,43,755,4813,6.4,33,200,17,250,45,427,12,4,16
412,1,2014-08-30,boston-college,N,Massachusetts,W (30-7),17,25,68.0,173,1,61,338,5.5,2,86,511,5.9,9,17,1,27,7,55,0,1,1
413,2,2014-09-05,boston-college,,Pittsburgh,L (20-30),10,28,35.7,134,1,34,142,4.2,2,62,276,4.5,5,9,1,15,3,25,0,2,2
414,3,2014-09-13,boston-college,,Southern California,W (37-31),5,14,35.7,54,0,54,452,8.4,5,68,506,7.4,2,17,0,19,2,25,0,1,1
415,4,2014-09-20,boston-college,,Maine,W (40-10),12,21,57.1,136,1,64,413,6.5,4,85,549,6.5,4,24,0,28,3,26,0,1,1
416,5,2014-09-27,boston-college,,Colorado State,L (21-24),12,18,66.7,169,0,49,239,4.9,3,67,408,6.1,9,9,3,21,5,35,0,1,1
417,6,2014-10-11,boston-college,@,North Carolina State,W (30-14),12,19,63.2,101,0,57,310,5.4,4,76,411,5.4,6,17,1,24,4,30,1,0,1
418,7,2014-10-18,boston-college,,Clemson,L (13-17),9,20,45.0,143,2,36,120,3.3,0,56,263,4.7,5,5,1,11,3,30,0,0,0
419,8,2014-10-25,boston-college,@,Wake Forest,W (23-17),11,15,73.3,165,1,44,202,4.6,2,59,367,6.2,7,11,2,20,7,54,1,0,1
420,9,2014-11-01,boston-college,@,Virginia Tech,W (33-31),8,15,53.3,110,2,47,258,5.5,2,62,368,5.9,3,7,1,11,3,20,0,0,0
421,10,2014-11-08,boston-college,,Louisville,L (19-38),9,20,45.0,166,1,43,166,3.9,2,63,332,5.3,7,7,4,18,5,45,0,4,4
422,11,2014-11-22,boston-college,@,Florida State,L (17-20),6,11,54.5,73,1,51,240,4.7,1,62,313,5.0,2,16,1,19,3,20,0,0,0
423,12,2014-11-29,boston-college,,Syracuse,W (28-7),13,17,76.5,160,1,49,142,2.9,2,66,302,4.6,10,7,2,19,4,36,1,0,1
424,13,2014-12-27,boston-college,N,Penn State*,L (30-31),11,20,55.0,97,2,46,289,6.3,2,66,386,5.8,4,11,1,16,9,97,0,0,0
425,,13 Games,boston-college,,,,135,243,55.6,1681,13,635,3311,5.2,31,878,4992,5.7,73,157,18,248,58,498,3,10,13
426,1,2015-09-05,boston-college,,Maine,W (24-3),14,25,56.0,155,1,49,204,4.2,2,74,359,4.9,10,9,2,21,5,35,0,0,0
427,2,2015-09-12,boston-college,,Howard,W (76-0),12,15,80.0,136,2,40,347,8.7,8,55,483,8.8,5,18,1,24,6,40,0,0,0
428,3,2015-09-18,boston-college,,Florida State,L (0-14),5,15,33.3,56,0,43,139,3.2,0,58,195,3.4,3,8,1,12,6,66,1,1,2
429,4,2015-09-26,boston-college,,Northern Illinois,W (17-14),5,14,35.7,92,1,63,234,3.7,1,77,326,4.2,4,13,1,18,5,55,0,1,1
430,5,2015-10-03,boston-college,@,Duke,L (7-9),8,21,38.1,141,1,41,164,4.0,0,62,305,4.9,5,8,0,13,6,60,1,0,1
431,6,2015-10-10,boston-college,,Wake Forest,L (0-3),6,20,30.0,74,0,54,196,3.6,0,74,270,3.6,3,10,5,18,9,51,3,1,4
432,7,2015-10-17,boston-college,@,Clemson,L (17-34),7,23,30.4,87,1,38,159,4.2,1,61,246,4.0,3,7,1,11,8,80,0,0,0
433,8,2015-10-24,boston-college,@,Louisville,L (14-17),9,22,40.9,93,0,30,-14,-0.5,1,52,79,1.5,3,1,0,4,4,25,1,0,1
434,9,2015-10-31,boston-college,,Virginia Tech,L (10-26),8,21,38.1,143,0,35,75,2.1,1,56,218,3.9,6,3,6,15,6,48,3,1,4
435,10,2015-11-07,boston-college,,North Carolina State,L (8-24),23,37,62.2,257,1,34,28,0.8,0,71,285,4.0,11,4,1,16,3,35,1,3,4
436,11,2015-11-21,boston-college,N,Notre Dame,L (16-19),12,22,54.5,88,1,36,214,5.9,1,58,302,5.2,5,7,1,13,9,75,1,0,1
437,12,2015-11-28,boston-college,@,Syracuse,L (17-20),1,13,7.7,9,0,40,230,5.8,2,53,239,4.5,1,8,0,9,11,119,0,2,2
438,,12 Games,boston-college,,,,110,248,44.4,1331,8,503,1976,3.9,17,751,3307,4.4,59,96,19,174,78,689,11,9,20
439,1,2016-09-03,boston-college,N,Georgia Tech,L (14-17),11,17,64.7,144,0,37,176,4.8,2,54,320,5.9,6,7,2,15,7,39,2,1,3
440,2,2016-09-10,boston-college,@,Massachusetts,W (26-7),12,22,54.5,191,2,41,153,3.7,1,63,344,5.5,8,6,0,14,5,45,0,1,1
441,3,2016-09-17,boston-college,@,Virginia Tech,L (0-49),9,29,31.0,80,0,28,44,1.6,0,57,124,2.2,4,2,0,6,12,93,1,1,2
442,4,2016-09-24,boston-college,,Wagner,W (42-10),12,20,60.0,190,2,56,300,5.4,4,76,490,6.4,9,14,0,23,7,85,0,0,0
443,5,2016-10-01,boston-college,,Buffalo,W (35-3),15,27,55.6,258,2,57,142,2.5,3,84,400,4.8,10,10,1,21,4,28,2,0,2
444,6,2016-10-07,boston-college,,Clemson,L (10-56),12,24,50.0,96,1,48,155,3.2,0,72,251,3.5,7,7,1,15,6,52,1,1,2
445,7,2016-10-22,boston-college,,Syracuse,L (20-28),7,20,35.0,64,0,40,223,5.6,1,60,287,4.8,4,8,4,16,8,66,1,1,2
446,8,2016-10-29,boston-college,@,North Carolina State,W (21-14),19,34,55.9,218,1,44,168,3.8,1,78,386,4.9,11,7,3,21,6,44,1,1,2
447,9,2016-11-05,boston-college,,Louisville,L (7-52),14,25,56.0,150,1,37,57,1.5,0,62,207,3.3,6,3,0,9,6,70,2,1,3
448,10,2016-11-11,boston-college,@,Florida State,L (7-45),4,13,30.8,50,0,35,96,2.7,1,48,146,3.0,2,4,2,8,6,50,0,0,0
449,11,2016-11-19,boston-college,,Connecticut,W (30-0),14,19,73.7,183,1,52,154,3.0,1,71,337,4.7,7,8,1,16,9,73,0,0,0
450,12,2016-11-26,boston-college,@,Wake Forest,W (17-14),10,23,43.5,74,1,39,93,2.4,1,62,167,2.7,6,4,0,10,8,55,1,0,1
451,13,2016-12-26,boston-college,N,Maryland*,W (36-30),11,23,47.8,171,3,52,177,3.4,1,75,348,4.6,7,8,0,15,6,46,1,1,2
452,,13 Games,boston-college,,,,150,296,50.7,1869,14,566,1938,3.4,16,862,3807,4.4,87,88,14,189,90,746,12,8,20
453,1,2017-09-01,boston-college,@,Northern Illinois,W (23-20),26,42,61.9,191,2,50,148,3.0,0,92,339,3.7,8,11,2,21,8,79,0,1,1
454,2,2017-09-09,boston-college,,Wake Forest,L (10-34),18,41,43.9,163,1,41,142,3.5,0,82,305,3.7,8,10,1,19,0,0,1,3,4
455,3,2017-09-16,boston-college,,Notre Dame,L (20-49),24,41,58.5,215,2,44,185,4.2,0,85,400,4.7,12,10,0,22,6,35,1,2,3
456,4,2017-09-23,boston-college,@,Clemson,L (7-34),15,32,46.9,141,0,34,97,2.9,1,66,238,3.6,6,5,1,12,2,20,0,2,2
457,5,2017-09-30,boston-college,,Central Michigan,W (28-8),14,21,66.7,85,1,53,224,4.2,3,74,309,4.2,4,10,3,17,6,43,2,0,2
458,6,2017-10-07,boston-college,,Virginia Tech,L (10-23),14,33,42.4,191,1,33,153,4.6,0,66,344,5.2,7,7,2,16,5,27,0,0,0
459,7,2017-10-14,boston-college,@,Louisville,W (45-42),12,28,42.9,191,1,59,364,6.2,5,87,555,6.4,11,16,0,27,1,10,0,1,1
460,8,2017-10-21,boston-college,@,Virginia,W (41-10),19,24,79.2,275,3,47,237,5.0,1,71,512,7.2,12,7,0,19,5,52,0,0,0
461,9,2017-10-27,boston-college,,Florida State,W (35-3),7,21,33.3,88,2,55,241,4.4,3,76,329,4.3,3,12,4,19,1,10,0,0,0
462,10,2017-11-11,boston-college,,North Carolina State,L (14-17),10,22,45.5,111,0,54,236,4.4,2,76,347,4.6,6,14,0,20,3,15,1,1,2
463,11,2017-11-18,boston-college,N,Connecticut,W (39-16),7,15,46.7,55,1,49,330,6.7,4,64,385,6.0,1,12,1,14,3,25,1,0,1
464,12,2017-11-25,boston-college,@,Syracuse,W (42-14),16,20,80.0,248,1,56,333,5.9,4,76,581,7.6,11,13,0,24,1,15,1,0,1
465,13,2017-12-27,boston-college,N,Iowa*,L (20-27),16,27,59.3,208,1,43,175,4.1,1,70,383,5.5,12,4,0,16,6,57,1,2,3
466,,13 Games,boston-college,,,,198,367,54.0,2162,16,618,2865,4.6,24,985,5027,5.1,101,131,14,246,47,388,8,12,20
467,1,2018-09-01,boston-college,,Massachusetts,W (55-21),21,27,77.8,326,4,59,273,4.6,3,86,599,7.0,14,16,1,31,7,38,0,0,0
468,2,2018-09-08,boston-college,,Holy Cross,W (62-14),16,20,80.0,245,4,52,365,7.0,4,72,610,8.5,8,14,0,22,5,40,1,0,1
469,3,2018-09-13,boston-college,@,Wake Forest,W (41-34),16,25,64.0,304,5,44,220,5.0,1,69,524,7.6,9,9,1,19,4,35,1,0,1
470,4,2018-09-22,boston-college,@,Purdue,L (13-30),15,29,51.7,144,1,34,85,2.5,1,63,229,3.6,7,7,0,14,7,60,0,4,4
471,5,2018-09-29,boston-college,,Temple,W (45-35),16,34,47.1,148,3,66,275,4.2,3,100,423,4.2,9,13,6,28,10,79,2,0,2
472,6,2018-10-06,boston-college,@,North Carolina State,L (23-28),14,25,56.0,198,1,25,120,4.8,1,50,318,6.4,6,6,0,12,6,37,1,0,1
473,7,2018-10-13,boston-college,,Louisville,W (38-20),16,22,72.7,179,1,61,251,4.1,3,83,430,5.2,6,14,0,20,7,60,2,0,2
474,8,2018-10-26,boston-college,,Miami (FL),W (27-14),17,30,56.7,210,1,53,223,4.2,2,83,433,5.2,10,11,1,22,8,70,0,1,1
475,9,2018-11-03,boston-college,@,Virginia Tech,W (31-21),15,26,57.7,177,1,49,219,4.5,3,75,396,5.3,8,10,1,19,4,39,1,0,1
476,10,2018-11-10,boston-college,,Clemson,L (7-27),14,24,58.3,104,0,33,9,0.3,0,57,113,2.0,6,2,0,8,6,42,0,0,0
477,11,2018-11-17,boston-college,@,Florida State,L (21-22),18,38,47.4,297,1,49,125,2.6,2,87,422,4.9,13,7,0,20,5,40,0,2,2
478,,11 Games,boston-college,,,,178,300,59.3,2332,22,525,2165,4.1,23,825,4497,5.5,96,109,10,215,69,540,8,7,15
479,1,2014-08-30,north-carolina,,Liberty,W (56-29),29,45,64.4,235,3,48,208,4.3,4,93,443,4.8,14,13,2,29,10,60,1,3,4
480,2,2014-09-06,north-carolina,,San Diego State,W (31-27),21,31,67.7,263,2,33,131,4.0,1,64,394,6.2,11,8,1,20,5,37,0,1,1
481,3,2014-09-20,north-carolina,@,East Carolina,L (41-70),24,43,55.8,294,3,39,145,3.7,2,82,439,5.4,14,8,1,23,8,85,0,1,1
482,4,2014-09-27,north-carolina,@,Clemson,L (35-50),30,49,61.2,394,4,30,84,2.8,1,79,478,6.1,13,8,1,22,15,130,0,1,1
483,5,2014-10-04,north-carolina,,Virginia Tech,L (17-34),18,37,48.6,198,1,29,125,4.3,1,66,323,4.9,8,8,0,16,10,62,2,1,3
484,6,2014-10-11,north-carolina,@,Notre Dame,L (43-50),25,42,59.5,326,3,42,190,4.5,2,84,516,6.1,17,10,3,30,9,94,1,1,2
485,7,2014-10-18,north-carolina,,Georgia Tech,W (48-43),38,47,80.9,390,4,41,189,4.6,3,88,579,6.6,19,12,0,31,4,35,0,1,1
486,8,2014-10-25,north-carolina,@,Virginia,W (28-27),16,29,55.2,275,3,34,99,2.9,1,63,374,5.9,8,6,6,20,6,45,0,1,1
487,9,2014-11-01,north-carolina,@,Miami (FL),L (20-47),24,38,63.2,247,0,32,11,0.3,2,70,258,3.7,8,5,4,17,5,28,1,1,2
488,10,2014-11-15,north-carolina,,Pittsburgh,W (40-35),23,40,57.5,276,1,43,226,5.3,5,83,502,6.0,14,14,2,30,6,41,0,0,0
489,11,2014-11-20,north-carolina,@,Duke,W (45-20),18,27,66.7,276,2,57,316,5.5,3,84,592,7.0,11,15,2,28,9,85,3,0,3
490,12,2014-11-29,north-carolina,,North Carolina State,L (7-35),17,35,48.6,177,1,28,30,1.1,0,63,207,3.3,8,6,4,18,6,49,0,2,2
491,13,2014-12-26,north-carolina,N,Rutgers*,L (21-40),32,46,69.6,263,2,40,219,5.5,1,86,482,5.6,12,15,0,25,6,70,2,0,2
492,,13 Games,north-carolina,,,,315,509,61.9,3614,29,496,1973,4.0,26,1005,5587,5.6,157,128,26,309,99,821,10,13,23
493,1,2015-09-03,north-carolina,N,South Carolina,L (13-17),19,31,61.3,232,1,32,208,6.5,0,63,440,7.0,11,8,1,20,6,30,0,3,3
494,2,2015-09-12,north-carolina,,North Carolina A&T,W (53-14),20,27,74.1,248,3,44,215,4.9,4,71,463,6.5,14,10,0,24,5,50,0,0,0
495,3,2015-09-19,north-carolina,,Illinois,W (48-14),19,26,73.1,217,3,37,254,6.9,2,63,471,7.5,10,10,3,23,6,51,0,1,1
496,4,2015-09-26,north-carolina,,Delaware,W (41-14),23,33,69.7,377,4,35,191,5.5,1,68,568,8.4,14,11,4,29,2,20,1,0,1
497,5,2015-10-03,north-carolina,@,Georgia Tech,W (38-31),15,26,57.7,182,1,31,231,7.5,4,57,413,7.2,8,11,2,21,6,42,0,0,0
498,6,2015-10-17,north-carolina,,Wake Forest,W (50-14),18,26,69.2,326,3,33,212,6.4,4,59,538,9.1,11,10,1,22,6,44,0,2,2
499,7,2015-10-24,north-carolina,,Virginia,W (26-13),21,26,80.8,226,0,38,196,5.2,3,64,422,6.6,12,11,1,24,13,135,1,1,2
500,8,2015-10-29,north-carolina,@,Pittsburgh,W (26-19),14,23,60.9,270,2,35,174,5.0,0,58,444,7.7,8,8,1,17,3,15,0,0,0
501,9,2015-11-07,north-carolina,,Duke,W (66-31),28,40,70.0,537,4,40,167,4.2,5,80,704,8.8,17,9,3,29,5,39,0,0,0
502,10,2015-11-14,north-carolina,,Miami (FL),W (59-21),16,22,72.7,189,1,46,298,6.5,6,68,487,7.2,10,15,5,30,5,56,0,0,0
503,11,2015-11-21,north-carolina,@,Virginia Tech,W (30-27),13,26,50.0,205,1,47,240,5.1,3,73,445,6.1,9,12,1,22,9,60,3,0,3
504,12,2015-11-28,north-carolina,@,North Carolina State,W (45-34),20,31,64.5,179,2,41,374,9.1,4,72,553,7.7,9,14,2,25,3,30,2,1,3
505,13,2015-12-05,north-carolina,N,Clemson,L (37-45),12,35,34.3,240,3,32,142,4.4,2,67,382,5.7,10,7,4,21,6,44,1,1,2
506,14,2015-12-29,north-carolina,N,Baylor*,L (38-49),22,36,61.1,243,3,36,244,6.8,2,72,487,6.8,15,10,3,28,5,34,1,1,2
507,,14 Games,north-carolina,,,,260,408,63.7,3671,31,527,3146,6.0,40,935,6817,7.3,158,146,31,335,80,650,9,10,19
508,1,2016-09-03,north-carolina,N,Georgia,L (24-33),24,40,60.0,156,0,19,159,8.4,2,59,315,5.3,10,6,0,16,13,101,0,0,0
509,2,2016-09-10,north-carolina,@,Illinois,W (48-23),19,25,76.0,265,2,37,197,5.3,4,62,462,7.5,12,6,3,21,6,46,1,0,1
510,3,2016-09-17,north-carolina,,James Madison,W (56-28),29,33,87.9,462,3,32,173,5.4,5,65,635,9.8,18,9,3,30,10,110,1,0,1
511,4,2016-09-24,north-carolina,,Pittsburgh,W (37-36),35,46,76.1,453,5,22,18,0.8,0,68,471,6.9,18,3,1,22,5,41,1,0,1
512,5,2016-10-01,north-carolina,@,Florida State,W (37-35),31,38,81.6,405,3,32,133,4.2,2,70,538,7.7,18,8,2,28,6,49,1,0,1
513,6,2016-10-08,north-carolina,,Virginia Tech,L (3-34),13,33,39.4,58,0,29,73,2.5,0,62,131,2.1,4,3,1,8,8,49,2,2,4
514,7,2016-10-15,north-carolina,@,Miami (FL),W (20-13),33,46,71.7,299,2,43,162,3.8,0,89,461,5.2,11,12,0,23,11,70,0,0,0
515,8,2016-10-22,north-carolina,@,Virginia,W (35-14),24,31,77.4,310,3,36,178,4.9,2,67,488,7.3,15,9,1,25,7,60,2,0,2
516,9,2016-11-05,north-carolina,,Georgia Tech,W (48-20),23,35,65.7,353,1,35,283,8.1,5,70,636,9.1,16,10,0,26,6,45,0,0,0
517,10,2016-11-10,north-carolina,@,Duke,L (27-28),24,33,72.7,297,3,27,106,3.9,0,60,403,6.7,13,8,2,23,7,65,0,2,2
518,11,2016-11-19,north-carolina,,Citadel,W (41-7),12,21,57.1,193,3,26,163,6.3,0,47,356,7.6,6,8,1,15,6,61,0,0,0
519,12,2016-11-25,north-carolina,,North Carolina State,L (21-28),23,39,59.0,280,3,26,133,5.1,0,65,413,6.4,12,6,2,20,7,50,1,0,1
520,13,2016-12-30,north-carolina,N,Stanford*,L (23-25),23,39,59.0,280,2,37,118,3.2,1,76,398,5.2,15,8,3,26,7,50,1,2,3
521,,13 Games,north-carolina,,,,313,459,68.2,3811,30,401,1896,4.7,21,860,5707,6.6,168,96,19,283,99,797,10,6,16
522,1,2017-09-02,north-carolina,,California,L (30-35),25,44,56.8,221,1,45,219,4.9,3,89,440,4.9,16,10,2,28,7,50,1,2,3
523,2,2017-09-09,north-carolina,,Louisville,L (35-47),29,38,76.3,384,3,23,17,0.7,1,61,401,6.6,18,0,2,20,5,50,0,0,0
524,3,2017-09-16,north-carolina,@,Old Dominion,W (53-23),16,26,61.5,259,1,50,252,5.0,6,76,511,6.7,9,14,2,25,9,110,1,0,1
525,4,2017-09-23,north-carolina,,Duke,L (17-27),17,32,53.1,259,1,33,118,3.6,1,65,377,5.8,10,5,0,15,6,65,0,1,1
526,5,2017-09-30,north-carolina,@,Georgia Tech,L (7-33),18,32,56.3,141,0,26,106,4.1,1,58,247,4.3,7,4,0,11,6,60,0,2,2
527,6,2017-10-07,north-carolina,,Notre Dame,L (10-33),19,42,45.2,179,1,28,86,3.1,0,70,265,3.8,6,6,1,13,10,104,2,1,3
528,7,2017-10-14,north-carolina,,Virginia,L (14-20),7,18,38.9,46,0,35,211,6.0,2,53,257,4.8,4,7,1,12,6,52,0,3,3
529,8,2017-10-21,north-carolina,@,Virginia Tech,L (7-59),8,22,36.4,118,1,42,54,1.3,0,64,172,2.7,5,5,1,11,14,100,1,2,3
530,9,2017-10-28,north-carolina,,Miami (FL),L (19-24),20,46,43.5,252,2,46,176,3.8,0,92,428,4.7,12,12,3,27,7,56,1,3,4
531,10,2017-11-09,north-carolina,@,Pittsburgh,W (34-31),21,32,65.6,270,3,32,96,3.0,0,64,366,5.7,15,5,1,21,7,65,0,0,0
532,11,2017-11-18,north-carolina,,Western Carolina,W (65-10),20,30,66.7,298,5,43,313,7.3,3,73,611,8.4,13,17,1,31,4,33,0,0,0
533,12,2017-11-25,north-carolina,@,North Carolina State,L (21-33),21,45,46.7,277,3,24,83,3.5,0,69,360,5.2,14,4,4,22,12,127,0,2,2
534,,12 Games,north-carolina,,,,221,407,54.3,2704,21,427,1731,4.1,17,834,4435,5.3,129,89,18,236,93,872,6,16,22
535,1,2018-09-01,north-carolina,@,California,L (17-24),15,35,42.9,137,1,38,164,4.3,1,73,301,4.1,5,10,1,16,13,124,0,4,4
536,2,2018-09-08,north-carolina,@,East Carolina,L (19-41),25,44,56.8,234,0,25,161,6.4,1,69,395,5.7,9,8,2,19,7,65,0,0,0
537,3,2018-09-22,north-carolina,,Pittsburgh,W (38-35),22,31,71.0,313,2,40,173,4.3,3,71,486,6.8,13,9,1,23,5,45,1,0,1
538,4,2018-09-27,north-carolina,@,Miami (FL),L (10-47),20,35,57.1,114,0,40,215,5.4,1,75,329,4.4,8,14,2,24,4,40,3,3,6
539,5,2018-10-13,north-carolina,,Virginia Tech,L (19-22),22,35,62.9,287,1,38,235,6.2,0,73,522,7.2,12,6,3,21,7,35,2,0,2
540,6,2018-10-20,north-carolina,@,Syracuse,L (37-40),34,54,63.0,321,2,41,179,4.4,1,95,500,5.3,14,10,0,24,5,34,1,1,2
541,7,2018-10-27,north-carolina,@,Virginia,L (21-31),22,38,57.9,271,2,22,66,3.0,1,60,337,5.6,11,3,0,14,4,19,1,0,1
542,8,2018-11-03,north-carolina,,Georgia Tech,L (28-38),18,31,58.1,208,1,36,166,4.6,1,67,374,5.6,10,9,0,19,1,10,0,3,3
543,9,2018-11-10,north-carolina,@,Duke,L (35-42),27,43,62.8,221,1,37,315,8.5,4,80,536,6.7,11,14,0,25,10,115,0,0,0
544,10,2018-11-17,north-carolina,,Western Carolina,W (49-26),20,28,71.4,358,3,50,296,5.9,4,78,654,8.4,14,14,2,30,7,85,1,2,3
545,,10 Games,north-carolina,,,,225,374,60.2,2464,13,367,1970,5.4,17,741,4434,6.0,107,97,11,215,63,572,9,13,22
546,1,2014-08-30,north-carolina-state,,Georgia Southern,W (24-23),28,40,70.0,291,3,35,173,4.9,0,75,464,6.2,14,10,2,26,4,20,0,1,1
547,2,2014-09-06,north-carolina-state,,Old Dominion,W (46-34),21,29,72.4,253,2,39,242,6.2,4,68,495,7.3,14,14,0,28,1,5,0,0,0
548,3,2014-09-13,north-carolina-state,@,South Florida,W (49-17),21,33,63.6,274,2,53,315,5.9,5,86,589,6.8,15,15,0,30,5,38,1,1,2
549,4,2014-09-20,north-carolina-state,,Presbyterian,W (42-0),14,22,63.6,195,3,31,265,8.5,3,53,460,8.7,7,11,3,21,7,70,0,0,0
550,5,2014-09-27,north-carolina-state,,Florida State,L (41-56),32,50,64.0,359,3,37,161,4.4,2,87,520,6.0,15,13,1,29,8,83,2,0,2
551,6,2014-10-04,north-carolina-state,@,Clemson,L (0-41),4,19,21.1,35,0,38,119,3.1,0,57,154,2.7,1,8,3,12,5,45,3,0,3
552,7,2014-10-11,north-carolina-state,,Boston College,L (14-30),14,30,46.7,174,1,28,43,1.5,1,58,217,3.7,8,5,0,13,2,20,1,1,2
553,8,2014-10-18,north-carolina-state,@,Louisville,L (18-30),18,32,56.3,223,2,31,128,4.1,0,63,351,5.6,9,8,3,20,2,20,0,1,1
554,9,2014-11-01,north-carolina-state,@,Syracuse,W (24-17),20,33,60.6,186,1,35,121,3.5,0,68,307,4.5,8,5,1,14,9,80,0,0,0
555,10,2014-11-08,north-carolina-state,,Georgia Tech,L (23-56),18,35,51.4,213,1,28,155,5.5,2,63,368,5.8,13,9,1,23,6,52,1,2,3
556,11,2014-11-15,north-carolina-state,,Wake Forest,W (42-13),8,19,42.1,83,1,46,362,7.9,5,65,445,6.8,4,14,2,20,2,10,0,0,0
557,12,2014-11-29,north-carolina-state,@,North Carolina,W (35-7),9,11,81.8,66,3,58,388,6.7,2,69,454,6.6,3,15,2,20,6,81,0,0,0
558,13,2014-12-26,north-carolina-state,N,Central Florida*,W (34-27),17,28,60.7,300,2,49,187,3.8,2,77,487,6.3,11,13,2,26,6,34,1,0,1
559,,13 Games,north-carolina-state,,,,224,381,58.8,2652,24,508,2659,5.2,26,889,5311,6.0,122,140,20,282,63,558,9,6,15
560,1,2015-09-05,north-carolina-state,,Troy,W (49-21),22,26,84.6,199,2,58,251,4.3,5,84,450,5.4,12,15,3,30,1,15,0,0,0
561,2,2015-09-12,north-carolina-state,,Eastern Kentucky,W (35-0),21,30,70.0,244,1,48,199,4.1,4,78,443,5.7,13,10,1,24,7,56,1,0,1
562,3,2015-09-19,north-carolina-state,@,Old Dominion,W (38-14),18,27,66.7,179,1,52,256,4.9,4,79,435,5.5,10,16,0,26,2,26,0,0,0
563,4,2015-09-26,north-carolina-state,@,South Alabama,W (63-13),21,27,77.8,256,2,41,330,8.0,7,68,586,8.6,11,15,0,26,4,44,0,0,0
564,5,2015-10-03,north-carolina-state,,Louisville,L (13-20),16,28,57.1,183,1,30,45,1.5,1,58,228,3.9,6,3,2,11,4,50,2,0,2
565,6,2015-10-09,north-carolina-state,@,Virginia Tech,L (13-28),12,25,48.0,113,1,40,157,3.9,0,65,270,4.2,7,9,1,17,9,81,0,1,1
566,7,2015-10-24,north-carolina-state,@,Wake Forest,W (35-17),20,34,58.8,227,2,30,248,8.3,2,64,475,7.4,8,9,2,19,6,46,0,0,0
567,8,2015-10-31,north-carolina-state,,Clemson,L (41-56),24,41,58.5,254,3,27,135,5.0,2,68,389,5.7,13,4,1,18,4,40,1,0,1
568,9,2015-11-07,north-carolina-state,@,Boston College,W (24-8),14,27,51.9,212,1,33,139,4.2,2,60,351,5.9,6,5,1,12,5,50,1,1,2
569,10,2015-11-14,north-carolina-state,@,Florida State,L (17-34),28,49,57.1,218,1,31,79,2.5,1,80,297,3.7,15,5,1,21,9,59,1,0,1
570,11,2015-11-21,north-carolina-state,,Syracuse,W (42-29),21,34,61.8,235,2,47,276,5.9,3,81,511,6.3,13,14,0,27,10,98,1,1,2
571,12,2015-11-28,north-carolina-state,,North Carolina,L (34-45),17,37,45.9,206,2,52,308,5.9,2,89,514,5.8,9,18,1,28,7,72,0,1,1
572,13,2015-12-30,north-carolina-state,N,Mississippi State*,L (28-51),12,28,42.9,214,1,51,210,4.1,3,79,424,5.4,8,10,2,20,4,50,0,2,2
573,,13 Games,north-carolina-state,,,,246,413,59.6,2740,20,540,2633,4.9,36,953,5373,5.6,131,133,15,279,72,687,7,6,13
574,1,2016-09-01,north-carolina-state,,William & Mary,W (48-14),23,30,76.7,262,2,57,259,4.5,5,87,521,6.0,13,14,1,28,7,80,0,1,1
575,2,2016-09-10,north-carolina-state,@,East Carolina,L (30-33),21,32,65.6,287,1,31,215,6.9,3,63,502,8.0,10,8,1,19,8,54,1,0,1
576,3,2016-09-17,north-carolina-state,,Old Dominion,W (49-22),27,32,84.4,316,4,39,158,4.1,3,71,474,6.7,18,8,2,28,2,24,1,0,1
577,4,2016-10-01,north-carolina-state,,Wake Forest,W (33-16),24,37,64.9,327,3,39,200,5.1,1,76,527,6.9,16,10,2,28,13,144,0,0,0
578,5,2016-10-08,north-carolina-state,,Notre Dame,W (10-3),7,14,50.0,41,0,51,157,3.1,0,65,198,3.0,2,11,1,14,2,20,2,0,2
579,6,2016-10-15,north-carolina-state,@,Clemson,L (17-24),21,42,50.0,269,0,32,128,4.0,1,74,397,5.4,12,9,2,23,13,120,0,2,2
580,7,2016-10-22,north-carolina-state,@,Louisville,L (13-54),16,36,44.4,236,2,25,14,0.6,0,61,250,4.1,8,0,1,9,6,65,0,3,3
581,8,2016-10-29,north-carolina-state,,Boston College,L (14-21),23,41,56.1,307,2,23,31,1.3,0,64,338,5.3,10,2,2,14,8,94,1,2,3
582,9,2016-11-05,north-carolina-state,,Florida State,L (20-24),25,41,61.0,304,1,41,165,4.0,1,82,469,5.7,19,8,4,31,3,28,0,1,1
583,10,2016-11-12,north-carolina-state,@,Syracuse,W (35-20),23,34,67.6,360,1,48,184,3.8,4,82,544,6.6,14,12,1,27,6,66,0,2,2
584,11,2016-11-19,north-carolina-state,,Miami (FL),L (13-27),20,44,45.5,210,0,29,119,4.1,1,73,329,4.5,9,8,1,18,4,51,1,1,2
585,12,2016-11-25,north-carolina-state,@,North Carolina,W (28-21),14,24,58.3,233,1,53,259,4.9,3,77,492,6.4,9,15,0,24,5,59,1,0,1
586,13,2016-12-26,north-carolina-state,N,Vanderbilt*,W (41-17),19,31,61.3,235,3,36,141,3.9,1,67,376,5.6,14,5,2,21,1,5,1,0,1
587,,13 Games,north-carolina-state,,,,263,438,60.0,3387,20,504,2030,4.0,23,942,5417,5.8,154,110,20,284,78,810,8,12,20
588,1,2017-09-02,north-carolina-state,N,South Carolina,L (28-35),45,64,70.3,415,2,35,89,2.5,2,99,504,5.1,21,7,1,29,8,65,2,0,2
589,2,2017-09-09,north-carolina-state,,Marshall,W (37-20),29,36,80.6,341,3,33,144,4.4,2,69,485,7.0,14,7,2,23,3,33,0,0,0
590,3,2017-09-16,north-carolina-state,,Furman,W (49-16),24,30,80.0,248,1,39,242,6.2,5,69,490,7.1,12,13,0,25,5,50,0,0,0
591,4,2017-09-23,north-carolina-state,@,Florida State,W (27-21),23,33,69.7,255,2,37,110,3.0,1,70,365,5.2,11,6,4,21,6,41,0,0,0
592,5,2017-09-30,north-carolina-state,,Syracuse,W (33-25),21,34,61.8,206,1,47,256,5.4,3,81,462,5.7,11,15,3,29,6,49,0,0,0
593,6,2017-10-05,north-carolina-state,,Louisville,W (39-25),20,32,62.5,367,1,39,153,3.9,3,71,520,7.3,14,7,2,23,6,50,1,0,1
594,7,2017-10-14,north-carolina-state,@,Pittsburgh,W (35-17),14,25,56.0,198,1,38,248,6.5,3,63,446,7.1,10,8,0,18,3,39,0,0,0
595,8,2017-10-28,north-carolina-state,@,Notre Dame,L (14-35),17,37,45.9,213,1,24,50,2.1,0,61,263,4.3,9,4,1,14,12,89,0,1,1
596,9,2017-11-04,north-carolina-state,,Clemson,L (31-38),31,50,62.0,338,3,34,153,4.5,1,84,491,5.8,14,12,1,27,6,69,0,2,2
597,10,2017-11-11,north-carolina-state,@,Boston College,W (17-14),13,32,40.6,146,0,41,221,5.4,2,73,367,5.0,9,8,0,17,2,10,1,1,2
598,11,2017-11-18,north-carolina-state,@,Wake Forest,L (24-30),34,52,65.4,327,1,42,175,4.2,2,94,502,5.3,16,10,2,28,5,64,2,1,3
599,12,2017-11-25,north-carolina-state,,North Carolina,W (33-21),20,30,66.7,204,0,45,292,6.5,5,75,496,6.6,8,12,5,25,11,108,0,1,1
600,13,2017-12-29,north-carolina-state,N,Arizona State*,W (52-31),24,29,82.8,318,1,41,169,4.1,6,70,487,7.0,13,10,1,24,5,54,1,0,1
601,,13 Games,north-carolina-state,,,,315,484,65.1,3576,17,495,2302,4.7,35,979,5878,6.0,162,119,22,303,78,721,7,6,13
602,1,2018-09-01,north-carolina-state,,James Madison,W (24-13),29,43,67.4,309,2,29,83,2.9,1,72,392,5.4,18,6,1,25,5,50,1,0,1
603,2,2018-09-08,north-carolina-state,,Georgia State,W (41-7),32,39,82.1,426,2,31,117,3.8,3,70,543,7.8,19,3,2,24,6,52,0,1,1
604,3,2018-09-22,north-carolina-state,@,Marshall,W (37-20),23,40,57.5,377,1,36,125,3.5,2,76,502,6.6,17,6,1,24,4,25,1,0,1
605,4,2018-09-29,north-carolina-state,,Virginia,W (35-21),22,32,68.8,257,3,39,176,4.5,1,71,433,6.1,12,10,3,25,7,80,0,0,0
606,5,2018-10-06,north-carolina-state,,Boston College,W (28-23),25,34,73.5,308,2,53,225,4.2,2,87,533,6.1,17,14,3,34,1,5,2,2,4
607,6,2018-10-20,north-carolina-state,@,Clemson,L (7-41),22,35,62.9,193,0,32,104,3.3,1,67,297,4.4,5,7,4,16,6,49,1,2,3
608,7,2018-10-27,north-carolina-state,@,Syracuse,L (41-51),26,44,59.1,473,3,29,68,2.3,2,73,541,7.4,13,6,2,21,9,95,0,1,1
609,8,2018-11-03,north-carolina-state,,Florida State,W (47-28),21,28,75.0,240,3,49,177,3.6,2,77,417,5.4,10,10,5,25,4,50,0,0,0
610,9,2018-11-08,north-carolina-state,,Wake Forest,L (23-27),35,53,66.0,374,1,27,47,1.7,1,80,421,5.3,18,3,2,23,6,55,0,1,1
611,10,2018-11-17,north-carolina-state,@,Louisville,W (52-10),31,42,73.8,354,4,36,164,4.6,3,78,518,6.6,19,9,1,29,2,25,0,0,0
612,,10 Games,north-carolina-state,,,,266,390,68.2,3311,21,361,1286,3.6,18,751,4597,6.1,148,74,24,246,50,486,5,7,12
613,1,2014-08-29,syracuse,,Villanova,W (27-26),22,35,62.9,184,1,34,136,4.0,2,69,320,4.6,12,4,5,21,7,55,0,0,0
614,2,2014-09-13,syracuse,@,Central Michigan,W (40-3),20,30,66.7,175,1,49,289,5.9,3,79,464,5.9,9,15,1,25,9,41,0,0,0
615,3,2014-09-20,syracuse,,Maryland,L (20-34),14,28,50.0,219,0,51,370,7.3,2,79,589,7.5,9,15,2,26,8,69,1,1,2
616,4,2014-09-27,syracuse,N,Notre Dame,L (15-31),22,38,57.9,294,0,30,135,4.5,1,68,429,6.3,9,6,2,17,10,85,0,1,1
617,5,2014-10-03,syracuse,,Louisville,L (6-28),17,37,45.9,201,0,26,44,1.7,0,63,245,3.9,7,6,1,14,7,60,0,2,2
618,6,2014-10-11,syracuse,,Florida State,L (20-38),21,36,58.3,256,2,31,156,5.0,0,67,412,6.1,11,8,1,20,7,64,0,3,3
619,7,2014-10-18,syracuse,@,Wake Forest,W (30-7),22,32,68.8,171,0,38,199,5.2,1,70,370,5.3,9,7,1,17,6,55,0,0,0
620,8,2014-10-25,syracuse,@,Clemson,L (6-16),12,28,42.9,82,0,34,88,2.6,0,62,170,2.7,4,6,0,10,5,30,1,2,3
621,9,2014-11-01,syracuse,,North Carolina State,L (17-24),22,42,52.4,307,2,37,38,1.0,0,79,345,4.4,10,8,2,20,6,61,1,2,3
622,10,2014-11-08,syracuse,,Duke,L (10-27),17,32,53.1,105,0,37,119,3.2,1,69,224,3.2,4,7,1,12,7,55,0,2,2
623,11,2014-11-22,syracuse,@,Pittsburgh,L (7-30),10,25,40.0,149,0,29,106,3.7,1,54,255,4.7,7,5,0,12,6,67,1,2,3
624,12,2014-11-29,syracuse,@,Boston College,L (7-28),8,20,40.0,66,0,28,62,2.2,1,48,128,2.7,2,5,1,8,8,67,0,2,2
625,,12 Games,syracuse,,,,207,383,54.0,2209,6,424,1742,4.1,12,807,3951,4.9,93,92,17,202,86,709,4,17,21
626,1,2015-09-04,syracuse,,Rhode Island,W (47-0),10,20,50.0,114,2,58,312,5.4,2,78,426,5.5,6,16,1,23,3,36,0,1,1
627,2,2015-09-12,syracuse,,Wake Forest,W (30-17),8,14,57.1,221,2,37,149,4.0,0,51,370,7.3,5,9,1,15,4,30,0,0,0
628,3,2015-09-19,syracuse,,Central Michigan,W (30-27),11,17,64.7,161,2,30,165,5.5,2,47,326,6.9,6,5,0,11,6,60,0,1,1
629,4,2015-09-26,syracuse,,Louisiana State,L (24-34),16,38,42.1,154,3,31,127,4.1,0,69,281,4.1,8,8,5,21,4,36,0,1,1
630,5,2015-10-10,syracuse,@,South Florida,L (24-45),21,34,61.8,232,2,33,73,2.2,1,67,305,4.6,12,7,4,23,6,64,2,1,3
631,6,2015-10-17,syracuse,@,Virginia,L (38-44),16,22,72.7,150,2,43,184,4.3,2,65,334,5.1,8,10,3,21,4,32,2,0,2
632,7,2015-10-24,syracuse,,Pittsburgh,L (20-23),22,31,71.0,217,2,23,136,5.9,0,54,353,6.5,10,5,1,16,4,39,0,2,2
633,8,2015-10-31,syracuse,@,Florida State,L (21-45),12,25,48.0,130,0,42,173,4.1,2,67,303,4.5,3,11,0,14,5,45,1,0,1
634,9,2015-11-07,syracuse,@,Louisville,L (17-41),19,37,51.4,184,1,36,102,2.8,1,73,286,3.9,6,5,2,13,4,20,1,2,3
635,10,2015-11-14,syracuse,,Clemson,L (27-37),8,21,38.1,80,0,34,242,7.1,3,55,322,5.9,4,10,2,16,9,83,1,0,1
636,11,2015-11-21,syracuse,@,North Carolina State,L (29-42),10,21,47.6,152,2,32,140,4.4,1,53,292,5.5,6,5,4,15,9,77,1,1,2
637,12,2015-11-28,syracuse,,Boston College,W (20-17),12,27,44.4,88,1,45,155,3.4,1,72,243,3.4,5,8,4,17,6,55,1,0,1
638,,12 Games,syracuse,,,,165,307,53.7,1883,19,444,1958,4.4,15,751,3841,5.1,79,99,27,205,64,577,9,9,18
639,1,2016-09-02,syracuse,,Colgate,W (33-7),40,46,87.0,437,2,35,117,3.3,1,81,554,6.8,18,5,2,25,6,55,1,0,1
640,2,2016-09-09,syracuse,,Louisville,L (28-62),27,53,50.9,293,3,40,121,3.0,1,93,414,4.5,12,9,3,24,8,55,1,1,2
641,3,2016-09-17,syracuse,,South Florida,L (20-45),32,50,64.0,350,2,55,199,3.6,0,105,549,5.2,16,11,3,30,10,69,1,2,3
642,4,2016-09-24,syracuse,@,Connecticut,W (31-24),26,40,65.0,407,2,26,62,2.4,1,66,469,7.1,16,3,0,19,4,25,0,0,0
643,5,2016-10-01,syracuse,N,Notre Dame,L (33-50),31,51,60.8,363,2,37,126,3.4,3,88,489,5.6,16,6,3,25,5,45,0,0,0
644,6,2016-10-08,syracuse,@,Wake Forest,L (9-28),17,26,65.4,168,0,40,158,4.0,1,66,326,4.9,8,6,0,14,7,63,1,1,2
645,7,2016-10-15,syracuse,,Virginia Tech,W (31-17),30,55,54.5,405,2,45,156,3.5,2,100,561,5.6,18,11,3,32,8,55,0,1,1
646,8,2016-10-22,syracuse,@,Boston College,W (28-20),32,38,84.2,434,3,33,99,3.0,1,71,533,7.5,14,5,4,23,16,135,2,1,3
647,9,2016-11-05,syracuse,@,Clemson,L (0-54),24,40,60.0,172,0,28,105,3.8,0,68,277,4.1,10,4,1,15,10,55,0,3,3
648,10,2016-11-12,syracuse,,North Carolina State,L (20-35),14,25,56.0,190,1,28,28,1.0,1,53,218,4.1,5,4,1,10,5,45,1,1,2
649,11,2016-11-19,syracuse,,Florida State,L (14-45),16,37,43.2,196,2,35,37,1.1,0,72,233,3.2,9,1,3,13,10,77,0,2,2
650,12,2016-11-26,syracuse,@,Pittsburgh,L (61-76),43,61,70.5,440,5,45,228,5.1,4,106,668,6.3,21,14,3,38,7,50,0,1,1
651,,12 Games,syracuse,,,,332,522,63.6,3855,24,447,1436,3.2,15,969,5291,5.5,163,79,26,268,96,729,7,13,20
652,1,2017-09-01,syracuse,,Central Connecticut State,W (50-7),37,52,71.2,431,3,41,155,3.8,3,93,586,6.3,21,10,3,34,4,28,2,0,2
653,2,2017-09-09,syracuse,,Middle Tennessee State,L (23-30),27,44,61.4,182,0,49,126,2.6,2,93,308,3.3,9,10,6,25,4,40,1,1,2
654,3,2017-09-16,syracuse,,Central Michigan,W (41-17),19,35,54.3,279,2,44,300,6.8,2,79,579,7.3,9,7,2,18,9,104,2,1,3
655,4,2017-09-23,syracuse,@,Louisiana State,L (26-35),34,55,61.8,308,2,27,76,2.8,1,82,384,4.7,17,6,1,24,7,38,0,1,1
656,5,2017-09-30,syracuse,@,North Carolina State,L (25-33),30,48,62.5,385,1,30,59,2.0,2,78,444,5.7,13,5,2,20,12,93,0,1,1
657,6,2017-10-07,syracuse,,Pittsburgh,W (27-24),33,49,67.3,365,2,42,135,3.2,1,91,500,5.5,14,9,3,26,9,58,0,0,0
658,7,2017-10-13,syracuse,,Clemson,W (27-24),20,33,60.6,278,3,50,162,3.2,0,83,440,5.3,12,11,5,28,12,100,1,0,1
659,8,2017-10-21,syracuse,@,Miami (FL),L (19-27),14,42,33.3,135,0,51,264,5.2,1,93,399,4.3,7,15,1,23,3,22,0,4,4
660,9,2017-11-04,syracuse,@,Florida State,L (24-27),31,55,56.4,314,2,40,149,3.7,1,95,463,4.9,14,6,1,21,2,20,0,1,1
661,10,2017-11-11,syracuse,,Wake Forest,L (43-64),38,67,56.7,443,3,32,178,5.6,2,99,621,6.3,22,9,2,33,3,25,0,2,2
662,11,2017-11-18,syracuse,@,Louisville,L (10-56),13,34,38.2,138,0,45,197,4.4,1,79,335,4.2,8,12,2,22,7,52,0,4,4
663,12,2017-11-25,syracuse,,Boston College,L (14-42),24,34,70.6,280,2,28,137,4.9,0,62,417,6.7,11,8,0,19,2,13,2,1,3
664,,12 Games,syracuse,,,,320,548,58.4,3538,20,479,1938,4.0,16,1027,5476,5.3,157,108,28,293,74,593,8,16,24
665,1,2018-08-31,syracuse,@,Western Michigan,W (55-42),11,28,39.3,226,2,62,334,5.4,5,90,560,6.2,7,17,2,26,5,45,1,0,1
666,2,2018-09-08,syracuse,,Wagner,W (62-10),24,37,64.9,241,5,43,215,5.0,2,80,456,5.7,13,13,0,26,5,50,0,1,1
667,3,2018-09-15,syracuse,,Florida State,W (30-7),18,31,58.1,219,1,57,222,3.9,2,88,441,5.0,10,11,4,25,8,33,0,0,0
668,4,2018-09-22,syracuse,,Connecticut,W (51-21),22,32,68.8,295,2,46,341,7.4,3,78,636,8.2,11,15,0,26,11,100,1,0,1
669,5,2018-09-29,syracuse,@,Clemson,L (23-27),26,41,63.4,250,0,26,61,2.3,2,67,311,4.6,8,4,0,12,5,31,0,1,1
670,6,2018-10-06,syracuse,@,Pittsburgh,L (37-44),18,38,47.4,195,1,40,189,4.7,3,78,384,4.9,9,10,1,20,5,24,1,2,3
671,7,2018-10-20,syracuse,,North Carolina,W (40-37),28,52,53.8,406,3,33,140,4.2,2,85,546,6.4,15,8,2,25,6,53,1,1,2
672,8,2018-10-27,syracuse,,North Carolina State,W (51-41),30,42,71.4,480,3,37,81,2.2,3,79,561,7.1,19,5,6,30,9,65,0,0,0
673,9,2018-11-03,syracuse,@,Wake Forest,W (41-24),23,35,65.7,157,0,60,264,4.4,5,95,421,4.4,7,15,3,25,9,77,0,0,0
674,10,2018-11-09,syracuse,,Louisville,W (54-23),14,27,51.9,192,1,54,344,6.4,5,81,536,6.6,6,13,4,23,7,65,2,1,3
675,11,2018-11-17,syracuse,N,Notre Dame,L (3-36),15,35,42.9,115,0,38,119,3.1,0,73,234,3.2,6,9,1,16,3,45,0,3,3
676,,11 Games,syracuse,,,,229,398,57.5,2776,18,496,2310,4.7,32,894,5086,5.7,111,120,23,254,73,588,6,9,15
677,1,2014-08-30,duke,,Elon,W (52-13),28,42,66.7,292,4,44,275,6.3,3,86,567,6.6,14,17,0,31,2,15,0,0,0
678,2,2014-09-06,duke,@,Troy,W (34-17),28,42,66.7,270,2,41,182,4.4,2,83,452,5.4,15,10,0,25,6,43,0,0,0
679,3,2014-09-13,duke,,Kansas,W (41-3),20,34,58.8,180,2,36,331,9.2,3,70,511,7.3,9,10,4,23,5,41,0,0,0
680,4,2014-09-20,duke,,Tulane,W (47-13),15,28,53.6,181,0,42,256,6.1,4,70,437,6.2,8,12,3,23,7,80,1,1,2
681,5,2014-09-27,duke,@,Miami (FL),L (10-22),22,51,43.1,179,0,25,85,3.4,1,76,264,3.5,8,5,4,17,8,50,1,2,3
682,6,2014-10-11,duke,@,Georgia Tech,W (31-25),16,26,61.5,131,1,47,242,5.1,3,73,373,5.1,5,16,4,25,5,35,0,0,0
683,7,2014-10-18,duke,,Virginia,W (20-13),23,38,60.5,179,2,30,155,5.2,0,68,334,4.9,7,10,2,19,3,30,0,0,0
684,8,2014-11-01,duke,@,Pittsburgh,W (51-48),23,31,74.2,266,3,27,172,6.4,3,58,438,7.6,12,11,2,25,3,20,0,0,0
685,9,2014-11-08,duke,@,Syracuse,W (27-10),15,33,45.5,161,2,33,98,3.0,0,66,259,3.9,6,5,1,12,5,40,0,1,1
686,10,2014-11-15,duke,,Virginia Tech,L (16-17),19,41,46.3,185,0,41,141,3.4,1,82,326,4.0,12,9,2,23,8,50,1,2,3
687,11,2014-11-20,duke,,North Carolina,L (20-45),22,40,55.0,262,2,37,116,3.1,1,77,378,4.9,12,8,1,21,5,35,2,1,3
688,12,2014-11-29,duke,,Wake Forest,W (41-21),20,32,62.5,293,2,45,146,3.2,3,77,439,5.7,11,10,0,21,3,29,1,0,1
689,13,2014-12-27,duke,N,Arizona State*,L (31-36),17,33,51.5,235,3,44,165,3.8,0,77,400,5.2,11,10,0,21,4,35,1,1,2
690,,13 Games,duke,,,,268,471,56.9,2814,23,492,2364,4.8,24,963,5178,5.4,130,133,23,286,64,503,7,8,15
691,1,2015-09-03,duke,@,Tulane,W (37-7),29,44,65.9,324,2,49,206,4.2,1,93,530,5.7,16,11,2,29,8,78,2,0,2
692,2,2015-09-12,duke,,North Carolina Central,W (55-0),19,26,73.1,367,3,59,288,4.9,4,85,655,7.7,9,17,3,29,3,34,0,0,0
693,3,2015-09-19,duke,,Northwestern,L (10-19),24,39,61.5,150,0,35,177,5.1,1,74,327,4.4,6,9,1,16,4,39,2,1,3
694,4,2015-09-26,duke,,Georgia Tech,W (34-20),17,25,68.0,114,1,36,165,4.6,3,61,279,4.6,6,5,0,11,4,35,1,2,3
695,5,2015-10-03,duke,,Boston College,W (9-7),18,36,50.0,195,0,35,33,0.9,0,71,228,3.2,9,4,3,16,5,31,0,0,0
696,6,2015-10-10,duke,@,Army,W (44-3),20,30,66.7,243,1,48,215,4.5,4,78,458,5.9,14,8,3,25,5,50,0,0,0
697,7,2015-10-24,duke,@,Virginia Tech,W (45-43),19,40,47.5,270,4,32,179,5.6,1,72,449,6.2,12,7,1,20,7,22,0,0,0
698,8,2015-10-31,duke,,Miami (FL),L (27-30),31,52,59.6,258,1,39,182,4.7,2,91,440,4.8,15,11,8,34,5,41,1,0,1
699,9,2015-11-07,duke,@,North Carolina,L (31-66),20,40,50.0,206,1,44,327,7.4,3,84,533,6.3,13,15,2,30,8,72,1,2,3
700,10,2015-11-14,duke,,Pittsburgh,L (13-31),23,43,53.5,248,0,22,113,5.1,1,65,361,5.6,11,5,2,18,4,44,2,1,3
701,11,2015-11-21,duke,@,Virginia,L (34-42),30,53,56.6,385,2,31,100,3.2,1,84,485,5.8,19,6,4,29,9,80,2,1,3
702,12,2015-11-28,duke,@,Wake Forest,W (27-21),27,41,65.9,280,2,48,151,3.1,1,89,431,4.8,19,7,4,30,4,34,0,0,0
703,13,2015-12-26,duke,N,Indiana*,W (44-41),17,40,42.5,163,1,46,373,8.1,3,86,536,6.2,7,15,1,23,5,61,0,3,3
704,,13 Games,duke,,,,294,509,57.8,3203,18,524,2509,4.8,25,1033,5712,5.5,156,120,34,310,71,621,11,10,21
705,1,2016-09-03,duke,,North Carolina Central,W (49-6),16,26,61.5,227,3,63,308,4.9,4,89,535,6.0,9,17,3,29,10,85,5,0,5
706,2,2016-09-10,duke,,Wake Forest,L (14-24),31,48,64.6,332,0,30,37,1.2,2,78,369,4.7,15,5,1,21,5,22,2,1,3
707,3,2016-09-17,duke,@,Northwestern,L (13-24),27,49,55.1,279,0,34,117,3.4,2,83,396,4.8,15,7,1,23,7,62,1,1,2
708,4,2016-09-24,duke,@,Notre Dame,W (38-35),24,32,75.0,290,3,42,208,5.0,1,74,498,6.7,12,11,1,24,1,5,0,1,1
709,5,2016-10-01,duke,,Virginia,L (20-34),33,54,61.1,324,1,31,106,3.4,1,85,430,5.1,17,6,2,25,2,25,1,5,6
710,6,2016-10-08,duke,,Army,W (13-6),8,16,50.0,44,2,50,145,2.9,0,66,189,2.9,3,6,0,9,6,39,1,0,1
711,7,2016-10-14,duke,@,Louisville,L (14-24),14,21,66.7,129,2,39,110,2.8,0,60,239,4.0,7,5,1,13,3,25,0,0,0
712,8,2016-10-29,duke,@,Georgia Tech,L (35-38),22,36,61.1,305,2,37,254,6.9,3,73,559,7.7,13,9,1,23,4,20,2,1,3
713,9,2016-11-05,duke,,Virginia Tech,L (21-24),18,31,58.1,148,0,45,227,5.0,3,76,375,4.9,9,12,3,24,6,46,0,0,0
714,10,2016-11-10,duke,,North Carolina,W (28-27),22,34,64.7,240,1,55,227,4.1,3,89,467,5.2,15,10,2,27,5,60,0,0,0
715,11,2016-11-19,duke,@,Pittsburgh,L (14-56),28,46,60.9,243,1,22,25,1.1,0,68,268,3.9,14,2,2,18,6,45,2,0,2
716,12,2016-11-26,duke,@,Miami (FL),L (21-40),34,50,68.0,316,3,26,79,3.0,0,76,395,5.2,14,5,3,22,7,51,0,0,0
717,,12 Games,duke,,,,277,443,62.5,2877,18,474,1843,3.9,19,917,4720,5.1,143,95,20,258,62,485,14,9,23
718,1,2017-09-02,duke,,North Carolina Central,W (60-7),26,34,76.5,281,3,47,243,5.2,4,81,524,6.5,13,15,2,30,3,40,0,0,0
719,2,2017-09-09,duke,,Northwestern,W (41-17),29,45,64.4,305,2,59,233,3.9,3,104,538,5.2,17,14,3,34,8,55,1,1,2
720,3,2017-09-16,duke,,Baylor,W (34-20),20,35,57.1,184,0,51,246,4.8,3,86,430,5.0,7,14,3,24,5,54,1,1,2
721,4,2017-09-23,duke,@,North Carolina,W (27-17),18,34,52.9,202,1,45,186,4.1,1,79,388,4.9,8,12,0,20,2,12,0,0,0
722,5,2017-09-29,duke,,Miami (FL),L (6-31),21,42,50.0,166,0,46,183,4.0,0,88,349,4.0,7,14,3,24,7,82,1,1,2
723,6,2017-10-07,duke,@,Virginia,L (21-28),14,42,33.3,124,1,32,131,4.1,1,74,255,3.4,8,7,2,17,7,68,0,2,2
724,7,2017-10-14,duke,,Florida State,L (10-17),22,37,59.5,204,0,25,111,4.4,1,62,315,5.1,10,7,0,17,5,37,0,1,1
725,8,2017-10-21,duke,,Pittsburgh,L (17-24),16,34,47.1,283,2,26,76,2.9,0,60,359,6.0,13,6,3,22,7,32,1,1,2
726,9,2017-10-28,duke,@,Virginia Tech,L (3-24),10,24,41.7,82,0,35,101,2.9,0,59,183,3.1,3,5,2,10,7,53,1,1,2
727,10,2017-11-11,duke,@,Army,L (16-21),19,30,63.3,164,0,33,89,2.7,2,63,253,4.0,12,7,3,22,4,43,1,1,2
728,11,2017-11-18,duke,,Georgia Tech,W (43-20),19,28,67.9,181,3,51,319,6.3,2,79,500,6.3,9,20,1,30,1,15,0,0,0
729,12,2017-11-25,duke,@,Wake Forest,W (31-23),25,44,56.8,346,2,45,97,2.2,2,89,443,5.0,16,6,0,22,4,20,0,3,3
730,13,2017-12-26,duke,N,Northern Illinois*,W (36-14),27,40,67.5,252,2,52,213,4.1,3,92,465,5.1,13,14,0,27,2,30,1,0,1
731,,13 Games,duke,,,,266,469,56.7,2774,16,547,2228,4.1,22,1016,5002,4.9,136,141,22,299,62,541,7,12,19
732,1,2018-08-31,duke,,Army,W (34-14),13,17,76.5,197,1,35,184,5.3,3,52,381,7.3,8,9,2,19,4,30,1,0,1
733,2,2018-09-08,duke,@,Northwestern,W (21-7),18,24,75.0,204,3,39,97,2.5,0,63,301,4.8,8,6,1,15,4,42,0,0,0
734,3,2018-09-15,duke,@,Baylor,W (40-27),12,30,40.0,174,3,44,225,5.1,1,74,399,5.4,7,12,1,20,0,0,0,0,0
735,4,2018-09-22,duke,,North Carolina Central,W (55-13),20,39,51.3,256,4,59,372,6.3,4,98,628,6.4,11,19,2,32,8,75,1,0,1
736,5,2018-09-29,duke,,Virginia Tech,L (14-31),25,39,64.1,256,1,36,71,2.0,1,75,327,4.4,12,6,0,18,3,15,0,1,1
737,6,2018-10-13,duke,@,Georgia Tech,W (28-14),17,27,63.0,206,3,33,98,3.0,1,60,304,5.1,9,10,0,19,3,15,2,1,3
738,7,2018-10-20,duke,,Virginia,L (14-28),23,42,54.8,262,2,27,58,2.1,0,69,320,4.6,13,5,1,19,6,67,0,2,2
739,8,2018-10-27,duke,@,Pittsburgh,L (45-54),27,43,62.8,396,4,34,223,6.6,2,77,619,8.0,19,8,1,28,4,36,1,0,1
740,9,2018-11-03,duke,@,Miami (FL),W (20-12),19,37,51.4,144,1,30,146,4.9,1,67,290,4.3,6,5,2,13,3,25,0,1,1
741,10,2018-11-10,duke,,North Carolina,W (42-35),31,54,57.4,361,3,35,268,7.7,3,89,629,7.1,15,10,4,29,6,40,2,1,3
742,11,2018-11-17,duke,@,Clemson,L (6-35),24,44,54.5,158,0,35,104,3.0,0,79,262,3.3,5,10,2,17,6,52,0,0,0
743,,11 Games,duke,,,,229,396,57.8,2614,25,407,1846,4.5,16,803,4460,5.6,113,100,16,229,47,397,7,6,13
744,1,2014-08-30,virginia,,UCLA,L (20-28),29,45,64.4,266,2,39,120,3.1,0,84,386,4.6,12,3,2,17,4,20,1,2,3
745,2,2014-09-06,virginia,,Richmond,W (45-13),18,23,78.3,173,2,40,157,3.9,3,63,330,5.2,8,9,0,17,6,39,1,1,2
746,3,2014-09-13,virginia,,Louisville,W (23-21),16,30,53.3,171,1,40,114,2.9,1,70,285,4.1,8,5,0,13,7,46,1,2,3
747,4,2014-09-20,virginia,@,Brigham Young,L (33-41),35,58,60.3,327,1,44,192,4.4,2,102,519,5.1,18,11,6,35,8,86,1,1,2
748,5,2014-09-27,virginia,,Kent State,W (45-13),19,32,59.4,266,2,45,254,5.6,3,77,520,6.8,13,12,2,27,9,79,1,2,3
749,6,2014-10-04,virginia,,Pittsburgh,W (24-19),10,17,58.8,121,1,43,225,5.2,1,60,346,5.8,5,11,2,18,6,65,0,1,1
750,7,2014-10-18,virginia,@,Duke,L (13-20),22,47,46.8,325,1,31,140,4.5,0,78,465,6.0,15,7,1,23,6,60,1,0,1
751,8,2014-10-25,virginia,,North Carolina,L (27-28),21,41,51.2,284,2,43,159,3.7,1,84,443,5.3,15,12,4,31,8,83,0,2,2
752,9,2014-11-01,virginia,@,Georgia Tech,L (10-35),23,41,56.1,262,1,16,22,1.4,0,57,284,5.0,14,1,0,15,6,61,0,2,2
753,10,2014-11-08,virginia,@,Florida State,L (20-34),20,35,57.1,220,3,32,37,1.2,0,67,257,3.8,11,5,1,17,6,49,2,1,3
754,11,2014-11-22,virginia,,Miami (FL),W (30-13),17,25,68.0,146,1,43,195,4.5,2,68,341,5.0,6,11,1,18,3,30,0,1,1
755,12,2014-11-28,virginia,@,Virginia Tech,L (20-24),18,38,47.4,276,1,35,38,1.1,0,73,314,4.3,12,1,2,15,9,75,0,1,1
756,,12 Games,virginia,,,,248,432,57.4,2837,18,451,1653,3.7,13,883,4490,5.1,137,88,21,246,78,693,8,16,24
757,1,2015-09-05,virginia,@,UCLA,L (16-34),21,35,60.0,238,1,34,98,2.9,0,69,336,4.9,13,3,3,19,7,45,0,1,1
758,2,2015-09-12,virginia,,Notre Dame,L (27-34),26,38,68.4,289,2,30,127,4.2,2,68,416,6.1,16,4,2,22,9,55,1,0,1
759,3,2015-09-19,virginia,,William & Mary,W (35-29),17,23,73.9,263,3,29,110,3.8,1,52,373,7.2,8,7,0,15,5,60,0,2,2
760,4,2015-09-25,virginia,,Boise State,L (14-56),16,33,48.5,233,2,33,40,1.2,0,66,273,4.1,9,1,0,10,9,80,1,4,5
761,5,2015-10-10,virginia,@,Pittsburgh,L (19-26),17,34,50.0,209,1,31,139,4.5,0,65,348,5.4,9,7,0,16,4,22,0,1,1
762,6,2015-10-17,virginia,,Syracuse,W (44-38),24,37,64.9,234,2,44,159,3.6,3,81,393,4.9,14,10,1,25,7,78,1,1,2
763,7,2015-10-24,virginia,@,North Carolina,L (13-26),17,30,56.7,148,1,39,205,5.3,0,69,353,5.1,10,7,6,23,10,62,1,4,5
764,8,2015-10-31,virginia,,Georgia Tech,W (27-21),17,28,60.7,175,1,42,233,5.5,2,70,408,5.8,10,10,1,21,7,45,0,1,1
765,9,2015-11-07,virginia,@,Miami (FL),L (21-27),29,42,69.0,280,0,32,127,4.0,1,74,407,5.5,14,8,2,24,8,80,0,1,1
766,10,2015-11-14,virginia,@,Louisville,L (31-38),25,41,61.0,260,4,31,94,3.0,0,72,354,4.9,12,7,3,22,8,69,1,0,1
767,11,2015-11-21,virginia,,Duke,W (42-34),25,34,73.5,359,3,39,143,3.7,3,73,502,6.9,15,8,2,25,8,105,1,1,2
768,12,2015-11-28,virginia,,Virginia Tech,L (20-23),18,38,47.4,171,1,40,262,6.6,1,78,433,5.6,9,11,1,21,9,65,0,2,2
769,,12 Games,virginia,,,,252,413,61.0,2859,21,424,1737,4.1,13,837,4596,5.5,139,83,21,243,91,766,6,18,24
770,1,2016-09-03,virginia,,Richmond,L (20-37),26,34,76.5,264,3,21,38,1.8,0,55,302,5.5,12,5,2,19,0,0,3,1,4
771,2,2016-09-10,virginia,@,Oregon,L (26-44),21,40,52.5,195,2,40,193,4.8,2,80,388,4.9,9,14,5,28,10,102,0,2,2
772,3,2016-09-17,virginia,@,Connecticut,L (10-13),23,43,53.5,241,0,30,140,4.7,1,73,381,5.2,11,6,4,21,10,91,0,1,1
773,4,2016-09-24,virginia,,Central Michigan,W (49-35),27,43,62.8,421,5,26,148,5.7,2,69,569,8.2,16,8,1,25,4,45,0,1,1
774,5,2016-10-01,virginia,@,Duke,W (34-20),23,41,56.1,336,3,36,80,2.2,1,77,416,5.4,12,4,0,16,7,59,0,1,1
775,6,2016-10-15,virginia,,Pittsburgh,L (31-45),20,45,44.4,278,1,26,86,3.3,3,71,364,5.1,11,6,2,19,10,67,0,1,1
776,7,2016-10-22,virginia,,North Carolina,L (14-35),22,45,48.9,143,1,39,110,2.8,1,84,253,3.0,10,8,1,19,9,82,1,0,1
777,8,2016-10-29,virginia,,Louisville,L (25-32),25,40,62.5,238,3,28,84,3.0,0,68,322,4.7,10,6,1,17,5,48,0,2,2
778,9,2016-11-05,virginia,@,Wake Forest,L (20-27),20,40,50.0,190,2,32,105,3.3,1,72,295,4.1,11,8,2,21,3,30,1,2,3
779,10,2016-11-12,virginia,,Miami (FL),L (14-34),19,34,55.9,207,1,33,82,2.5,1,67,289,4.3,10,4,0,14,10,110,4,0,4
780,11,2016-11-19,virginia,@,Georgia Tech,L (17-31),27,46,58.7,220,1,42,189,4.5,1,88,409,4.6,15,10,0,25,4,30,0,3,3
781,12,2016-11-26,virginia,@,Virginia Tech,L (10-52),13,36,36.1,139,1,31,108,3.5,0,67,247,3.7,5,7,2,14,4,31,1,2,3
782,,12 Games,virginia,,,,266,487,54.6,2872,23,384,1363,3.5,13,871,4235,4.9,132,86,20,238,76,695,10,16,26
783,1,2017-09-02,virginia,,William & Mary,W (28-10),27,40,67.5,262,3,32,92,2.9,1,72,354,4.9,13,6,0,19,3,15,0,0,0
784,2,2017-09-09,virginia,,Indiana,L (17-34),39,66,59.1,259,1,25,55,2.2,1,91,314,3.5,11,7,4,22,5,26,0,0,0
785,3,2017-09-16,virginia,,Connecticut,W (38-18),30,40,75.0,455,3,31,171,5.5,2,71,626,8.8,18,9,0,27,9,109,0,1,1
786,4,2017-09-22,virginia,@,Boise State,W (42-23),19,29,65.5,273,3,40,167,4.2,3,69,440,6.4,13,8,0,21,3,23,0,0,0
787,5,2017-10-07,virginia,,Duke,W (28-21),24,43,55.8,182,3,38,128,3.4,0,81,310,3.8,8,8,5,21,7,67,0,2,2
788,6,2017-10-14,virginia,@,North Carolina,W (20-14),19,31,61.3,249,2,47,156,3.3,0,78,405,5.2,8,13,2,23,6,54,1,0,1
789,7,2017-10-21,virginia,,Boston College,L (10-41),19,42,45.2,152,0,26,95,3.7,1,68,247,3.6,9,7,3,19,1,15,0,3,3
790,8,2017-10-28,virginia,@,Pittsburgh,L (14-31),22,42,52.4,212,2,31,102,3.3,0,73,314,4.3,12,4,4,20,3,45,0,1,1
791,9,2017-11-04,virginia,,Georgia Tech,W (40-36),21,43,48.8,260,3,25,97,3.9,0,68,357,5.3,11,3,1,15,4,25,1,1,2
792,10,2017-11-11,virginia,@,Louisville,L (21-38),19,36,52.8,214,1,28,63,2.3,2,64,277,4.3,11,4,1,16,8,73,1,1,2
793,11,2017-11-18,virginia,@,Miami (FL),L (28-44),28,37,75.7,384,4,28,55,2.0,0,65,439,6.8,13,3,2,18,6,40,2,1,3
794,12,2017-11-24,virginia,,Virginia Tech,L (0-10),17,34,50.0,186,0,20,5,0.3,0,54,191,3.5,7,2,0,9,4,50,1,0,1
795,13,2017-12-28,virginia,@,Navy*,L (7-49),16,36,44.4,145,0,18,30,1.7,0,54,175,3.2,7,4,0,11,4,40,2,1,3
796,,13 Games,virginia,,,,300,519,57.8,3233,25,389,1216,3.1,10,908,4449,4.9,141,78,22,241,63,582,8,11,19
797,1,2018-09-01,virginia,,Richmond,W (42-13),14,26,53.8,191,2,48,301,6.3,4,74,492,6.6,8,17,0,25,4,24,0,1,1
798,2,2018-09-08,virginia,@,Indiana,L (16-20),12,25,48.0,106,2,39,188,4.8,0,64,294,4.6,6,7,2,15,5,56,1,0,1
799,3,2018-09-15,virginia,N,Ohio,W (45-31),25,30,83.3,379,3,31,173,5.6,3,61,552,9.0,14,8,1,23,3,20,3,0,3
800,4,2018-09-22,virginia,,Louisville,W (27-3),17,26,65.4,197,2,39,204,5.2,1,65,401,6.2,10,9,1,20,3,29,0,1,1
801,5,2018-09-29,virginia,@,North Carolina State,L (21-35),20,35,57.1,258,2,29,93,3.2,1,64,351,5.5,10,7,3,20,6,62,0,2,2
802,6,2018-10-13,virginia,,Miami (FL),W (16-13),12,21,57.1,92,0,41,139,3.4,1,62,231,3.7,3,12,3,18,6,60,0,3,3
803,7,2018-10-20,virginia,@,Duke,W (28-14),21,34,61.8,198,1,44,178,4.0,2,78,376,4.8,12,8,1,21,6,55,0,0,0
804,8,2018-10-27,virginia,,North Carolina,W (31-21),18,27,66.7,217,3,44,208,4.7,1,71,425,6.0,11,12,0,23,1,5,0,1,1
805,9,2018-11-02,virginia,,Pittsburgh,L (13-23),17,24,70.8,205,1,26,44,1.7,0,50,249,5.0,6,6,1,13,10,80,1,0,1
806,10,2018-11-10,virginia,,Liberty,W (45-24),14,22,63.6,168,2,39,221,5.7,3,61,389,6.4,8,15,1,24,1,10,0,1,1
807,11,2018-11-17,virginia,@,Georgia Tech,L (27-30),22,28,78.6,273,2,33,130,3.9,1,61,403,6.6,14,10,0,24,4,35,1,0,1
808,,11 Games,virginia,,,,192,298,64.4,2284,20,413,1879,4.5,17,711,4163,5.9,102,111,13,226,49,436,6,9,15
809,1,2014-08-28,wake-forest,@,Louisiana-Monroe,L (10-17),12,22,54.5,97,0,27,-3,-0.1,0,49,94,1.9,3,2,0,5,8,51,0,1,1
810,2,2014-09-06,wake-forest,,Gardner-Webb,W (23-7),30,39,76.9,291,2,36,96,2.7,0,75,387,5.2,17,7,0,24,7,71,0,3,3
811,3,2014-09-13,wake-forest,@,Utah State,L (24-36),20,50,40.0,257,2,24,-25,-1.0,0,74,232,3.1,13,1,2,16,10,103,1,2,3
812,4,2014-09-20,wake-forest,,Army,W (24-21),25,35,71.4,238,2,30,100,3.3,1,65,338,5.2,12,8,1,21,4,30,0,1,1
813,5,2014-09-27,wake-forest,@,Louisville,L (10-20),19,34,55.9,122,0,23,-22,-1.0,0,57,100,1.8,5,1,1,7,4,45,0,3,3
814,6,2014-10-04,wake-forest,@,Florida State,L (3-43),13,22,59.1,86,0,39,40,1.0,0,61,126,2.1,4,4,2,10,7,62,2,1,3
815,7,2014-10-18,wake-forest,,Syracuse,L (7-30),15,23,65.2,99,1,36,71,2.0,0,59,170,2.9,6,5,1,12,3,35,1,1,2
816,8,2014-10-25,wake-forest,,Boston College,L (17-23),22,30,73.3,242,0,33,19,0.6,2,63,261,4.1,11,3,3,17,6,49,0,1,1
817,9,2014-11-06,wake-forest,,Clemson,L (20-34),12,30,40.0,112,2,34,7,0.2,0,64,119,1.9,6,3,6,15,2,29,0,0,0
818,10,2014-11-15,wake-forest,@,North Carolina State,L (13-42),15,32,46.9,161,0,35,58,1.7,1,67,219,3.3,6,6,0,12,2,21,1,0,1
819,11,2014-11-22,wake-forest,,Virginia Tech,W (6-3),18,32,56.3,160,0,42,74,1.8,0,74,234,3.2,8,6,1,15,4,43,0,1,1
820,12,2014-11-29,wake-forest,@,Duke,L (21-41),24,36,66.7,251,3,24,64,2.7,0,60,315,5.3,11,5,2,18,3,35,2,0,2
821,,12 Games,wake-forest,,,,225,385,58.4,2116,12,383,479,1.3,4,768,2595,3.4,102,51,19,172,60,574,7,14,21
822,1,2015-09-03,wake-forest,,Elon,W (41-3),29,40,72.5,388,3,42,203,4.8,2,82,591,7.2,19,8,2,29,3,30,0,0,0
823,2,2015-09-12,wake-forest,@,Syracuse,L (17-30),30,45,66.7,373,1,32,46,1.4,1,77,419,5.4,17,5,1,23,6,52,0,3,3
824,3,2015-09-19,wake-forest,@,Army,W (17-14),18,33,54.5,175,0,35,171,4.9,2,68,346,5.1,7,9,3,19,6,47,0,3,3
825,4,2015-09-26,wake-forest,,Indiana,L (24-31),20,48,41.7,264,1,32,99,3.1,2,80,363,4.5,15,5,5,25,7,48,0,1,1
826,5,2015-10-03,wake-forest,,Florida State,L (16-24),27,43,62.8,215,1,36,142,3.9,0,79,357,4.5,12,10,5,27,5,32,1,1,2
827,6,2015-10-10,wake-forest,@,Boston College,W (3-0),11,25,44.0,109,0,28,33,1.2,0,53,142,2.7,4,1,0,5,9,102,1,1,2
828,7,2015-10-17,wake-forest,@,North Carolina,L (14-50),20,30,66.7,197,2,43,113,2.6,0,73,310,4.2,9,6,1,16,3,24,1,0,1
829,8,2015-10-24,wake-forest,,North Carolina State,L (17-35),14,30,46.7,122,0,38,149,3.9,2,68,271,4.0,7,6,4,17,3,35,0,1,1
830,9,2015-10-30,wake-forest,,Louisville,L (19-20),9,30,30.0,226,2,32,40,1.3,0,62,266,4.3,7,2,2,11,3,29,1,4,5
831,10,2015-11-14,wake-forest,@,Notre Dame,L (7-28),19,30,63.3,219,0,44,121,2.8,1,74,340,4.6,9,11,3,23,5,58,0,1,1
832,11,2015-11-21,wake-forest,@,Clemson,L (13-33),16,28,57.1,113,1,32,39,1.2,1,60,152,2.5,5,4,2,11,6,55,1,1,2
833,12,2015-11-28,wake-forest,,Duke,L (21-27),23,35,65.7,338,2,23,112,4.9,1,58,450,7.8,12,7,2,21,5,51,1,2,3
834,,12 Games,wake-forest,,,,236,417,56.6,2739,13,417,1268,3.0,12,834,4007,4.8,123,74,30,227,61,563,6,18,24
835,1,2016-09-01,wake-forest,,Tulane,W (7-3),12,21,57.1,96,0,34,79,2.3,1,55,175,3.2,4,6,0,10,5,45,0,0,0
836,2,2016-09-10,wake-forest,@,Duke,W (24-14),9,16,56.3,150,0,49,239,4.9,3,65,389,6.0,4,9,0,13,4,24,1,1,2
837,3,2016-09-17,wake-forest,,Delaware,W (38-21),15,28,53.6,179,1,59,302,5.1,4,87,481,5.5,10,19,0,29,6,60,1,1,2
838,4,2016-09-24,wake-forest,@,Indiana,W (33-28),16,29,55.2,172,1,50,180,3.6,2,79,352,4.5,9,9,3,21,5,40,0,0,0
839,5,2016-10-01,wake-forest,@,North Carolina State,L (16-33),27,46,58.7,283,1,21,69,3.3,0,67,352,5.3,14,4,5,23,3,38,0,0,0
840,6,2016-10-08,wake-forest,,Syracuse,W (28-9),13,22,59.1,140,0,51,190,3.7,3,73,330,4.5,7,12,2,21,1,5,1,1,2
841,7,2016-10-15,wake-forest,@,Florida State,L (6-17),16,34,47.1,184,0,32,68,2.1,0,66,252,3.8,8,4,1,13,5,40,1,2,3
842,8,2016-10-29,wake-forest,,Army,L (13-21),23,43,53.5,220,1,23,123,5.3,0,66,343,5.2,7,10,0,17,7,45,0,3,3
843,9,2016-11-05,wake-forest,,Virginia,W (27-20),9,10,90.0,83,1,51,226,4.4,1,61,309,5.1,5,10,1,16,6,32,0,0,0
844,10,2016-11-12,wake-forest,@,Louisville,L (12-44),13,24,54.2,141,0,49,73,1.5,0,73,214,2.9,6,7,3,16,4,25,1,1,2
845,11,2016-11-19,wake-forest,,Clemson,L (13-35),7,18,38.9,126,0,36,71,2.0,1,54,197,3.6,2,6,1,9,5,44,0,0,0
846,12,2016-11-26,wake-forest,,Boston College,L (14-17),16,33,48.5,137,2,35,150,4.3,0,68,287,4.2,7,5,3,15,3,35,1,2,3
847,13,2016-12-27,wake-forest,N,Temple*,W (34-26),14,29,48.3,243,2,43,125,2.9,2,72,368,5.1,11,10,1,22,7,68,0,2,2
848,,13 Games,wake-forest,,,,190,353,53.8,2154,9,533,1895,3.6,17,886,4049,4.6,94,111,20,225,61,501,6,13,19
849,1,2017-08-31,wake-forest,,Presbyterian,W (51-7),20,27,74.1,239,5,45,248,5.5,2,72,487,6.8,10,16,2,28,4,25,0,1,1
850,2,2017-09-09,wake-forest,@,Boston College,W (34-10),13,19,68.4,151,1,52,158,3.0,2,71,309,4.4,7,8,0,15,5,40,0,0,0
851,3,2017-09-16,wake-forest,,Utah State,W (46-10),16,27,59.3,297,2,59,291,4.9,3,86,588,6.8,11,13,2,26,8,62,0,0,0
852,4,2017-09-23,wake-forest,@,Appalachian State,W (20-19),14,27,51.9,176,2,40,168,4.2,0,67,344,5.1,9,7,2,18,8,66,0,0,0
853,5,2017-09-30,wake-forest,,Florida State,L (19-26),24,35,68.6,271,0,34,96,2.8,2,69,367,5.3,13,4,0,17,7,59,1,1,2
854,6,2017-10-07,wake-forest,@,Clemson,L (14-28),14,30,46.7,203,2,35,133,3.8,0,65,336,5.2,8,7,1,16,4,25,0,0,0
855,7,2017-10-21,wake-forest,@,Georgia Tech,L (24-38),17,30,56.7,252,2,31,110,3.5,1,61,362,5.9,12,6,2,20,4,40,0,1,1
856,8,2017-10-28,wake-forest,,Louisville,W (42-32),28,34,82.4,461,5,39,164,4.2,1,73,625,8.6,16,10,0,26,6,55,1,0,1
857,9,2017-11-04,wake-forest,@,Notre Dame,L (37-48),30,48,62.5,348,2,40,239,6.0,3,88,587,6.7,20,13,1,34,3,15,0,1,1
858,10,2017-11-11,wake-forest,@,Syracuse,W (64-43),25,38,65.8,363,3,51,371,7.3,5,89,734,8.2,14,18,1,33,10,62,1,0,1
859,11,2017-11-18,wake-forest,,North Carolina State,W (30-24),19,28,67.9,247,3,28,87,3.1,1,56,334,6.0,10,7,1,18,4,40,0,1,1
860,12,2017-11-25,wake-forest,,Duke,L (23-31),16,34,47.1,191,2,35,145,4.1,0,69,336,4.9,6,6,2,14,2,10,1,2,3
861,13,2017-12-29,wake-forest,N,Texas A&M*,W (55-52),32,49,65.3,400,4,46,248,5.4,2,95,648,6.8,18,10,3,31,4,45,2,0,2
862,,13 Games,wake-forest,,,,268,426,62.9,3599,33,535,2458,4.6,22,961,6057,6.3,154,125,17,296,69,544,6,7,13
863,1,2018-08-30,wake-forest,@,Tulane,W (23-17),31,51,60.8,378,2,43,170,4.0,1,94,548,5.8,20,10,2,32,6,70,1,2,3
864,2,2018-09-08,wake-forest,,Towson,W (51-20),17,27,63.0,242,2,54,340,6.3,2,81,582,7.2,13,16,3,32,0,0,1,1,2
865,3,2018-09-13,wake-forest,,Boston College,L (34-41),20,45,44.4,214,2,60,298,5.0,1,105,512,4.9,10,16,1,27,3,35,0,2,2
866,4,2018-09-22,wake-forest,,Notre Dame,L (27-56),16,31,51.6,139,0,61,259,4.2,3,92,398,4.3,9,15,3,27,3,23,0,1,1
867,5,2018-09-29,wake-forest,,Rice,W (56-24),17,20,85.0,243,4,41,171,4.2,2,61,414,6.8,8,9,3,20,3,25,1,1,2
868,6,2018-10-06,wake-forest,,Clemson,L (3-63),7,27,25.9,74,0,51,175,3.4,0,78,249,3.2,4,7,0,11,5,55,0,1,1
869,7,2018-10-20,wake-forest,@,Florida State,L (17-38),26,56,46.4,261,2,51,119,2.3,0,107,380,3.6,14,10,1,25,5,65,0,1,1
870,8,2018-10-27,wake-forest,@,Louisville,W (56-35),16,24,66.7,223,2,48,368,7.7,5,72,591,8.2,10,18,0,28,3,35,0,0,0
871,9,2018-11-03,wake-forest,,Syracuse,L (24-41),21,37,56.8,275,2,44,159,3.6,1,81,434,5.4,12,10,4,26,10,95,2,1,3
872,10,2018-11-08,wake-forest,@,North Carolina State,W (27-23),22,33,66.7,297,3,38,138,3.6,0,71,435,6.1,11,10,1,22,5,50,1,0,1
873,11,2018-11-17,wake-forest,,Pittsburgh,L (13-34),15,30,50.0,206,1,28,79,2.8,0,58,285,4.9,9,6,1,16,1,15,0,2,2
874,,11 Games,wake-forest,,,,208,381,54.6,2552,20,519,2276,4.4,15,900,4828,5.4,120,127,19,266,44,468,6,12,18
875,1,2014-08-30,maryland,,James Madison,W (52-7),18,35,51.4,186,2,50,285,5.7,5,85,471,5.5,11,16,3,30,5,35,0,1,1
876,2,2014-09-06,maryland,@,South Florida,W (24-17),17,28,60.7,201,2,40,116,2.9,0,68,317,4.7,9,8,0,17,4,35,4,2,6
877,3,2014-09-13,maryland,,West Virginia,L (37-40),21,38,55.3,284,2,27,163,6.0,1,65,447,6.9,11,5,0,16,7,71,0,1,1
878,4,2014-09-20,maryland,@,Syracuse,W (34-20),16,26,61.5,280,2,32,89,2.8,1,58,369,6.4,10,6,1,17,8,75,0,0,0
879,5,2014-09-27,maryland,@,Indiana,W (37-15),22,33,66.7,361,3,36,123,3.4,1,69,484,7.0,14,8,1,23,8,83,0,0,0
880,6,2014-10-04,maryland,,Ohio State,L (24-52),24,40,60.0,244,1,24,66,2.8,2,64,310,4.8,8,6,3,17,2,23,0,4,4
881,7,2014-10-18,maryland,,Iowa,W (38-31),17,33,51.5,206,1,46,212,4.6,3,79,418,5.3,8,11,3,22,6,50,0,2,2
882,8,2014-10-25,maryland,@,Wisconsin,L (7-52),13,29,44.8,129,1,28,46,1.6,0,57,175,3.1,6,3,1,10,7,45,1,0,1
883,9,2014-11-01,maryland,@,Penn State,W (20-19),18,38,47.4,161,1,30,33,1.1,1,68,194,2.9,7,5,3,15,6,89,2,0,2
884,10,2014-11-15,maryland,,Michigan State,L (15-37),20,43,46.5,246,2,17,6,0.4,0,60,252,4.2,9,0,2,11,5,30,1,3,4
885,11,2014-11-22,maryland,@,Michigan,W (23-16),13,24,54.2,165,0,35,147,4.2,2,59,312,5.3,8,8,1,17,4,30,0,0,0
886,12,2014-11-29,maryland,,Rutgers,L (38-41),14,24,58.3,195,2,36,281,7.8,3,60,476,7.9,8,11,1,20,10,72,0,0,0
887,13,2014-12-30,maryland,N,Stanford*,L (21-45),15,27,55.6,205,0,27,17,0.6,2,54,222,4.1,10,1,1,12,5,39,0,1,1
888,,13 Games,maryland,,,,228,418,54.5,2863,19,428,1584,3.7,21,846,4447,5.3,119,88,20,227,77,677,8,14,22
889,1,2015-09-05,maryland,,Richmond,W (50-21),12,22,54.5,138,2,45,341,7.6,3,67,479,7.1,6,18,0,24,5,39,0,1,1
890,2,2015-09-12,maryland,,Bowling Green State,L (27-48),16,33,48.5,185,2,26,156,6.0,0,59,341,5.8,8,7,1,16,6,57,1,3,4
891,3,2015-09-19,maryland,,South Florida,W (35-17),21,34,61.8,297,4,34,114,3.4,1,68,411,6.0,12,4,2,18,12,120,0,3,3
892,4,2015-09-26,maryland,@,West Virginia,L (6-45),14,36,38.9,153,1,29,173,6.0,0,65,326,5.0,7,4,3,14,10,100,1,5,6
893,5,2015-10-03,maryland,,Michigan,L (0-28),10,36,27.8,76,0,26,29,1.1,0,62,105,1.7,5,1,1,7,5,66,0,3,3
894,6,2015-10-10,maryland,@,Ohio State,L (28-49),10,27,37.0,133,1,42,253,6.0,3,69,386,5.6,6,13,1,20,9,63,0,2,2
895,7,2015-10-24,maryland,N,Penn State,L (30-31),19,28,67.9,225,1,48,241,5.0,2,76,466,6.1,9,11,1,21,6,55,2,3,5
896,8,2015-10-31,maryland,@,Iowa,L (15-31),11,23,47.8,74,1,34,167,4.9,0,57,241,4.2,3,10,2,15,8,72,1,3,4
897,9,2015-11-07,maryland,,Wisconsin,L (24-31),13,34,38.2,204,2,32,112,3.5,1,66,316,4.8,9,6,1,16,11,79,0,2,2
898,10,2015-11-14,maryland,@,Michigan State,L (7-24),17,36,47.2,182,0,37,107,2.9,1,73,289,4.0,8,7,1,16,1,8,2,3,5
899,11,2015-11-21,maryland,,Indiana,L (28-47),21,41,51.2,170,1,46,314,6.8,3,87,484,5.6,11,11,1,23,8,52,0,0,0
900,12,2015-11-28,maryland,@,Rutgers,W (46-41),19,38,50.0,255,0,42,401,9.5,6,80,656,8.2,12,13,2,27,3,31,0,1,1
901,,12 Games,maryland,,,,183,388,47.2,2092,15,441,2408,5.5,20,829,4500,5.4,96,105,16,217,84,742,7,29,36
902,1,2016-09-03,maryland,,Howard,W (52-13),20,29,69.0,204,0,44,315,7.2,6,73,519,7.1,10,14,1,25,2,25,0,0,0
903,2,2016-09-09,maryland,@,Florida International,W (41-14),15,21,71.4,238,3,45,239,5.3,1,66,477,7.2,11,11,0,22,8,85,0,0,0
904,3,2016-09-17,maryland,@,Central Florida,W (30-24),10,23,43.5,127,0,50,246,4.9,4,73,373,5.1,4,16,0,20,6,47,0,0,0
905,4,2016-10-01,maryland,,Purdue,W (50-7),9,17,52.9,96,3,46,400,8.7,4,63,496,7.9,5,13,1,19,11,92,1,1,2
906,5,2016-10-08,maryland,@,Penn State,L (14-38),10,16,62.5,100,1,38,170,4.5,1,54,270,5.0,3,8,0,11,5,49,1,1,2
907,6,2016-10-15,maryland,,Minnesota,L (10-31),18,37,48.6,161,1,36,130,3.6,0,73,291,4.0,8,8,0,16,9,75,2,2,4
908,7,2016-10-22,maryland,,Michigan State,W (28-17),21,28,75.0,200,2,42,247,5.9,2,70,447,6.4,8,10,4,22,3,25,1,0,1
909,8,2016-10-29,maryland,@,Indiana,L (36-42),22,34,64.7,248,2,50,269,5.4,3,84,517,6.2,14,13,2,29,6,60,1,1,2
910,9,2016-11-05,maryland,@,Michigan,L (3-59),17,28,60.7,289,0,38,78,2.1,0,66,367,5.6,12,6,1,19,6,46,0,2,2
911,10,2016-11-12,maryland,,Ohio State,L (3-62),15,27,55.6,133,0,40,43,1.1,0,67,176,2.6,7,3,0,10,7,74,1,1,2
912,11,2016-11-19,maryland,@,Nebraska,L (7-28),15,31,48.4,196,1,25,11,0.4,0,56,207,3.7,7,2,0,9,5,65,0,0,0
913,12,2016-11-26,maryland,,Rutgers,W (31-13),9,16,56.3,96,0,45,318,7.1,3,61,414,6.8,4,12,1,17,9,60,0,0,0
914,13,2016-12-26,maryland,N,Boston College*,L (30-36),15,35,42.9,229,2,34,128,3.8,2,69,357,5.2,9,7,1,17,11,86,3,1,4
915,,13 Games,maryland,,,,196,342,57.3,2317,15,533,2594,4.9,26,875,4911,5.6,102,123,11,236,88,789,10,9,19
916,1,2017-09-02,maryland,@,Texas,W (51-41),12,15,80.0,219,2,43,263,6.1,4,58,482,8.3,7,10,1,18,10,53,0,1,1
917,2,2017-09-09,maryland,,Towson,W (63-17),14,18,77.8,167,2,36,367,10.2,6,54,534,9.9,7,14,2,23,5,55,0,0,0
918,3,2017-09-23,maryland,,Central Florida,L (10-38),17,28,60.7,155,1,37,42,1.1,0,65,197,3.0,7,5,6,18,7,53,0,2,2
919,4,2017-09-30,maryland,@,Minnesota,W (31-24),18,28,64.3,154,2,47,262,5.6,2,75,416,5.5,9,13,1,23,6,70,0,0,0
920,5,2017-10-07,maryland,@,Ohio State,L (14-62),3,13,23.1,16,0,42,50,1.2,1,55,66,1.2,0,3,3,6,6,66,2,0,2
921,6,2017-10-14,maryland,,Northwestern,L (21-37),17,38,44.7,255,3,31,85,2.7,0,69,340,4.9,9,7,3,19,2,30,0,0,0
922,7,2017-10-21,maryland,@,Wisconsin,L (13-38),13,30,43.3,125,1,35,143,4.1,0,65,268,4.1,6,10,2,18,4,54,1,1,2
923,8,2017-10-28,maryland,,Indiana,W (42-39),10,16,62.5,171,2,40,174,4.4,3,56,345,6.2,6,8,4,18,12,133,0,1,1
924,9,2017-11-04,maryland,N,Rutgers,L (24-31),19,32,59.4,218,1,37,167,4.5,2,69,385,5.6,11,6,3,20,10,65,0,1,1
925,10,2017-11-11,maryland,,Michigan,L (10-35),18,38,47.4,160,1,32,180,5.6,0,70,340,4.9,7,8,0,15,7,59,0,2,2
926,11,2017-11-18,maryland,@,Michigan State,L (7-17),13,25,52.0,121,0,31,83,2.7,1,56,204,3.6,6,5,1,12,6,45,1,0,1
927,12,2017-11-25,maryland,,Penn State,L (3-66),21,37,56.8,179,0,25,124,5.0,0,62,303,4.9,7,3,1,11,8,91,2,0,2
928,,12 Games,maryland,,,,175,318,55.0,1940,15,436,1940,4.4,19,754,3880,5.1,82,92,27,201,83,774,6,8,14
929,1,2018-09-01,maryland,N,Texas,W (34-29),21,34,61.8,264,2,46,143,3.1,2,80,407,5.1,8,8,5,21,8,70,0,0,0
930,2,2018-09-08,maryland,@,Bowling Green State,W (45-14),8,16,50.0,121,1,53,444,8.4,5,69,565,8.2,4,19,1,24,14,139,1,0,1
931,3,2018-09-15,maryland,,Temple,L (14-35),8,21,38.1,63,0,31,132,4.3,0,52,195,3.8,2,7,2,11,5,35,0,2,2
932,4,2018-09-22,maryland,,Minnesota,W (42-13),10,14,71.4,117,1,37,315,8.5,4,51,432,8.5,2,12,1,15,10,118,0,0,0
933,5,2018-10-06,maryland,@,Michigan,L (21-42),7,13,53.8,73,0,37,147,4.0,2,50,220,4.4,5,5,1,11,12,107,0,1,1
934,6,2018-10-13,maryland,,Rutgers,W (34-7),9,20,45.0,85,3,40,290,7.3,1,60,375,6.3,4,12,0,16,9,85,1,0,1
935,7,2018-10-20,maryland,@,Iowa,L (0-23),6,16,37.5,47,0,23,68,3.0,0,39,115,2.9,3,4,0,7,6,46,1,1,2
936,8,2018-10-27,maryland,,Illinois,W (63-33),13,21,61.9,281,3,48,431,9.0,5,69,712,10.3,10,19,1,30,7,85,0,0,0
937,9,2018-11-03,maryland,,Michigan State,L (3-24),8,24,33.3,74,0,29,26,0.9,0,53,100,1.9,4,3,2,9,3,25,2,0,2
938,10,2018-11-10,maryland,@,Indiana,L (32-34),14,25,56.0,189,1,59,353,6.0,2,84,542,6.5,8,18,1,27,10,93,3,1,4
939,11,2018-11-17,maryland,,Ohio State,L (51-52),7,14,50.0,196,1,47,340,7.2,4,61,536,8.8,5,12,2,19,9,88,1,0,1
940,,11 Games,maryland,,,,111,218,50.9,1510,12,450,2689,6.0,25,668,4199,6.3,55,119,16,190,93,891,9,5,14
941,1,2014-08-28,south-carolina,,Texas A&M,L (28-52),20,40,50.0,366,4,22,67,3.0,0,62,433,7.0,14,5,4,23,4,21,0,1,1
942,2,2014-09-06,south-carolina,,East Carolina,W (33-23),25,38,65.8,266,1,38,175,4.6,2,76,441,5.8,15,10,1,26,5,60,0,1,1
943,3,2014-09-13,south-carolina,,Georgia,W (38-35),21,30,70.0,271,3,42,176,4.2,2,72,447,6.2,13,13,1,27,7,69,1,1,2
944,4,2014-09-20,south-carolina,@,Vanderbilt,W (48-34),22,34,64.7,237,3,34,212,6.2,2,68,449,6.6,10,12,2,24,5,35,1,0,1
945,5,2014-09-27,south-carolina,,Missouri,L (20-21),21,37,56.8,219,1,42,119,2.8,1,79,338,4.3,7,9,2,18,8,71,0,0,0
946,6,2014-10-04,south-carolina,@,Kentucky,L (38-45),23,37,62.2,218,1,48,282,5.9,4,85,500,5.9,13,16,3,32,4,35,0,3,3
947,7,2014-10-18,south-carolina,,Furman,W (41-10),16,28,57.1,281,2,43,267,6.2,3,71,548,7.7,11,14,1,26,7,53,2,0,2
948,8,2014-10-25,south-carolina,@,Auburn,L (35-42),30,53,56.6,416,5,33,119,3.6,0,86,535,6.2,20,7,3,30,4,20,0,3,3
949,9,2014-11-01,south-carolina,,Tennessee,L (42-45),21,34,61.8,377,3,39,248,6.4,3,73,625,8.6,14,12,0,26,7,51,0,1,1
950,10,2014-11-15,south-carolina,@,Florida,W (23-20),22,42,52.4,206,0,38,95,2.5,3,80,301,3.8,8,8,3,19,6,67,1,0,1
951,11,2014-11-22,south-carolina,,South Alabama,W (37-12),11,20,55.0,244,2,37,210,5.7,1,57,454,8.0,7,12,1,20,6,57,4,1,5
952,12,2014-11-29,south-carolina,@,Clemson,L (17-35),23,41,56.1,276,1,33,63,1.9,1,74,339,4.6,8,8,2,18,2,6,1,0,1
953,13,2014-12-27,south-carolina,N,Miami (FL)*,W (24-21),22,34,64.7,294,2,30,60,2.0,1,64,354,5.5,10,5,1,16,5,61,0,0,0
954,,13 Games,south-carolina,,,,277,468,59.2,3671,28,479,2093,4.4,23,947,5764,6.1,150,131,24,305,70,606,10,11,21
955,1,2015-09-03,south-carolina,N,North Carolina,W (17-13),12,27,44.4,140,1,47,254,5.4,1,74,394,5.3,7,15,0,22,8,60,0,0,0
956,2,2015-09-12,south-carolina,,Kentucky,L (22-26),17,27,63.0,222,1,34,195,5.7,1,61,417,6.8,10,9,3,22,5,50,0,1,1
957,3,2015-09-19,south-carolina,@,Georgia,L (20-52),10,22,45.5,84,0,39,174,4.5,2,61,258,4.2,7,8,1,16,4,40,0,1,1
958,4,2015-09-26,south-carolina,,Central Florida,W (31-14),12,25,48.0,184,2,43,216,5.0,1,68,400,5.9,9,10,1,20,2,20,1,0,1
959,5,2015-10-03,south-carolina,@,Missouri,L (10-24),17,30,56.7,186,1,34,112,3.3,0,64,298,4.7,9,7,1,17,4,35,0,3,3
960,6,2015-10-10,south-carolina,,Louisiana State,L (24-45),15,30,50.0,209,2,20,74,3.7,0,50,283,5.7,6,6,0,12,5,32,0,1,1
961,7,2015-10-17,south-carolina,,Vanderbilt,W (19-10),17,29,58.6,272,1,37,152,4.1,0,66,424,6.4,10,6,1,17,6,39,1,1,2
962,8,2015-10-31,south-carolina,@,Texas A&M,L (28-35),15,24,62.5,192,0,43,253,5.9,4,67,445,6.6,8,11,0,19,5,26,0,2,2
963,9,2015-11-07,south-carolina,@,Tennessee,L (24-27),20,39,51.3,233,3,40,152,3.8,0,79,385,4.9,11,10,2,23,6,40,1,0,1
964,10,2015-11-14,south-carolina,,Florida,L (14-24),14,25,56.0,180,2,23,21,0.9,0,48,201,4.2,9,1,3,13,4,45,0,2,2
965,11,2015-11-21,south-carolina,,Citadel,L (22-23),28,43,65.1,367,1,25,72,2.9,1,68,439,6.5,14,4,0,18,7,51,0,0,0
966,12,2015-11-28,south-carolina,,Clemson,L (32-37),14,30,46.7,221,3,38,181,4.8,1,68,402,5.9,7,10,0,17,4,30,0,1,1
967,,12 Games,south-carolina,,,,191,351,54.4,2490,17,423,1856,4.4,11,774,4346,5.6,107,97,12,216,60,468,3,12,15
968,1,2016-09-01,south-carolina,@,Vanderbilt,W (13-10),16,30,53.3,187,0,32,121,3.8,1,62,308,5.0,10,4,0,14,7,51,2,0,2
969,2,2016-09-10,south-carolina,@,Mississippi State,L (14-27),20,39,51.3,209,2,31,34,1.1,0,70,243,3.5,12,5,1,18,6,70,1,1,2
970,3,2016-09-17,south-carolina,,East Carolina,W (20-15),16,28,57.1,195,0,25,117,4.7,2,53,312,5.9,8,3,2,13,7,65,0,0,0
971,4,2016-09-24,south-carolina,@,Kentucky,L (10-17),15,30,50.0,177,0,35,91,2.6,1,65,268,4.1,10,5,1,16,5,45,0,0,0
972,5,2016-10-01,south-carolina,,Texas A&M,L (13-24),22,35,62.9,217,0,35,161,4.6,1,70,378,5.4,11,8,2,21,3,20,1,1,2
973,6,2016-10-09,south-carolina,,Georgia,L (14-28),26,36,72.2,288,0,26,30,1.2,2,62,318,5.1,9,4,0,13,5,42,2,1,3
974,7,2016-10-22,south-carolina,,Massachusetts,W (34-28),17,26,65.4,201,2,44,194,4.4,3,70,395,5.6,6,11,4,21,6,67,2,0,2
975,8,2016-10-29,south-carolina,,Tennessee,W (24-21),15,21,71.4,167,2,49,158,3.2,1,70,325,4.6,8,9,2,19,7,77,0,0,0
976,9,2016-11-05,south-carolina,,Missouri,W (31-21),22,28,78.6,254,2,49,174,3.6,2,77,428,5.6,10,11,1,22,6,45,0,0,0
977,10,2016-11-12,south-carolina,@,Florida,L (7-20),18,33,54.5,213,0,30,43,1.4,1,63,256,4.1,10,4,1,15,2,10,1,1,2
978,11,2016-11-19,south-carolina,,Western Carolina,W (44-31),15,24,62.5,166,0,56,422,7.5,4,80,588,7.4,8,19,1,28,3,25,1,0,1
979,12,2016-11-26,south-carolina,@,Clemson,L (7-56),14,29,48.3,107,1,29,111,3.8,0,58,218,3.8,5,6,3,14,5,54,0,1,1
980,13,2016-12-29,south-carolina,N,South Florida*,L (39-46),32,43,74.4,390,3,34,91,2.7,2,77,481,6.2,20,4,3,27,3,35,3,2,5
981,,13 Games,south-carolina,,,,248,402,61.7,2771,12,475,1747,3.7,20,877,4518,5.2,127,93,21,241,65,606,13,7,20
982,1,2017-09-02,south-carolina,N,North Carolina State,W (35-28),17,29,58.6,215,3,21,31,1.5,1,50,246,4.9,8,4,0,12,6,45,0,1,1
983,2,2017-09-09,south-carolina,@,Missouri,W (31-13),18,28,64.3,187,1,40,172,4.3,2,68,359,5.3,9,9,2,20,4,29,0,0,0
984,3,2017-09-16,south-carolina,,Kentucky,L (13-23),24,37,64.9,304,2,20,54,2.7,0,57,358,6.3,11,3,0,14,7,45,0,2,2
985,4,2017-09-23,south-carolina,,Louisiana Tech,W (17-16),22,35,62.9,295,1,31,154,5.0,1,66,449,6.8,12,11,0,23,1,15,1,1,2
986,5,2017-09-30,south-carolina,@,Texas A&M,L (17-24),17,30,56.7,256,2,26,23,0.9,0,56,279,5.0,11,2,1,14,2,10,1,0,1
987,6,2017-10-07,south-carolina,,Arkansas,W (48-22),16,31,51.6,199,3,36,159,4.4,0,67,358,5.3,9,9,1,19,3,25,0,0,0
988,7,2017-10-14,south-carolina,@,Tennessee,W (15-9),15,24,62.5,129,0,40,194,4.9,1,64,323,5.0,8,11,0,19,8,59,0,0,0
989,8,2017-10-28,south-carolina,,Vanderbilt,W (34-27),19,29,65.5,174,1,37,212,5.7,3,66,386,5.8,8,14,4,26,7,50,0,0,0
990,9,2017-11-04,south-carolina,@,Georgia,L (10-24),21,36,58.3,227,1,17,43,2.5,0,53,270,5.1,11,1,2,14,2,15,0,2,2
991,10,2017-11-11,south-carolina,,Florida,W (28-20),19,29,65.5,249,0,47,220,4.7,4,76,469,6.2,13,9,2,24,3,26,1,3,4
992,11,2017-11-18,south-carolina,,Wofford,W (31-10),22,28,78.6,194,1,38,195,5.1,3,66,389,5.9,9,13,1,23,3,31,0,0,0
993,12,2017-11-25,south-carolina,,Clemson,L (10-34),16,29,55.2,126,1,25,81,3.2,0,54,207,3.8,6,4,0,10,9,76,0,2,2
994,13,2018-01-01,south-carolina,N,Michigan*,W (26-19),19,32,59.4,239,2,26,61,2.3,1,58,300,5.2,10,2,1,13,7,68,2,1,3
995,,13 Games,south-carolina,,,,245,397,61.7,2794,18,404,1599,4.0,16,801,4393,5.5,125,92,14,231,62,494,5,12,17
996,1,2018-09-01,south-carolina,,Coastal Carolina,W (49-15),25,35,71.4,294,5,37,267,7.2,2,72,561,7.8,15,16,1,32,9,99,0,0,0
997,2,2018-09-08,south-carolina,,Georgia,L (17-41),31,48,64.6,282,2,20,54,2.7,0,68,336,4.9,16,1,2,19,3,40,0,2,2
998,3,2018-09-22,south-carolina,@,Vanderbilt,W (37-14),19,28,67.9,261,1,48,273,5.7,3,76,534,7.0,14,12,2,28,8,54,2,1,3
999,4,2018-09-29,south-carolina,@,Kentucky,L (10-24),17,34,50.0,193,1,35,133,3.8,0,69,326,4.7,8,11,1,20,11,94,1,3,4
1000,5,2018-10-06,south-carolina,,Missouri,W (37-35),20,35,57.1,249,3,47,128,2.7,0,82,377,4.6,13,4,1,18,9,83,1,0,1
1001,6,2018-10-13,south-carolina,,Texas A&M,L (23-26),17,35,48.6,223,3,18,76,4.2,0,53,299,5.6,8,6,5,19,4,39,1,1,2
1002,7,2018-10-27,south-carolina,,Tennessee,W (27-24),11,16,68.8,152,1,40,224,5.6,2,56,376,6.7,6,12,1,19,2,9,0,1,1
1003,8,2018-11-03,south-carolina,@,Mississippi,W (48-44),22,32,68.8,363,2,36,145,4.0,3,68,508,7.5,12,6,0,18,5,51,0,0,0
1004,9,2018-11-10,south-carolina,@,Florida,L (31-35),18,28,64.3,239,2,36,147,4.1,2,64,386,6.0,10,7,1,18,7,41,0,1,1
1005,10,2018-11-17,south-carolina,,Chattanooga,W (49-9),29,36,80.6,364,4,42,238,5.7,3,78,602,7.7,13,17,3,33,6,48,0,0,0
1006,,10 Games,south-carolina,,,,209,327,63.9,2620,24,359,1685,4.7,15,686,4305,6.3,115,92,17,224,64,558,5,9,14
1007,1,2014-08-29,houston,,Texas-San Antonio,L (7-27),25,50,50.0,234,0,23,-26,-1.1,1,73,208,2.8,10,4,4,18,9,47,2,4,6
1008,2,2014-09-06,houston,,Grambling State,W (47-0),15,26,57.7,202,1,40,275,6.9,3,66,477,7.2,8,8,4,20,5,30,2,0,2
1009,3,2014-09-11,houston,@,Brigham Young,L (25-33),31,53,58.5,315,3,13,10,0.8,0,66,325,4.9,14,1,3,18,8,83,0,0,0
1010,4,2014-09-20,houston,,Nevada-Las Vegas,W (47-14),12,29,41.4,135,2,52,399,7.7,4,81,534,6.6,6,19,5,30,9,110,0,2,2
1011,5,2014-10-02,houston,,Central Florida,L (12-17),22,43,51.2,214,0,33,117,3.5,0,76,331,4.4,7,9,4,20,11,99,1,2,3
1012,6,2014-10-11,houston,@,Memphis,W (28-24),17,28,60.7,188,1,40,166,4.2,3,68,354,5.2,8,6,1,15,3,32,2,1,3
1013,7,2014-10-17,houston,,Temple,W (31-10),29,33,87.9,268,2,49,171,3.5,1,82,439,5.4,10,11,2,23,10,102,0,0,0
1014,8,2014-11-01,houston,@,South Florida,W (27-3),15,19,78.9,89,1,47,217,4.6,3,66,306,4.6,5,14,2,21,1,5,0,0,0
1015,9,2014-11-08,houston,,Tulane,L (24-31),30,49,61.2,336,2,32,90,2.8,0,81,426,5.3,13,8,4,25,6,51,0,4,4
1016,10,2014-11-22,houston,,Tulsa,W (38-28),16,21,76.2,227,1,43,244,5.7,4,64,471,7.4,9,12,0,21,5,47,0,0,0
1017,11,2014-11-28,houston,@,Southern Methodist,W (35-9),18,29,62.1,151,0,48,282,5.9,5,77,433,5.6,11,12,2,25,4,28,0,1,1
1018,12,2014-12-06,houston,N,Cincinnati,L (31-38),27,45,60.0,360,2,35,234,6.7,2,80,594,7.4,12,14,1,27,4,37,0,1,1
1019,13,2015-01-02,houston,N,Pittsburgh*,W (35-34),15,25,60.0,274,3,40,212,5.3,2,65,486,7.5,10,12,1,23,9,100,0,0,0
1020,,13 Games,houston,,,,272,450,60.4,2993,18,495,2391,4.8,28,945,5384,5.7,123,130,33,286,84,771,7,15,22
1021,1,2015-09-05,houston,,Tennessee Tech,W (52-24),27,38,71.1,355,1,44,272,6.2,6,82,627,7.6,13,14,0,27,9,59,1,0,1
1022,2,2015-09-12,houston,@,Louisville,W (34-31),23,35,65.7,236,3,57,226,4.0,0,92,462,5.0,11,12,2,25,7,78,0,1,1
1023,3,2015-09-26,houston,,Texas State,W (59-14),18,24,75.0,323,4,54,366,6.8,3,78,689,8.8,10,19,0,29,10,69,0,0,0
1024,4,2015-10-03,houston,@,Tulsa,W (38-24),22,38,57.9,273,0,56,365,6.5,5,94,638,6.8,12,13,3,28,3,44,1,0,1
1025,5,2015-10-08,houston,,Southern Methodist,W (49-28),16,18,88.9,243,0,48,214,4.5,7,66,457,6.9,9,13,1,23,6,55,1,0,1
1026,6,2015-10-16,houston,@,Tulane,W (42-7),17,25,68.0,222,1,47,239,5.1,4,72,461,6.4,8,12,4,24,10,99,0,1,1
1027,7,2015-10-24,houston,@,Central Florida,W (59-10),20,28,71.4,234,2,48,366,7.6,5,76,600,7.9,10,17,3,30,7,87,0,0,0
1028,8,2015-10-31,houston,,Vanderbilt,W (34-0),15,23,65.2,221,1,51,150,2.9,2,74,371,5.0,11,6,2,19,6,55,2,0,2
1029,9,2015-11-07,houston,,Cincinnati,W (33-30),16,24,66.7,161,2,63,266,4.2,1,87,427,4.9,10,8,6,24,4,40,0,2,2
1030,10,2015-11-14,houston,,Memphis,W (35-34),26,44,59.1,296,1,31,96,3.1,4,75,392,5.2,14,5,1,20,4,40,0,0,0
1031,11,2015-11-21,houston,@,Connecticut,L (17-20),17,31,54.8,208,1,33,110,3.3,0,64,318,5.0,8,4,1,13,7,69,2,2,4
1032,12,2015-11-27,houston,,Navy,W (52-31),27,36,75.0,337,4,44,218,5.0,3,80,555,6.9,14,13,0,27,3,29,0,0,0
1033,13,2015-12-05,houston,,Temple,W (24-13),12,22,54.5,106,0,40,233,5.8,3,62,339,5.5,5,11,0,16,5,40,0,0,0
1034,14,2015-12-31,houston,N,Florida State*,W (38-24),28,46,60.9,261,2,53,187,3.5,3,99,448,4.5,14,10,3,27,4,30,0,1,1
1035,,14 Games,houston,,,,284,432,65.7,3476,22,669,3308,4.9,46,1101,6784,6.2,149,157,26,332,85,794,7,7,14
1036,1,2016-09-03,houston,N,Oklahoma,W (33-23),23,40,57.5,321,2,40,89,2.2,0,80,410,5.1,16,5,4,25,7,75,1,0,1
1037,2,2016-09-10,houston,,Lamar,W (42-0),15,26,57.7,130,0,71,381,5.4,6,97,511,5.3,7,17,1,25,2,15,0,1,1
1038,3,2016-09-15,houston,@,Cincinnati,W (40-16),24,36,66.7,326,1,57,180,3.2,2,93,506,5.4,14,14,0,28,4,45,1,2,3
1039,4,2016-09-24,houston,@,Texas State,W (64-3),25,32,78.1,320,3,50,243,4.9,5,82,563,6.9,14,14,4,32,0,0,0,0,0
1040,5,2016-09-29,houston,,Connecticut,W (42-14),40,49,81.6,426,3,30,114,3.8,3,79,540,6.8,20,6,1,27,2,20,0,0,0
1041,6,2016-10-08,houston,@,Navy,L (40-46),32,50,64.0,359,3,33,125,3.8,2,83,484,5.8,20,8,0,28,4,30,1,2,3
1042,7,2016-10-15,houston,,Tulsa,W (38-31),26,34,76.5,254,0,55,268,4.9,4,89,522,5.9,15,15,0,30,10,104,2,1,3
1043,8,2016-10-22,houston,@,Southern Methodist,L (16-38),21,33,63.6,241,2,35,62,1.8,0,68,303,4.5,8,5,0,13,4,55,2,0,2
1044,9,2016-10-29,houston,,Central Florida,W (31-24),26,37,70.3,240,1,49,158,3.2,3,86,398,4.6,12,10,0,22,6,71,1,3,4
1045,10,2016-11-12,houston,,Tulane,W (30-18),21,37,56.8,221,2,35,66,1.9,1,72,287,4.0,8,5,1,14,7,55,1,1,2
1046,11,2016-11-17,houston,,Louisville,W (36-10),27,46,58.7,298,3,33,64,1.9,1,79,362,4.6,15,5,1,21,1,5,0,0,0
1047,12,2016-11-25,houston,@,Memphis,L (44-48),47,69,68.1,487,4,32,137,4.3,1,101,624,6.2,20,10,3,33,9,69,1,1,2
1048,13,2016-12-17,houston,N,San Diego State*,L (10-34),25,34,73.5,229,0,41,25,0.6,1,75,254,3.4,9,7,0,16,2,10,0,4,4
1049,,13 Games,houston,,,,352,523,67.3,3852,24,561,1912,3.4,29,1084,5764,5.3,178,121,15,314,58,554,10,15,25
1050,1,2017-09-09,houston,@,Arizona,W (19-16),25,32,78.1,225,1,37,158,4.3,1,69,383,5.6,11,6,1,18,10,110,0,2,2
1051,2,2017-09-16,houston,,Rice,W (38-3),34,38,89.5,354,2,37,130,3.5,3,75,484,6.5,16,6,0,22,2,10,0,0,0
1052,3,2017-09-23,houston,,Texas Tech,L (24-27),32,52,61.5,317,2,31,110,3.5,1,83,427,5.1,14,8,3,25,6,50,3,2,5
1053,4,2017-09-30,houston,@,Temple,W (20-13),25,36,69.4,226,1,31,162,5.2,1,67,388,5.8,10,9,4,23,12,108,0,1,1
1054,5,2017-10-07,houston,,Southern Methodist,W (35-22),20,28,71.4,198,3,40,265,6.6,2,68,463,6.8,10,14,3,27,4,48,0,2,2
1055,6,2017-10-14,houston,@,Tulsa,L (17-45),25,41,61.0,258,0,47,146,3.1,2,88,404,4.6,13,11,1,25,6,36,1,2,3
1056,7,2017-10-19,houston,,Memphis,L (38-42),29,41,70.7,315,1,54,239,4.4,4,95,554,5.8,16,9,0,25,8,72,2,1,3
1057,8,2017-10-28,houston,@,South Florida,W (28-24),14,25,56.0,142,1,48,255,5.3,3,73,397,5.4,5,11,0,16,5,45,1,0,1
1058,9,2017-11-04,houston,,East Carolina,W (52-27),15,22,68.2,330,3,26,142,5.5,3,48,472,9.8,8,7,1,16,4,34,0,0,0
1059,10,2017-11-18,houston,@,Tulane,L (17-20),18,26,69.2,225,0,33,220,6.7,2,59,445,7.5,13,8,1,22,5,46,1,1,2
1060,11,2017-11-24,houston,,Navy,W (24-14),21,27,77.8,277,1,32,103,3.2,2,59,380,6.4,10,5,1,16,4,43,2,0,2
1061,12,2017-12-24,houston,N,Fresno State*,L (27-33),23,43,53.5,269,1,30,72,2.4,1,73,341,4.7,13,3,1,17,6,44,1,1,2
1062,,12 Games,houston,,,,281,411,68.4,3136,16,446,2002,4.5,25,857,5138,6.0,139,97,16,252,72,646,11,12,23
1063,1,2018-09-01,houston,@,Rice,W (45-27),18,25,72.0,320,3,37,251,6.8,3,62,571,9.2,11,10,2,23,5,38,2,0,2
1064,2,2018-09-08,houston,,Arizona,W (45-18),19,40,47.5,254,4,40,297,7.4,2,80,551,6.9,11,14,3,28,7,56,0,0,0
1065,3,2018-09-15,houston,@,Texas Tech,L (49-63),31,52,59.6,462,5,40,173,4.3,2,92,635,6.9,18,8,2,28,9,68,0,0,0
1066,4,2018-09-22,houston,,Texas Southern,W (70-14),33,49,67.3,386,5,41,285,7.0,5,90,671,7.5,18,17,1,36,2,10,0,1,1
1067,5,2018-10-04,houston,,Tulsa,W (41-26),19,27,70.4,165,3,39,314,8.1,2,66,479,7.3,8,11,2,21,8,55,1,2,3
1068,6,2018-10-13,houston,@,East Carolina,W (42-20),16,28,57.1,249,3,43,157,3.7,2,71,406,5.7,8,8,2,18,12,115,0,0,0
1069,7,2018-10-20,houston,@,Navy,W (49-36),25,39,64.1,413,3,25,157,6.3,3,64,570,8.9,18,11,0,29,3,20,1,1,2
1070,8,2018-10-27,houston,,South Florida,W (57-36),28,40,70.0,419,5,49,263,5.4,3,89,682,7.7,16,16,3,35,5,50,0,2,2
1071,9,2018-11-03,houston,@,Southern Methodist,L (31-45),11,22,50.0,175,2,47,190,4.0,1,69,365,5.3,6,9,0,15,6,50,2,0,2
1072,10,2018-11-10,houston,,Temple,L (49-59),28,47,59.6,322,5,44,205,4.7,2,91,527,5.8,14,11,6,31,12,90,2,1,3
1073,11,2018-11-15,houston,,Tulane,W (48-17),17,30,56.7,190,3,48,298,6.2,3,78,488,6.3,9,13,2,24,6,54,0,1,1
1074,,11 Games,houston,,,,245,399,61.4,3355,41,453,2590,5.7,28,852,5945,7.0,137,128,23,288,75,606,8,8,16
1075,1,2014-08-30,navy,N,Ohio State,L (17-34),2,4,50.0,20,0,63,370,5.9,2,67,390,5.8,1,21,0,22,3,20,1,0,1
1076,2,2014-09-06,navy,@,Temple,W (31-24),4,8,50.0,30,0,63,487,7.7,4,71,517,7.3,1,24,2,27,1,15,3,0,3
1077,3,2014-09-13,navy,@,Texas State,W (35-21),5,7,71.4,117,2,57,352,6.2,3,64,469,7.3,3,13,1,17,4,50,0,1,1
1078,4,2014-09-20,navy,,Rutgers,L (24-31),12,22,54.5,231,1,43,171,4.0,2,65,402,6.2,8,11,1,20,3,34,1,0,1
1079,5,2014-09-27,navy,,Western Kentucky,L (27-36),3,15,20.0,55,0,52,412,7.9,4,67,467,7.0,3,19,0,22,3,25,1,1,2
1080,6,2014-10-04,navy,@,Air Force,L (21-30),8,16,50.0,142,1,55,251,4.6,2,71,393,5.5,5,12,3,20,5,55,1,1,2
1081,7,2014-10-11,navy,,Virginia Military Institute,W (51-14),3,6,50.0,82,1,49,352,7.2,5,55,434,7.9,3,17,0,20,3,18,1,1,2
1082,8,2014-10-25,navy,,San Jose State,W (41-31),4,8,50.0,56,0,68,423,6.2,5,76,479,6.3,2,25,1,28,0,0,1,0,1
1083,9,2014-11-01,navy,N,Notre Dame,L (39-49),6,17,35.3,118,2,60,336,5.6,3,77,454,5.9,5,18,0,23,3,56,0,1,1
1084,10,2014-11-15,navy,,Georgia Southern,W (52-19),5,8,62.5,71,1,50,394,7.9,6,58,465,8.0,3,20,0,23,0,0,0,0,0
1085,11,2014-11-28,navy,@,South Alabama,W (42-40),1,4,25.0,42,0,54,388,7.2,6,58,430,7.4,1,15,2,18,1,15,3,0,3
1086,12,2014-12-13,navy,N,Army,W (17-10),6,8,75.0,77,1,55,205,3.7,1,63,282,4.5,2,14,0,16,3,20,1,0,1
1087,13,2014-12-23,navy,N,San Diego State*,W (17-16),3,7,42.9,17,0,58,254,4.4,2,65,271,4.2,0,13,0,13,5,45,4,0,4
1088,,13 Games,navy,,,,62,130,47.7,1058,9,727,4395,6.0,45,857,5453,6.4,37,222,10,269,34,353,17,5,22
1089,1,2015-09-05,navy,,Colgate,W (48-10),3,6,50.0,67,0,47,371,7.9,5,53,438,8.3,2,16,1,19,3,34,1,0,1
1090,2,2015-09-19,navy,,East Carolina,W (45-21),4,7,57.1,41,0,75,415,5.5,6,82,456,5.6,2,23,3,28,6,55,0,0,0
1091,3,2015-09-26,navy,@,Connecticut,W (28-18),3,5,60.0,40,1,61,303,5.0,3,66,343,5.2,3,17,1,21,3,37,0,0,0
1092,4,2015-10-03,navy,,Air Force,W (33-11),4,10,40.0,117,1,51,270,5.3,3,61,387,6.3,4,9,1,14,7,35,0,0,0
1093,5,2015-10-10,navy,@,Notre Dame,L (24-41),3,6,50.0,22,0,49,318,6.5,3,55,340,6.2,0,16,0,16,3,41,2,1,3
1094,6,2015-10-24,navy,,Tulane,W (31-14),8,12,66.7,158,1,54,133,2.5,3,66,291,4.4,5,11,2,18,3,30,0,0,0
1095,7,2015-10-31,navy,,South Florida,W (29-17),3,9,33.3,16,0,69,428,6.2,3,78,444,5.7,0,21,1,22,2,20,1,0,1
1096,8,2015-11-07,navy,@,Memphis,W (45-20),3,5,60.0,85,1,66,374,5.7,5,71,459,6.5,1,20,2,23,2,5,0,0,0
1097,9,2015-11-14,navy,,Southern Methodist,W (55-14),2,9,22.2,81,1,65,403,6.2,7,74,484,6.5,2,24,2,28,0,0,0,0,0
1098,10,2015-11-21,navy,@,Tulsa,W (44-21),2,3,66.7,55,1,61,469,7.7,5,64,524,8.2,2,22,0,24,4,27,1,0,1
1099,11,2015-11-27,navy,@,Houston,L (31-52),13,18,72.2,312,1,38,147,3.9,3,56,459,8.2,8,8,1,17,2,15,0,1,1
1100,12,2015-12-12,navy,N,Army,W (21-17),6,14,42.9,113,1,41,199,4.9,2,55,312,5.7,3,8,0,11,3,25,0,0,0
1101,13,2015-12-28,navy,N,Pittsburgh*,W (44-28),10,18,55.6,173,1,71,417,5.9,5,89,590,6.6,8,22,1,31,2,15,1,0,1
1102,,13 Games,navy,,,,64,122,52.5,1280,9,748,4247,5.7,53,870,5527,6.4,40,217,15,272,40,339,6,2,8
1103,1,2016-09-03,navy,,Fordham,W (52-16),4,4,100.0,123,1,53,427,8.1,6,57,550,9.6,3,15,0,18,2,16,0,0,0
1104,2,2016-09-10,navy,,Connecticut,W (28-24),6,8,75.0,130,0,50,235,4.7,3,58,365,6.3,4,14,0,18,2,30,1,0,1
1105,3,2016-09-17,navy,@,Tulane,W (21-14),5,12,41.7,59,0,52,300,5.8,3,64,359,5.6,3,16,2,21,3,30,2,0,2
1106,4,2016-10-01,navy,@,Air Force,L (14-28),17,31,54.8,260,0,38,57,1.5,2,69,317,4.6,11,5,2,18,3,15,1,2,3
1107,5,2016-10-08,navy,,Houston,W (46-40),3,5,60.0,76,2,63,306,4.9,2,68,382,5.6,3,16,1,20,1,5,0,0,0
1108,6,2016-10-22,navy,,Memphis,W (42-28),3,4,75.0,85,2,74,447,6.0,4,78,532,6.8,3,23,1,27,3,20,1,0,1
1109,7,2016-10-28,navy,@,South Florida,L (45-52),15,27,55.6,299,1,54,317,5.9,6,81,616,7.6,10,19,0,29,2,10,0,1,1
1110,8,2016-11-05,navy,N,Notre Dame,W (28-27),5,8,62.5,48,0,56,320,5.7,4,64,368,5.8,2,17,2,21,1,5,0,0,0
1111,9,2016-11-12,navy,,Tulsa,W (42-40),6,8,75.0,111,1,64,390,6.1,5,72,501,7.0,4,19,1,24,5,35,0,0,0
1112,10,2016-11-19,navy,@,East Carolina,W (66-31),3,5,60.0,113,0,68,480,7.1,9,73,593,8.1,3,24,1,28,4,40,0,0,0
1113,11,2016-11-26,navy,@,Southern Methodist,W (75-31),5,9,55.6,104,1,48,496,10.3,9,57,600,10.5,4,17,2,23,4,50,1,0,1
1114,12,2016-12-03,navy,,Temple,L (10-34),8,15,53.3,138,0,44,168,3.8,1,59,306,5.2,6,6,1,13,0,0,1,2,3
1115,13,2016-12-10,navy,N,Army,L (17-21),6,10,60.0,89,0,26,112,4.3,2,36,201,5.6,4,4,0,8,3,15,1,2,3
1116,14,2016-12-23,navy,N,Louisiana Tech*,L (45-48),7,12,58.3,159,1,49,300,6.1,5,61,459,7.5,5,17,3,25,6,70,1,0,1
1117,,14 Games,navy,,,,93,158,58.9,1794,9,739,4355,5.9,61,897,6149,6.9,65,212,16,293,39,341,9,7,16
1118,1,2017-09-01,navy,@,Florida Atlantic,W (42-19),3,10,30.0,110,1,68,416,6.1,5,78,526,6.7,3,20,0,23,2,20,1,1,2
1119,2,2017-09-09,navy,,Tulane,W (23-21),4,12,33.3,132,1,52,194,3.7,1,64,326,5.1,2,12,1,15,0,0,1,1,2
1120,3,2017-09-23,navy,,Cincinnati,W (42-32),2,3,66.7,53,1,72,569,7.9,5,75,622,8.3,2,26,3,31,4,50,1,0,1
1121,4,2017-09-30,navy,@,Tulsa,W (31-21),3,4,75.0,90,0,68,421,6.2,4,72,511,7.1,2,22,0,24,9,83,1,0,1
1122,5,2017-10-07,navy,,Air Force,W (48-45),4,12,33.3,86,2,57,471,8.3,4,69,557,8.1,3,19,0,22,4,35,0,0,0
1123,6,2017-10-14,navy,@,Memphis,L (27-30),1,8,12.5,20,0,68,314,4.6,3,76,334,4.4,1,17,1,19,5,65,3,2,5
1124,7,2017-10-21,navy,,Central Florida,L (21-31),5,13,38.5,171,1,59,248,4.2,2,72,419,5.8,4,15,0,19,4,40,1,2,3
1125,8,2017-11-02,navy,@,Temple,L (26-34),13,19,68.4,226,3,52,136,2.6,0,71,362,5.1,8,11,1,20,7,69,0,1,1
1126,9,2017-11-11,navy,,Southern Methodist,W (43-40),0,1,0.0,0,0,72,559,7.8,6,73,559,7.7,0,21,3,24,5,68,1,1,2
1127,10,2017-11-18,navy,@,Notre Dame,L (17-24),3,8,37.5,41,1,72,277,3.8,1,80,318,4.0,2,19,2,23,2,16,0,1,1
1128,11,2017-11-24,navy,@,Houston,L (14-24),3,8,37.5,74,0,60,217,3.6,2,68,291,4.3,2,16,1,19,4,32,0,1,1
1129,12,2017-12-09,navy,N,Army,L (13-14),1,2,50.0,2,0,46,294,6.4,1,48,296,6.2,0,11,1,12,4,25,0,0,0
1130,13,2017-12-28,navy,,Virginia*,W (49-7),0,1,0.0,0,0,76,452,5.9,7,77,452,5.9,0,23,1,24,3,25,0,0,0
1131,,13 Games,navy,,,,42,101,41.6,1005,10,822,4568,5.6,41,923,5573,6.0,29,232,14,275,53,528,9,10,19
1132,1,2018-09-01,navy,@,Hawaii,L (41-59),6,13,46.2,85,1,49,326,6.7,5,62,411,6.6,6,13,0,19,2,18,0,0,0
1133,2,2018-09-08,navy,,Memphis,W (22-21),4,6,66.7,52,0,73,264,3.6,3,79,316,4.0,3,16,1,20,1,10,1,0,1
1134,3,2018-09-15,navy,,Lehigh,W (51-21),6,14,42.9,145,0,62,484,7.8,6,76,629,8.3,4,21,1,26,8,63,1,1,2
1135,4,2018-09-22,navy,@,Southern Methodist,L (30-31),1,4,25.0,25,1,78,349,4.5,3,82,374,4.6,1,22,0,23,2,25,3,0,3
1136,5,2018-10-06,navy,@,Air Force,L (7-35),3,12,25.0,49,0,41,129,3.1,1,53,178,3.4,2,7,0,9,4,40,0,0,0
1137,6,2018-10-13,navy,,Temple,L (17-24),3,11,27.3,14,0,53,270,5.1,2,64,284,4.4,1,14,3,18,6,40,1,0,1
1138,7,2018-10-20,navy,,Houston,L (36-49),10,16,62.5,178,1,68,344,5.1,4,84,522,6.2,6,19,1,26,3,32,0,1,1
1139,8,2018-10-27,navy,N,Notre Dame,L (22-44),4,12,33.3,52,0,48,292,6.1,3,60,344,5.7,2,11,1,14,4,16,1,1,2
1140,9,2018-11-03,navy,@,Cincinnati,L (0-42),3,4,75.0,47,0,52,124,2.4,0,56,171,3.1,2,9,2,13,3,31,1,0,1
1141,10,2018-11-10,navy,@,Central Florida,L (24-35),0,2,0.0,0,0,62,375,6.0,3,64,375,5.9,0,19,1,20,4,30,1,0,1
1142,11,2018-11-17,navy,,Tulsa,W (37-29),1,2,50.0,15,0,61,395,6.5,5,63,410,6.5,1,18,2,21,4,45,1,0,1
1143,,11 Games,navy,,,,41,96,42.7,662,3,647,3352,5.2,35,743,4014,5.4,28,169,12,209,41,350,10,3,13
1144,1,2014-08-30,memphis,,Austin Peay,W (63-0),20,27,74.1,242,2,55,303,5.5,7,82,545,6.6,10,14,4,28,6,55,1,1,2
1145,2,2014-09-06,memphis,@,UCLA,L (35-42),27,42,64.3,305,1,39,164,4.2,3,81,469,5.8,17,5,2,24,10,110,0,0,0
1146,3,2014-09-20,memphis,,Middle Tennessee State,W (36-17),21,35,60.0,219,2,51,261,5.1,1,86,480,5.6,14,11,1,26,6,35,0,1,1
1147,4,2014-09-27,memphis,@,Mississippi,L (3-24),13,31,41.9,81,0,31,23,0.7,0,62,104,1.7,4,4,5,13,9,105,1,1,2
1148,5,2014-10-04,memphis,N,Cincinnati,W (41-14),18,25,72.0,311,2,69,299,4.3,3,94,610,6.5,14,16,0,30,8,72,0,0,0
1149,6,2014-10-11,memphis,,Houston,L (24-28),26,37,70.3,243,2,41,125,3.0,1,78,368,4.7,12,7,1,20,4,41,2,3,5
1150,7,2014-10-25,memphis,@,Southern Methodist,W (48-10),20,27,74.1,352,2,53,230,4.3,4,80,582,7.3,17,10,2,29,8,69,1,0,1
1151,8,2014-10-31,memphis,,Tulsa,W (40-20),18,31,58.1,183,0,41,243,5.9,4,72,426,5.9,7,13,3,23,4,40,1,0,1
1152,9,2014-11-07,memphis,@,Temple,W (16-13),21,28,75.0,230,1,40,82,2.1,0,68,312,4.6,13,3,1,17,6,46,1,0,1
1153,10,2014-11-15,memphis,@,Tulane,W (38-7),14,25,56.0,178,1,40,156,3.9,2,65,334,5.1,8,5,0,13,4,51,2,0,2
1154,11,2014-11-22,memphis,,South Florida,W (31-20),18,23,78.3,232,2,39,238,6.1,2,62,470,7.6,8,10,1,19,6,58,0,0,0
1155,12,2014-11-29,memphis,,Connecticut,W (41-10),22,41,53.7,194,4,44,178,4.0,1,85,372,4.4,10,12,6,28,4,40,0,0,0
1156,13,2014-12-22,memphis,N,Brigham Young*,W (55-48),24,46,52.2,306,4,51,174,3.4,3,97,480,4.9,15,8,1,24,6,43,2,3,5
1157,,13 Games,memphis,,,,262,418,62.7,3076,23,594,2476,4.2,31,1012,5552,5.5,149,118,27,294,81,765,11,9,20
1158,1,2015-09-05,memphis,,Missouri State,W (63-7),16,21,76.2,202,3,60,317,5.3,5,81,519,6.4,9,16,2,27,9,92,0,0,0
1159,2,2015-09-12,memphis,@,Kansas,W (55-23),24,27,88.9,370,2,52,281,5.4,5,79,651,8.2,0,0,0,34,7,58,3,0,3
1160,3,2015-09-19,memphis,@,Bowling Green State,W (44-41),29,40,72.5,386,3,50,155,3.1,2,90,541,6.0,14,11,3,28,7,78,0,0,0
1161,4,2015-09-24,memphis,,Cincinnati,W (53-46),24,36,66.7,412,2,37,158,4.3,4,73,570,7.8,16,6,0,22,9,100,1,0,1
1162,5,2015-10-02,memphis,@,South Florida,W (24-17),20,33,60.6,305,2,39,120,3.1,1,72,425,5.9,12,7,1,20,7,75,0,0,0
1163,6,2015-10-17,memphis,,Mississippi,W (37-24),39,53,73.6,384,3,41,107,2.6,1,94,491,5.2,21,7,3,31,10,80,0,1,1
1164,7,2015-10-23,memphis,@,Tulsa,W (66-42),32,44,72.7,447,4,52,257,4.9,5,96,704,7.3,18,11,6,35,12,120,1,0,1
1165,8,2015-10-31,memphis,,Tulane,W (41-13),27,44,61.4,358,1,39,223,5.7,3,83,581,7.0,16,16,0,32,8,106,0,0,0
1166,9,2015-11-07,memphis,,Navy,L (20-45),26,42,61.9,305,1,31,133,4.3,1,73,438,6.0,13,7,1,21,4,43,2,1,3
1167,10,2015-11-14,memphis,@,Houston,L (34-35),20,32,62.5,278,2,54,212,3.9,2,86,490,5.7,11,14,1,26,7,45,1,1,2
1168,11,2015-11-21,memphis,@,Temple,L (12-31),25,34,73.5,156,0,35,76,2.2,0,69,232,3.4,10,3,0,13,8,79,0,0,0
1169,12,2015-11-28,memphis,,Southern Methodist,W (63-0),13,22,59.1,288,7,42,195,4.6,0,64,483,7.5,10,8,2,20,5,60,1,1,2
1170,13,2015-12-30,memphis,N,Auburn*,L (10-31),16,37,43.2,106,0,31,99,3.2,0,68,205,3.0,6,5,2,13,6,40,0,1,1
1171,,13 Games,memphis,,,,311,465,66.9,3997,30,563,2333,4.1,29,1028,6330,6.2,156,111,21,322,99,976,9,5,14
1172,1,2016-09-03,memphis,,Southeast Missouri State,W (35-17),26,40,65.0,295,3,32,117,3.7,1,72,412,5.7,18,5,4,27,4,40,1,2,3
1173,2,2016-09-17,memphis,,Kansas,W (43-7),15,25,60.0,189,2,47,205,4.4,2,72,394,5.5,6,12,1,19,8,89,0,0,0
1174,3,2016-09-24,memphis,,Bowling Green State,W (77-3),23,32,71.9,395,6,45,240,5.3,4,77,635,8.2,13,9,3,25,9,85,0,0,0
1175,4,2016-10-01,memphis,@,Mississippi,L (28-48),31,47,66.0,355,0,31,119,3.8,4,78,474,6.1,16,7,4,27,7,52,1,3,4
1176,5,2016-10-06,memphis,,Temple,W (34-27),17,26,65.4,174,0,31,151,4.9,2,57,325,5.7,10,4,1,15,3,25,1,0,1
1177,6,2016-10-14,memphis,@,Tulane,W (24-14),21,34,61.8,236,1,33,163,4.9,1,67,399,6.0,7,8,1,16,7,79,2,1,3
1178,7,2016-10-22,memphis,@,Navy,L (28-42),25,40,62.5,333,2,31,98,3.2,1,71,431,6.1,18,6,0,24,3,25,1,0,1
1179,8,2016-10-29,memphis,,Tulsa,L (30-59),19,40,47.5,349,3,42,159,3.8,1,82,508,6.2,11,9,2,22,12,98,2,2,4
1180,9,2016-11-05,memphis,@,Southern Methodist,W (51-7),24,33,72.7,314,4,39,160,4.1,1,72,474,6.6,13,10,1,24,3,26,0,0,0
1181,10,2016-11-12,memphis,,South Florida,L (42-49),29,46,63.0,331,3,35,277,7.9,2,81,608,7.5,15,12,2,29,6,60,0,1,1
1182,11,2016-11-18,memphis,@,Cincinnati,W (34-7),16,20,80.0,159,2,53,172,3.2,2,73,331,4.5,10,9,1,20,5,45,1,0,1
1183,12,2016-11-25,memphis,,Houston,W (48-44),30,45,66.7,409,4,34,146,4.3,2,79,555,7.0,19,6,3,28,10,94,0,0,0
1184,13,2016-12-20,memphis,N,Western Kentucky*,L (31-51),27,49,55.1,418,4,32,73,2.3,0,81,491,6.1,18,5,4,27,5,53,2,1,3
1185,,13 Games,memphis,,,,303,477,63.5,3957,34,485,2080,4.3,23,962,6037,6.3,174,102,27,303,82,771,11,10,21
1186,1,2017-08-31,memphis,,Louisiana-Monroe,W (37-29),10,25,40.0,97,0,39,319,8.2,4,64,416,6.5,4,10,2,16,10,96,1,1,2
1187,2,2017-09-16,memphis,,UCLA,W (48-45),23,39,59.0,398,6,37,162,4.4,0,76,560,7.4,15,5,6,26,11,109,1,2,3
1188,3,2017-09-23,memphis,,Southern Illinois,W (44-31),22,36,61.1,288,2,36,176,4.9,2,72,464,6.4,15,8,1,24,8,90,0,0,0
1189,4,2017-09-30,memphis,@,Central Florida,L (13-40),27,49,55.1,321,1,24,75,3.1,1,73,396,5.4,14,6,5,25,3,20,1,3,4
1190,5,2017-10-06,memphis,@,Connecticut,W (70-31),39,55,70.9,480,8,45,231,5.1,2,100,711,7.1,21,12,1,34,12,104,0,0,0
1191,6,2017-10-14,memphis,,Navy,W (30-27),24,40,60.0,279,3,29,118,4.1,0,69,397,5.8,14,6,4,24,9,39,1,0,1
1192,7,2017-10-19,memphis,@,Houston,W (42-38),33,53,62.3,471,1,23,30,1.3,4,76,501,6.6,20,4,4,28,2,10,1,1,2
1193,8,2017-10-27,memphis,,Tulane,W (56-26),18,31,58.1,298,3,32,259,8.1,4,63,557,8.8,12,6,0,18,8,80,0,1,1
1194,9,2017-11-03,memphis,@,Tulsa,W (41-14),28,40,70.0,333,4,37,191,5.2,1,77,524,6.8,17,6,5,28,10,77,0,0,0
1195,10,2017-11-18,memphis,,Southern Methodist,W (66-45),22,28,78.6,331,2,46,333,7.2,7,74,664,9.0,16,15,1,32,11,132,0,1,1
1196,11,2017-11-25,memphis,,East Carolina,W (70-13),10,15,66.7,302,3,34,333,9.8,5,49,635,13.0,8,14,1,23,8,88,0,0,0
1197,12,2017-12-02,memphis,@,Central Florida,L (55-62),30,44,68.2,471,4,45,282,6.3,3,89,753,8.5,18,12,2,32,14,127,1,1,2
1198,13,2017-12-30,memphis,,Iowa State*,L (20-21),21,33,63.6,286,2,26,53,2.0,0,59,339,5.7,14,2,1,17,5,34,0,0,0
1199,,13 Games,memphis,,,,307,488,62.9,4355,39,453,2562,5.7,33,941,6917,7.4,188,106,33,327,111,1006,6,10,16
1200,1,2018-09-01,memphis,,Mercer,W (66-14),28,39,71.8,428,5,47,324,6.9,3,86,752,8.7,19,11,2,32,7,57,1,0,1
1201,2,2018-09-08,memphis,@,Navy,L (21-22),15,25,60.0,145,0,24,233,9.7,3,49,378,7.7,8,6,0,14,4,20,3,1,4
1202,3,2018-09-14,memphis,,Georgia State,W (59-22),19,27,70.4,269,5,35,410,11.7,3,62,679,11.0,14,13,0,27,10,79,0,1,1
1203,4,2018-09-22,memphis,,South Alabama,W (52-35),22,30,73.3,292,2,46,271,5.9,5,76,563,7.4,14,14,3,31,5,50,0,0,0
1204,5,2018-09-28,memphis,@,Tulane,L (24-40),14,30,46.7,246,2,21,31,1.5,1,51,277,5.4,8,2,3,13,4,20,0,0,0
1205,6,2018-10-06,memphis,,Connecticut,W (55-14),17,19,89.5,256,2,40,378,9.5,6,59,634,10.7,9,16,1,26,9,90,0,0,0
1206,7,2018-10-13,memphis,,Central Florida,L (30-31),17,29,58.6,209,0,52,281,5.4,3,81,490,6.0,10,14,3,27,7,43,2,0,2
1207,8,2018-10-20,memphis,@,Missouri,L (33-65),15,38,39.5,208,2,43,200,4.7,2,81,408,5.0,12,9,4,25,8,65,0,2,2
1208,9,2018-11-03,memphis,@,East Carolina,W (59-41),21,30,70.0,362,3,52,277,5.3,5,82,639,7.8,11,14,1,26,9,56,0,0,0
1209,10,2018-11-10,memphis,,Tulsa,W (47-21),16,23,69.6,202,2,55,297,5.4,3,78,499,6.4,10,14,2,26,8,79,1,0,1
1210,11,2018-11-16,memphis,@,Southern Methodist,W (28-18),18,31,58.1,226,2,43,208,4.8,2,74,434,5.9,12,7,2,21,12,143,0,2,2
1211,,11 Games,memphis,,,,202,321,62.9,2843,25,458,2910,6.4,36,779,5753,7.4,127,120,21,268,83,702,7,6,13
1212,1,2014-08-28,temple,@,Vanderbilt,W (37-7),23,36,63.9,207,2,45,144,3.2,1,81,351,4.3,9,9,0,17,3,23,2,0,2
1213,2,2014-09-06,temple,,Navy,L (24-31),29,50,58.0,240,2,34,156,4.6,0,84,396,4.7,10,14,1,25,6,56,1,1,2
1214,3,2014-09-20,temple,,Delaware State,W (59-0),16,21,76.2,179,2,40,172,4.3,3,61,351,5.8,8,11,0,19,8,69,0,2,2
1215,4,2014-09-27,temple,@,Connecticut,W (36-10),20,31,64.5,231,1,24,41,1.7,1,55,272,4.9,13,2,0,15,5,57,1,0,1
1216,5,2014-10-11,temple,,Tulsa,W (35-24),15,31,48.4,294,2,35,203,5.8,3,66,497,7.5,10,6,5,21,5,30,1,1,2
1217,6,2014-10-17,temple,@,Houston,L (10-31),12,29,41.4,259,1,20,98,4.9,0,49,357,7.3,6,4,1,11,11,93,1,3,4
1218,7,2014-10-25,temple,@,Central Florida,L (14-34),20,38,52.6,150,1,20,32,1.6,0,58,182,3.1,5,4,2,11,8,68,1,3,4
1219,8,2014-11-01,temple,,East Carolina,W (20-10),7,19,36.8,70,0,37,65,1.8,2,56,135,2.4,4,2,4,10,7,65,0,0,0
1220,9,2014-11-07,temple,,Memphis,L (13-16),16,37,43.2,140,0,32,158,4.9,1,69,298,4.3,6,8,2,16,4,36,1,1,2
1221,10,2014-11-15,temple,@,Penn State,L (13-30),17,38,44.7,187,1,20,61,3.1,0,58,248,4.3,4,4,0,8,10,69,1,4,5
1222,11,2014-11-29,temple,,Cincinnati,L (6-14),19,35,54.3,196,0,32,71,2.2,0,67,267,4.0,8,6,0,14,3,26,2,0,2
1223,12,2014-12-06,temple,@,Tulane,W (10-3),20,38,52.6,255,1,30,92,3.1,0,68,347,5.1,10,6,0,16,8,67,0,1,1
1224,,12 Games,temple,,,,214,403,53.1,2408,13,369,1293,3.5,11,772,3701,4.8,93,76,15,183,78,659,11,16,27
1225,1,2015-09-05,temple,,Penn State,W (27-10),16,21,76.2,168,0,43,149,3.5,3,64,317,5.0,7,6,2,15,5,35,1,0,1
1226,2,2015-09-12,temple,@,Cincinnati,W (34-26),13,20,65.0,81,2,36,215,6.0,1,56,296,5.3,5,8,0,13,12,112,1,0,1
1227,3,2015-09-19,temple,@,Massachusetts,W (25-23),28,49,57.1,391,1,37,67,1.8,1,86,458,5.3,19,4,1,24,7,70,1,2,3
1228,4,2015-10-02,temple,@,UNC Charlotte,W (37-3),11,23,47.8,116,2,45,206,4.6,2,68,322,4.7,6,11,2,19,2,25,1,0,1
1229,5,2015-10-10,temple,,Tulane,W (49-10),14,18,77.8,223,3,46,122,2.7,3,64,345,5.4,12,7,4,23,7,55,2,0,2
1230,6,2015-10-17,temple,,Central Florida,W (30-16),15,27,55.6,149,1,41,212,5.2,3,68,361,5.3,8,10,2,20,8,84,3,1,4
1231,7,2015-10-22,temple,@,East Carolina,W (24-14),19,36,52.8,250,1,25,72,2.9,2,61,322,5.3,9,5,3,17,12,114,0,0,0
1232,8,2015-10-31,temple,,Notre Dame,L (20-24),13,30,43.3,188,1,32,107,3.3,1,62,295,4.8,7,7,2,16,6,79,0,1,1
1233,9,2015-11-06,temple,@,Southern Methodist,W (60-40),18,25,72.0,268,4,37,268,7.2,3,62,536,8.6,9,9,2,20,7,81,0,0,0
1234,10,2015-11-14,temple,@,South Florida,L (23-44),20,48,41.7,259,1,31,121,3.9,1,79,380,4.8,12,7,3,22,5,48,0,1,1
1235,11,2015-11-21,temple,,Memphis,W (31-12),14,26,53.8,261,2,46,200,4.3,2,72,461,6.4,11,10,4,25,1,10,1,1,2
1236,12,2015-11-28,temple,,Connecticut,W (27-3),19,29,65.5,160,1,39,161,4.1,2,68,321,4.7,9,6,3,18,3,15,0,0,0
1237,13,2015-12-05,temple,@,Houston,L (13-24),26,44,59.1,287,1,27,98,3.6,0,71,385,5.4,13,5,1,19,2,15,1,1,2
1238,14,2015-12-22,temple,N,Toledo*,L (17-32),23,42,54.8,236,0,33,99,3.0,1,75,335,4.5,9,9,3,21,4,30,0,1,1
1239,,14 Games,temple,,,,249,438,56.8,3037,20,518,2097,4.0,25,956,5134,5.4,136,104,32,272,81,773,11,8,19
1240,1,2016-09-02,temple,,Army,L (13-28),12,26,46.2,168,0,28,83,3.0,1,54,251,4.6,10,5,1,16,5,35,0,3,3
1241,2,2016-09-10,temple,,Stony Brook,W (38-0),11,25,44.0,124,3,39,177,4.5,2,64,301,4.7,6,8,0,14,2,20,0,1,1
1242,3,2016-09-17,temple,@,Penn State,L (27-34),25,34,73.5,286,0,28,38,1.4,3,62,324,5.2,9,2,2,13,13,118,0,1,1
1243,4,2016-09-24,temple,,UNC Charlotte,W (48-20),17,32,53.1,297,2,34,210,6.2,4,66,507,7.7,11,12,3,26,5,31,0,0,0
1244,5,2016-10-01,temple,,Southern Methodist,W (45-20),7,18,38.9,124,1,45,244,5.4,4,63,368,5.8,5,11,1,17,3,25,1,2,3
1245,6,2016-10-06,temple,@,Memphis,L (27-34),36,59,61.0,445,2,29,86,3.0,1,88,531,6.0,19,6,2,27,7,61,1,2,3
1246,7,2016-10-15,temple,@,Central Florida,W (26-25),12,24,50.0,167,2,51,197,3.9,1,75,364,4.9,9,11,4,24,10,69,1,1,2
1247,8,2016-10-21,temple,,South Florida,W (46-30),14,21,66.7,209,1,48,322,6.7,4,69,531,7.7,8,16,2,26,8,75,0,0,0
1248,9,2016-10-29,temple,,Cincinnati,W (34-13),12,19,63.2,199,2,60,275,4.6,2,79,474,6.0,7,16,2,25,3,25,1,0,1
1249,10,2016-11-04,temple,@,Connecticut,W (21-0),12,18,66.7,215,3,46,216,4.7,0,64,431,6.7,9,13,0,22,4,25,1,2,3
1250,11,2016-11-19,temple,@,Tulane,W (31-0),18,33,54.5,337,2,48,196,4.1,2,81,533,6.6,12,12,2,26,7,55,0,0,0
1251,12,2016-11-26,temple,,East Carolina,W (37-10),12,20,60.0,158,0,46,256,5.6,5,66,414,6.3,9,12,2,23,0,0,0,0,0
1252,13,2016-12-03,temple,@,Navy,W (34-10),16,25,64.0,199,2,36,189,5.3,2,61,388,6.4,8,10,0,18,4,30,0,0,0
1253,14,2016-12-27,temple,N,Wake Forest*,L (26-34),28,49,57.1,396,2,23,-20,-0.9,0,72,376,5.2,14,5,2,21,4,35,1,1,2
1254,,14 Games,temple,,,,232,403,57.6,3324,22,561,2469,4.4,31,964,5793,6.0,136,139,23,298,75,604,6,13,19
1255,1,2017-09-02,temple,@,Notre Dame,L (16-49),19,35,54.3,245,2,37,85,2.3,0,72,330,4.6,13,4,1,18,6,42,1,0,1
1256,2,2017-09-09,temple,,Villanova,W (16-13),20,34,58.8,274,0,27,79,2.9,1,61,353,5.8,10,5,2,17,8,59,0,0,0
1257,3,2017-09-15,temple,,Massachusetts,W (29-21),24,39,61.5,268,3,34,119,3.5,0,73,387,5.3,14,5,1,20,7,74,0,0,0
1258,4,2017-09-21,temple,@,South Florida,L (7-43),7,25,28.0,89,0,33,-4,-0.1,0,58,85,1.5,4,2,1,7,6,51,2,4,6
1259,5,2017-09-30,temple,,Houston,L (13-20),20,42,47.6,182,1,37,142,3.8,0,79,324,4.1,9,11,2,22,10,83,0,3,3
1260,6,2017-10-07,temple,@,East Carolina,W (34-10),21,33,63.6,344,2,46,179,3.9,2,79,523,6.6,14,6,4,24,8,65,0,1,1
1261,7,2017-10-14,temple,,Connecticut,L (24-28),33,55,60.0,356,1,29,117,4.0,2,84,473,5.6,18,7,3,28,12,117,1,1,2
1262,8,2017-10-21,temple,@,Army,L (28-31),21,31,67.7,289,1,37,217,5.9,3,68,506,7.4,13,10,1,24,8,45,0,0,0
1263,9,2017-11-02,temple,,Navy,W (34-26),22,30,73.3,289,4,28,104,3.7,0,58,393,6.8,14,4,2,20,6,50,0,1,1
1264,10,2017-11-10,temple,@,Cincinnati,W (35-24),19,30,63.3,224,1,43,205,4.8,2,73,429,5.9,11,12,2,25,4,50,1,1,2
1265,11,2017-11-18,temple,,Central Florida,L (19-45),17,42,40.5,201,2,35,196,5.6,0,77,397,5.2,8,10,1,19,6,57,1,4,5
1266,12,2017-11-25,temple,@,Tulsa,W (43-22),21,29,72.4,258,3,34,193,5.7,2,63,451,7.2,13,6,1,20,10,123,0,0,0
1267,13,2017-12-21,temple,N,Florida International*,W (28-3),18,28,64.3,254,1,41,141,3.4,3,69,395,5.7,11,7,2,20,10,86,1,0,1
1268,,13 Games,temple,,,,262,453,57.8,3273,21,461,1773,3.8,15,914,5046,5.5,152,89,23,264,101,902,7,15,22
1269,1,2018-09-01,temple,,Villanova,L (17-19),19,33,57.6,205,1,22,46,2.1,0,55,251,4.6,10,5,1,16,6,56,0,2,2
1270,2,2018-09-08,temple,,Buffalo,L (29-36),17,38,44.7,240,3,29,115,4.0,0,67,355,5.3,10,6,0,16,6,65,1,2,3
1271,3,2018-09-15,temple,@,Maryland,W (35-14),16,28,57.1,264,2,52,165,3.2,2,80,429,5.4,11,9,1,21,4,50,0,1,1
1272,4,2018-09-20,temple,,Tulsa,W (31-17),8,21,38.1,109,0,36,191,5.3,2,57,300,5.3,4,11,1,16,6,47,0,2,2
1273,5,2018-09-29,temple,@,Boston College,L (35-45),21,47,44.7,261,0,34,191,5.6,4,81,452,5.6,15,7,2,24,11,95,1,2,3
1274,6,2018-10-06,temple,,East Carolina,W (49-6),25,30,83.3,297,4,48,173,3.6,2,78,470,6.0,14,11,1,26,6,66,0,1,1
1275,7,2018-10-13,temple,@,Navy,W (24-17),23,32,71.9,300,1,34,109,3.2,2,66,409,6.2,11,8,2,21,7,63,1,1,2
1276,8,2018-10-20,temple,,Cincinnati,W (24-17),20,42,47.6,237,3,30,80,2.7,0,72,317,4.4,11,3,2,16,6,60,0,3,3
1277,9,2018-11-01,temple,@,Central Florida,L (40-52),31,52,59.6,444,4,46,226,4.9,1,98,670,6.8,21,12,2,35,14,149,0,2,2
1278,10,2018-11-10,temple,@,Houston,W (59-49),15,23,65.2,225,0,55,317,5.8,8,78,542,6.9,11,15,2,28,15,114,1,0,1
1279,11,2018-11-17,temple,,South Florida,W (27-17),20,35,57.1,264,0,39,74,1.9,1,74,338,4.6,15,2,1,18,7,61,1,1,2
1280,,11 Games,temple,,,,215,381,56.4,2846,18,425,1687,4.0,22,806,4533,5.6,133,89,15,237,88,826,5,17,22
1281,1,2014-09-12,cincinnati,,Toledo,W (58-34),29,42,69.0,436,6,30,148,4.9,2,72,584,8.1,21,6,1,28,2,30,0,0,0
1282,2,2014-09-20,cincinnati,N,Miami (OH),W (31-24),25,39,64.1,271,4,30,99,3.3,0,69,370,5.4,13,7,2,22,4,30,0,2,2
1283,3,2014-09-27,cincinnati,@,Ohio State,L (28-50),21,33,63.6,352,4,19,70,3.7,0,52,422,8.1,10,5,0,15,6,40,0,0,0
1284,4,2014-10-04,cincinnati,N,Memphis,L (14-41),16,40,40.0,255,1,25,97,3.9,1,65,352,5.4,13,4,2,19,6,55,1,1,2
1285,5,2014-10-11,cincinnati,@,Miami (FL),L (34-55),31,60,51.7,355,3,29,67,2.3,0,89,422,4.7,17,5,4,26,5,54,0,3,3
1286,6,2014-10-18,cincinnati,@,Southern Methodist,W (41-3),17,27,63.0,268,1,46,240,5.2,3,73,508,7.0,12,14,3,29,6,69,0,0,0
1287,7,2014-10-24,cincinnati,N,South Florida,W (34-17),27,37,73.0,317,1,50,273,5.5,3,87,590,6.8,16,12,3,31,4,37,3,0,3
1288,8,2014-10-31,cincinnati,@,Tulane,W (38-14),17,26,65.4,214,3,35,265,7.6,1,61,479,7.9,11,8,2,21,5,35,1,2,3
1289,9,2014-11-13,cincinnati,N,East Carolina,W (54-46),29,45,64.4,436,4,33,150,4.5,2,78,586,7.5,19,9,1,29,8,64,1,3,4
1290,10,2014-11-22,cincinnati,@,Connecticut,W (41-0),20,36,55.6,176,3,48,249,5.2,2,84,425,5.1,10,13,1,24,2,25,0,1,1
1291,11,2014-11-29,cincinnati,@,Temple,W (14-6),19,31,61.3,174,1,33,81,2.5,1,64,255,4.0,9,4,1,14,3,20,1,0,1
1292,12,2014-12-06,cincinnati,N,Houston,W (38-31),25,38,65.8,348,2,43,152,3.5,3,81,500,6.2,20,11,2,33,1,10,0,0,0
1293,13,2014-12-27,cincinnati,N,Virginia Tech*,L (17-33),18,37,48.6,345,2,33,144,4.4,0,70,489,7.0,14,5,0,19,7,73,1,2,3
1294,,13 Games,cincinnati,,,,294,491,59.9,3947,35,454,2035,4.5,18,945,5982,6.3,185,103,22,310,59,542,8,14,22
1295,1,2015-09-05,cincinnati,,Alabama A&M,W (52-10),26,38,68.4,340,3,51,296,5.8,4,89,636,7.1,17,14,3,34,8,79,2,0,2
1296,2,2015-09-12,cincinnati,,Temple,L (26-34),30,52,57.7,427,2,31,130,4.2,1,83,557,6.7,21,8,5,34,5,51,1,4,5
1297,3,2015-09-19,cincinnati,@,Miami (OH),W (37-33),22,40,55.0,263,1,54,282,5.2,3,94,545,5.8,15,15,3,33,7,55,2,2,4
1298,4,2015-09-24,cincinnati,@,Memphis,L (46-53),38,64,59.4,620,4,36,132,3.7,1,100,752,7.5,27,8,3,38,11,101,0,3,3
1299,5,2015-10-01,cincinnati,,Miami (FL),W (34-23),22,33,66.7,279,2,34,167,4.9,2,67,446,6.7,13,9,0,22,7,75,0,1,1
1300,6,2015-10-16,cincinnati,@,Brigham Young,L (24-38),16,31,51.6,220,1,46,121,2.6,2,77,341,4.4,13,6,2,21,9,65,0,0,0
1301,7,2015-10-24,cincinnati,,Connecticut,W (37-13),26,35,74.3,327,2,49,285,5.8,2,84,612,7.3,14,14,0,28,10,105,1,0,1
1302,8,2015-10-31,cincinnati,,Central Florida,W (52-7),27,32,84.4,489,6,42,237,5.6,1,74,726,9.8,17,11,5,33,7,62,0,1,1
1303,9,2015-11-07,cincinnati,@,Houston,L (30-33),28,51,54.9,523,4,18,66,3.7,0,69,589,8.5,20,3,1,24,11,85,1,2,3
1304,10,2015-11-14,cincinnati,,Tulsa,W (49-38),29,42,69.0,386,2,41,266,6.5,5,83,652,7.9,21,11,1,33,10,68,2,1,3
1305,11,2015-11-20,cincinnati,@,South Florida,L (27-65),28,51,54.9,333,1,35,97,2.8,2,86,430,5.0,14,10,1,25,4,42,2,4,6
1306,12,2015-11-28,cincinnati,@,East Carolina,W (19-16),30,47,63.8,270,1,43,157,3.7,1,90,427,4.7,16,12,2,30,5,50,0,1,1
1307,13,2015-12-24,cincinnati,N,San Diego State*,L (7-42),19,31,61.3,202,0,32,77,2.4,1,63,279,4.4,9,5,1,15,10,110,0,3,3
1308,,13 Games,cincinnati,,,,341,547,62.3,4679,29,512,2313,4.5,25,1059,6992,6.6,217,126,27,370,104,948,11,22,33
1309,1,2016-09-01,cincinnati,,Tennessee-Martin,W (28-7),21,34,61.8,260,2,34,140,4.1,1,68,400,5.9,13,8,1,22,5,60,2,1,3
1310,2,2016-09-10,cincinnati,@,Purdue,W (38-20),19,32,59.4,250,3,46,262,5.7,2,78,512,6.6,12,9,1,22,5,45,0,0,0
1311,3,2016-09-15,cincinnati,,Houston,L (16-40),22,39,56.4,277,2,25,30,1.2,0,64,307,4.8,11,1,1,13,2,15,0,3,3
1312,4,2016-09-24,cincinnati,,Miami (OH),W (27-20),25,38,65.8,276,0,48,187,3.9,3,86,463,5.4,15,12,1,28,5,60,1,2,3
1313,5,2016-10-01,cincinnati,,South Florida,L (20-45),23,41,56.1,263,1,35,130,3.7,2,76,393,5.2,11,8,2,21,4,40,1,3,4
1314,6,2016-10-08,cincinnati,@,Connecticut,L (9-20),29,56,51.8,315,0,22,2,0.1,0,78,317,4.1,18,2,2,22,5,57,0,1,1
1315,7,2016-10-22,cincinnati,,East Carolina,W (31-19),23,40,57.5,348,4,35,165,4.7,0,75,513,6.8,11,12,2,25,9,82,0,0,0
1316,8,2016-10-29,cincinnati,@,Temple,L (13-34),15,27,55.6,119,2,22,67,3.0,0,49,186,3.8,8,2,0,10,4,35,2,0,2
1317,9,2016-11-05,cincinnati,,Brigham Young,L (3-20),19,32,59.4,199,0,25,96,3.8,0,57,295,5.2,12,4,0,16,4,40,0,1,1
1318,10,2016-11-12,cincinnati,@,Central Florida,L (3-24),19,42,45.2,220,0,36,107,3.0,0,78,327,4.2,11,6,1,18,2,15,1,2,3
1319,11,2016-11-18,cincinnati,,Memphis,L (7-34),23,34,67.6,144,1,35,100,2.9,0,69,244,3.5,9,7,1,17,5,52,1,2,3
1320,12,2016-11-25,cincinnati,@,Tulsa,L (37-40),21,38,55.3,400,4,33,134,4.1,0,71,534,7.5,12,5,1,18,5,43,0,0,0
1321,,12 Games,cincinnati,,,,259,453,57.2,3071,19,396,1420,3.6,8,849,4491,5.3,143,76,13,232,55,544,8,15,23
1322,1,2017-08-31,cincinnati,,Austin Peay,W (26-14),17,28,60.7,151,3,29,97,3.3,1,57,248,4.4,7,6,2,15,7,70,0,0,0
1323,2,2017-09-09,cincinnati,@,Michigan,L (14-36),15,40,37.5,132,1,30,68,2.3,1,70,200,2.9,6,4,3,13,4,30,0,2,2
1324,3,2017-09-16,cincinnati,@,Miami (OH),W (21-17),24,43,55.8,222,1,35,139,4.0,0,78,361,4.6,10,8,3,21,6,56,0,2,2
1325,4,2017-09-23,cincinnati,@,Navy,L (32-42),28,46,60.9,381,3,23,58,2.5,1,69,439,6.4,19,3,0,22,6,60,1,0,1
1326,5,2017-09-30,cincinnati,,Marshall,L (21-38),22,45,48.9,211,1,26,138,5.3,2,71,349,4.9,9,7,5,21,7,78,3,0,3
1327,6,2017-10-07,cincinnati,,Central Florida,L (23-51),23,40,57.5,278,1,26,113,4.3,2,66,391,5.9,13,6,2,21,9,74,0,1,1
1328,7,2017-10-14,cincinnati,@,South Florida,L (3-33),21,37,56.8,178,0,33,95,2.9,0,70,273,3.9,9,7,5,21,11,98,1,1,2
1329,8,2017-10-21,cincinnati,,Southern Methodist,L (28-31),22,35,62.9,189,2,42,249,5.9,1,77,438,5.7,11,14,1,26,6,46,1,1,2
1330,9,2017-11-04,cincinnati,@,Tulane,W (17-16),18,27,66.7,248,1,35,208,5.9,1,62,456,7.4,11,8,0,19,12,123,0,0,0
1331,10,2017-11-10,cincinnati,,Temple,L (24-35),21,37,56.8,221,2,35,184,5.3,1,72,405,5.6,8,10,3,21,11,107,1,0,1
1332,11,2017-11-18,cincinnati,@,East Carolina,L (20-48),15,28,53.6,187,3,31,139,4.5,0,59,326,5.5,6,11,0,17,10,90,0,1,1
1333,12,2017-11-25,cincinnati,,Connecticut,W (22-21),19,28,67.9,199,2,26,136,5.2,1,54,335,6.2,11,8,0,19,5,44,0,1,1
1334,,12 Games,cincinnati,,,,245,434,56.5,2597,20,371,1624,4.4,11,805,4221,5.2,120,92,24,236,94,876,7,9,16
1335,1,2018-09-01,cincinnati,@,UCLA,W (26-17),14,26,53.8,110,0,51,194,3.8,3,77,304,3.9,7,11,0,18,7,45,1,0,1
1336,2,2018-09-08,cincinnati,@,Miami (OH),W (21-0),6,11,54.5,45,1,51,188,3.7,2,62,233,3.8,3,9,1,13,8,86,0,0,0
1337,3,2018-09-15,cincinnati,,Alabama A&M,W (63-7),21,26,80.8,332,3,55,409,7.4,5,81,741,9.1,12,26,0,38,7,75,0,1,1
1338,4,2018-09-22,cincinnati,,Ohio,W (34-30),19,31,61.3,274,2,34,150,4.4,3,65,424,6.5,12,10,2,24,14,150,0,1,1
1339,5,2018-09-29,cincinnati,@,Connecticut,W (49-7),23,29,79.3,339,2,53,320,6.0,5,82,659,8.0,18,13,0,31,11,113,1,0,1
1340,6,2018-10-06,cincinnati,,Tulane,W (37-21),15,25,60.0,174,2,48,272,5.7,3,73,446,6.1,8,10,4,22,7,65,2,1,3
1341,7,2018-10-20,cincinnati,@,Temple,L (17-24),14,34,41.2,111,0,47,200,4.3,2,81,311,3.8,8,11,1,20,7,65,2,1,3
1342,8,2018-10-27,cincinnati,@,Southern Methodist,W (26-20),33,50,66.0,352,2,39,125,3.2,0,89,477,5.4,15,9,1,25,6,51,1,2,3
1343,9,2018-11-03,cincinnati,,Navy,W (42-0),14,20,70.0,189,2,41,262,6.4,4,61,451,7.4,8,14,0,22,4,30,0,0,0
1344,10,2018-11-10,cincinnati,,South Florida,W (35-23),17,24,70.8,194,2,52,238,4.6,3,76,432,5.7,8,14,2,24,5,22,2,0,2
1345,11,2018-11-17,cincinnati,@,Central Florida,L (13-38),11,26,42.3,127,0,55,252,4.6,1,81,379,4.7,6,13,1,20,9,70,3,0,3
1346,,11 Games,cincinnati,,,,187,302,61.9,2247,16,526,2610,5.0,31,828,4857,5.9,105,140,12,257,85,772,12,6,18
1347,1,2014-08-30,south-florida,,Western Carolina,W (36-31),10,27,37.0,191,0,33,294,8.9,4,60,485,8.1,6,6,1,13,6,38,1,1,2
1348,2,2014-09-06,south-florida,,Maryland,L (17-24),15,37,40.5,174,0,37,83,2.2,1,74,257,3.5,9,6,1,16,6,39,0,1,1
1349,3,2014-09-13,south-florida,,North Carolina State,L (17-49),5,20,25.0,89,1,27,70,2.6,0,47,159,3.4,3,4,1,8,5,40,1,2,3
1350,4,2014-09-19,south-florida,,Connecticut,W (17-14),10,18,55.6,113,1,53,158,3.0,1,71,271,3.8,6,10,1,17,5,45,0,1,1
1351,5,2014-09-27,south-florida,@,Wisconsin,L (10-27),8,19,42.1,173,0,19,72,3.8,1,38,245,6.4,5,3,0,8,11,90,1,1,2
1352,6,2014-10-11,south-florida,,East Carolina,L (17-28),21,42,50.0,257,1,27,93,3.4,1,69,350,5.1,12,6,5,23,8,59,0,1,1
1353,7,2014-10-18,south-florida,@,Tulsa,W (38-30),17,26,65.4,272,3,32,140,4.4,2,58,412,7.1,12,5,2,19,7,77,1,1,2
1354,8,2014-10-24,south-florida,N,Cincinnati,L (17-34),20,33,60.6,239,2,22,42,1.9,0,55,281,5.1,9,3,0,12,7,95,2,2,4
1355,9,2014-11-01,south-florida,,Houston,L (3-27),13,26,50.0,146,0,29,76,2.6,0,55,222,4.0,8,5,0,13,5,45,0,1,1
1356,10,2014-11-15,south-florida,@,Southern Methodist,W (14-13),15,31,48.4,211,2,40,167,4.2,0,71,378,5.3,10,8,0,18,8,96,2,0,2
1357,11,2014-11-22,south-florida,@,Memphis,L (20-31),27,46,58.7,301,1,35,95,2.7,1,81,396,4.9,15,3,2,20,2,29,1,0,1
1358,12,2014-11-28,south-florida,,Central Florida,L (0-16),18,39,46.2,195,0,22,5,0.2,0,61,200,3.3,9,3,3,15,5,75,0,0,0
1359,,12 Games,south-florida,,,,179,364,49.2,2361,11,376,1295,3.4,11,740,3656,4.9,104,62,16,182,75,728,9,11,20
1360,1,2015-09-05,south-florida,,Florida A&M,W (51-3),20,26,76.9,281,3,46,275,6.0,4,72,556,7.7,9,15,3,27,11,97,0,1,1
1361,2,2015-09-12,south-florida,@,Florida State,L (14-34),12,24,50.0,125,2,36,149,4.1,0,60,274,4.6,5,6,0,11,2,21,0,1,1
1362,3,2015-09-19,south-florida,@,Maryland,L (17-35),10,22,45.5,60,1,50,240,4.8,1,72,300,4.2,3,12,3,18,10,105,0,2,2
1363,4,2015-10-02,south-florida,,Memphis,L (17-24),17,26,65.4,199,1,43,178,4.1,1,69,377,5.5,8,7,4,19,6,40,0,1,1
1364,5,2015-10-10,south-florida,,Syracuse,W (45-24),15,22,68.2,259,2,47,281,6.0,4,69,540,7.8,10,15,1,26,9,85,1,0,1
1365,6,2015-10-17,south-florida,@,Connecticut,W (28-20),12,16,75.0,186,3,44,275,6.3,1,60,461,7.7,6,11,0,17,3,30,0,2,2
1366,7,2015-10-24,south-florida,,Southern Methodist,W (38-14),9,21,42.9,97,0,44,255,5.8,5,65,352,5.4,3,10,2,15,4,40,1,0,1
1367,8,2015-10-31,south-florida,@,Navy,L (17-29),12,20,60.0,208,0,24,62,2.6,1,44,270,6.1,7,1,1,9,6,54,1,0,1
1368,9,2015-11-07,south-florida,@,East Carolina,W (22-17),12,23,52.2,200,2,60,242,4.0,0,83,442,5.3,10,10,2,22,6,58,1,0,1
1369,10,2015-11-14,south-florida,,Temple,W (44-23),15,22,68.2,230,2,48,326,6.8,3,70,556,7.9,8,13,1,22,8,86,1,0,1
1370,11,2015-11-20,south-florida,,Cincinnati,W (65-27),13,20,65.0,200,5,53,361,6.8,3,73,561,7.7,7,18,0,25,1,11,1,2,3
1371,12,2015-11-26,south-florida,@,Central Florida,W (44-3),15,23,65.2,174,3,54,281,5.2,2,77,455,5.9,8,16,1,25,4,20,0,0,0
1372,13,2015-12-21,south-florida,N,Western Kentucky*,L (35-45),15,34,44.1,307,2,45,290,6.4,3,79,597,7.6,11,16,1,28,9,67,0,0,0
1373,,13 Games,south-florida,,,,177,299,59.2,2526,26,594,3215,5.4,28,893,5741,6.4,95,150,19,264,79,714,6,9,15
1374,1,2016-09-03,south-florida,,Towson,W (56-20),13,25,52.0,230,4,41,214,5.2,4,66,444,6.7,9,10,3,22,4,42,1,1,2
1375,2,2016-09-10,south-florida,,Northern Illinois,W (48-17),25,39,64.1,365,4,50,293,5.9,2,89,658,7.4,15,15,4,34,8,77,1,0,1
1376,3,2016-09-17,south-florida,@,Syracuse,W (45-20),14,29,48.3,220,1,32,240,7.5,4,61,460,7.5,9,10,1,20,4,50,0,0,0
1377,4,2016-09-24,south-florida,,Florida State,L (35-55),5,14,35.7,160,1,41,290,7.1,4,55,450,8.2,3,12,2,17,8,68,0,2,2
1378,5,2016-10-01,south-florida,@,Cincinnati,W (45-20),22,33,66.7,228,0,48,226,4.7,5,81,454,5.6,12,13,0,25,2,21,0,0,0
1379,6,2016-10-08,south-florida,,East Carolina,W (38-22),21,29,72.4,250,3,42,306,7.3,2,71,556,7.8,8,14,1,23,9,101,1,0,1
1380,7,2016-10-15,south-florida,,Connecticut,W (42-27),23,37,62.2,213,2,47,316,6.7,4,84,529,6.3,11,15,0,26,4,36,2,2,4
1381,8,2016-10-21,south-florida,@,Temple,L (30-46),11,20,55.0,187,2,33,165,5.0,2,53,352,6.6,9,8,1,18,11,88,0,1,1
1382,9,2016-10-28,south-florida,,Navy,W (52-45),20,30,66.7,217,2,44,412,9.4,5,74,629,8.5,11,14,0,25,8,50,1,0,1
1383,10,2016-11-12,south-florida,@,Memphis,W (49-42),24,29,82.8,263,2,50,416,8.3,5,79,679,8.6,11,17,2,30,7,75,0,0,0
1384,11,2016-11-19,south-florida,@,Southern Methodist,W (35-27),7,15,46.7,195,3,43,278,6.5,2,58,473,8.2,4,12,0,16,7,55,1,1,2
1385,12,2016-11-26,south-florida,,Central Florida,W (48-31),17,26,65.4,152,0,48,351,7.3,5,74,503,6.8,6,14,0,20,6,50,1,0,1
1386,13,2016-12-29,south-florida,N,South Carolina*,W (46-39),23,32,71.9,261,2,48,208,4.3,3,80,469,5.9,13,10,1,24,5,50,1,1,2
1387,,13 Games,south-florida,,,,225,358,62.8,2941,26,567,3715,6.6,47,925,6656,7.2,121,164,15,300,83,763,9,8,17
1388,1,2017-08-26,south-florida,@,San Jose State,W (42-22),13,26,50.0,233,2,74,315,4.3,4,100,548,5.5,10,17,2,29,10,57,0,0,0
1389,2,2017-09-02,south-florida,,Stony Brook,W (31-17),19,32,59.4,186,2,49,153,3.1,2,81,339,4.2,6,13,2,21,5,40,0,1,1
1390,3,2017-09-15,south-florida,,Illinois,W (47-23),17,32,53.1,304,4,66,376,5.7,2,98,680,6.9,14,21,3,38,16,140,0,1,1
1391,4,2017-09-21,south-florida,,Temple,W (43-7),8,20,40.0,96,0,63,312,5.0,4,83,408,4.9,4,15,3,22,9,70,2,0,2
1392,5,2017-09-30,south-florida,@,East Carolina,W (61-31),13,21,61.9,185,2,50,390,7.8,5,71,575,8.1,8,15,2,25,8,102,1,0,1
1393,6,2017-10-14,south-florida,,Cincinnati,W (33-3),17,30,56.7,190,0,53,212,4.0,2,83,402,4.8,9,14,2,25,14,137,0,0,0
1394,7,2017-10-21,south-florida,@,Tulane,W (34-28),10,24,41.7,127,2,52,378,7.3,3,76,505,6.6,6,18,1,25,7,89,0,1,1
1395,8,2017-10-28,south-florida,,Houston,L (24-28),23,38,60.5,325,0,55,137,2.5,3,93,462,5.0,14,6,1,21,5,35,0,0,0
1396,9,2017-11-04,south-florida,@,Connecticut,W (37-20),24,37,64.9,385,3,40,217,5.4,1,77,602,7.8,15,12,1,28,11,100,1,1,2
1397,10,2017-11-16,south-florida,,Tulsa,W (27-20),11,28,39.3,142,2,45,279,6.2,1,73,421,5.8,6,14,1,21,6,60,1,1,2
1398,11,2017-11-24,south-florida,@,Central Florida,L (42-49),24,45,53.3,503,4,39,150,3.8,2,84,653,7.8,16,10,1,27,10,102,1,1,2
1399,12,2017-12-23,south-florida,N,Texas Tech*,W (38-34),17,34,50.0,311,4,48,250,5.2,1,82,561,6.8,12,11,4,27,10,100,2,0,2
1400,,12 Games,south-florida,,,,196,367,53.4,2987,25,634,3169,5.0,30,1001,6156,6.1,120,166,23,309,111,1032,8,6,14
1401,1,2018-09-01,south-florida,,Elon,W (34-14),29,46,63.0,367,3,38,148,3.9,1,84,515,6.1,17,10,0,27,7,55,0,0,0
1402,2,2018-09-08,south-florida,,Georgia Tech,W (49-38),21,31,67.7,202,2,44,224,5.1,3,75,426,5.7,13,13,3,29,5,36,0,1,1
1403,3,2018-09-15,south-florida,N,Illinois,W (25-19),23,40,57.5,411,2,44,215,4.9,1,84,626,7.5,19,11,1,31,14,124,0,2,2
1404,4,2018-09-22,south-florida,,East Carolina,W (20-13),12,20,60.0,181,1,32,115,3.6,2,52,296,5.7,5,4,0,9,3,33,1,0,1
1405,5,2018-10-06,south-florida,@,Massachusetts,W (58-42),17,24,70.8,209,1,41,365,8.9,5,65,574,8.8,8,9,1,18,11,100,1,1,2
1406,6,2018-10-12,south-florida,@,Tulsa,W (25-24),17,40,42.5,237,0,47,250,5.3,3,87,487,5.6,11,12,3,26,8,70,0,1,1
1407,7,2018-10-20,south-florida,,Connecticut,W (38-30),20,28,71.4,265,1,37,346,9.4,4,65,611,9.4,8,16,0,24,9,90,1,2,3
1408,8,2018-10-27,south-florida,@,Houston,L (36-57),26,39,66.7,263,1,42,204,4.9,3,81,467,5.8,14,13,2,29,8,85,1,1,2
1409,9,2018-11-03,south-florida,,Tulane,L (15-41),29,49,59.2,322,0,33,102,3.1,2,82,424,5.2,17,8,2,27,10,91,2,1,3
1410,10,2018-11-10,south-florida,@,Cincinnati,L (23-35),14,32,43.8,232,3,29,81,2.8,0,61,313,5.1,8,4,0,12,8,80,0,0,0
1411,11,2018-11-17,south-florida,@,Temple,L (17-27),14,23,60.9,82,0,48,184,3.8,2,71,266,3.7,3,10,2,15,7,55,3,2,5
1412,,11 Games,south-florida,,,,222,372,59.7,2771,14,435,2234,5.1,26,807,5005,6.2,123,110,14,247,90,819,9,11,20
1413,1,2014-08-30,east-carolina,,North Carolina Central,W (52-7),33,46,71.7,374,4,28,208,7.4,3,74,582,7.9,19,9,4,32,8,72,1,1,2
1414,2,2014-09-06,east-carolina,@,South Carolina,L (23-33),32,46,69.6,321,1,21,132,6.3,1,67,453,6.8,20,4,3,27,4,40,0,2,2
1415,3,2014-09-13,east-carolina,@,Virginia Tech,W (28-21),23,47,48.9,427,3,25,75,3.0,1,72,502,7.0,16,2,2,20,13,114,1,0,1
1416,4,2014-09-20,east-carolina,,North Carolina,W (70-41),32,51,62.7,446,4,46,343,7.5,5,97,789,8.1,21,14,4,39,9,74,0,1,1
1417,5,2014-10-04,east-carolina,,Southern Methodist,W (45-24),31,41,75.6,410,4,33,171,5.2,2,74,581,7.9,20,10,0,30,5,53,1,0,1
1418,6,2014-10-11,east-carolina,@,South Florida,W (28-17),24,34,70.6,250,1,37,231,6.2,3,71,481,6.8,16,9,0,25,12,148,0,1,1
1419,7,2014-10-23,east-carolina,,Connecticut,W (31-21),39,65,60.0,445,2,35,135,3.9,2,100,580,5.8,18,8,5,31,11,105,0,1,1
1420,8,2014-11-01,east-carolina,@,Temple,L (10-20),24,42,57.1,217,0,46,211,4.6,1,88,428,4.9,12,15,3,30,12,116,5,0,5
1421,9,2014-11-13,east-carolina,N,Cincinnati,L (46-54),35,62,56.5,425,2,32,154,4.8,4,94,579,6.2,19,6,5,30,5,38,2,0,2
1422,10,2014-11-22,east-carolina,,Tulane,W (34-6),31,44,70.5,358,1,33,139,4.2,3,77,497,6.5,17,12,1,30,5,40,0,0,0
1423,11,2014-11-28,east-carolina,@,Tulsa,W (49-32),28,42,66.7,338,4,37,172,4.6,2,79,510,6.5,17,7,2,26,8,42,0,1,1
1424,12,2014-12-04,east-carolina,,Central Florida,L (30-32),36,49,73.5,397,3,27,14,0.5,1,76,411,5.4,20,5,1,26,12,127,1,2,3
1425,13,2015-01-03,east-carolina,N,Florida*,L (20-28),34,68,50.0,427,2,33,109,3.3,0,101,536,5.3,23,6,3,32,5,35,1,2,3
1426,,13 Games,east-carolina,,,,402,637,63.1,4835,31,433,2094,4.8,28,1070,6929,6.5,238,107,33,378,109,1004,12,11,23
1427,1,2015-09-05,east-carolina,,Towson,W (28-20),29,37,78.4,230,0,34,210,6.2,4,71,440,6.2,11,11,1,23,8,102,0,0,0
1428,2,2015-09-12,east-carolina,@,Florida,L (24-31),37,58,63.8,346,3,22,-13,-0.6,0,80,333,4.2,16,1,3,20,9,65,2,1,3
1429,3,2015-09-19,east-carolina,@,Navy,L (21-45),36,49,73.5,325,3,21,80,3.8,0,70,405,5.8,17,7,1,25,6,47,1,1,2
1430,4,2015-09-26,east-carolina,,Virginia Tech,W (35-28),14,20,70.0,228,2,43,182,4.2,3,63,410,6.5,10,6,3,19,7,97,1,1,2
1431,5,2015-10-03,east-carolina,@,Southern Methodist,W (49-23),19,26,73.1,249,3,54,306,5.7,4,80,555,6.9,11,14,1,26,5,45,0,2,2
1432,6,2015-10-10,east-carolina,@,Brigham Young,L (38-45),30,42,71.4,385,2,32,133,4.2,2,74,518,7.0,17,8,2,27,7,64,2,1,3
1433,7,2015-10-17,east-carolina,,Tulsa,W (30-17),20,29,69.0,239,1,43,143,3.3,1,72,382,5.3,11,7,0,18,9,78,0,1,1
1434,8,2015-10-22,east-carolina,,Temple,L (14-24),33,53,62.3,283,1,35,95,2.7,1,88,378,4.3,16,6,2,24,9,99,1,1,2
1435,9,2015-10-30,east-carolina,@,Connecticut,L (13-31),19,33,57.6,137,0,36,203,5.6,1,69,340,4.9,7,9,0,16,7,64,0,4,4
1436,10,2015-11-07,east-carolina,,South Florida,L (17-22),14,23,60.9,158,0,34,62,1.8,2,57,220,3.9,5,2,1,8,5,40,0,0,0
1437,11,2015-11-19,east-carolina,@,Central Florida,W (44-7),36,52,69.2,473,4,33,149,4.5,1,85,622,7.3,17,12,2,31,11,93,0,0,0
1438,12,2015-11-28,east-carolina,,Cincinnati,L (16-19),34,51,66.7,317,2,18,68,3.8,0,69,385,5.6,20,3,0,23,6,64,0,0,0
1439,,12 Games,east-carolina,,,,321,473,67.9,3370,21,405,1618,4.0,19,878,4988,5.7,158,86,16,260,89,858,7,12,19
1440,1,2016-09-03,east-carolina,,Western Carolina,W (52-7),29,33,87.9,413,5,38,275,7.2,2,71,688,9.7,17,11,0,28,3,25,1,0,1
1441,2,2016-09-10,east-carolina,,North Carolina State,W (33-30),33,43,76.7,297,1,33,148,4.5,3,76,445,5.9,12,9,2,23,4,36,1,1,2
1442,3,2016-09-17,east-carolina,@,South Carolina,L (15-20),44,58,75.9,400,1,33,119,3.6,0,91,519,5.7,24,6,4,34,8,75,2,2,4
1443,4,2016-09-24,east-carolina,@,Virginia Tech,L (17-54),17,34,50.0,362,2,35,81,2.3,0,69,443,6.4,10,6,0,16,5,43,1,0,1
1444,5,2016-10-01,east-carolina,,Central Florida,L (29-47),38,70,54.3,488,3,32,33,1.0,1,102,521,5.1,22,3,5,30,2,15,2,3,5
1445,6,2016-10-08,east-carolina,@,South Florida,L (22-38),33,56,58.9,308,1,35,168,4.8,1,91,476,5.2,15,8,1,24,2,19,0,1,1
1446,7,2016-10-22,east-carolina,@,Cincinnati,L (19-31),28,43,65.1,283,2,44,221,5.0,0,87,504,5.8,13,13,2,28,4,34,1,2,3
1447,8,2016-10-29,east-carolina,,Connecticut,W (41-3),33,47,70.2,294,4,40,136,3.4,1,87,430,4.9,16,8,1,25,5,35,0,0,0
1448,9,2016-11-05,east-carolina,@,Tulsa,L (24-45),38,62,61.3,436,2,30,38,1.3,1,92,474,5.2,20,6,1,27,13,117,0,0,0
1449,10,2016-11-12,east-carolina,,Southern Methodist,L (31-55),29,49,59.2,314,1,32,152,4.8,3,81,466,5.8,13,12,2,27,9,84,2,3,5
1450,11,2016-11-19,east-carolina,,Navy,L (31-66),16,25,64.0,238,3,25,176,7.0,1,50,414,8.3,6,6,0,12,1,5,1,0,1
1451,12,2016-11-26,east-carolina,@,Temple,L (10-37),21,34,61.8,183,1,27,42,1.6,0,61,225,3.7,9,4,0,13,4,33,1,0,1
1452,,12 Games,east-carolina,,,,359,554,64.8,4016,26,404,1589,3.9,13,958,5605,5.9,177,92,18,287,60,521,12,12,24
1453,1,2017-09-02,east-carolina,,James Madison,L (14-34),28,53,52.8,292,0,28,75,2.7,2,81,367,4.5,17,3,8,28,8,61,1,3,4
1454,2,2017-09-09,east-carolina,@,West Virginia,L (20-56),23,47,48.9,328,2,32,142,4.4,0,79,470,5.9,13,6,2,21,8,103,0,2,2
1455,3,2017-09-16,east-carolina,,Virginia Tech,L (17-64),11,30,36.7,241,2,31,40,1.3,0,61,281,4.6,6,3,3,12,6,40,2,1,3
1456,4,2017-09-24,east-carolina,@,Connecticut,W (41-38),30,39,76.9,426,3,47,170,3.6,2,86,596,6.9,19,10,1,30,8,78,0,0,0
1457,5,2017-09-30,east-carolina,,South Florida,L (31-61),21,46,45.7,306,2,36,108,3.0,2,82,414,5.0,13,7,3,23,6,58,0,2,2
1458,6,2017-10-07,east-carolina,,Temple,L (10-34),20,38,52.6,253,1,22,34,1.5,0,60,287,4.8,11,3,1,15,8,96,0,1,1
1459,7,2017-10-14,east-carolina,@,Central Florida,L (21-63),15,33,45.5,160,3,37,187,5.1,0,70,347,5.0,8,5,3,16,10,50,0,1,1
1460,8,2017-10-21,east-carolina,,Brigham Young,W (33-17),20,30,66.7,298,2,35,115,3.3,1,65,413,6.4,12,8,2,22,2,15,1,0,1
1461,9,2017-11-04,east-carolina,@,Houston,L (27-52),54,74,73.0,468,3,24,36,1.5,0,98,504,5.1,27,4,2,33,7,51,1,2,3
1462,10,2017-11-11,east-carolina,,Tulane,L (24-31),25,53,47.2,228,1,32,161,5.0,2,85,389,4.6,12,9,3,24,2,20,0,1,1
1463,11,2017-11-18,east-carolina,,Cincinnati,W (48-20),32,46,69.6,464,5,33,114,3.5,1,79,578,7.3,19,6,3,28,7,54,0,0,0
1464,12,2017-11-25,east-carolina,@,Memphis,L (13-70),28,54,51.9,351,2,37,115,3.1,0,91,466,5.1,15,8,4,27,8,74,0,3,3
1465,,12 Games,east-carolina,,,,307,543,56.5,3815,26,394,1297,3.3,10,937,5112,5.5,172,72,35,279,80,700,5,16,21
1466,1,2018-09-02,east-carolina,,North Carolina A&T,L (23-28),38,66,57.6,314,2,29,68,2.3,0,95,382,4.0,16,6,6,28,5,45,1,2,3
1467,2,2018-09-08,east-carolina,,North Carolina,W (41-19),19,33,57.6,290,1,49,220,4.5,4,82,510,6.2,15,9,2,26,4,40,0,0,0
1468,3,2018-09-22,east-carolina,@,South Florida,L (13-20),22,50,44.0,256,0,46,156,3.4,1,96,412,4.3,11,10,3,24,2,10,0,1,1
1469,4,2018-09-29,east-carolina,,Old Dominion,W (37-35),25,45,55.6,313,3,38,179,4.7,2,83,492,5.9,17,6,2,25,8,86,0,2,2
1470,5,2018-10-06,east-carolina,@,Temple,L (6-49),18,39,46.2,120,0,28,76,2.7,0,67,196,2.9,4,5,3,12,2,25,0,0,0
1471,6,2018-10-13,east-carolina,,Houston,L (20-42),38,63,60.3,374,1,31,41,1.3,1,94,415,4.4,20,4,3,27,8,69,1,3,4
1472,7,2018-10-20,east-carolina,,Central Florida,L (10-37),29,56,51.8,406,1,38,90,2.4,0,94,496,5.3,18,9,2,29,8,60,4,1,5
1473,8,2018-11-03,east-carolina,,Memphis,L (41-59),34,62,54.8,449,3,29,107,3.7,2,91,556,6.1,18,8,3,29,4,45,1,0,1
1474,9,2018-11-10,east-carolina,@,Tulane,L (18-24),21,68,30.9,360,2,26,90,3.5,0,94,450,4.8,13,6,4,23,7,69,0,1,1
1475,10,2018-11-17,east-carolina,,Connecticut,W (55-21),22,33,66.7,242,4,54,415,7.7,3,87,657,7.6,9,23,2,34,5,48,0,0,0
1476,,10 Games,east-carolina,,,,266,515,51.7,3124,17,368,1442,3.9,13,883,4566,5.2,141,86,30,257,53,497,7,10,17
1477,1,2014-08-28,tulsa,,Tulane,W (38-31),31,53,58.5,438,4,36,154,4.3,0,89,592,6.7,20,7,3,30,9,90,0,2,2
1478,2,2014-09-06,tulsa,,Oklahoma,L (7-52),27,50,54.0,234,1,34,94,2.8,0,84,328,3.9,14,8,1,23,6,62,1,3,4
1479,3,2014-09-13,tulsa,@,Florida Atlantic,L (21-50),24,52,46.2,269,1,27,94,3.5,2,79,363,4.6,12,9,3,24,5,25,1,2,3
1480,4,2014-09-27,tulsa,,Texas State,L (34-37),23,40,57.5,234,2,56,200,3.6,2,96,434,4.5,10,13,2,25,4,34,0,1,1
1481,5,2014-10-04,tulsa,@,Colorado State,L (17-42),18,35,51.4,263,1,45,127,2.8,1,80,390,4.9,9,8,2,19,4,30,1,2,3
1482,6,2014-10-11,tulsa,@,Temple,L (24-35),21,36,58.3,260,2,50,178,3.6,1,86,438,5.1,12,11,1,24,8,108,0,0,0
1483,7,2014-10-18,tulsa,,South Florida,L (30-38),22,34,64.7,314,1,41,174,4.2,1,75,488,6.5,11,7,2,20,11,114,1,0,1
1484,8,2014-10-31,tulsa,@,Memphis,L (20-40),28,54,51.9,349,2,34,62,1.8,0,88,411,4.7,19,2,1,22,11,111,0,0,0
1485,9,2014-11-08,tulsa,,Southern Methodist,W (38-28),16,25,64.0,286,5,47,215,4.6,0,72,501,7.0,10,13,3,26,5,40,1,0,1
1486,10,2014-11-14,tulsa,@,Central Florida,L (7-31),10,29,34.5,72,1,27,129,4.8,0,56,201,3.6,4,7,0,11,6,64,0,3,3
1487,11,2014-11-22,tulsa,@,Houston,L (28-38),28,41,68.3,258,2,35,158,4.5,2,76,416,5.5,12,12,1,25,4,35,0,3,3
1488,12,2014-11-28,tulsa,,East Carolina,L (32-49),15,32,46.9,199,1,45,189,4.2,2,77,388,5.0,7,10,4,21,5,55,0,2,2
1489,,12 Games,tulsa,,,,263,481,54.7,3176,23,477,1774,3.7,11,958,4950,5.2,140,107,23,270,78,768,5,18,23
1490,1,2015-09-05,tulsa,,Florida Atlantic,W (47-44),21,35,60.0,424,2,51,194,3.8,4,86,618,7.2,14,13,4,31,4,26,2,2,4
1491,2,2015-09-12,tulsa,@,New Mexico,W (40-21),16,30,53.3,321,2,59,279,4.7,2,89,600,6.7,0,0,0,31,7,56,1,0,1
1492,3,2015-09-19,tulsa,@,Oklahoma,L (38-52),34,51,66.7,427,4,40,176,4.4,1,91,603,6.6,21,7,3,31,8,60,0,0,0
1493,4,2015-10-03,tulsa,,Houston,L (24-38),26,45,57.8,326,0,43,130,3.0,3,88,456,5.2,14,6,3,23,10,71,1,1,2
1494,5,2015-10-10,tulsa,,Louisiana-Monroe,W (34-24),28,45,62.2,341,2,62,222,3.6,2,107,563,5.3,16,13,2,31,10,82,0,0,0
1495,6,2015-10-17,tulsa,@,East Carolina,L (17-30),19,41,46.3,288,1,45,175,3.9,1,86,463,5.4,11,8,3,22,7,53,1,1,2
1496,7,2015-10-23,tulsa,,Memphis,L (42-66),24,36,66.7,421,4,45,113,2.5,2,81,534,6.6,13,8,6,27,11,76,2,1,3
1497,8,2015-10-31,tulsa,@,Southern Methodist,W (40-31),19,27,70.4,240,0,57,179,3.1,4,84,419,5.0,10,12,0,22,7,70,0,0,0
1498,9,2015-11-07,tulsa,,Central Florida,W (45-30),10,18,55.6,150,2,46,275,6.0,3,64,425,6.6,5,13,3,21,3,38,2,2,4
1499,10,2015-11-14,tulsa,@,Cincinnati,L (38-49),30,50,60.0,375,2,39,213,5.5,3,89,588,6.6,14,10,2,26,7,53,1,0,1
1500,11,2015-11-21,tulsa,,Navy,L (21-44),32,37,86.5,278,0,34,78,2.3,3,71,356,5.0,13,5,2,20,5,50,2,0,2
1501,12,2015-11-27,tulsa,@,Tulane,W (45-34),19,33,57.6,367,3,31,41,1.3,1,64,408,6.4,17,2,1,20,6,51,0,1,1
1502,13,2015-12-26,tulsa,N,Virginia Tech*,L (52-55),27,44,61.4,374,3,39,189,4.8,4,83,563,6.8,15,11,1,27,6,44,0,0,0
1503,,13 Games,tulsa,,,,305,492,62.0,4332,25,591,2264,3.8,33,1083,6596,6.1,163,108,30,332,91,730,12,8,20
1504,1,2016-09-03,tulsa,,San Jose State,W (45-10),13,25,52.0,207,1,58,305,5.3,3,83,512,6.2,9,19,0,28,2,25,0,0,0
1505,2,2016-09-10,tulsa,@,Ohio State,L (3-48),15,32,46.9,127,0,37,61,1.6,0,69,188,2.7,9,4,1,14,5,46,2,4,6
1506,3,2016-09-17,tulsa,,North Carolina A&T,W (58-21),25,39,64.1,358,4,38,136,3.6,2,77,494,6.4,16,8,4,28,6,60,1,1,2
1507,4,2016-09-24,tulsa,@,Fresno State,W (48-41),24,34,70.6,281,4,68,344,5.1,2,102,625,6.1,10,22,2,34,8,71,1,1,2
1508,5,2016-10-07,tulsa,,Southern Methodist,W (43-40),25,44,56.8,247,1,59,315,5.3,4,103,562,5.5,17,15,2,34,17,149,0,1,1
1509,6,2016-10-15,tulsa,@,Houston,L (31-38),27,51,52.9,365,1,35,94,2.7,3,86,459,5.3,18,6,3,27,5,25,1,1,2
1510,7,2016-10-22,tulsa,,Tulane,W (50-27),14,23,60.9,236,3,58,330,5.7,3,81,566,7.0,9,17,3,29,6,36,2,0,2
1511,8,2016-10-29,tulsa,@,Memphis,W (59-30),20,33,60.6,234,2,54,362,6.7,6,87,596,6.9,13,14,2,29,7,63,1,0,1
1512,9,2016-11-05,tulsa,,East Carolina,W (45-24),22,38,57.9,274,3,54,342,6.3,3,92,616,6.7,14,18,5,37,10,86,0,0,0
1513,10,2016-11-12,tulsa,@,Navy,L (40-42),16,27,59.3,369,4,38,207,5.4,1,65,576,8.9,13,10,0,23,3,35,0,1,1
1514,11,2016-11-19,tulsa,@,Central Florida,W (35-20),12,25,48.0,126,2,56,348,6.2,3,81,474,5.9,5,15,1,21,3,26,0,1,1
1515,12,2016-11-25,tulsa,,Cincinnati,W (40-37),25,39,64.1,305,3,65,306,4.7,2,104,611,5.9,18,14,3,35,3,37,1,2,3
1516,13,2016-12-19,tulsa,N,Central Michigan*,W (55-10),29,39,74.4,320,5,46,261,5.7,1,85,581,6.8,14,20,0,34,3,25,0,0,0
1517,,13 Games,tulsa,,,,267,449,59.5,3449,33,666,3411,5.1,33,1115,6860,6.2,165,182,26,373,78,684,9,12,21
1518,1,2017-08-31,tulsa,@,Oklahoma State,L (24-59),20,38,52.6,188,0,60,244,4.1,2,98,432,4.4,10,14,2,26,6,48,2,0,2
1519,2,2017-09-09,tulsa,,Louisiana,W (66-42),14,20,70.0,243,1,72,424,5.9,8,92,667,7.3,9,21,3,33,5,46,1,0,1
1520,3,2017-09-16,tulsa,@,Toledo,L (51-54),12,20,60.0,125,0,68,423,6.2,6,88,548,6.2,4,21,4,29,9,97,0,0,0
1521,4,2017-09-23,tulsa,,New Mexico,L (13-16),13,27,48.1,131,0,31,155,5.0,1,58,286,4.9,8,6,1,15,6,59,0,1,1
1522,5,2017-09-30,tulsa,,Navy,L (21-31),12,18,66.7,115,1,39,229,5.9,2,57,344,6.0,4,6,2,12,5,40,0,0,0
1523,6,2017-10-07,tulsa,@,Tulane,L (28-62),12,20,60.0,273,1,28,139,5.0,3,48,412,8.6,6,9,1,16,4,36,1,1,2
1524,7,2017-10-14,tulsa,,Houston,W (45-17),9,18,50.0,128,1,53,288,5.4,4,71,416,5.9,3,16,1,20,9,70,0,1,1
1525,8,2017-10-21,tulsa,@,Connecticut,L (14-20),17,28,60.7,259,0,44,194,4.4,2,72,453,6.3,11,9,3,23,5,47,0,1,1
1526,9,2017-10-27,tulsa,@,Southern Methodist,L (34-38),9,25,36.0,212,1,53,246,4.6,3,78,458,5.9,6,12,4,22,8,73,0,1,1
1527,10,2017-11-03,tulsa,,Memphis,L (14-41),18,31,58.1,157,0,35,145,4.1,2,66,302,4.6,7,8,2,17,14,103,0,1,1
1528,11,2017-11-16,tulsa,@,South Florida,L (20-27),14,28,50.0,191,0,55,166,3.0,2,83,357,4.3,7,13,2,22,7,46,0,0,0
1529,12,2017-11-25,tulsa,,Temple,L (22-43),6,19,31.6,55,1,54,314,5.8,1,73,369,5.1,2,18,5,25,6,55,1,2,3
1530,,12 Games,tulsa,,,,156,292,53.4,2077,6,592,2967,5.0,36,884,5044,5.7,77,153,30,260,84,720,5,8,13
1531,1,2018-09-01,tulsa,,Central Arkansas,W (38-27),15,24,62.5,196,2,63,274,4.3,3,87,470,5.4,6,18,1,25,9,92,1,0,1
1532,2,2018-09-08,tulsa,@,Texas,L (21-28),13,26,50.0,164,1,38,189,5.0,2,64,353,5.5,7,9,1,17,6,45,0,2,2
1533,3,2018-09-15,tulsa,,Arkansas State,L (20-29),19,27,70.4,172,1,42,167,4.0,1,69,339,4.9,7,10,2,19,8,64,2,1,3
1534,4,2018-09-20,tulsa,@,Temple,L (17-31),22,41,53.7,195,0,66,208,3.2,2,107,403,3.8,12,18,2,32,8,73,2,3,5
1535,5,2018-10-04,tulsa,@,Houston,L (26-41),13,31,41.9,227,1,57,199,3.5,1,88,426,4.8,8,11,0,19,9,85,2,1,3
1536,6,2018-10-12,tulsa,,South Florida,L (24-25),6,21,28.6,79,1,49,220,4.5,2,70,299,4.3,5,10,1,16,10,81,0,0,0
1537,7,2018-10-20,tulsa,@,Arkansas,L (0-23),8,25,32.0,127,0,40,133,3.3,0,65,260,4.0,5,9,1,15,4,43,1,1,2
1538,8,2018-10-27,tulsa,,Tulane,L (17-24),12,26,46.2,180,1,35,135,3.9,1,61,315,5.2,8,8,1,17,8,57,1,0,1
1539,9,2018-11-03,tulsa,,Connecticut,W (49-19),9,14,64.3,168,4,57,470,8.2,3,71,638,9.0,7,18,0,25,6,60,1,0,1
1540,10,2018-11-10,tulsa,@,Memphis,L (21-47),14,26,53.8,140,1,41,112,2.7,2,67,252,3.8,9,5,2,16,6,46,1,0,1
1541,11,2018-11-17,tulsa,@,Navy,L (29-37),19,28,67.9,206,0,44,164,3.7,4,72,370,5.1,11,10,1,22,7,75,1,1,2
1542,,11 Games,tulsa,,,,150,289,51.9,1854,12,532,2271,4.3,21,821,4125,5.0,85,126,12,223,81,721,12,9,21
1543,1,2014-08-28,tulane,@,Tulsa,L (31-38),22,44,50.0,262,3,30,254,8.5,1,74,516,7.0,13,6,3,22,9,96,1,1,2
1544,2,2014-09-06,tulane,,Georgia Tech,L (21-38),17,35,48.6,231,2,25,96,3.8,1,60,327,5.5,10,6,1,17,10,69,0,3,3
1545,3,2014-09-13,tulane,,Southeastern Louisiana,W (35-20),14,30,46.7,238,3,40,122,3.1,2,70,360,5.1,10,5,6,21,12,115,1,2,3
1546,4,2014-09-20,tulane,@,Duke,L (13-47),14,36,38.9,160,0,58,231,4.0,2,94,391,4.2,7,17,4,28,13,92,1,4,5
1547,5,2014-09-27,tulane,@,Rutgers,L (6-31),18,29,62.1,152,0,31,152,4.9,1,60,304,5.1,4,7,2,13,7,62,0,0,0
1548,6,2014-10-11,tulane,,Connecticut,W (12-3),19,26,73.1,135,1,33,167,5.1,0,59,302,5.1,6,8,0,14,7,64,0,0,0
1549,7,2014-10-18,tulane,@,Central Florida,L (13-20),18,42,42.9,147,0,36,131,3.6,1,78,278,3.6,6,9,3,18,9,84,0,2,2
1550,8,2014-10-31,tulane,,Cincinnati,L (14-38),24,35,68.6,205,1,33,175,5.3,1,68,380,5.6,12,9,0,21,4,51,1,0,1
1551,9,2014-11-08,tulane,@,Houston,W (31-24),24,35,68.6,237,3,36,124,3.4,1,71,361,5.1,11,9,2,22,5,64,1,1,2
1552,10,2014-11-15,tulane,,Memphis,L (7-38),26,48,54.2,196,0,39,155,4.0,1,87,351,4.0,10,9,2,21,3,30,2,3,5
1553,11,2014-11-22,tulane,@,East Carolina,L (6-34),25,43,58.1,301,0,27,24,0.9,0,70,325,4.6,11,2,2,15,7,79,0,1,1
1554,12,2014-12-06,tulane,,Temple,L (3-10),19,40,47.5,151,0,31,115,3.7,0,71,266,3.7,5,6,3,14,4,35,0,1,1
1555,,12 Games,tulane,,,,240,443,54.2,2415,13,419,1746,4.2,11,862,4161,4.8,105,93,28,226,90,841,7,18,25
1556,1,2015-09-03,tulane,,Duke,L (7-37),24,42,57.1,246,1,23,25,1.1,0,65,271,4.2,8,3,3,14,5,25,0,1,1
1557,2,2015-09-12,tulane,@,Georgia Tech,L (10-65),15,33,45.5,177,1,33,71,2.2,0,66,248,3.8,9,8,1,18,4,34,1,1,2
1558,3,2015-09-19,tulane,,Maine,W (38-7),18,31,58.1,292,1,42,205,4.9,4,73,497,6.8,14,6,0,20,7,65,1,1,2
1559,4,2015-10-03,tulane,,Central Florida,W (45-31),17,29,58.6,225,5,44,170,3.9,1,73,395,5.4,7,8,2,17,7,67,1,0,1
1560,5,2015-10-10,tulane,@,Temple,L (10-49),17,30,56.7,102,1,27,8,0.3,0,57,110,1.9,5,2,1,8,9,102,0,2,2
1561,6,2015-10-16,tulane,,Houston,L (7-42),14,33,42.4,150,0,32,112,3.5,1,65,262,4.0,6,4,1,11,12,133,0,0,0
1562,7,2015-10-24,tulane,@,Navy,L (14-31),27,38,71.1,263,1,27,123,4.6,1,65,386,5.9,18,2,1,21,9,80,2,1,3
1563,8,2015-10-31,tulane,@,Memphis,L (13-41),10,24,41.7,131,0,42,139,3.3,2,66,270,4.1,6,8,3,17,6,50,0,0,0
1564,9,2015-11-07,tulane,,Connecticut,L (3-7),13,40,32.5,106,0,25,34,1.4,0,65,140,2.2,6,3,0,9,2,10,0,1,1
1565,10,2015-11-14,tulane,@,Army,W (34-31),14,29,48.3,252,2,28,115,4.1,1,57,367,6.4,11,7,0,18,2,10,0,1,1
1566,11,2015-11-21,tulane,@,Southern Methodist,L (21-49),13,33,39.4,128,2,33,200,6.1,1,66,328,5.0,7,8,2,17,4,40,0,0,0
1567,12,2015-11-27,tulane,,Tulsa,L (34-45),23,41,56.1,343,4,41,187,4.6,0,82,530,6.5,15,9,1,25,3,25,0,2,2
1568,,12 Games,tulane,,,,205,403,50.9,2415,18,397,1389,3.5,11,800,3804,4.8,112,68,15,195,70,641,5,10,15
1569,1,2016-09-01,tulane,@,Wake Forest,L (3-7),12,23,52.2,134,0,47,146,3.1,0,70,280,4.0,6,7,1,14,4,30,1,0,1
1570,2,2016-09-10,tulane,,Southern,W (66-21),2,6,33.3,12,0,57,437,7.7,7,63,449,7.1,0,20,2,22,4,35,0,1,1
1571,3,2016-09-17,tulane,,Navy,L (14-21),3,12,25.0,21,0,47,240,5.1,2,59,261,4.4,0,14,0,14,9,71,0,0,0
1572,4,2016-09-24,tulane,,Louisiana,W (41-39),13,26,50.0,181,4,48,130,2.7,0,74,311,4.2,7,7,0,14,6,40,0,1,1
1573,5,2016-10-01,tulane,@,Massachusetts,W (31-24),11,21,52.4,168,1,64,280,4.4,3,85,448,5.3,8,16,3,27,6,50,1,0,1
1574,6,2016-10-14,tulane,,Memphis,L (14-24),11,30,36.7,144,1,44,169,3.8,1,74,313,4.2,7,9,4,20,7,62,2,1,3
1575,7,2016-10-22,tulane,@,Tulsa,L (27-50),3,19,15.8,37,0,49,355,7.2,4,68,392,5.8,2,12,1,15,9,85,1,0,1
1576,8,2016-10-29,tulane,,Southern Methodist,L (31-35),13,26,50.0,164,2,46,227,4.9,2,72,391,5.4,7,9,2,18,10,100,0,1,1
1577,9,2016-11-05,tulane,@,Central Florida,L (6-37),5,21,23.8,68,0,64,280,4.4,1,85,348,4.1,3,16,3,22,6,65,2,3,5
1578,10,2016-11-12,tulane,@,Houston,L (18-30),21,42,50.0,241,2,36,100,2.8,0,78,341,4.4,11,5,1,17,5,33,1,0,1
1579,11,2016-11-19,tulane,,Temple,L (0-31),4,13,30.8,24,0,33,118,3.6,0,46,142,3.1,0,8,0,8,6,50,2,0,2
1580,12,2016-11-26,tulane,@,Connecticut,W (38-13),11,19,57.9,166,0,55,257,4.7,5,74,423,5.7,8,8,1,17,5,40,0,1,1
1581,,12 Games,tulane,,,,109,258,42.2,1360,10,590,2739,4.6,25,848,4099,4.8,59,131,18,208,77,661,10,8,18
1582,1,2017-09-02,tulane,,Grambling State,W (43-14),10,15,66.7,185,3,51,296,5.8,3,66,481,7.3,9,15,2,26,8,75,0,0,0
1583,2,2017-09-09,tulane,@,Navy,L (21-23),8,13,61.5,71,0,46,191,4.2,2,59,262,4.4,1,10,0,11,7,41,0,0,0
1584,3,2017-09-16,tulane,@,Oklahoma,L (14-56),6,12,50.0,54,0,62,237,3.8,2,74,291,3.9,3,16,1,20,2,20,1,1,2
1585,4,2017-09-23,tulane,,Army,W (21-17),10,22,45.5,103,0,30,253,8.4,3,52,356,6.8,5,8,2,15,6,59,0,0,0
1586,5,2017-10-07,tulane,,Tulsa,W (62-28),9,13,69.2,165,1,70,488,7.0,8,83,653,7.9,7,22,2,31,6,60,0,0,0
1587,6,2017-10-14,tulane,@,Florida International,L (10-23),5,16,31.3,36,0,40,203,5.1,1,56,239,4.3,1,14,3,18,1,15,1,1,2
1588,7,2017-10-21,tulane,,South Florida,L (28-34),9,19,47.4,221,2,47,194,4.1,2,66,415,6.3,8,12,3,23,12,137,0,1,1
1589,8,2017-10-27,tulane,@,Memphis,L (26-56),15,31,48.4,203,3,52,122,2.3,1,83,325,3.9,6,11,1,18,4,27,1,0,1
1590,9,2017-11-04,tulane,,Cincinnati,L (16-17),17,24,70.8,196,0,35,132,3.8,1,59,328,5.6,8,5,3,16,6,39,0,0,0
1591,10,2017-11-11,tulane,@,East Carolina,W (31-24),12,20,60.0,121,0,52,325,6.3,4,72,446,6.2,5,17,0,22,8,70,1,2,3
1592,11,2017-11-18,tulane,,Houston,W (20-17),17,25,68.0,251,1,47,166,3.5,1,72,417,5.8,12,11,0,23,5,42,0,1,1
1593,12,2017-11-25,tulane,@,Southern Methodist,L (38-41),18,31,58.1,314,2,43,171,4.0,3,74,485,6.6,13,12,2,27,5,40,1,0,1
1594,,12 Games,tulane,,,,136,241,56.4,1920,12,575,2778,4.8,31,816,4698,5.8,78,153,19,250,70,625,5,6,11
1595,1,2018-08-30,tulane,,Wake Forest,L (17-23),19,38,50.0,283,2,41,153,3.7,0,79,436,5.5,8,9,3,20,9,83,1,0,1
1596,2,2018-09-08,tulane,,Nicholls State,W (42-17),12,16,75.0,190,1,41,268,6.5,5,57,458,8.0,9,12,1,22,9,78,1,0,1
1597,3,2018-09-15,tulane,@,Alabama-Birmingham,L (24-31),7,26,26.9,180,2,40,175,4.4,1,66,355,5.4,6,8,3,17,2,25,2,1,3
1598,4,2018-09-22,tulane,@,Ohio State,L (6-49),10,16,62.5,156,0,41,107,2.6,1,57,263,4.6,8,5,1,14,6,55,0,0,0
1599,5,2018-09-28,tulane,,Memphis,W (40-24),13,22,59.1,178,1,56,318,5.7,4,78,496,6.4,9,13,0,22,9,95,0,0,0
1600,6,2018-10-06,tulane,@,Cincinnati,L (21-37),12,31,38.7,132,2,38,134,3.5,1,69,266,3.9,5,7,2,14,12,90,1,0,1
1601,7,2018-10-20,tulane,,Southern Methodist,L (23-27),14,22,63.6,153,0,46,168,3.7,2,68,321,4.7,7,10,1,18,10,96,2,1,3
1602,8,2018-10-27,tulane,@,Tulsa,W (24-17),10,19,52.6,92,0,55,312,5.7,3,74,404,5.5,5,9,3,17,8,70,1,0,1
1603,9,2018-11-03,tulane,@,South Florida,W (41-15),4,11,36.4,61,0,52,365,7.0,5,63,426,6.8,1,15,1,17,7,52,1,0,1
1604,10,2018-11-10,tulane,,East Carolina,W (24-18),12,28,42.9,372,3,49,163,3.3,0,77,535,6.9,10,7,0,17,8,93,1,0,1
1605,11,2018-11-15,tulane,@,Houston,L (17-48),10,24,41.7,147,0,43,212,4.9,2,67,359,5.4,6,12,0,18,5,43,1,3,4
1606,,11 Games,tulane,,,,123,253,48.6,1944,11,502,2375,4.7,24,755,4319,5.7,74,107,15,196,85,780,11,5,16
1607,1,2014-08-29,connecticut,,Brigham Young,L (10-35),25,48,52.1,284,0,31,71,2.3,1,79,355,4.5,14,3,6,23,8,90,1,1,2
1608,2,2014-09-06,connecticut,,Stony Brook,W (19-16),12,27,44.4,142,1,37,81,2.2,0,64,223,3.5,7,5,3,15,3,25,2,0,2
1609,3,2014-09-13,connecticut,,Boise State,L (21-38),22,38,57.9,242,2,36,48,1.3,0,74,290,3.9,11,6,1,183,3,30,1,2,3
1610,4,2014-09-19,connecticut,@,South Florida,L (14-17),6,10,60.0,88,1,26,57,2.2,0,36,145,4.0,3,2,1,6,9,61,1,0,1
1611,5,2014-09-27,connecticut,,Temple,L (10-36),14,28,50.0,174,1,43,133,3.1,0,71,307,4.3,6,10,2,18,7,70,1,2,3
1612,6,2014-10-11,connecticut,@,Tulane,L (3-12),17,26,65.4,141,0,28,76,2.7,0,54,217,4.0,6,6,1,13,1,15,2,1,3
1613,7,2014-10-23,connecticut,@,East Carolina,L (21-31),20,32,62.5,313,2,26,84,3.2,1,58,397,6.8,10,3,3,16,12,118,0,1,1
1614,8,2014-11-01,connecticut,,Central Florida,W (37-29),14,28,50.0,148,2,40,179,4.5,3,68,327,4.8,6,7,3,16,10,102,1,0,1
1615,9,2014-11-08,connecticut,N,Army,L (21-35),23,37,62.2,190,2,24,169,7.0,1,61,359,5.9,9,8,1,18,5,37,0,2,2
1616,10,2014-11-22,connecticut,,Cincinnati,L (0-41),14,27,51.9,81,0,27,48,1.8,0,54,129,2.4,5,5,0,10,2,20,2,1,3
1617,11,2014-11-29,connecticut,@,Memphis,L (10-41),13,27,48.1,162,1,36,107,3.0,0,63,269,4.3,7,6,1,14,10,115,1,1,2
1618,12,2014-12-06,connecticut,,Southern Methodist,L (20-27),5,14,35.7,67,0,41,249,6.1,2,55,316,5.7,3,8,0,11,4,44,4,1,5
1619,,12 Games,connecticut,,,,185,342,54.1,2032,12,395,1302,3.3,8,737,3334,4.5,87,69,22,343,74,727,16,12,28
1620,1,2015-09-03,connecticut,,Villanova,W (20-15),12,20,60.0,202,2,39,105,2.7,1,59,307,5.2,9,8,2,19,4,30,0,1,1
1621,2,2015-09-12,connecticut,,Army,W (22-17),19,25,76.0,270,0,46,145,3.2,2,71,415,5.8,10,11,2,23,7,50,1,0,1
1622,3,2015-09-19,connecticut,@,Missouri,L (6-9),17,28,60.7,156,0,33,77,2.3,1,61,233,3.8,7,4,0,11,8,85,1,1,2
1623,4,2015-09-26,connecticut,,Navy,L (18-28),19,32,59.4,219,2,31,106,3.4,0,63,325,5.2,10,8,2,20,3,22,1,0,1
1624,5,2015-10-02,connecticut,@,Brigham Young,L (13-30),14,28,50.0,168,1,27,62,2.3,0,55,230,4.2,9,3,2,14,5,43,0,2,2
1625,6,2015-10-10,connecticut,@,Central Florida,W (40-13),18,24,75.0,263,1,45,170,3.8,4,69,433,6.3,10,10,0,20,11,69,0,0,0
1626,7,2015-10-17,connecticut,,South Florida,L (20-28),28,42,66.7,365,1,38,163,4.3,1,80,528,6.6,16,9,1,26,4,39,0,1,1
1627,8,2015-10-24,connecticut,@,Cincinnati,L (13-37),17,41,41.5,130,0,30,136,4.5,1,71,266,3.7,6,8,5,19,3,25,1,1,2
1628,9,2015-10-30,connecticut,,East Carolina,W (31-13),12,21,57.1,184,1,44,220,5.0,3,65,404,6.2,7,7,3,17,5,34,1,1,2
1629,10,2015-11-07,connecticut,@,Tulane,W (7-3),8,19,42.1,81,0,42,146,3.5,0,61,227,3.7,2,7,0,9,4,45,0,1,1
1630,11,2015-11-21,connecticut,,Houston,W (20-17),14,24,58.3,159,2,43,156,3.6,0,67,315,4.7,6,6,1,13,10,63,0,0,0
1631,12,2015-11-28,connecticut,@,Temple,L (3-27),13,21,61.9,129,0,26,9,0.3,0,47,138,2.9,7,2,0,9,7,65,1,1,2
1632,13,2015-12-26,connecticut,N,Marshall*,L (10-16),10,17,58.8,86,0,33,127,3.8,1,50,213,4.3,6,7,2,15,3,25,0,1,1
1633,,13 Games,connecticut,,,,201,342,58.8,2412,10,477,1622,3.4,14,819,4034,4.9,105,90,20,215,74,595,6,10,16
1634,1,2016-09-01,connecticut,,Maine,W (24-21),16,23,69.6,162,0,50,200,4.0,3,73,362,5.0,11,11,1,23,3,30,1,0,1
1635,2,2016-09-10,connecticut,@,Navy,L (24-28),24,27,88.9,264,1,34,90,2.6,1,61,354,5.8,12,6,1,19,2,6,2,0,2
1636,3,2016-09-17,connecticut,,Virginia,W (13-10),13,24,54.2,154,0,40,123,3.1,1,64,277,4.3,9,4,5,18,3,35,1,1,2
1637,4,2016-09-24,connecticut,,Syracuse,L (24-31),28,46,60.9,281,1,45,144,3.2,2,91,425,4.7,13,10,0,23,1,5,0,1,1
1638,5,2016-09-29,connecticut,@,Houston,L (14-42),16,36,44.4,273,1,27,62,2.3,1,63,335,5.3,12,2,0,14,4,38,0,0,0
1639,6,2016-10-08,connecticut,,Cincinnati,W (20-9),18,33,54.5,224,2,41,188,4.6,0,74,412,5.6,10,8,3,21,8,69,0,2,2
1640,7,2016-10-15,connecticut,@,South Florida,L (27-42),22,39,56.4,306,2,36,72,2.0,1,75,378,5.0,11,7,2,20,3,20,0,0,0
1641,8,2016-10-22,connecticut,,Central Florida,L (16-24),18,35,51.4,242,0,45,171,3.8,1,80,413,5.2,11,13,0,24,4,30,0,0,0
1642,9,2016-10-29,connecticut,@,East Carolina,L (3-41),18,35,51.4,206,0,31,89,2.9,0,66,295,4.5,9,4,1,14,4,34,1,2,3
1643,10,2016-11-04,connecticut,,Temple,L (0-21),12,21,57.1,69,0,28,91,3.3,0,49,160,3.3,5,3,0,8,4,23,0,0,0
1644,11,2016-11-19,connecticut,@,Boston College,L (0-30),13,30,43.3,127,0,17,-6,-0.4,0,47,121,2.6,6,1,1,8,6,46,1,3,4
1645,12,2016-11-26,connecticut,,Tulane,L (13-38),15,31,48.4,124,1,24,184,7.7,1,55,308,5.6,8,4,1,13,1,3,2,2,4
1646,,12 Games,connecticut,,,,213,380,56.1,2432,8,418,1408,3.4,11,798,3840,4.8,117,73,15,205,43,339,8,11,19
1647,1,2017-08-31,connecticut,,Holy Cross,W (27-20),28,41,68.3,278,1,37,160,4.3,3,78,438,5.6,10,7,1,18,4,40,2,0,2
1648,2,2017-09-16,connecticut,@,Virginia,L (18-38),18,26,69.2,227,2,41,207,5.0,1,67,434,6.5,10,9,4,23,1,5,1,1,2
1649,3,2017-09-24,connecticut,,East Carolina,L (38-41),24,39,61.5,406,3,38,190,5.0,2,77,596,7.7,15,9,3,27,4,40,0,1,1
1650,4,2017-09-30,connecticut,@,Southern Methodist,L (28-49),22,28,78.6,408,2,36,-8,-0.2,1,64,400,6.3,13,2,3,18,5,42,1,0,1
1651,5,2017-10-06,connecticut,,Memphis,L (31-70),21,35,60.0,310,1,34,167,4.9,3,69,477,6.9,14,7,3,24,6,55,2,1,3
1652,6,2017-10-14,connecticut,@,Temple,W (28-24),18,28,64.3,105,3,36,143,4.0,0,64,248,3.9,6,6,3,15,6,51,1,1,2
1653,7,2017-10-21,connecticut,,Tulsa,W (20-14),23,29,79.3,372,1,42,69,1.6,1,71,441,6.2,11,6,2,19,11,105,0,0,0
1654,8,2017-10-28,connecticut,,Missouri,L (12-52),22,52,42.3,233,0,41,121,3.0,1,93,354,3.8,9,11,3,23,5,65,0,1,1
1655,9,2017-11-04,connecticut,,South Florida,L (20-37),21,28,75.0,176,1,41,148,3.6,2,69,324,4.7,12,7,3,22,2,20,0,1,1
1656,10,2017-11-11,connecticut,@,Central Florida,L (24-49),18,31,58.1,201,2,45,212,4.7,1,76,413,5.4,9,11,3,23,8,79,1,1,2
1657,11,2017-11-18,connecticut,N,Boston College,L (16-39),14,33,42.4,241,1,41,171,4.2,1,74,412,5.6,8,7,0,15,7,47,0,3,3
1658,12,2017-11-25,connecticut,@,Cincinnati,L (21-22),27,51,52.9,273,1,52,176,3.4,1,103,449,4.4,13,13,3,29,4,37,0,1,1
1659,,12 Games,connecticut,,,,256,421,60.8,3230,18,484,1756,3.6,17,905,4986,5.5,130,95,31,256,63,586,8,11,19
1660,1,2018-08-30,connecticut,,Central Florida,L (17-56),27,41,65.9,266,1,46,220,4.8,1,87,486,5.6,9,16,2,27,7,93,2,1,3
1661,2,2018-09-08,connecticut,@,Boise State,L (7-62),11,21,52.4,71,1,25,122,4.9,0,46,193,4.2,3,6,0,9,7,44,0,1,1
1662,3,2018-09-15,connecticut,,Rhode Island,W (56-49),20,27,74.1,308,4,54,265,4.9,4,81,573,7.1,16,11,5,32,4,35,2,1,3
1663,4,2018-09-22,connecticut,@,Syracuse,L (21-51),19,29,65.5,217,2,39,178,4.6,1,68,395,5.8,7,7,2,16,5,42,2,1,3
1664,5,2018-09-29,connecticut,,Cincinnati,L (7-49),14,35,40.0,181,1,29,77,2.7,0,64,258,4.0,7,5,7,19,2,15,0,1,1
1665,6,2018-10-06,connecticut,@,Memphis,L (14-55),24,43,55.8,215,1,30,112,3.7,1,73,327,4.5,14,4,1,19,3,25,1,3,4
1666,7,2018-10-20,connecticut,@,South Florida,L (30-38),10,21,47.6,133,0,51,322,6.3,4,72,455,6.3,5,17,2,24,4,25,0,1,1
1667,8,2018-10-27,connecticut,,Massachusetts,L (17-22),4,6,66.7,15,0,44,250,5.7,2,50,265,5.3,0,11,0,11,2,25,0,1,1
1668,9,2018-11-03,connecticut,@,Tulsa,L (19-49),14,28,50.0,232,2,50,255,5.1,0,78,487,6.2,8,13,2,23,5,45,2,1,3
1669,10,2018-11-10,connecticut,,Southern Methodist,L (50-62),25,40,62.5,215,4,49,365,7.4,3,89,580,6.5,12,17,5,34,9,77,0,1,1
1670,11,2018-11-17,connecticut,@,East Carolina,L (21-55),17,33,51.5,183,3,29,91,3.1,0,62,274,4.4,11,4,1,16,5,30,1,2,3
1671,,11 Games,connecticut,,,,185,324,57.1,2036,19,446,2257,5.1,16,770,4293,5.6,92,111,27,230,53,456,10,14,24
1672,1,2014-09-01,louisville,,Miami (FL),W (31-13),20,28,71.4,206,2,43,130,3.0,1,71,336,4.7,10,11,0,21,7,57,2,0,2
1673,2,2014-09-06,louisville,,Murray State,W (66-21),25,39,64.1,278,3,49,325,6.6,6,88,603,6.9,13,15,3,31,3,19,0,0,0
1674,3,2014-09-13,louisville,@,Virginia,L (21-23),20,43,46.5,203,2,27,79,2.9,1,70,282,4.0,9,6,2,17,7,50,2,2,4
1675,4,2014-09-20,louisville,@,Florida International,W (34-3),20,36,55.6,324,2,35,12,0.3,1,71,336,4.7,9,6,1,16,7,36,2,0,2
1676,5,2014-09-27,louisville,,Wake Forest,W (20-10),16,32,50.0,206,0,49,215,4.4,2,81,421,5.2,9,11,1,21,11,89,3,0,3
1677,6,2014-10-03,louisville,@,Syracuse,W (28-6),12,22,54.5,174,1,48,178,3.7,2,70,352,5.0,6,11,1,18,9,75,1,1,2
1678,7,2014-10-11,louisville,@,Clemson,L (17-23),15,30,50.0,212,1,38,52,1.4,1,68,264,3.9,6,3,1,10,11,65,2,0,2
1679,8,2014-10-18,louisville,,North Carolina State,W (30-18),21,36,58.3,203,2,33,166,5.0,1,69,369,5.3,10,11,0,21,4,33,0,0,0
1680,9,2014-10-30,louisville,,Florida State,L (31-42),20,38,52.6,330,1,33,158,4.8,3,71,488,6.9,14,9,1,24,3,14,1,1,2
1681,10,2014-11-08,louisville,@,Boston College,W (38-19),17,24,70.8,257,2,40,166,4.2,3,64,423,6.6,10,9,2,21,10,87,1,0,1
1682,11,2014-11-22,louisville,@,Notre Dame,W (31-28),8,21,38.1,180,1,50,229,4.6,3,71,409,5.8,7,14,2,23,8,57,0,1,1
1683,12,2014-11-29,louisville,,Kentucky,W (44-40),22,35,62.9,389,3,39,83,2.1,3,74,472,6.4,16,4,2,22,3,15,2,2,4
1684,13,2014-12-30,louisville,N,Georgia*,L (14-37),21,44,47.7,314,1,27,62,2.3,1,71,376,5.3,14,6,0,20,7,44,0,3,3
1685,,13 Games,louisville,,,,237,428,55.4,3276,21,511,1855,3.6,28,939,5131,5.5,133,116,16,265,90,641,16,10,26
1686,1,2015-09-05,louisville,N,Auburn,L (24-31),17,33,51.5,167,0,48,238,5.0,3,81,405,5.0,9,17,1,27,5,35,1,1,2
1687,2,2015-09-12,louisville,,Houston,L (31-34),27,45,60.0,325,2,26,70,2.7,2,71,395,5.6,15,7,3,25,9,80,2,2,4
1688,3,2015-09-17,louisville,,Clemson,L (17-20),20,35,57.1,253,0,28,19,0.7,1,63,272,4.3,10,3,3,16,2,15,0,2,2
1689,4,2015-09-26,louisville,,Samford,W (45-3),18,28,64.3,274,2,46,288,6.3,4,74,562,7.6,13,12,0,25,9,89,0,2,2
1690,5,2015-10-03,louisville,@,North Carolina State,W (20-13),10,27,37.0,103,1,45,203,4.5,1,72,306,4.3,7,10,3,20,6,50,0,0,0
1691,6,2015-10-17,louisville,@,Florida State,L (21-41),20,35,57.1,307,3,30,99,3.3,0,65,406,6.2,13,6,1,20,9,84,1,1,2
1692,7,2015-10-24,louisville,,Boston College,W (17-14),15,26,57.7,230,0,48,135,2.8,1,74,365,4.9,10,8,0,18,8,49,2,2,4
1693,8,2015-10-30,louisville,@,Wake Forest,W (20-19),23,32,71.9,249,2,42,68,1.6,0,74,317,4.3,12,3,2,17,10,89,1,0,1
1694,9,2015-11-07,louisville,,Syracuse,W (41-17),24,36,66.7,362,3,31,217,7.0,1,67,579,8.6,12,11,0,23,9,84,3,1,4
1695,10,2015-11-14,louisville,,Virginia,W (38-31),11,22,50.0,159,2,37,266,7.2,3,59,425,7.2,9,11,3,23,5,53,2,0,2
1696,11,2015-11-21,louisville,@,Pittsburgh,L (34-45),20,38,52.6,355,3,24,-1,0.0,1,62,354,5.7,13,2,2,17,8,50,0,1,1
1697,12,2015-11-28,louisville,@,Kentucky,W (38-24),10,26,38.5,175,1,40,314,7.9,4,66,489,7.4,6,13,1,20,7,46,0,3,3
1698,13,2015-12-30,louisville,N,Texas A&M*,W (27-21),12,26,46.2,227,2,46,307,6.7,2,72,534,7.4,7,12,2,21,10,90,0,0,0
1699,,13 Games,louisville,,,,227,409,55.5,3186,21,491,2223,4.5,23,900,5409,6.0,136,115,21,272,97,814,12,15,27
1700,1,2016-09-01,louisville,,UNC Charlotte,W (70-14),26,35,74.3,391,8,35,272,7.8,2,70,663,9.5,20,14,4,38,10,49,2,1,3
1701,2,2016-09-09,louisville,@,Syracuse,W (62-28),21,40,52.5,431,1,41,414,10.1,7,81,845,10.4,16,13,1,30,9,100,2,1,3
1702,3,2016-09-17,louisville,,Florida State,W (63-20),13,20,65.0,216,1,46,314,6.8,7,66,530,8.0,8,13,3,24,5,56,0,1,1
1703,4,2016-09-24,louisville,@,Marshall,W (59-28),24,44,54.5,417,5,41,273,6.7,3,85,690,8.1,14,15,4,33,12,143,2,1,3
1704,5,2016-10-01,louisville,@,Clemson,L (36-42),27,44,61.4,295,1,55,273,5.0,3,99,568,5.7,12,16,3,31,11,104,2,1,3
1705,6,2016-10-14,louisville,,Duke,W (24-14),13,26,50.0,181,1,35,288,8.2,2,61,469,7.7,6,14,1,21,4,32,1,0,1
1706,7,2016-10-22,louisville,,North Carolina State,W (54-13),21,36,58.3,390,3,44,163,3.7,3,80,553,6.9,12,10,2,24,12,94,2,0,2
1707,8,2016-10-29,louisville,@,Virginia,W (32-25),24,41,58.5,361,4,34,147,4.3,0,75,508,6.8,16,10,1,27,7,68,1,1,2
1708,9,2016-11-05,louisville,@,Boston College,W (52-7),19,29,65.5,305,4,36,210,5.8,3,65,515,7.9,13,6,3,22,0,0,2,1,3
1709,10,2016-11-12,louisville,,Wake Forest,W (44-12),14,26,53.8,145,1,37,346,9.4,4,63,491,7.8,7,13,0,20,4,55,3,0,3
1710,11,2016-11-17,louisville,@,Houston,L (10-36),20,43,46.5,211,1,40,101,2.5,0,83,312,3.8,8,10,0,18,15,114,3,0,3
1711,12,2016-11-26,louisville,,Kentucky,L (38-41),16,25,64.0,281,2,46,280,6.1,3,71,561,7.9,12,14,0,26,4,48,1,3,4
1712,13,2016-12-31,louisville,N,Louisiana State*,L (9-29),10,27,37.0,153,0,35,67,1.9,0,62,220,3.5,6,4,1,11,8,56,1,0,1
1713,,13 Games,louisville,,,,248,436,56.9,3777,32,525,3148,6.0,37,961,6925,7.2,150,152,23,325,101,919,22,10,32
1714,1,2017-09-02,louisville,N,Purdue,W (35-28),30,46,65.2,378,2,33,146,4.4,1,79,524,6.6,16,8,3,27,16,110,3,0,3
1715,2,2017-09-09,louisville,@,North Carolina,W (47-35),25,39,64.1,393,3,44,312,7.1,3,83,705,8.5,18,15,2,35,6,61,0,0,0
1716,3,2017-09-16,louisville,,Clemson,L (21-47),21,42,50.0,317,3,27,116,4.3,0,69,433,6.3,13,7,1,21,4,35,0,1,1
1717,4,2017-09-23,louisville,,Kent State,W (42-3),23,30,76.7,374,2,27,165,6.1,3,57,539,9.5,12,9,2,23,4,30,2,2,4
1718,5,2017-09-30,louisville,,Murray State,W (55-10),32,45,71.1,364,4,46,312,6.8,3,91,676,7.4,18,16,4,38,7,69,2,0,2
1719,6,2017-10-05,louisville,@,North Carolina State,L (25-39),26,48,54.2,354,1,29,116,4.0,2,77,470,6.1,12,12,1,25,10,69,0,1,1
1720,7,2017-10-14,louisville,,Boston College,L (42-45),19,39,48.7,332,2,36,293,8.1,4,75,625,8.3,12,13,0,25,4,30,1,1,2
1721,8,2017-10-21,louisville,@,Florida State,W (31-28),13,21,61.9,156,1,44,293,6.7,3,65,449,6.9,7,14,1,22,2,13,1,0,1
1722,9,2017-10-28,louisville,@,Wake Forest,L (32-42),28,46,60.9,332,1,42,191,4.5,3,88,523,5.9,19,10,1,30,0,0,0,1,1
1723,10,2017-11-11,louisville,,Virginia,W (38-21),15,26,57.7,195,3,43,298,6.9,2,69,493,7.1,9,15,3,27,6,65,2,0,2
1724,11,2017-11-18,louisville,,Syracuse,W (56-10),17,30,56.7,316,3,42,411,9.8,5,72,727,10.1,12,15,0,27,11,85,0,0,0
1725,12,2017-11-25,louisville,@,Kentucky,W (44-17),15,21,71.4,216,2,43,346,8.0,3,64,562,8.8,11,16,5,32,6,55,0,0,0
1726,13,2017-12-30,louisville,N,Mississippi State*,L (27-31),13,31,41.9,171,2,39,187,4.8,1,70,358,5.1,9,7,4,20,6,42,0,4,4
1727,,13 Games,louisville,,,,277,464,59.7,3898,29,495,3186,6.4,33,959,7084,7.4,168,157,27,352,82,664,11,10,21
1728,1,2018-09-01,louisville,N,Alabama,L (14-51),20,39,51.3,252,2,25,27,1.1,0,64,279,4.4,13,1,5,19,11,93,0,2,2
1729,2,2018-09-08,louisville,,Indiana State,W (31-7),14,22,63.6,164,1,38,199,5.2,2,60,363,6.1,6,12,1,19,7,75,1,1,2
1730,3,2018-09-15,louisville,,Western Kentucky,W (20-17),10,21,47.6,88,0,38,204,5.4,2,59,292,4.9,4,11,2,17,5,40,0,1,1
1731,4,2018-09-22,louisville,@,Virginia,L (3-27),16,28,57.1,148,0,29,66,2.3,0,57,214,3.8,11,3,0,14,6,52,1,2,3
1732,5,2018-09-29,louisville,,Florida State,L (24-28),24,45,53.3,306,2,38,115,3.0,1,83,421,5.1,11,11,2,24,8,75,1,2,3
1733,6,2018-10-05,louisville,,Georgia Tech,L (31-66),27,44,61.4,370,3,23,113,4.9,1,67,483,7.2,14,7,2,23,4,35,2,1,3
1734,7,2018-10-13,louisville,@,Boston College,L (20-38),17,35,48.6,170,0,32,47,1.5,3,67,217,3.2,10,4,1,15,4,33,0,1,1
1735,8,2018-10-27,louisville,,Wake Forest,L (35-56),30,54,55.6,358,1,36,174,4.8,4,90,532,5.9,19,11,1,31,5,31,1,0,1
1736,9,2018-11-03,louisville,@,Clemson,L (16-77),17,34,50.0,231,0,36,81,2.3,1,70,312,4.5,8,8,0,16,10,100,1,2,3
1737,10,2018-11-09,louisville,@,Syracuse,L (23-54),14,31,45.2,210,1,39,203,5.2,2,70,413,5.9,7,9,2,18,17,125,2,2,4
1738,11,2018-11-17,louisville,,North Carolina State,L (10-52),13,25,52.0,157,0,38,254,6.7,1,63,411,6.5,8,11,0,19,12,68,1,1,2
1739,,11 Games,louisville,,,,202,378,53.4,2454,10,372,1483,4.0,17,750,3937,5.2,111,88,16,215,89,727,10,15,25
1740,1,2014-08-28,rutgers,N,Washington State,W (41-38),16,27,59.3,281,2,43,215,5.0,3,70,496,7.1,10,11,1,22,8,78,0,1,1
1741,2,2014-09-06,rutgers,,Howard,W (38-25),16,22,72.7,288,4,38,109,2.9,1,60,397,6.6,10,8,2,20,3,41,1,0,1
1742,3,2014-09-13,rutgers,,Penn State,L (10-13),15,31,48.4,192,0,31,102,3.3,1,62,294,4.7,8,7,0,15,9,75,0,5,5
1743,4,2014-09-20,rutgers,@,Navy,W (31-24),11,14,78.6,151,0,56,284,5.1,4,70,435,6.2,7,16,1,24,2,24,1,0,1
1744,5,2014-09-27,rutgers,,Tulane,W (31-6),14,21,66.7,291,4,40,171,4.3,0,61,462,7.6,8,11,1,20,4,30,0,1,1
1745,6,2014-10-04,rutgers,,Michigan,W (26-24),23,40,57.5,402,3,30,74,2.5,0,70,476,6.8,13,5,0,18,9,85,0,0,0
1746,7,2014-10-18,rutgers,@,Ohio State,L (17-56),18,29,62.1,196,0,38,149,3.9,2,67,345,5.1,10,7,1,18,0,0,2,1,3
1747,8,2014-10-25,rutgers,@,Nebraska,L (24-42),12,26,46.2,205,1,38,143,3.8,2,64,348,5.4,8,7,0,15,4,26,0,1,1
1748,9,2014-11-01,rutgers,,Wisconsin,L (0-37),7,27,25.9,63,0,29,76,2.6,0,56,139,2.5,3,5,0,8,4,35,0,1,1
1749,10,2014-11-15,rutgers,,Indiana,W (45-23),16,27,59.3,217,2,40,212,5.3,4,67,429,6.4,8,9,2,19,5,41,1,0,1
1750,11,2014-11-22,rutgers,@,Michigan State,L (3-45),14,31,45.2,139,0,29,95,3.3,0,60,234,3.9,6,8,1,15,3,25,0,3,3
1751,12,2014-11-29,rutgers,@,Maryland,W (41-38),28,42,66.7,347,4,35,144,4.1,1,77,491,6.4,15,8,1,24,7,60,2,0,2
1752,13,2014-12-26,rutgers,N,North Carolina*,W (40-21),9,20,45.0,184,2,42,340,8.1,3,62,524,8.5,8,15,0,23,3,25,0,0,0
1753,,13 Games,rutgers,,,,199,357,55.7,2956,22,489,2114,4.3,21,846,5070,6.0,114,117,10,241,61,545,7,13,20
1754,1,2015-09-05,rutgers,,Norfolk State,W (63-13),13,15,86.7,248,4,47,291,6.2,4,62,539,8.7,8,17,1,26,9,60,1,0,1
1755,2,2015-09-12,rutgers,,Washington State,L (34-37),23,29,79.3,204,1,37,198,5.4,1,66,402,6.1,12,12,2,26,11,100,2,1,3
1756,3,2015-09-19,rutgers,@,Penn State,L (3-28),27,42,64.3,251,0,32,43,1.3,0,74,294,4.0,14,5,1,20,8,29,1,2,3
1757,4,2015-09-26,rutgers,,Kansas,W (27-14),18,25,72.0,201,2,58,312,5.4,2,83,513,6.2,13,15,3,31,10,80,1,2,3
1758,5,2015-10-10,rutgers,,Michigan State,L (24-31),15,26,57.7,208,3,32,141,4.4,0,58,349,6.0,7,8,0,15,3,20,0,0,0
1759,6,2015-10-17,rutgers,@,Indiana,W (55-52),28,43,65.1,386,3,40,210,5.3,4,83,596,7.2,15,10,0,25,1,10,0,1,1
1760,7,2015-10-24,rutgers,,Ohio State,L (7-49),13,27,48.1,189,1,29,104,3.6,0,56,293,5.2,6,6,0,12,7,55,0,1,1
1761,8,2015-10-31,rutgers,@,Wisconsin,L (10-48),6,20,30.0,82,0,38,83,2.2,0,58,165,2.8,3,5,0,8,6,40,1,1,2
1762,9,2015-11-07,rutgers,@,Michigan,L (16-49),11,27,40.7,97,0,32,128,4.0,0,59,225,3.8,6,7,4,17,7,80,0,1,1
1763,10,2015-11-14,rutgers,,Nebraska,L (14-31),14,28,50.0,170,1,39,89,2.3,1,67,259,3.9,8,7,0,15,4,23,0,2,2
1764,11,2015-11-21,rutgers,@,Army,W (31-21),13,21,61.9,105,0,39,254,6.5,4,60,359,6.0,6,11,1,18,4,35,0,0,0
1765,12,2015-11-28,rutgers,,Maryland,L (41-46),21,33,63.6,344,4,47,186,4.0,1,80,530,6.6,14,8,1,23,9,92,0,1,1
1766,,12 Games,rutgers,,,,202,336,60.1,2485,19,470,2039,4.3,17,806,4524,5.6,112,111,13,236,79,624,6,12,18
1767,1,2016-09-03,rutgers,@,Washington,L (13-48),24,40,60.0,168,0,48,136,2.8,1,88,304,3.5,9,9,3,21,4,35,2,1,3
1768,2,2016-09-10,rutgers,,Howard,W (52-14),11,23,47.8,137,3,52,379,7.3,3,75,516,6.9,8,18,0,26,6,61,0,1,1
1769,3,2016-09-17,rutgers,,New Mexico,W (37-28),12,30,40.0,173,2,32,177,5.5,1,62,350,5.6,7,6,1,14,5,37,1,0,1
1770,4,2016-09-24,rutgers,,Iowa,L (7-14),13,24,54.2,190,1,53,193,3.6,0,77,383,5.0,8,13,0,21,4,50,1,0,1
1771,5,2016-10-01,rutgers,@,Ohio State,L (0-58),3,16,18.8,33,0,38,83,2.2,0,54,116,2.1,2,6,1,9,4,21,0,0,0
1772,6,2016-10-08,rutgers,,Michigan,L (0-78),2,18,11.1,5,0,36,34,0.9,0,54,39,0.7,0,2,0,2,7,41,1,0,1
1773,7,2016-10-15,rutgers,,Illinois,L (7-24),17,30,56.7,182,1,50,203,4.1,0,80,385,4.8,11,11,1,23,4,36,4,1,5
1774,8,2016-10-22,rutgers,@,Minnesota,L (32-34),23,40,57.5,222,3,36,150,4.2,0,76,372,4.9,13,8,1,22,6,30,1,2,3
1775,9,2016-11-05,rutgers,,Indiana,L (27-33),19,36,52.8,258,1,34,93,2.7,1,70,351,5.0,8,5,0,13,8,80,1,0,1
1776,10,2016-11-12,rutgers,@,Michigan State,L (0-49),6,18,33.3,40,0,36,109,3.0,0,54,149,2.8,3,5,0,8,6,50,0,2,2
1777,11,2016-11-19,rutgers,,Penn State,L (0-39),7,17,41.2,48,0,33,39,1.2,0,50,87,1.7,2,3,0,5,6,50,0,0,0
1778,12,2016-11-26,rutgers,@,Maryland,L (13-31),22,40,55.0,203,0,40,147,3.7,2,80,350,4.4,10,10,2,22,3,25,1,0,1
1779,,12 Games,rutgers,,,,159,332,47.9,1659,11,488,1743,3.6,8,820,3402,4.1,81,96,9,186,63,516,12,7,19
1780,1,2017-09-01,rutgers,,Washington,L (14-30),24,35,68.6,178,2,42,131,3.1,0,77,309,4.0,9,9,1,19,4,25,0,2,2
1781,2,2017-09-09,rutgers,,Eastern Michigan,L (13-16),17,38,44.7,198,0,30,128,4.3,1,68,326,4.8,7,5,3,15,9,88,0,2,2
1782,3,2017-09-16,rutgers,,Morgan State,W (65-0),13,19,68.4,152,2,54,326,6.0,7,73,478,6.5,6,15,4,25,8,60,1,0,1
1783,4,2017-09-23,rutgers,@,Nebraska,L (17-27),15,29,51.7,126,0,24,68,2.8,1,53,194,3.7,7,4,1,12,4,35,0,2,2
1784,5,2017-09-30,rutgers,,Ohio State,L (0-56),11,27,40.7,92,0,41,117,2.9,0,68,209,3.1,7,4,2,13,10,80,0,2,2
1785,6,2017-10-14,rutgers,@,Illinois,W (35-24),6,12,50.0,102,0,47,274,5.8,5,59,376,6.4,4,10,3,17,8,75,3,0,3
1786,7,2017-10-21,rutgers,,Purdue,W (14-12),9,18,50.0,87,1,37,130,3.5,1,55,217,3.9,3,5,0,8,4,35,0,0,0
1787,8,2017-10-28,rutgers,@,Michigan,L (14-35),8,16,50.0,101,0,31,94,3.0,2,47,195,4.1,4,4,1,9,3,20,0,0,0
1788,9,2017-11-04,rutgers,N,Maryland,W (31-24),8,18,44.4,107,1,46,239,5.2,2,64,346,5.4,4,16,1,21,6,49,1,1,2
1789,10,2017-11-11,rutgers,@,Penn State,L (6-35),7,20,35.0,43,0,40,175,4.4,0,60,218,3.6,2,8,0,10,4,41,1,0,1
1790,11,2017-11-18,rutgers,@,Indiana,L (0-41),11,24,45.8,103,0,33,87,2.6,0,57,190,3.3,4,6,1,11,6,49,2,0,2
1791,12,2017-11-25,rutgers,,Michigan State,L (7-40),6,19,31.6,98,1,12,14,1.2,0,31,112,3.6,2,1,2,5,5,44,1,2,3
1792,,12 Games,rutgers,,,,135,275,49.1,1387,7,437,1783,4.1,19,712,3170,4.5,59,87,19,165,71,601,9,11,20
1793,1,2018-09-01,rutgers,,Texas State,W (35-7),20,29,69.0,205,1,46,218,4.7,3,75,423,5.6,11,10,2,23,7,50,1,3,4
1794,2,2018-09-08,rutgers,@,Ohio State,L (3-52),11,30,36.7,65,0,31,69,2.2,0,61,134,2.2,4,4,4,12,7,72,0,2,2
1795,3,2018-09-15,rutgers,@,Kansas,L (14-55),14,31,45.2,124,0,33,150,4.5,1,64,274,4.3,6,7,1,14,5,60,3,3,6
1796,4,2018-09-22,rutgers,,Buffalo,L (13-42),18,37,48.6,168,0,38,116,3.1,1,75,284,3.8,7,6,1,14,9,97,0,0,0
1797,5,2018-09-29,rutgers,,Indiana,L (17-24),19,36,52.8,193,1,23,98,4.3,1,59,291,4.9,10,6,3,19,6,63,0,1,1
1798,6,2018-10-06,rutgers,,Illinois,L (17-38),29,46,63.0,267,1,30,119,4.0,1,76,386,5.1,14,8,3,25,10,105,0,3,3
1799,7,2018-10-13,rutgers,@,Maryland,L (7-34),2,17,11.8,8,0,45,171,3.8,1,62,179,2.9,0,11,3,14,4,23,0,5,5
1800,8,2018-10-20,rutgers,,Northwestern,L (15-18),15,31,48.4,81,0,26,107,4.1,1,57,188,3.3,2,7,1,10,7,60,0,0,0
1801,9,2018-11-03,rutgers,@,Wisconsin,L (17-31),20,39,51.3,261,1,26,72,2.8,1,65,333,5.1,10,2,1,13,4,50,0,0,0
1802,10,2018-11-10,rutgers,,Michigan,L (7-42),9,20,45.0,59,0,33,193,5.8,1,53,252,4.8,3,7,1,11,3,30,1,1,2
1803,11,2018-11-17,rutgers,,Penn State,L (7-20),5,16,31.3,46,0,55,188,3.4,1,71,234,3.3,1,13,3,17,5,62,1,2,3
1804,,11 Games,rutgers,,,,162,332,48.8,1477,4,386,1501,3.9,12,718,2978,4.1,68,81,23,172,67,672,6,20,26
1805,1,2014-08-30,oklahoma,,Louisiana Tech,W (48-16),19,34,55.9,253,1,40,183,4.6,5,74,436,5.9,13,11,2,26,3,34,1,1,2
1806,2,2014-09-06,oklahoma,@,Tulsa,W (52-7),24,38,63.2,319,2,31,261,8.4,4,69,580,8.4,14,9,3,26,5,60,0,0,0
1807,3,2014-09-13,oklahoma,,Tennessee,W (34-10),20,33,60.6,308,1,34,146,4.3,2,67,454,6.8,14,7,0,21,5,41,1,1,2
1808,4,2014-09-20,oklahoma,@,West Virginia,W (45-33),17,30,56.7,209,1,46,301,6.5,4,76,510,6.7,10,13,1,24,8,82,0,1,1
1809,5,2014-10-04,oklahoma,@,Texas Christian,L (33-37),14,36,38.9,309,1,42,152,3.6,3,78,461,5.9,8,10,1,19,7,73,0,2,2
1810,6,2014-10-11,oklahoma,N,Texas,W (31-26),12,20,60.0,129,1,30,103,3.4,1,50,232,4.6,6,5,0,11,3,20,0,0,0
1811,7,2014-10-18,oklahoma,,Kansas State,L (30-31),28,36,77.8,335,3,42,198,4.7,1,78,533,6.8,15,14,1,30,3,19,0,2,2
1812,8,2014-11-01,oklahoma,@,Iowa State,W (59-14),23,43,53.5,241,3,59,510,8.6,5,102,751,7.4,11,29,1,41,5,60,0,3,3
1813,9,2014-11-08,oklahoma,,Baylor,L (14-48),13,29,44.8,148,2,33,171,5.2,0,62,319,5.1,5,8,0,13,7,59,0,1,1
1814,10,2014-11-15,oklahoma,@,Texas Tech,W (42-30),10,20,50.0,133,1,51,384,7.5,5,71,517,7.3,6,18,1,25,9,67,0,3,3
1815,11,2014-11-22,oklahoma,,Kansas,W (44-7),3,13,23.1,39,0,55,510,9.3,5,68,549,8.1,3,15,1,19,4,25,2,0,2
1816,12,2014-12-06,oklahoma,,Oklahoma State,L (35-38),10,17,58.8,120,1,63,304,4.8,4,80,424,5.3,7,11,3,21,3,28,1,0,1
1817,13,2014-12-29,oklahoma,N,Clemson*,L (6-40),17,37,45.9,103,0,31,172,5.5,1,68,275,4.0,6,11,0,17,8,80,2,3,5
1818,,13 Games,oklahoma,,,,210,386,54.4,2646,17,557,3395,6.1,40,943,6041,6.4,118,161,14,293,70,648,7,17,24
1819,1,2015-09-05,oklahoma,,Akron,W (41-3),28,42,66.7,439,3,33,100,3.0,2,75,539,7.2,18,5,3,26,9,90,1,1,2
1820,2,2015-09-12,oklahoma,@,Tennessee,W (31-24),19,39,48.7,187,3,48,161,3.4,1,87,348,4.0,7,9,4,20,9,67,0,2,2
1821,3,2015-09-19,oklahoma,,Tulsa,W (52-38),32,38,84.2,487,4,47,286,6.1,3,85,773,9.1,22,14,3,39,8,85,2,0,2
1822,4,2015-10-03,oklahoma,,West Virginia,W (44-24),14,25,56.0,320,3,33,107,3.2,1,58,427,7.4,11,3,2,16,12,134,1,1,2
1823,5,2015-10-10,oklahoma,N,Texas,L (17-24),20,28,71.4,211,1,37,67,1.8,1,65,278,4.3,12,6,3,21,5,45,1,0,1
1824,6,2015-10-17,oklahoma,@,Kansas State,W (55-0),25,32,78.1,336,5,52,232,4.5,1,84,568,6.8,18,12,0,30,3,24,0,0,0
1825,7,2015-10-24,oklahoma,,Texas Tech,W (63-27),15,22,68.2,212,2,57,405,7.1,7,79,617,7.8,9,24,2,35,3,34,1,1,2
1826,8,2015-10-31,oklahoma,@,Kansas,W (62-7),33,41,80.5,445,5,41,265,6.5,3,82,710,8.7,19,11,5,35,4,40,2,0,2
1827,9,2015-11-07,oklahoma,,Iowa State,W (52-16),25,33,75.8,405,4,39,279,7.2,3,72,684,9.5,14,13,1,28,2,10,1,0,1
1828,10,2015-11-14,oklahoma,@,Baylor,W (44-34),24,34,70.6,270,3,53,241,4.5,3,87,511,5.9,13,12,3,28,8,83,0,1,1
1829,11,2015-11-21,oklahoma,,Texas Christian,W (30-29),14,37,37.8,203,2,59,333,5.6,1,96,536,5.6,10,17,1,28,8,90,0,1,1
1830,12,2015-11-28,oklahoma,@,Oklahoma State,W (58-23),17,25,68.0,180,2,42,344,8.2,5,67,524,7.8,11,11,1,23,4,33,0,0,0
1831,13,2015-12-31,oklahoma,N,Clemson*,L (17-37),26,43,60.5,311,1,33,67,2.0,1,76,378,5.0,16,6,2,24,5,65,0,2,2
1832,,13 Games,oklahoma,,,,292,439,66.5,4006,38,574,2887,5.0,32,1013,6893,6.8,180,143,30,353,80,800,9,9,18
1833,1,2016-09-03,oklahoma,N,Houston,L (23-33),24,34,70.6,323,2,26,70,2.7,1,60,393,6.6,11,5,1,17,5,66,2,0,2
1834,2,2016-09-10,oklahoma,,Louisiana-Monroe,W (59-17),26,35,74.3,352,5,46,288,6.3,3,81,640,7.9,18,11,1,30,4,30,1,0,1
1835,3,2016-09-17,oklahoma,,Ohio State,L (24-45),17,32,53.1,226,2,35,178,5.1,0,67,404,6.0,9,9,1,19,4,28,0,2,2
1836,4,2016-10-01,oklahoma,@,Texas Christian,W (52-46),23,30,76.7,274,2,48,260,5.4,5,78,534,6.8,11,10,2,23,5,54,2,0,2
1837,5,2016-10-08,oklahoma,N,Texas,W (45-40),22,31,71.0,390,3,55,282,5.1,3,86,672,7.8,14,14,0,28,5,55,2,2,4
1838,6,2016-10-15,oklahoma,,Kansas State,W (38-17),26,32,81.3,372,5,33,138,4.2,0,65,510,7.8,15,9,0,24,3,35,0,1,1
1839,7,2016-10-22,oklahoma,@,Texas Tech,W (66-59),27,36,75.0,545,7,40,309,7.7,2,76,854,11.2,21,12,0,33,6,60,0,0,0
1840,8,2016-10-29,oklahoma,,Kansas,W (56-3),20,33,60.6,271,4,38,267,7.0,2,71,538,7.6,14,9,1,24,6,45,1,0,1
1841,9,2016-11-03,oklahoma,@,Iowa State,W (34-24),25,34,73.5,328,4,42,149,3.5,0,76,477,6.3,16,11,1,28,5,50,0,1,1
1842,10,2016-11-12,oklahoma,,Baylor,W (45-24),20,25,80.0,300,2,50,253,5.1,4,75,553,7.4,14,9,0,23,3,30,0,1,1
1843,11,2016-11-19,oklahoma,@,West Virginia,W (56-28),9,15,60.0,169,2,64,316,4.9,5,79,485,6.1,7,15,5,27,6,72,0,1,1
1844,12,2016-12-03,oklahoma,,Oklahoma State,W (38-20),13,19,68.4,288,3,52,341,6.6,2,71,629,8.9,12,11,2,25,4,54,1,0,1
1845,13,2017-01-02,oklahoma,N,Auburn*,W (35-19),19,28,67.9,296,2,43,228,5.3,3,71,524,7.4,14,11,3,28,10,100,0,0,0
1846,,13 Games,oklahoma,,,,271,384,70.6,4134,43,572,3079,5.4,30,956,7213,7.5,176,136,17,329,66,679,9,8,17
1847,1,2017-09-02,oklahoma,,Texas-El Paso,W (56-7),32,36,88.9,496,4,38,180,4.7,4,74,676,9.1,23,14,1,35,5,60,0,0,0
1848,2,2017-09-09,oklahoma,@,Ohio State,W (31-16),27,35,77.1,386,3,37,104,2.8,1,72,490,6.8,17,6,4,27,3,26,2,0,2
1849,3,2017-09-16,oklahoma,,Tulane,W (56-14),20,30,66.7,434,5,32,197,6.2,2,62,631,10.2,15,8,1,24,4,37,2,0,2
1850,4,2017-09-23,oklahoma,@,Baylor,W (49-41),13,19,68.4,283,3,40,342,8.6,4,59,625,10.6,8,12,0,20,10,105,1,0,1
1851,5,2017-10-07,oklahoma,,Iowa State,L (31-38),25,34,73.5,323,2,35,190,5.4,2,69,513,7.4,18,10,0,28,6,59,1,0,1
1852,6,2017-10-14,oklahoma,N,Texas,W (29-24),18,28,64.3,344,2,39,174,4.5,1,67,518,7.7,8,12,0,20,8,81,0,1,1
1853,7,2017-10-21,oklahoma,@,Kansas State,W (42-35),32,41,78.0,410,2,38,209,5.5,3,79,619,7.8,18,10,0,28,5,37,1,1,2
1854,8,2017-10-28,oklahoma,,Texas Tech,W (49-27),22,34,64.7,281,4,47,336,7.1,3,81,617,7.6,15,14,2,31,7,94,0,1,1
1855,9,2017-11-04,oklahoma,@,Oklahoma State,W (62-52),24,36,66.7,598,5,40,187,4.7,3,76,785,10.3,19,10,1,30,9,81,0,2,2
1856,10,2017-11-11,oklahoma,,Texas Christian,W (38-20),18,27,66.7,333,3,41,200,4.9,2,68,533,7.8,12,8,1,21,4,29,0,0,0
1857,11,2017-11-18,oklahoma,@,Kansas,W (41-3),23,35,65.7,312,3,36,157,4.4,2,71,469,6.6,15,6,3,24,8,63,0,0,0
1858,12,2017-11-25,oklahoma,,West Virginia,W (59-31),16,19,84.2,333,4,35,313,8.9,4,54,646,12.0,13,12,2,27,9,102,0,0,0
1859,13,2017-12-02,oklahoma,N,Texas Christian,W (41-17),15,23,65.2,243,4,43,218,5.1,0,66,461,7.0,10,10,2,22,3,30,0,0,0
1860,14,2018-01-01,oklahoma,N,Georgia*,L (48-54),24,36,66.7,289,3,45,242,5.4,2,81,531,6.6,11,11,2,24,1,5,0,1,1
1861,,14 Games,oklahoma,,,,309,433,71.4,5065,47,546,3049,5.6,33,979,8114,8.3,202,143,19,361,82,809,7,6,13
1862,1,2018-09-01,oklahoma,,Florida Atlantic,W (63-14),19,23,82.6,334,3,39,316,8.1,5,62,650,10.5,13,12,1,26,6,70,0,0,0
1863,2,2018-09-08,oklahoma,,UCLA,W (49-21),19,35,54.3,306,3,35,179,5.1,4,70,485,6.9,14,9,4,27,6,40,0,1,1
1864,3,2018-09-15,oklahoma,@,Iowa State,W (37-27),21,29,72.4,348,3,39,171,4.4,1,68,519,7.6,13,10,1,24,5,60,1,0,1
1865,4,2018-09-22,oklahoma,,Army,W (28-21),11,15,73.3,165,3,25,190,7.6,1,40,355,8.9,8,10,1,19,4,20,0,1,1
1866,5,2018-09-29,oklahoma,,Baylor,W (66-33),17,23,73.9,432,6,31,175,5.6,3,54,607,11.2,12,8,2,22,7,80,0,0,0
1867,6,2018-10-06,oklahoma,N,Texas,L (45-48),20,27,74.1,310,4,31,222,7.2,2,58,532,9.2,12,9,0,21,7,73,2,1,3
1868,7,2018-10-20,oklahoma,@,Texas Christian,W (52-27),19,25,76.0,213,4,47,323,6.9,3,72,536,7.4,11,15,0,26,8,60,0,0,0
1869,8,2018-10-27,oklahoma,,Kansas State,W (51-14),22,29,75.9,380,3,39,322,8.3,3,68,702,10.3,15,15,2,32,5,69,0,0,0
1870,9,2018-11-03,oklahoma,@,Texas Tech,W (51-46),20,35,57.1,360,3,44,323,7.3,4,79,683,8.6,15,16,1,32,10,113,0,2,2
1871,10,2018-11-10,oklahoma,,Oklahoma State,W (48-47),21,30,70.0,349,1,47,353,7.5,5,77,702,9.1,15,14,0,29,8,70,0,0,0
1872,11,2018-11-17,oklahoma,,Kansas,W (55-40),21,32,65.6,272,2,38,296,7.8,5,70,568,8.1,15,14,2,31,2,25,1,1,2
1873,,11 Games,oklahoma,,,,210,303,69.3,3469,35,415,2870,6.9,36,718,6339,8.8,143,132,14,289,68,680,4,6,10
1874,1,2014-08-30,texas,,North Texas,W (38-7),19,34,55.9,190,1,40,163,4.1,3,74,353,4.8,10,6,2,18,7,65,2,0,2
1875,2,2014-09-06,texas,,Brigham Young,L (7-41),20,31,64.5,176,1,35,82,2.3,0,66,258,3.9,9,6,0,15,6,64,3,1,4
1876,3,2014-09-13,texas,N,UCLA,L (17-20),24,34,70.6,196,2,30,126,4.2,0,64,322,5.0,8,6,0,14,7,50,0,0,0
1877,4,2014-09-27,texas,@,Kansas,W (23-0),19,34,55.9,218,2,36,111,3.1,1,70,329,4.7,9,8,2,19,6,46,1,0,1
1878,5,2014-10-04,texas,,Baylor,L (7-28),16,34,47.1,144,0,40,190,4.8,1,74,334,4.5,6,9,5,20,5,45,1,2,3
1879,6,2014-10-11,texas,N,Oklahoma,L (26-31),27,44,61.4,334,2,40,148,3.7,1,84,482,5.7,12,12,0,24,11,85,0,1,1
1880,7,2014-10-18,texas,,Iowa State,W (48-45),24,36,66.7,321,1,39,191,4.9,4,75,512,6.8,13,11,3,27,4,33,1,1,2
1881,8,2014-10-25,texas,@,Kansas State,L (0-23),13,25,52.0,106,0,27,90,3.3,0,52,196,3.8,6,6,0,12,7,66,1,0,1
1882,9,2014-11-01,texas,@,Texas Tech,W (34-13),13,25,52.0,228,1,51,241,4.7,3,76,469,6.2,7,13,1,21,5,50,2,0,2
1883,10,2014-11-08,texas,,West Virginia,W (33-16),11,29,37.9,124,1,39,227,5.8,3,68,351,5.2,7,10,2,19,5,60,0,1,1
1884,11,2014-11-15,texas,@,Oklahoma State,W (28-7),24,33,72.7,305,2,43,125,2.9,1,76,430,5.7,15,7,2,24,6,49,0,0,0
1885,12,2014-11-27,texas,,Texas Christian,L (10-48),20,34,58.8,200,1,36,90,2.5,0,70,290,4.1,7,5,0,12,3,17,2,4,6
1886,13,2014-12-29,texas,N,Arkansas*,L (7-31),13,25,52.0,57,0,18,2,0.1,1,43,59,1.4,6,1,0,7,5,34,1,1,2
1887,,13 Games,texas,,,,243,418,58.1,2599,14,474,1786,3.8,18,892,4385,4.9,115,100,17,232,77,664,14,11,25
1888,1,2015-09-05,texas,@,Notre Dame,L (3-38),8,23,34.8,103,0,29,60,2.1,0,52,163,3.1,5,2,1,8,4,50,0,0,0
1889,2,2015-09-12,texas,,Rice,W (42-28),5,10,50.0,128,2,28,149,5.3,2,38,277,7.3,4,7,0,11,4,42,1,0,1
1890,3,2015-09-19,texas,,California,L (44-45),20,31,64.5,364,0,52,286,5.5,6,83,650,7.8,13,12,3,28,10,93,1,1,2
1891,4,2015-09-26,texas,,Oklahoma State,L (27-30),9,17,52.9,119,0,42,171,4.1,1,59,290,4.9,3,8,0,11,16,128,0,1,1
1892,5,2015-10-03,texas,@,Texas Christian,L (7-50),13,28,46.4,122,1,51,191,3.7,0,79,313,4.0,5,13,2,20,4,40,1,0,1
1893,6,2015-10-10,texas,N,Oklahoma,W (24-17),9,12,75.0,55,2,58,313,5.4,1,70,368,5.3,4,15,1,20,5,67,0,0,0
1894,7,2015-10-24,texas,,Kansas State,W (23-9),10,16,62.5,99,0,53,274,5.2,3,69,373,5.4,5,15,0,20,3,35,0,0,0
1895,8,2015-10-31,texas,@,Iowa State,L (0-24),12,22,54.5,85,0,32,119,3.7,0,54,204,3.8,4,7,0,11,3,39,0,1,1
1896,9,2015-11-07,texas,,Kansas,W (59-20),19,30,63.3,299,2,40,299,7.5,6,70,598,8.5,11,9,0,20,6,36,1,0,1
1897,10,2015-11-14,texas,@,West Virginia,L (20-38),11,19,57.9,162,1,54,277,5.1,1,73,439,6.0,7,12,0,19,7,55,3,2,5
1898,11,2015-11-26,texas,,Texas Tech,L (45-48),11,23,47.8,64,0,48,403,8.4,6,71,467,6.6,1,16,2,19,8,64,1,1,2
1899,12,2015-12-05,texas,@,Baylor,W (23-17),12,21,57.1,151,1,42,156,3.7,1,63,307,4.9,7,7,1,15,7,60,0,0,0
1900,,12 Games,texas,,,,139,252,55.2,1751,9,529,2698,5.1,27,781,4449,5.7,69,123,10,202,77,709,8,6,14
1901,1,2016-09-04,texas,,Notre Dame,W (50-47),16,27,59.3,280,2,59,237,4.0,5,86,517,6.0,10,14,2,26,11,104,0,1,1
1902,2,2016-09-10,texas,,Texas-El Paso,W (41-7),23,28,82.1,245,4,47,171,3.6,1,75,416,5.5,10,11,2,23,10,115,1,0,1
1903,3,2016-09-17,texas,@,California,L (43-50),23,39,59.0,261,1,51,307,6.0,4,90,568,6.3,11,19,4,34,7,50,0,2,2
1904,4,2016-10-01,texas,@,Oklahoma State,L (31-49),21,33,63.6,239,1,49,329,6.7,4,82,568,6.9,8,16,2,26,5,39,0,1,1
1905,5,2016-10-08,texas,N,Oklahoma,L (40-45),19,36,52.8,245,3,46,180,3.9,2,82,425,5.2,10,10,3,23,2,10,1,1,2
1906,6,2016-10-15,texas,,Iowa State,W (27-6),26,38,68.4,296,2,47,209,4.4,1,85,505,5.9,12,14,2,28,9,100,1,1,2
1907,7,2016-10-22,texas,@,Kansas State,L (21-24),17,24,70.8,222,2,36,133,3.7,1,60,355,5.9,9,8,3,20,10,72,0,0,0
1908,8,2016-10-29,texas,,Baylor,W (35-34),12,21,57.1,291,2,51,257,5.0,2,72,548,7.6,8,11,0,19,4,23,1,1,2
1909,9,2016-11-05,texas,@,Texas Tech,W (45-37),20,40,50.0,244,2,50,414,8.3,4,90,658,7.3,13,16,0,29,9,99,2,0,2
1910,10,2016-11-12,texas,,West Virginia,L (20-24),31,50,62.0,318,1,50,218,4.4,1,100,536,5.4,15,16,1,33,5,50,2,1,3
1911,11,2016-11-19,texas,@,Kansas,L (21-24),17,27,63.0,165,1,63,238,3.8,2,90,403,4.5,5,15,2,22,7,65,3,3,6
1912,12,2016-11-25,texas,,Texas Christian,L (9-31),16,39,41.0,218,0,46,189,4.1,0,85,407,4.8,11,7,1,19,6,42,0,1,1
1913,,12 Games,texas,,,,241,402,60.0,3024,21,595,2882,4.8,27,997,5906,5.9,122,157,22,302,85,769,11,12,23
1914,1,2017-09-02,texas,,Maryland,L (41-51),34,53,64.2,375,2,31,98,3.2,1,84,473,5.6,19,8,2,26,11,117,1,1,2
1915,2,2017-09-09,texas,,San Jose State,W (56-0),16,29,55.2,217,1,59,406,6.9,6,88,623,7.1,10,21,1,32,6,68,0,0,0
1916,3,2017-09-16,texas,@,Southern California,L (24-27),21,40,52.5,298,2,35,68,1.9,0,75,366,4.9,13,3,1,17,10,73,2,2,4
1917,4,2017-09-28,texas,@,Iowa State,W (17-7),19,26,73.1,171,1,52,141,2.7,1,78,312,4.0,7,10,2,19,10,76,1,1,2
1918,5,2017-10-07,texas,,Kansas State,W (40-34),30,51,58.8,380,2,40,166,4.2,3,91,546,6.0,21,10,1,32,3,30,0,1,1
1919,6,2017-10-14,texas,N,Oklahoma,L (24-29),21,41,51.2,289,1,39,139,3.6,2,80,428,5.4,13,7,3,23,5,33,0,0,0
1920,7,2017-10-21,texas,,Oklahoma State,L (10-13),22,36,61.1,241,0,33,42,1.3,1,69,283,4.1,5,7,1,13,8,73,0,1,1
1921,8,2017-10-28,texas,@,Baylor,W (38-7),27,36,75.0,256,1,35,171,4.9,3,71,427,6.0,11,8,0,19,7,72,0,1,1
1922,9,2017-11-04,texas,@,Texas Christian,L (7-24),21,44,47.7,254,1,26,9,0.3,0,70,263,3.8,10,3,1,14,6,65,0,0,0
1923,10,2017-11-11,texas,,Kansas,W (42-27),24,34,70.6,258,2,40,113,2.8,3,74,371,5.0,9,8,1,18,8,68,1,1,2
1924,11,2017-11-18,texas,@,West Virginia,W (28-14),17,27,63.0,187,2,42,233,5.5,2,69,420,6.1,7,10,1,18,6,75,0,1,1
1925,12,2017-11-24,texas,,Texas Tech,L (23-27),29,51,56.9,272,1,33,116,3.5,1,84,388,4.6,11,6,1,18,5,37,2,2,4
1926,13,2017-12-27,texas,N,Missouri*,W (33-16),17,29,58.6,167,2,41,118,2.9,1,70,285,4.1,7,6,4,17,7,82,0,0,0
1927,,13 Games,texas,,,,298,497,60.0,3365,18,506,1820,3.6,24,1003,5185,5.2,143,107,19,266,92,869,7,11,18
1928,1,2018-09-01,texas,N,Maryland,L (29-34),21,39,53.8,263,2,36,142,3.9,2,75,405,5.4,10,9,1,20,10,102,1,2,3
1929,2,2018-09-08,texas,,Tulsa,W (28-21),21,27,77.8,237,2,47,241,5.1,2,74,478,6.5,9,12,3,24,8,65,1,0,1
1930,3,2018-09-15,texas,,Southern California,W (37-14),16,34,47.1,234,2,48,160,3.3,1,82,394,4.8,11,10,4,25,7,86,1,0,1
1931,4,2018-09-22,texas,,Texas Christian,W (31-16),22,32,68.8,255,2,45,112,2.5,2,77,367,4.8,14,6,0,20,4,25,0,0,0
1932,5,2018-09-29,texas,@,Kansas State,W (19-14),30,38,78.9,228,1,27,115,4.3,0,65,343,5.3,14,8,0,22,10,104,0,0,0
1933,6,2018-10-06,texas,N,Oklahoma,W (48-45),26,37,70.3,324,3,38,177,4.7,3,75,501,6.7,15,9,3,27,6,43,0,0,0
1934,7,2018-10-13,texas,,Baylor,W (23-17),24,39,61.5,219,1,41,170,4.1,1,80,389,4.9,13,9,3,25,8,56,0,1,1
1935,8,2018-10-27,texas,@,Oklahoma State,L (35-38),22,42,52.4,283,2,30,119,4.0,3,72,402,5.6,13,8,3,24,11,86,0,0,0
1936,9,2018-11-03,texas,,West Virginia,L (41-42),25,36,69.4,354,3,39,166,4.3,2,75,520,6.9,15,11,2,28,7,64,1,0,1
1937,10,2018-11-10,texas,@,Texas Tech,W (41-34),22,34,64.7,312,4,48,157,3.3,1,82,469,5.7,15,10,3,28,6,59,0,0,0
1938,11,2018-11-17,texas,,Iowa State,W (24-10),22,25,88.0,226,2,46,179,3.9,1,71,405,5.7,10,10,0,20,3,25,1,0,1
1939,,11 Games,texas,,,,251,383,65.5,2935,24,445,1738,3.9,18,828,4673,5.6,139,102,22,263,80,715,5,3,8
1940,1,2014-08-30,texas-christian,,Samford,W (48-14),33,50,66.0,355,3,46,200,4.3,3,96,555,5.8,17,15,1,33,4,60,1,1,2
1941,2,2014-09-13,texas-christian,,Minnesota,W (30-7),27,46,58.7,258,2,27,169,6.3,1,73,427,5.8,13,8,1,22,8,72,1,1,2
1942,3,2014-09-27,texas-christian,@,Southern Methodist,W (56-0),28,43,65.1,349,5,38,265,7.0,3,81,614,7.6,18,12,1,31,5,48,0,0,0
1943,4,2014-10-04,texas-christian,,Oklahoma,W (37-33),20,39,51.3,318,2,39,151,3.9,2,78,469,6.0,12,8,3,23,12,90,2,1,3
1944,5,2014-10-11,texas-christian,@,Baylor,L (58-61),22,48,45.8,346,1,41,139,3.4,4,89,485,5.4,12,7,4,23,8,110,1,0,1
1945,6,2014-10-18,texas-christian,,Oklahoma State,W (42-9),27,42,64.3,415,3,40,261,6.5,3,82,676,8.2,12,13,1,26,5,45,0,1,1
1946,7,2014-10-25,texas-christian,,Texas Tech,W (82-27),27,45,60.0,480,7,41,305,7.4,3,86,785,9.1,16,13,3,32,10,77,0,0,0
1947,8,2014-11-01,texas-christian,@,West Virginia,W (31-30),12,30,40.0,166,1,42,223,5.3,3,72,389,5.4,5,11,0,16,5,40,1,1,2
1948,9,2014-11-08,texas-christian,,Kansas State,W (41-20),23,34,67.6,219,1,48,334,7.0,4,82,553,6.7,12,14,2,28,4,35,0,0,0
1949,10,2014-11-15,texas-christian,@,Kansas,W (34-30),26,36,72.2,330,1,36,133,3.7,2,72,463,6.4,13,10,1,24,5,40,2,1,3
1950,11,2014-11-27,texas-christian,@,Texas,W (48-10),20,34,58.8,233,2,31,135,4.4,2,65,368,5.7,10,5,1,16,6,45,1,1,2
1951,12,2014-12-06,texas-christian,,Iowa State,W (55-3),33,45,73.3,525,5,38,197,5.2,1,83,722,8.7,20,12,1,33,5,50,1,1,2
1952,13,2014-12-31,texas-christian,N,Mississippi*,W (42-3),27,37,73.0,246,4,42,177,4.2,1,79,423,5.4,13,11,0,24,5,55,1,3,4
1953,,13 Games,texas-christian,,,,325,529,61.4,4240,37,509,2689,5.3,32,1038,6929,6.7,173,139,19,331,82,767,11,11,22
1954,1,2015-09-03,texas-christian,@,Minnesota,W (23-17),26,42,61.9,246,1,44,203,4.6,1,86,449,5.2,13,10,2,25,9,50,1,1,2
1955,2,2015-09-12,texas-christian,,Stephen F. Austin,W (70-7),26,37,70.3,403,5,45,224,5.0,4,82,627,7.6,14,16,0,30,3,43,0,1,1
1956,3,2015-09-19,texas-christian,,Southern Methodist,W (56-37),21,30,70.0,454,5,41,266,6.5,3,71,720,10.1,16,12,0,28,9,115,0,1,1
1957,4,2015-09-26,texas-christian,@,Texas Tech,W (55-52),35,56,62.5,503,4,47,247,5.3,3,103,750,7.3,24,13,1,38,10,110,0,0,0
1958,5,2015-10-03,texas-christian,,Texas,W (50-7),22,38,57.9,376,6,42,228,5.4,0,80,604,7.6,18,12,1,31,8,84,0,0,0
1959,6,2015-10-10,texas-christian,@,Kansas State,W (52-45),20,30,66.7,301,2,23,242,10.5,4,53,543,10.2,13,7,2,22,11,81,0,2,2
1960,7,2015-10-17,texas-christian,@,Iowa State,W (45-21),28,34,82.4,444,4,41,177,4.3,2,75,621,8.3,20,7,3,30,7,75,1,0,1
1961,8,2015-10-29,texas-christian,,West Virginia,W (40-10),32,48,66.7,388,3,40,228,5.7,1,88,616,7.0,18,12,5,35,9,100,0,0,0
1962,9,2015-11-07,texas-christian,@,Oklahoma State,L (29-49),35,58,60.3,445,1,52,218,4.2,3,110,663,6.0,21,12,3,36,7,70,0,4,4
1963,10,2015-11-14,texas-christian,,Kansas,W (23-17),19,34,55.9,208,1,58,279,4.8,0,92,487,5.3,9,15,1,25,3,27,0,1,1
1964,11,2015-11-21,texas-christian,@,Oklahoma,L (29-30),13,29,44.8,229,3,36,161,4.5,1,65,390,6.0,5,9,2,16,2,19,1,3,4
1965,12,2015-11-27,texas-christian,,Baylor,W (28-21),18,33,54.5,148,2,46,154,3.3,1,79,302,3.8,5,8,2,15,8,65,1,1,2
1966,13,2016-01-02,texas-christian,N,Oregon*,W (47-41),30,47,63.8,371,2,47,174,3.7,3,94,545,5.8,14,12,1,27,8,83,0,1,1
1967,,13 Games,texas-christian,,,,325,516,63.0,4516,39,562,2801,5.0,26,1078,7317,6.8,190,145,23,358,94,922,4,15,19
1968,1,2016-09-03,texas-christian,,South Dakota State,W (59-41),33,50,66.0,439,2,37,223,6.0,5,87,662,7.6,22,11,2,35,12,125,0,2,2
1969,2,2016-09-10,texas-christian,,Arkansas,L (38-41),36,58,62.1,377,1,32,195,6.1,4,90,572,6.4,19,6,0,25,9,95,1,1,2
1970,3,2016-09-17,texas-christian,,Iowa State,W (41-20),22,35,62.9,252,1,37,229,6.2,4,72,481,6.7,12,8,2,22,5,50,0,0,0
1971,4,2016-09-23,texas-christian,@,Southern Methodist,W (33-3),32,47,68.1,452,2,31,137,4.4,1,78,589,7.6,16,8,1,25,8,65,0,1,1
1972,5,2016-10-01,texas-christian,,Oklahoma,L (46-52),26,45,57.8,449,5,29,65,2.2,1,74,514,6.9,14,4,1,19,9,64,0,1,1
1973,6,2016-10-08,texas-christian,@,Kansas,W (24-23),17,32,53.1,206,1,34,160,4.7,2,66,366,5.5,7,9,2,18,7,79,1,3,4
1974,7,2016-10-22,texas-christian,@,West Virginia,L (10-34),18,31,58.1,148,1,29,152,5.2,0,60,300,5.0,6,11,1,18,10,67,2,1,3
1975,8,2016-10-29,texas-christian,,Texas Tech,L (24-27),22,47,46.8,246,1,39,172,4.4,2,86,418,4.9,14,11,0,25,4,25,0,1,1
1976,9,2016-11-05,texas-christian,@,Baylor,W (62-22),18,31,58.1,257,1,59,431,7.3,6,90,688,7.6,9,21,4,34,7,55,0,0,0
1977,10,2016-11-19,texas-christian,,Oklahoma State,L (6-31),20,33,60.6,198,1,39,145,3.7,0,72,343,4.8,9,7,2,18,4,49,0,2,2
1978,11,2016-11-25,texas-christian,@,Texas,W (31-9),16,30,53.3,178,0,46,309,6.7,4,76,487,6.4,10,13,2,25,7,68,0,1,1
1979,12,2016-12-03,texas-christian,,Kansas State,L (6-30),17,36,47.2,138,0,37,142,3.8,0,73,280,3.8,5,8,2,15,4,45,0,1,1
1980,13,2016-12-30,texas-christian,N,Georgia*,L (23-31),18,28,64.3,146,2,39,175,4.5,1,67,321,4.8,7,8,2,17,2,10,2,0,2
1981,,13 Games,texas-christian,,,,295,503,58.6,3486,18,488,2535,5.2,30,991,6021,6.1,150,125,21,296,88,797,6,14,20
1982,1,2017-09-02,texas-christian,,Jackson State,W (63-0),23,30,76.7,300,6,36,242,6.7,1,66,542,8.2,11,13,0,24,5,51,0,1,1
1983,2,2017-09-09,texas-christian,@,Arkansas,W (28-7),21,31,67.7,166,0,42,195,4.6,4,73,361,4.9,8,15,1,24,6,60,1,1,2
1984,3,2017-09-16,texas-christian,,Southern Methodist,W (56-36),24,30,80.0,365,4,49,254,5.2,3,79,619,7.8,16,13,1,30,11,94,3,0,3
1985,4,2017-09-23,texas-christian,@,Oklahoma State,W (44-31),22,33,66.7,228,1,52,238,4.6,4,85,466,5.5,12,14,6,32,4,23,0,1,1
1986,5,2017-10-07,texas-christian,,West Virginia,W (31-24),16,29,55.2,236,2,36,170,4.7,2,65,406,6.2,9,7,0,16,5,51,0,0,0
1987,6,2017-10-14,texas-christian,@,Kansas State,W (26-6),27,37,73.0,297,0,36,98,2.7,3,73,395,5.4,11,5,1,17,7,51,1,0,1
1988,7,2017-10-21,texas-christian,,Kansas,W (43-0),20,28,71.4,284,5,42,191,4.5,0,70,475,6.8,11,10,1,22,7,55,0,0,0
1989,8,2017-10-28,texas-christian,@,Iowa State,L (7-14),12,25,48.0,135,0,34,172,5.1,0,59,307,5.2,7,6,1,14,11,104,1,2,3
1990,9,2017-11-04,texas-christian,,Texas,W (24-7),19,27,70.4,166,0,46,177,3.8,3,73,343,4.7,7,8,2,17,9,49,0,0,0
1991,10,2017-11-11,texas-christian,@,Oklahoma,L (20-38),14,29,48.3,269,1,32,155,4.8,2,61,424,7.0,7,10,2,19,7,60,0,0,0
1992,11,2017-11-18,texas-christian,@,Texas Tech,W (27-3),6,17,35.3,85,1,42,204,4.9,1,59,289,4.9,4,10,3,17,6,55,1,0,1
1993,12,2017-11-24,texas-christian,,Baylor,W (45-22),26,36,72.2,325,3,36,112,3.1,3,72,437,6.1,13,9,3,25,3,23,0,0,0
1994,13,2017-12-02,texas-christian,N,Oklahoma,L (17-41),27,37,73.0,234,2,24,83,3.5,0,61,317,5.2,14,5,1,20,7,70,1,1,2
1995,14,2017-12-28,texas-christian,N,Stanford*,W (39-37),28,41,68.3,341,3,26,147,5.7,1,67,488,7.3,13,8,0,21,1,4,1,2,3
1996,,14 Games,texas-christian,,,,285,430,66.3,3431,28,533,2438,4.6,27,963,5869,6.1,143,133,22,298,89,750,9,8,17
1997,1,2018-09-01,texas-christian,,Southern,W (55-7),21,32,65.6,264,4,42,235,5.6,2,74,499,6.7,16,12,2,30,5,48,0,0,0
1998,2,2018-09-07,texas-christian,@,Southern Methodist,W (42-12),15,28,53.6,146,1,42,247,5.9,3,70,393,5.6,5,17,1,23,4,35,1,1,2
1999,3,2018-09-15,texas-christian,N,Ohio State,L (28-40),24,40,60.0,308,1,36,203,5.6,3,76,511,6.7,13,8,1,22,5,40,1,2,3
2000,4,2018-09-22,texas-christian,@,Texas,L (16-31),20,39,51.3,231,1,32,141,4.4,0,71,372,5.2,9,7,0,16,3,30,1,3,4
2001,5,2018-09-29,texas-christian,,Iowa State,W (17-14),21,29,72.4,182,1,46,117,2.5,0,75,299,4.0,10,9,0,19,5,55,2,1,3
2002,6,2018-10-11,texas-christian,,Texas Tech,L (14-17),26,45,57.8,290,2,32,121,3.8,0,77,411,5.3,12,6,2,20,8,63,1,2,3
2003,7,2018-10-20,texas-christian,,Oklahoma,L (27-52),10,25,40.0,163,2,30,112,3.7,0,55,275,5.0,6,5,1,12,2,10,0,1,1
2004,8,2018-10-27,texas-christian,@,Kansas,L (26-27),23,33,69.7,351,1,39,153,3.9,2,72,504,7.0,17,7,3,27,5,57,1,1,2
2005,9,2018-11-03,texas-christian,,Kansas State,W (14-13),17,33,51.5,218,1,26,57,2.2,1,59,275,4.7,8,5,0,13,2,15,1,0,1
2006,10,2018-11-10,texas-christian,@,West Virginia,L (10-47),22,37,59.5,229,1,24,-7,-0.3,0,61,222,3.6,9,3,0,12,2,15,2,0,2
2007,11,2018-11-17,texas-christian,@,Baylor,W (16-9),15,21,71.4,151,1,42,160,3.8,1,63,311,4.9,4,10,0,14,8,80,0,0,0
2008,,11 Games,texas-christian,,,,214,362,59.1,2533,16,391,1539,3.9,12,753,4072,5.4,109,89,10,208,49,448,10,11,21
2009,1,2014-08-30,kansas-state,,Stephen F. Austin,W (55-16),20,30,66.7,238,3,51,240,4.7,4,81,478,5.9,13,16,0,29,3,15,0,1,1
2010,2,2014-09-06,kansas-state,@,Iowa State,W (32-28),16,29,55.2,239,0,41,232,5.7,4,70,471,6.7,9,12,3,24,10,77,0,0,0
2011,3,2014-09-18,kansas-state,,Auburn,L (14-20),24,40,60.0,245,0,30,40,1.3,2,70,285,4.1,13,4,3,20,0,0,1,2,3
2012,4,2014-09-27,kansas-state,,Texas-El Paso,W (58-28),13,19,68.4,263,1,37,188,5.1,6,56,451,8.1,9,7,0,16,6,55,1,0,1
2013,5,2014-10-04,kansas-state,,Texas Tech,W (45-13),24,31,77.4,290,4,50,245,4.9,2,81,535,6.6,13,12,4,29,1,15,1,0,1
2014,6,2014-10-18,kansas-state,@,Oklahoma,W (31-30),15,23,65.2,225,2,32,160,5.0,1,55,385,7.0,8,9,0,17,2,20,0,0,0
2015,7,2014-10-25,kansas-state,,Texas,W (23-0),19,30,63.3,224,0,43,143,3.3,2,73,367,5.0,9,10,3,22,3,25,0,0,0
2016,8,2014-11-01,kansas-state,,Oklahoma State,W (48-14),20,33,60.6,287,2,33,134,4.1,3,66,421,6.4,11,7,3,21,2,15,0,1,1
2017,9,2014-11-08,kansas-state,@,Texas Christian,L (20-41),22,40,55.0,376,2,19,34,1.8,1,59,410,6.9,13,2,1,16,5,68,0,1,1
2018,10,2014-11-20,kansas-state,@,West Virginia,W (26-20),22,34,64.7,400,1,29,1,0.0,0,63,401,6.4,16,0,2,18,10,102,1,1,2
2019,11,2014-11-29,kansas-state,,Kansas,W (51-13),23,30,76.7,311,4,39,194,5.0,2,69,505,7.3,17,10,1,28,6,50,0,0,0
2020,12,2014-12-06,kansas-state,@,Baylor,L (27-38),22,27,81.5,300,2,40,103,2.6,1,67,403,6.0,14,10,3,27,3,30,0,1,1
2021,13,2015-01-02,kansas-state,N,UCLA*,L (35-40),31,49,63.3,338,2,32,31,1.0,2,81,369,4.6,17,5,5,27,6,39,1,1,2
2022,,13 Games,kansas-state,,,,271,415,65.3,3736,23,476,1745,3.7,30,891,5481,6.2,162,104,28,294,57,511,5,8,13
2023,1,2015-09-05,kansas-state,,South Dakota,W (34-0),9,18,50.0,147,1,40,185,4.6,2,58,332,5.7,6,10,0,16,8,66,1,0,1
2024,2,2015-09-12,kansas-state,@,Texas-San Antonio,W (30-3),12,23,52.2,243,0,44,175,4.0,3,67,418,6.2,10,9,3,22,9,85,0,0,0
2025,3,2015-09-19,kansas-state,,Louisiana Tech,W (39-33),15,26,57.7,195,3,45,160,3.6,1,71,355,5.0,8,8,1,17,4,35,1,0,1
2026,4,2015-10-03,kansas-state,@,Oklahoma State,L (34-36),13,25,52.0,207,2,42,144,3.4,3,67,351,5.2,8,9,5,22,9,54,0,1,1
2027,5,2015-10-10,kansas-state,,Texas Christian,L (45-52),13,33,39.4,157,0,48,228,4.8,6,81,385,4.8,8,14,6,28,3,35,1,1,2
2028,6,2015-10-17,kansas-state,,Oklahoma,L (0-55),5,22,22.7,45,0,31,65,2.1,0,53,110,2.1,2,5,0,7,1,5,0,3,3
2029,7,2015-10-24,kansas-state,@,Texas,L (9-23),11,24,45.8,107,1,37,135,3.6,0,61,242,4.0,5,9,1,15,5,27,0,1,1
2030,8,2015-11-05,kansas-state,,Baylor,L (24-31),13,23,56.5,172,1,48,258,5.4,2,71,430,6.1,6,15,1,22,7,39,1,2,3
2031,9,2015-11-14,kansas-state,@,Texas Tech,L (44-59),19,42,45.2,289,2,34,123,3.6,3,76,412,5.4,11,6,2,19,7,55,1,1,2
2032,10,2015-11-21,kansas-state,,Iowa State,W (38-35),19,33,57.6,220,2,41,165,4.0,2,74,385,5.2,11,11,0,22,5,35,1,0,1
2033,11,2015-11-28,kansas-state,@,Kansas,W (45-14),11,20,55.0,137,0,49,226,4.6,5,69,363,5.3,7,12,3,22,1,5,0,1,1
2034,12,2015-12-05,kansas-state,,West Virginia,W (24-23),10,31,32.3,206,1,49,98,2.0,1,80,304,3.8,7,6,2,15,3,35,0,2,2
2035,13,2016-01-02,kansas-state,N,Arkansas*,L (23-45),12,25,48.0,163,1,22,79,3.6,1,47,242,5.1,10,2,1,13,4,25,0,1,1
2036,,13 Games,kansas-state,,,,162,345,47.0,2288,14,530,2041,3.9,29,875,4329,4.9,99,116,25,240,66,501,6,13,19
2037,1,2016-09-02,kansas-state,@,Stanford,L (13-26),19,41,46.3,243,1,32,92,2.9,0,73,335,4.6,11,6,1,18,8,44,0,2,2
2038,2,2016-09-17,kansas-state,,Florida Atlantic,W (63-7),13,18,72.2,159,1,54,336,6.2,7,72,495,6.9,7,15,2,24,13,131,1,0,1
2039,3,2016-09-24,kansas-state,,Missouri State,W (35-0),10,13,76.9,105,2,22,165,7.5,3,35,270,7.7,5,8,0,13,2,24,0,0,0
2040,4,2016-10-01,kansas-state,@,West Virginia,L (16-17),10,30,33.3,166,0,42,120,2.9,1,72,286,4.0,8,7,2,17,6,25,0,1,1
2041,5,2016-10-08,kansas-state,,Texas Tech,W (44-38),10,20,50.0,104,1,39,231,5.9,2,59,335,5.7,7,13,1,21,6,50,0,0,0
2042,6,2016-10-15,kansas-state,@,Oklahoma,L (17-38),20,37,54.1,225,1,32,110,3.4,1,69,335,4.9,12,6,1,19,7,35,0,0,0
2043,7,2016-10-22,kansas-state,,Texas,W (24-21),20,27,74.1,171,1,49,240,4.9,2,76,411,5.4,4,18,5,27,8,75,2,1,3
2044,8,2016-10-29,kansas-state,@,Iowa State,W (31-26),18,28,64.3,151,1,43,247,5.7,3,71,398,5.6,11,14,2,27,4,35,0,0,0
2045,9,2016-11-05,kansas-state,,Oklahoma State,L (37-43),12,18,66.7,87,0,56,345,6.2,4,74,432,5.8,5,16,3,24,4,31,0,1,1
2046,10,2016-11-19,kansas-state,@,Baylor,W (42-21),16,25,64.0,177,0,51,237,4.6,6,76,414,5.4,9,14,2,25,8,85,2,0,2
2047,11,2016-11-26,kansas-state,,Kansas,W (34-19),6,11,54.5,99,0,58,342,5.9,4,69,441,6.4,4,17,4,25,5,60,1,0,1
2048,12,2016-12-03,kansas-state,@,Texas Christian,W (30-6),9,21,42.9,159,1,51,336,6.6,3,72,495,6.9,6,15,0,21,6,61,1,0,1
2049,13,2016-12-28,kansas-state,N,Texas A&M*,W (33-28),14,20,70.0,195,1,41,218,5.3,3,61,413,6.8,6,9,2,17,12,80,0,0,0
2050,,13 Games,kansas-state,,,,177,309,57.3,2041,10,570,3019,5.3,39,879,5060,5.8,95,158,25,278,89,736,7,5,12
2051,1,2017-09-02,kansas-state,,Central Arkansas,W (55-19),10,16,62.5,333,4,31,186,6.0,2,47,519,11.0,8,8,0,16,6,58,0,0,0
2052,2,2017-09-09,kansas-state,,UNC Charlotte,W (55-7),17,23,73.9,189,0,51,304,6.0,5,74,493,6.7,12,15,1,28,5,44,0,0,0
2053,3,2017-09-16,kansas-state,@,Vanderbilt,L (7-14),10,28,35.7,76,0,35,201,5.7,1,63,277,4.4,3,10,0,13,7,68,0,2,2
2054,4,2017-09-30,kansas-state,,Baylor,W (33-20),7,17,41.2,119,1,43,225,5.2,2,60,344,5.7,6,13,0,19,6,45,1,0,1
2055,5,2017-10-07,kansas-state,@,Texas,L (34-40),14,23,60.9,254,2,39,140,3.6,2,62,394,6.4,8,7,1,16,7,70,0,1,1
2056,6,2017-10-14,kansas-state,,Texas Christian,L (6-26),11,30,36.7,146,0,29,70,2.4,0,59,216,3.7,6,3,1,10,5,38,1,0,1
2057,7,2017-10-21,kansas-state,,Oklahoma,L (35-42),12,14,85.7,144,1,42,268,6.4,4,56,412,7.4,4,13,1,18,2,25,1,1,2
2058,8,2017-10-28,kansas-state,@,Kansas,W (30-20),8,13,61.5,138,0,43,202,4.7,2,56,340,6.1,4,11,0,15,6,35,1,0,1
2059,9,2017-11-04,kansas-state,@,Texas Tech,W (42-35),18,28,64.3,263,2,36,145,4.0,2,64,408,6.4,14,6,4,24,6,46,0,1,1
2060,10,2017-11-11,kansas-state,,West Virginia,L (23-28),13,26,50.0,159,0,42,173,4.1,2,68,332,4.9,6,7,1,14,5,61,0,2,2
2061,11,2017-11-18,kansas-state,@,Oklahoma State,W (45-40),10,13,76.9,204,3,49,217,4.4,2,62,421,6.8,7,10,1,18,6,41,1,0,1
2062,12,2017-11-25,kansas-state,,Iowa State,W (20-19),16,22,72.7,155,2,30,109,3.6,1,52,264,5.1,7,4,1,12,4,45,0,0,0
2063,13,2017-12-26,kansas-state,N,UCLA*,W (35-17),10,17,58.8,79,1,49,344,7.0,4,66,423,6.4,4,14,3,21,2,20,0,1,1
2064,,13 Games,kansas-state,,,,156,270,57.8,2259,16,519,2584,5.0,29,789,4843,6.1,89,121,14,224,67,596,5,8,13
2065,1,2018-09-01,kansas-state,,South Dakota,W (27-24),13,28,46.4,152,1,47,256,5.4,0,75,408,5.4,8,10,1,19,13,129,2,2,4
2066,2,2018-09-08,kansas-state,,Mississippi State,L (10-31),9,21,42.9,100,1,35,113,3.2,0,56,213,3.8,5,7,3,15,2,15,0,1,1
2067,3,2018-09-15,kansas-state,,Texas-San Antonio,W (41-17),14,19,73.7,285,3,44,164,3.7,2,63,449,7.1,11,8,1,20,4,41,2,0,2
2068,4,2018-09-22,kansas-state,@,West Virginia,L (6-35),18,29,62.1,227,0,36,91,2.5,0,65,318,4.9,9,7,1,17,8,69,1,0,1
2069,5,2018-09-29,kansas-state,,Texas,L (14-19),11,25,44.0,110,0,39,107,2.7,2,64,217,3.4,6,7,4,17,0,0,0,0,0
2070,6,2018-10-06,kansas-state,@,Baylor,L (34-37),15,26,57.7,149,1,35,319,9.1,4,61,468,7.7,5,15,0,20,6,55,1,2,3
2071,7,2018-10-13,kansas-state,,Oklahoma State,W (31-12),11,22,50.0,130,0,55,291,5.3,4,77,421,5.5,7,13,3,23,4,40,0,0,0
2072,8,2018-10-27,kansas-state,@,Oklahoma,L (14-51),13,21,61.9,108,0,32,137,4.3,2,53,245,4.6,5,6,2,13,4,50,1,0,1
2073,9,2018-11-03,kansas-state,@,Texas Christian,L (13-14),16,28,57.1,162,1,47,139,3.0,1,75,301,4.0,8,11,2,21,2,3,2,1,3
2074,10,2018-11-10,kansas-state,,Kansas,W (21-17),11,18,61.1,126,0,40,175,4.4,3,58,301,5.2,7,8,2,17,7,55,0,0,0
2075,11,2018-11-17,kansas-state,,Texas Tech,W (21-6),17,26,65.4,213,1,50,154,3.1,0,76,367,4.8,11,9,2,22,2,20,0,1,1
2076,,11 Games,kansas-state,,,,148,263,56.3,1762,8,460,1946,4.2,18,723,3708,5.1,82,101,21,204,52,477,9,7,16
2077,1,2014-08-30,oklahoma-state,N,Florida State,L (31-37),15,28,53.6,203,1,42,161,3.8,3,70,364,5.2,9,9,4,22,7,70,1,1,2
2078,2,2014-09-06,oklahoma-state,,Missouri State,W (40-23),21,35,60.0,274,2,35,206,5.9,2,70,480,6.9,10,10,2,22,5,45,0,0,0
2079,3,2014-09-13,oklahoma-state,,Texas-San Antonio,W (43-13),16,30,53.3,315,2,49,162,3.3,2,79,477,6.0,12,8,4,24,5,45,0,0,0
2080,4,2014-09-25,oklahoma-state,,Texas Tech,W (45-35),17,31,54.8,370,4,42,158,3.8,2,73,528,7.2,12,7,3,22,10,129,0,2,2
2081,5,2014-10-04,oklahoma-state,,Iowa State,W (37-20),26,41,63.4,271,1,42,129,3.1,2,83,400,4.8,12,10,3,25,7,40,0,2,2
2082,6,2014-10-11,oklahoma-state,@,Kansas,W (27-20),17,31,54.8,161,1,37,114,3.1,1,68,275,4.0,7,5,3,15,7,44,1,1,2
2083,7,2014-10-18,oklahoma-state,@,Texas Christian,L (9-42),10,25,40.0,132,0,39,126,3.2,0,64,258,4.0,5,7,0,12,4,23,0,2,2
2084,8,2014-10-25,oklahoma-state,,West Virginia,L (10-34),21,41,51.2,242,1,39,194,5.0,0,80,436,5.5,15,7,1,23,4,30,0,2,2
2085,9,2014-11-01,oklahoma-state,@,Kansas State,L (14-48),12,23,52.2,148,0,40,112,2.8,1,63,260,4.1,7,8,0,15,5,54,1,2,3
2086,10,2014-11-15,oklahoma-state,,Texas,L (7-28),17,29,58.6,158,1,23,34,1.5,0,52,192,3.7,7,2,0,9,5,70,1,1,2
2087,11,2014-11-22,oklahoma-state,@,Baylor,L (28-49),13,25,52.0,281,2,43,116,2.7,2,68,397,5.8,8,6,3,17,4,45,0,2,2
2088,12,2014-12-06,oklahoma-state,@,Oklahoma,W (38-35),19,35,54.3,273,2,26,112,4.3,2,61,385,6.3,11,6,1,18,9,55,0,1,1
2089,13,2015-01-02,oklahoma-state,N,Washington*,W (30-22),18,27,66.7,321,2,49,152,3.1,1,76,473,6.2,13,7,2,22,7,50,1,1,2
2090,,13 Games,oklahoma-state,,,,222,401,55.4,3149,19,506,1776,3.5,18,907,4925,5.4,128,92,26,246,79,700,5,17,22
2091,1,2015-09-03,oklahoma-state,@,Central Michigan,W (24-13),22,32,68.8,266,1,35,153,4.4,2,67,419,6.3,13,6,0,19,4,35,0,0,0
2092,2,2015-09-12,oklahoma-state,,Central Arkansas,W (32-8),25,39,64.1,414,3,35,164,4.7,1,74,578,7.8,13,12,0,25,8,65,0,1,1
2093,3,2015-09-19,oklahoma-state,,Texas-San Antonio,W (69-14),19,26,73.1,312,3,40,217,5.4,3,66,529,8.0,11,11,0,22,5,45,1,0,1
2094,4,2015-09-26,oklahoma-state,@,Texas,W (30-27),24,36,66.7,292,2,46,103,2.2,1,82,395,4.8,17,4,6,27,7,40,1,2,3
2095,5,2015-10-03,oklahoma-state,,Kansas State,W (36-34),35,56,62.5,441,4,27,49,1.8,1,83,490,5.9,23,2,1,26,8,95,1,1,2
2096,6,2015-10-10,oklahoma-state,@,West Virginia,W (33-26),22,43,51.2,228,1,38,134,3.5,2,81,362,4.5,11,5,4,20,7,55,0,3,3
2097,7,2015-10-24,oklahoma-state,,Kansas,W (58-10),27,36,75.0,381,3,47,202,4.3,4,83,583,7.0,15,15,3,33,2,25,0,0,0
2098,8,2015-10-31,oklahoma-state,@,Texas Tech,W (70-53),27,43,62.8,478,5,36,184,5.1,3,79,662,8.4,20,8,1,29,7,65,0,1,1
2099,9,2015-11-07,oklahoma-state,,Texas Christian,W (49-29),18,27,66.7,375,5,26,81,3.1,1,53,456,8.6,13,1,2,16,7,67,0,0,0
2100,10,2015-11-14,oklahoma-state,@,Iowa State,W (35-31),26,38,68.4,343,2,48,154,3.2,3,86,497,5.8,17,11,0,28,6,48,1,0,1
2101,11,2015-11-21,oklahoma-state,,Baylor,L (35-45),28,51,54.9,433,4,23,8,0.3,1,74,441,6.0,15,3,1,19,4,25,0,0,0
2102,12,2015-11-28,oklahoma-state,,Oklahoma,L (23-58),25,45,55.6,325,2,29,132,4.6,0,74,457,6.2,15,5,2,22,2,10,0,2,2
2103,13,2016-01-01,oklahoma-state,N,Mississippi*,L (20-48),27,45,60.0,303,0,30,63,2.1,2,75,366,4.9,14,5,1,20,7,77,1,0,1
2104,,13 Games,oklahoma-state,,,,325,517,62.9,4591,35,460,1644,3.6,24,977,6235,6.4,197,88,21,306,74,652,5,10,15
2105,1,2016-09-03,oklahoma-state,,Southeastern Louisiana,W (61-7),25,35,71.4,253,2,38,144,3.8,4,73,397,5.4,14,9,0,23,5,55,1,0,1
2106,2,2016-09-10,oklahoma-state,,Central Michigan,L (27-30),28,44,63.6,288,3,26,50,1.9,0,70,338,4.8,17,3,3,23,4,40,0,1,1
2107,3,2016-09-17,oklahoma-state,,Pittsburgh,W (45-38),26,46,56.5,540,2,32,100,3.1,4,78,640,8.2,17,5,3,25,8,55,2,0,2
2108,4,2016-09-24,oklahoma-state,@,Baylor,L (24-35),27,46,58.7,279,0,55,213,3.9,3,101,492,4.9,15,12,3,30,4,32,3,1,4
2109,5,2016-10-01,oklahoma-state,,Texas,W (49-31),19,28,67.9,392,3,43,163,3.8,3,71,555,7.8,13,8,1,22,7,70,0,0,0
2110,6,2016-10-08,oklahoma-state,,Iowa State,W (38-31),26,44,59.1,351,4,33,108,3.3,1,77,459,6.0,13,7,0,20,5,63,0,0,0
2111,7,2016-10-22,oklahoma-state,@,Kansas,W (44-20),18,27,66.7,252,1,46,230,5.0,4,73,482,6.6,8,15,0,23,5,45,1,0,1
2112,8,2016-10-29,oklahoma-state,,West Virginia,W (37-20),26,36,72.2,273,3,31,85,2.7,1,67,358,5.3,13,2,2,17,3,30,0,0,0
2113,9,2016-11-05,oklahoma-state,@,Kansas State,W (43-37),29,38,76.3,457,5,26,180,6.9,1,64,637,10.0,20,8,1,29,7,67,1,2,3
2114,10,2016-11-12,oklahoma-state,,Texas Tech,W (45-44),20,28,71.4,395,2,38,210,5.5,4,66,605,9.2,16,11,0,27,7,80,1,0,1
2115,11,2016-11-19,oklahoma-state,@,Texas Christian,W (31-6),17,35,48.6,207,1,45,334,7.4,3,80,541,6.8,7,18,3,28,6,42,1,0,1
2116,12,2016-12-03,oklahoma-state,@,Oklahoma,L (20-38),11,25,44.0,186,0,37,217,5.9,2,62,403,6.5,6,10,1,17,3,22,0,0,0
2117,13,2016-12-29,oklahoma-state,N,Colorado*,W (38-8),23,33,69.7,338,3,41,189,4.6,2,74,527,7.1,15,8,1,24,5,42,0,0,0
2118,,13 Games,oklahoma-state,,,,295,465,63.4,4211,29,491,2223,4.5,32,956,6434,6.7,174,116,18,308,69,643,10,4,14
2119,1,2017-08-31,oklahoma-state,,Tulsa,W (59-24),21,26,80.8,308,3,37,332,9.0,4,63,640,10.2,8,15,2,25,5,51,2,0,2
2120,2,2017-09-08,oklahoma-state,@,South Alabama,W (44-7),26,41,63.4,342,3,37,163,4.4,1,78,505,6.5,19,8,2,29,4,25,0,0,0
2121,3,2017-09-16,oklahoma-state,@,Pittsburgh,W (59-21),26,37,70.3,572,5,32,131,4.1,2,69,703,10.2,19,7,1,27,4,30,1,1,2
2122,4,2017-09-23,oklahoma-state,,Texas Christian,L (31-44),22,42,52.4,398,2,31,101,3.3,2,73,499,6.8,17,8,1,26,8,77,1,3,4
2123,5,2017-09-30,oklahoma-state,@,Texas Tech,W (41-34),27,38,71.1,376,3,44,221,5.0,2,82,597,7.3,20,9,3,32,8,78,0,1,1
2124,6,2017-10-14,oklahoma-state,,Baylor,W (59-16),20,33,60.6,471,3,38,276,7.3,5,71,747,10.5,15,12,2,29,5,40,2,0,2
2125,7,2017-10-21,oklahoma-state,@,Texas,W (13-10),25,38,65.8,282,0,51,146,2.9,1,89,428,4.8,12,10,4,26,2,20,1,0,1
2126,8,2017-10-28,oklahoma-state,@,West Virginia,W (50-39),20,34,58.8,216,3,56,246,4.4,4,90,462,5.1,12,14,1,27,6,56,3,1,4
2127,9,2017-11-04,oklahoma-state,,Oklahoma,L (52-62),28,54,51.9,448,5,34,213,6.3,2,88,661,7.5,17,10,5,32,5,40,1,2,3
2128,10,2017-11-11,oklahoma-state,@,Iowa State,W (49-42),25,31,80.6,376,3,37,146,3.9,3,68,522,7.7,15,7,1,23,9,105,0,0,0
2129,11,2017-11-18,oklahoma-state,,Kansas State,L (40-45),32,53,60.4,425,3,31,85,2.7,2,84,510,6.1,23,4,3,30,2,20,0,2,2
2130,12,2017-11-25,oklahoma-state,,Kansas,W (58-17),32,44,72.7,494,2,42,167,4.0,5,86,661,7.7,20,7,2,29,4,30,0,0,0
2131,13,2017-12-28,oklahoma-state,N,Virginia Tech*,W (30-21),21,32,65.6,351,2,31,141,4.5,1,63,492,7.8,16,7,1,24,4,20,0,0,0
2132,,13 Games,oklahoma-state,,,,325,503,64.6,5059,37,501,2368,4.7,34,1004,7427,7.4,213,118,28,359,66,592,11,10,21
2133,1,2018-08-30,oklahoma-state,,Missouri State,W (58-17),25,37,67.6,296,5,55,436,7.9,3,92,732,8.0,15,15,3,33,7,55,1,1,2
2134,2,2018-09-08,oklahoma-state,,South Alabama,W (55-13),26,42,61.9,453,2,44,164,3.7,4,86,617,7.2,21,7,4,32,9,112,1,2,3
2135,3,2018-09-15,oklahoma-state,,Boise State,W (44-21),16,27,59.3,246,1,38,176,4.6,3,65,422,6.5,9,10,0,19,4,25,0,0,0
2136,4,2018-09-22,oklahoma-state,,Texas Tech,L (17-41),18,38,47.4,258,1,24,128,5.3,1,62,386,6.2,12,6,0,18,8,73,1,1,2
2137,5,2018-09-29,oklahoma-state,@,Kansas,W (48-28),15,20,75.0,312,4,46,256,5.6,2,66,568,8.6,10,14,1,25,8,92,0,1,1
2138,6,2018-10-06,oklahoma-state,,Iowa State,L (42-48),19,33,57.6,289,4,43,126,2.9,2,76,415,5.5,13,8,1,22,9,87,1,1,2
2139,7,2018-10-13,oklahoma-state,@,Kansas State,L (12-31),17,35,48.6,184,0,28,127,4.5,1,63,311,4.9,8,6,1,15,7,70,0,2,2
2140,8,2018-10-27,oklahoma-state,,Texas,W (38-35),23,34,67.6,321,3,51,181,3.5,2,85,502,5.9,14,10,3,27,4,52,0,0,0
2141,9,2018-11-03,oklahoma-state,@,Baylor,L (31-35),25,42,59.5,301,1,47,212,4.5,3,89,513,5.8,16,13,3,32,12,133,1,0,1
2142,10,2018-11-10,oklahoma-state,@,Oklahoma,L (47-48),34,53,64.2,501,3,33,139,4.2,4,86,640,7.4,27,9,3,39,5,31,1,0,1
2143,11,2018-11-17,oklahoma-state,,West Virginia,W (45-41),30,46,65.2,338,5,43,266,6.2,1,89,604,6.8,15,19,1,35,3,35,2,2,4
2144,,11 Games,oklahoma-state,,,,248,407,60.9,3499,29,452,2211,4.9,26,859,5710,6.6,160,117,20,297,76,765,8,10,18
2145,1,2014-08-30,west-virginia,N,Alabama,L (23-33),29,45,64.4,365,1,24,28,1.2,0,69,393,5.7,17,5,0,22,6,55,0,0,0
2146,2,2014-09-06,west-virginia,,Towson,W (54-0),38,44,86.4,355,2,52,251,4.8,5,96,606,6.3,18,14,1,33,3,35,1,0,1
2147,3,2014-09-13,west-virginia,@,Maryland,W (40-37),37,49,75.5,511,4,59,183,3.1,1,108,694,6.4,18,13,2,33,4,40,3,1,4
2148,4,2014-09-20,west-virginia,,Oklahoma,L (33-45),25,41,61.0,376,2,40,137,3.4,2,81,513,6.3,14,9,3,26,5,55,1,2,3
2149,5,2014-10-04,west-virginia,,Kansas,W (33-14),20,37,54.1,302,1,42,255,6.1,1,79,557,7.1,11,9,5,25,5,45,2,1,3
2150,6,2014-10-11,west-virginia,@,Texas Tech,W (37-34),28,44,63.6,301,2,50,249,5.0,2,94,550,5.9,14,11,4,29,7,63,1,0,1
2151,7,2014-10-18,west-virginia,,Baylor,W (41-27),23,35,65.7,322,3,50,134,2.7,2,85,456,5.4,13,10,10,33,14,138,2,1,3
2152,8,2014-10-25,west-virginia,@,Oklahoma State,W (34-10),21,30,70.0,238,2,44,210,4.8,1,74,448,6.1,9,11,2,22,7,57,0,0,0
2153,9,2014-11-01,west-virginia,,Texas Christian,L (30-31),15,26,57.7,162,1,54,195,3.6,1,80,357,4.5,8,9,0,17,6,40,3,2,5
2154,10,2014-11-08,west-virginia,@,Texas,L (16-33),36,49,73.5,248,0,41,200,4.9,2,90,448,5.0,13,10,1,24,8,57,1,1,2
2155,11,2014-11-20,west-virginia,,Kansas State,L (20-26),27,48,56.3,310,2,37,123,3.3,0,85,433,5.1,14,9,4,27,8,77,2,2,4
2156,12,2014-11-29,west-virginia,@,Iowa State,W (37-24),21,41,51.2,285,3,38,285,7.5,1,79,570,7.2,15,9,1,25,5,50,2,0,2
2157,13,2014-12-29,west-virginia,N,Texas A&M*,L (37-45),20,45,44.4,346,3,32,126,3.9,0,77,472,6.1,11,6,4,21,7,45,1,0,1
2158,,13 Games,west-virginia,,,,340,534,63.7,4121,26,563,2376,4.2,18,1097,6497,5.9,175,125,37,337,85,757,19,10,29
2159,1,2015-09-05,west-virginia,,Georgia Southern,W (44-0),16,26,61.5,359,2,40,185,4.6,3,66,544,8.2,11,10,0,21,5,37,0,0,0
2160,2,2015-09-12,west-virginia,,Liberty,W (41-17),27,32,84.4,313,3,45,172,3.8,2,77,485,6.3,15,9,1,25,6,58,0,0,0
2161,3,2015-09-26,west-virginia,,Maryland,W (45-6),23,37,62.2,297,4,59,304,5.2,2,96,601,6.3,16,15,6,37,10,124,1,1,2
2162,4,2015-10-03,west-virginia,@,Oklahoma,L (24-44),17,32,53.1,173,1,54,196,3.6,2,86,369,4.3,9,10,8,27,11,111,2,3,5
2163,5,2015-10-10,west-virginia,,Oklahoma State,L (26-33),18,37,48.6,188,1,61,255,4.2,2,98,443,4.5,9,14,3,26,11,107,3,1,4
2164,6,2015-10-17,west-virginia,@,Baylor,L (38-62),18,39,46.2,289,4,44,182,4.1,0,83,471,5.7,8,9,5,22,8,80,0,1,1
2165,7,2015-10-29,west-virginia,@,Texas Christian,L (10-40),16,39,41.0,160,1,37,167,4.5,0,76,327,4.3,7,10,4,21,9,114,0,1,1
2166,8,2015-11-07,west-virginia,,Texas Tech,W (31-26),12,24,50.0,149,0,57,300,5.3,4,81,449,5.5,7,17,4,28,4,40,0,2,2
2167,9,2015-11-14,west-virginia,,Texas,W (38-20),10,12,83.3,122,2,51,257,5.0,2,63,379,6.0,6,12,0,18,5,48,0,1,1
2168,10,2015-11-21,west-virginia,@,Kansas,W (49-0),16,32,50.0,204,1,55,426,7.7,5,87,630,7.2,11,18,1,30,5,52,0,2,2
2169,11,2015-11-28,west-virginia,,Iowa State,W (30-6),12,26,46.2,202,1,45,213,4.7,2,71,415,5.8,6,13,0,19,5,45,0,1,1
2170,12,2015-12-05,west-virginia,@,Kansas State,L (23-24),19,42,45.2,281,1,42,166,4.0,1,84,447,5.3,14,8,0,22,3,40,1,0,1
2171,13,2016-01-02,west-virginia,N,Arizona State*,W (43-42),28,51,54.9,532,5,33,144,4.4,0,84,676,8.0,20,8,1,29,5,54,0,2,2
2172,,13 Games,west-virginia,,,,232,429,54.1,3269,26,623,2967,4.8,25,1052,6236,5.9,139,153,33,325,87,910,7,15,22
2173,1,2016-09-03,west-virginia,,Missouri,W (26-11),23,37,62.2,253,0,48,241,5.0,2,85,494,5.8,13,9,2,24,4,45,1,2,3
2174,2,2016-09-10,west-virginia,,Youngstown State,W (38-21),20,33,60.6,389,5,46,235,5.1,0,79,624,7.9,16,11,3,30,6,49,0,1,1
2175,3,2016-09-24,west-virginia,N,Brigham Young,W (35-32),31,40,77.5,332,1,35,149,4.3,3,75,481,6.4,17,7,2,26,4,38,1,1,2
2176,4,2016-10-01,west-virginia,,Kansas State,W (17-16),24,41,58.5,298,1,35,124,3.5,1,76,422,5.6,15,6,0,21,6,60,1,1,2
2177,5,2016-10-15,west-virginia,@,Texas Tech,W (48-17),21,31,67.7,318,1,46,332,7.2,5,77,650,8.4,12,15,1,28,9,95,0,0,0
2178,6,2016-10-22,west-virginia,,Texas Christian,W (34-10),16,23,69.6,231,4,48,158,3.3,0,71,389,5.5,12,11,2,25,7,45,0,0,0
2179,7,2016-10-29,west-virginia,@,Oklahoma State,L (20-37),24,39,61.5,212,1,41,209,5.1,1,80,421,5.3,14,12,1,27,6,46,1,2,3
2180,8,2016-11-05,west-virginia,,Kansas,W (48-21),17,28,60.7,264,3,47,341,7.3,3,75,605,8.1,11,13,4,28,6,59,1,0,1
2181,9,2016-11-12,west-virginia,@,Texas,W (24-20),21,35,60.0,269,1,38,114,3.0,2,73,383,5.2,15,7,0,22,5,55,1,3,4
2182,10,2016-11-19,west-virginia,,Oklahoma,L (28-56),12,27,44.4,191,2,38,388,10.2,2,65,579,8.9,6,14,2,22,7,91,3,1,4
2183,11,2016-11-26,west-virginia,@,Iowa State,W (49-19),13,23,56.5,341,5,51,272,5.3,2,74,613,8.3,10,13,2,25,8,70,0,0,0
2184,12,2016-12-03,west-virginia,,Baylor,W (24-21),10,26,38.5,111,2,62,311,5.0,1,88,422,4.8,5,14,6,25,6,62,0,0,0
2185,13,2016-12-28,west-virginia,N,Miami (FL)*,L (14-31),17,26,65.4,134,0,39,95,2.4,2,65,229,3.5,6,3,2,11,11,108,1,0,1
2186,,13 Games,west-virginia,,,,249,409,60.9,3343,26,574,2969,5.2,24,983,6312,6.4,152,135,27,314,85,823,10,11,21
2187,1,2017-09-03,west-virginia,N,Virginia Tech,L (24-31),31,54,57.4,371,3,35,221,6.3,0,89,592,6.7,17,12,0,29,9,81,0,1,1
2188,2,2017-09-09,west-virginia,,East Carolina,W (56-20),24,34,70.6,403,5,47,211,4.5,3,81,614,7.6,15,13,3,31,4,55,0,0,0
2189,3,2017-09-16,west-virginia,,Delaware State,W (59-16),24,34,70.6,334,4,35,204,5.8,4,69,538,7.8,10,11,2,23,6,60,2,1,3
2190,4,2017-09-23,west-virginia,@,Kansas,W (56-34),25,39,64.1,347,2,43,288,6.7,5,82,635,7.7,15,14,2,31,4,42,0,1,1
2191,5,2017-10-07,west-virginia,@,Texas Christian,L (24-31),25,45,55.6,366,3,39,142,3.6,0,84,508,6.0,15,9,4,28,2,25,1,1,2
2192,6,2017-10-14,west-virginia,,Texas Tech,W (46-35),32,41,78.0,352,5,29,44,1.5,1,70,396,5.7,16,5,7,28,9,93,0,1,1
2193,7,2017-10-21,west-virginia,@,Baylor,W (38-36),26,37,70.3,375,5,29,118,4.1,0,66,493,7.5,15,7,1,23,11,134,0,0,0
2194,8,2017-10-28,west-virginia,,Oklahoma State,L (39-50),20,42,47.6,285,2,30,62,2.1,1,72,347,4.8,10,6,3,19,6,41,1,4,5
2195,9,2017-11-04,west-virginia,,Iowa State,W (20-16),20,25,80.0,316,2,47,208,4.4,0,72,524,7.3,12,11,0,23,8,85,0,1,1
2196,10,2017-11-11,west-virginia,@,Kansas State,W (28-23),27,46,58.7,372,4,26,120,4.6,0,72,492,6.8,13,7,0,20,3,21,2,2,4
2197,11,2017-11-18,west-virginia,,Texas,L (14-28),20,34,58.8,239,1,29,56,1.9,0,63,295,4.7,12,3,2,17,6,49,2,0,2
2198,12,2017-11-25,west-virginia,@,Oklahoma,L (31-59),10,20,50.0,137,0,51,250,4.9,4,71,387,5.5,4,14,6,24,6,39,2,0,2
2199,13,2017-12-26,west-virginia,N,Utah*,L (14-30),10,30,33.3,124,1,21,29,1.4,0,51,153,3.0,5,1,0,6,5,51,2,2,4
2200,,13 Games,west-virginia,,,,294,481,61.1,4021,37,461,1953,4.2,18,942,5974,6.3,159,113,30,302,79,776,12,14,26
2201,1,2018-09-01,west-virginia,N,Tennessee,W (40-14),25,34,73.5,429,5,27,118,4.4,0,61,547,9.0,18,6,2,26,4,35,1,0,1
2202,2,2018-09-08,west-virginia,,Youngstown State,W (52-17),22,29,75.9,336,4,46,289,6.3,3,75,625,8.3,17,11,1,29,12,114,0,1,1
2203,3,2018-09-22,west-virginia,,Kansas State,W (35-6),25,36,69.4,356,5,28,108,3.9,0,64,464,7.3,16,3,1,20,3,35,1,3,4
2204,4,2018-09-29,west-virginia,@,Texas Tech,W (42-34),27,41,65.9,370,3,32,119,3.7,2,73,489,6.7,15,8,3,26,12,115,0,0,0
2205,5,2018-10-06,west-virginia,,Kansas,W (38-22),28,41,68.3,332,4,39,177,4.5,1,80,509,6.4,14,15,0,29,7,50,1,3,4
2206,6,2018-10-13,west-virginia,@,Iowa State,L (14-30),11,15,73.3,100,1,27,52,1.9,0,42,152,3.6,2,7,0,9,9,103,0,1,1
2207,7,2018-10-25,west-virginia,,Baylor,W (58-14),21,31,67.7,396,4,33,172,5.2,3,64,568,8.9,13,5,4,22,6,64,0,0,0
2208,8,2018-11-03,west-virginia,@,Texas,W (42-41),28,42,66.7,346,3,33,232,7.0,2,75,578,7.7,16,9,3,28,14,120,0,0,0
2209,9,2018-11-10,west-virginia,,Texas Christian,W (47-10),26,41,63.4,371,3,40,164,4.1,3,81,535,6.6,15,11,0,26,2,15,1,1,2
2210,10,2018-11-17,west-virginia,@,Oklahoma State,L (41-45),27,48,56.3,364,2,43,189,4.4,3,91,553,6.1,17,7,1,25,5,24,1,0,1
2211,,10 Games,west-virginia,,,,240,358,67.0,3400,34,348,1620,4.7,17,706,5020,7.1,143,82,15,240,74,675,5,9,14
2212,1,2014-08-30,texas-tech,,Central Arkansas,W (42-35),39,53,73.6,452,4,36,184,5.1,2,89,636,7.1,25,10,0,35,15,114,0,2,2
2213,2,2014-09-06,texas-tech,@,Texas-El Paso,W (30-26),17,31,54.8,278,3,28,226,8.1,1,59,504,8.5,9,9,2,20,10,90,1,0,1
2214,3,2014-09-13,texas-tech,,Arkansas,L (28-49),27,45,60.0,252,3,22,101,4.6,1,67,353,5.3,11,9,0,20,5,60,1,2,3
2215,4,2014-09-25,texas-tech,@,Oklahoma State,L (35-45),37,60,61.7,394,5,30,118,3.9,0,90,512,5.7,20,8,4,32,16,158,0,3,3
2216,5,2014-10-04,texas-tech,@,Kansas State,L (13-45),27,50,54.0,301,2,14,46,3.3,0,64,347,5.4,16,4,0,20,9,89,0,4,4
2217,6,2014-10-11,texas-tech,,West Virginia,L (34-37),28,46,60.9,348,3,38,217,5.7,1,84,565,6.7,14,7,2,23,12,115,0,1,1
2218,7,2014-10-18,texas-tech,,Kansas,W (34-21),28,44,63.6,288,3,37,219,5.9,1,81,507,6.3,12,13,1,26,4,22,1,1,2
2219,8,2014-10-25,texas-tech,@,Texas Christian,L (27-82),20,41,48.8,345,3,28,101,3.6,0,69,446,6.5,14,5,2,21,6,69,2,2,4
2220,9,2014-11-01,texas-tech,,Texas,L (13-34),28,47,59.6,225,0,32,156,4.9,1,79,381,4.8,10,5,3,18,6,70,1,1,2
2221,10,2014-11-15,texas-tech,,Oklahoma,L (30-42),27,50,54.0,393,4,24,93,3.9,0,74,486,6.6,15,5,3,23,9,85,0,0,0
2222,11,2014-11-22,texas-tech,@,Iowa State,W (34-31),23,35,65.7,328,4,40,272,6.8,1,75,600,8.0,12,14,1,27,9,73,1,1,2
2223,12,2014-11-29,texas-tech,N,Baylor,L (46-48),31,57,54.4,609,6,26,103,4.0,0,83,712,8.6,20,6,5,31,11,125,3,1,4
2224,,12 Games,texas-tech,,,,332,559,59.4,4213,40,355,1836,5.2,8,914,6049,6.6,178,95,23,296,112,1070,10,18,28
2225,1,2015-09-05,texas-tech,,Sam Houston State,W (59-45),34,57,59.6,437,4,31,174,5.6,2,88,611,6.9,18,10,1,29,10,69,0,1,1
2226,2,2015-09-12,texas-tech,,Texas-El Paso,W (69-20),23,42,54.8,445,4,30,229,7.6,5,72,674,9.4,17,11,1,29,4,38,0,0,0
2227,3,2015-09-19,texas-tech,@,Arkansas,W (35-24),27,31,87.1,315,2,27,171,6.3,3,58,486,8.4,14,9,1,24,4,31,0,2,2
2228,4,2015-09-26,texas-tech,,Texas Christian,L (52-55),25,45,55.6,392,2,39,215,5.5,5,84,607,7.2,14,12,6,32,3,32,0,0,0
2229,5,2015-10-03,texas-tech,N,Baylor,L (35-63),40,65,61.5,530,4,24,106,4.4,1,89,636,7.1,19,6,2,27,17,142,2,2,4
2230,6,2015-10-10,texas-tech,,Iowa State,W (66-31),39,56,69.6,515,6,31,261,8.4,3,87,776,8.9,21,11,1,33,7,50,0,0,0
2231,7,2015-10-17,texas-tech,@,Kansas,W (30-20),29,50,58.0,354,1,44,222,5.0,1,94,576,6.1,15,13,1,29,6,70,1,1,2
2232,8,2015-10-24,texas-tech,@,Oklahoma,L (27-63),29,45,64.4,253,1,40,172,4.3,2,85,425,5.0,11,14,3,28,7,57,0,4,4
2233,9,2015-10-31,texas-tech,,Oklahoma State,L (53-70),38,55,69.1,480,4,39,162,4.2,2,94,642,6.8,21,8,3,32,7,66,1,2,3
2234,10,2015-11-07,texas-tech,@,West Virginia,L (26-31),22,36,61.1,199,3,42,179,4.3,0,78,378,4.8,9,12,2,23,8,75,0,1,1
2235,11,2015-11-14,texas-tech,,Kansas State,W (59-44),33,43,76.7,384,3,40,274,6.9,5,83,658,7.9,16,15,1,32,7,73,1,0,1
2236,12,2015-11-26,texas-tech,@,Texas,W (48-45),22,39,56.4,372,1,51,293,5.7,5,90,665,7.4,12,16,0,28,6,70,3,1,4
2237,13,2015-12-29,texas-tech,N,Louisiana State*,L (27-56),28,56,50.0,370,4,26,29,1.1,0,82,399,4.9,16,4,2,22,6,63,0,1,1
2238,,13 Games,texas-tech,,,,389,620,62.7,5046,39,464,2487,5.4,34,1084,7533,6.9,203,141,24,368,92,836,8,15,23
2239,1,2016-09-03,texas-tech,,Stephen F. Austin,W (69-17),48,71,67.6,633,5,28,125,4.5,4,99,758,7.7,25,11,1,37,7,42,0,1,1
2240,2,2016-09-10,texas-tech,@,Arizona State,L (55-68),38,53,71.7,540,5,22,72,3.3,3,75,612,8.2,22,3,3,28,9,94,0,2,2
2241,3,2016-09-17,texas-tech,,Louisiana Tech,W (59-45),26,36,72.2,470,5,43,196,4.6,3,79,666,8.4,18,13,4,35,11,95,0,0,0
2242,4,2016-09-29,texas-tech,,Kansas,W (55-19),42,55,76.4,548,8,24,73,3.0,0,79,621,7.9,26,6,2,34,12,70,1,1,2
2243,5,2016-10-08,texas-tech,@,Kansas State,L (38-44),46,63,73.0,529,2,28,63,2.3,3,91,592,6.5,26,4,3,33,9,100,0,1,1
2244,6,2016-10-15,texas-tech,,West Virginia,L (17-48),32,50,64.0,345,2,27,34,1.3,0,77,379,4.9,12,6,3,21,10,103,0,1,1
2245,7,2016-10-22,texas-tech,,Oklahoma,L (59-66),52,88,59.1,734,5,21,120,5.7,3,109,854,7.8,32,9,1,42,11,92,1,1,2
2246,8,2016-10-29,texas-tech,@,Texas Christian,W (27-24),24,40,60.0,206,2,49,139,2.8,1,89,345,3.9,8,15,0,23,1,5,1,1,2
2247,9,2016-11-05,texas-tech,,Texas,L (37-45),36,59,61.0,367,3,41,115,2.8,1,100,482,4.8,17,9,5,31,4,14,1,1,2
2248,10,2016-11-12,texas-tech,@,Oklahoma State,L (44-45),35,52,67.3,376,3,44,142,3.2,3,96,518,5.4,20,9,5,34,3,15,1,0,1
2249,11,2016-11-19,texas-tech,@,Iowa State,L (10-66),19,39,48.7,222,1,30,84,2.8,0,69,306,4.4,11,5,1,17,2,7,1,2,3
2250,12,2016-11-25,texas-tech,N,Baylor,W (54-35),30,47,63.8,586,6,32,80,2.5,1,79,666,8.4,20,2,2,24,15,107,0,0,0
2251,,12 Games,texas-tech,,,,428,653,65.5,5556,47,389,1243,3.2,22,1042,6799,6.5,237,92,30,359,94,744,6,11,17
2252,1,2017-09-02,texas-tech,,Eastern Washington,W (56-10),31,35,88.6,449,4,40,177,4.4,3,75,626,8.3,17,12,3,32,11,120,0,0,0
2253,2,2017-09-16,texas-tech,,Arizona State,W (52-45),37,50,74.0,543,6,29,72,2.5,1,79,615,7.8,27,5,1,33,6,67,1,0,1
2254,3,2017-09-23,texas-tech,@,Houston,W (27-24),29,45,64.4,321,2,33,200,6.1,1,78,521,6.7,11,5,1,17,15,117,0,1,1
2255,4,2017-09-30,texas-tech,,Oklahoma State,L (34-41),29,46,63.0,330,1,26,54,2.1,2,72,384,5.3,15,4,6,25,8,63,0,1,1
2256,5,2017-10-07,texas-tech,@,Kansas,W (65-19),22,27,81.5,290,3,52,313,6.0,5,79,603,7.6,12,17,1,30,2,21,1,1,2
2257,6,2017-10-14,texas-tech,@,West Virginia,L (35-46),24,39,61.5,323,4,33,190,5.8,1,72,513,7.1,14,10,3,27,16,159,0,1,1
2258,7,2017-10-21,texas-tech,,Iowa State,L (13-31),31,41,75.6,207,0,41,129,3.1,2,82,336,4.1,13,11,0,24,3,30,2,1,3
2259,8,2017-10-28,texas-tech,@,Oklahoma,L (27-49),22,36,61.1,322,4,34,115,3.4,0,70,437,6.2,12,9,3,24,6,63,0,1,1
2260,9,2017-11-04,texas-tech,,Kansas State,L (35-42),34,53,64.2,405,4,31,122,3.9,1,84,527,6.3,18,7,1,26,8,79,0,1,1
2261,10,2017-11-11,texas-tech,N,Baylor,W (38-24),24,29,82.8,246,2,30,91,3.0,1,59,337,5.7,10,7,1,18,6,64,1,0,1
2262,11,2017-11-18,texas-tech,,Texas Christian,L (3-27),18,36,50.0,153,0,41,174,4.2,0,77,327,4.2,8,10,3,21,5,55,1,1,2
2263,12,2017-11-24,texas-tech,@,Texas,W (27-23),20,45,44.4,333,2,34,62,1.8,1,79,395,5.0,12,3,1,16,8,51,0,2,2
2264,13,2017-12-23,texas-tech,N,South Florida*,L (34-38),32,59,54.2,416,3,35,133,3.8,1,94,549,5.8,19,6,1,26,10,107,0,2,2
2265,,13 Games,texas-tech,,,,353,541,65.2,4338,35,459,1832,4.0,19,1000,6170,6.2,188,106,25,319,104,996,6,12,18
2266,1,2018-09-01,texas-tech,N,Mississippi,L (27-47),33,56,58.9,322,1,39,154,3.9,2,95,476,5.0,18,10,2,31,6,80,0,0,0
2267,2,2018-09-08,texas-tech,,Lamar,W (77-0),30,35,85.7,419,3,51,264,5.2,7,86,683,7.9,20,12,0,32,14,139,0,1,1
2268,3,2018-09-15,texas-tech,,Houston,W (63-49),43,59,72.9,605,5,41,99,2.4,4,100,704,7.0,25,6,5,36,9,82,1,0,1
2269,4,2018-09-22,texas-tech,@,Oklahoma State,W (41-17),35,46,76.1,397,2,46,224,4.9,3,92,621,6.8,20,11,4,35,3,20,0,2,2
2270,5,2018-09-29,texas-tech,,West Virginia,L (34-42),25,47,53.2,295,2,42,168,4.0,2,89,463,5.2,13,13,2,28,7,60,0,3,3
2271,6,2018-10-11,texas-tech,@,Texas Christian,W (17-14),15,27,55.6,202,1,43,151,3.5,1,70,353,5.0,7,9,1,17,12,89,0,1,1
2272,7,2018-10-20,texas-tech,,Kansas,W (48-16),39,49,79.6,441,3,35,112,3.2,3,84,553,6.6,21,7,2,30,7,50,2,1,3
2273,8,2018-10-27,texas-tech,@,Iowa State,L (31-40),33,57,57.9,333,1,24,30,1.3,1,81,363,4.5,20,4,0,24,10,85,0,3,3
2274,9,2018-11-03,texas-tech,,Oklahoma,L (46-51),30,44,68.2,366,4,27,107,4.0,2,71,473,6.7,15,4,4,23,7,69,0,0,0
2275,10,2018-11-10,texas-tech,,Texas,L (34-41),38,48,79.2,454,4,33,141,4.3,0,81,595,7.3,22,9,1,32,8,89,2,1,3
2276,11,2018-11-17,texas-tech,@,Kansas State,L (6-21),19,30,63.3,150,0,26,31,1.2,0,56,181,3.2,8,3,0,11,4,37,2,1,3
2277,,11 Games,texas-tech,,,,340,498,68.3,3984,26,407,1481,3.6,25,905,5465,6.0,189,88,21,299,87,800,7,13,20
2278,1,2014-08-30,iowa-state,,North Dakota State,L (14-34),20,31,64.5,151,0,26,102,3.9,2,57,253,4.4,5,10,1,16,5,31,0,2,2
2279,2,2014-09-06,iowa-state,,Kansas State,L (28-32),22,33,66.7,214,2,37,105,2.8,1,70,319,4.6,13,6,2,21,5,55,0,1,1
2280,3,2014-09-13,iowa-state,@,Iowa,W (20-17),25,36,69.4,255,2,26,82,3.2,0,62,337,5.4,13,4,2,19,4,50,1,0,1
2281,4,2014-09-27,iowa-state,,Baylor,L (28-49),17,39,43.6,212,2,34,127,3.7,2,73,339,4.6,9,6,3,18,7,45,0,1,1
2282,5,2014-10-04,iowa-state,@,Oklahoma State,L (20-37),17,39,43.6,200,2,33,122,3.7,0,72,322,4.5,8,8,1,17,3,45,0,0,0
2283,6,2014-10-11,iowa-state,,Toledo,W (37-30),37,53,69.8,351,3,34,103,3.0,1,87,454,5.2,23,7,4,34,5,50,0,0,0
2284,7,2014-10-18,iowa-state,@,Texas,L (45-48),36,55,65.5,345,3,38,179,4.7,2,93,524,5.6,18,11,1,30,5,59,1,2,3
2285,8,2014-11-01,iowa-state,,Oklahoma,L (14-59),17,45,37.8,247,1,31,87,2.8,1,76,334,4.4,9,5,3,17,4,40,1,0,1
2286,9,2014-11-08,iowa-state,@,Kansas,L (14-34),25,50,50.0,275,2,25,98,3.9,0,75,373,5.0,11,9,2,22,4,26,1,1,2
2287,10,2014-11-22,iowa-state,,Texas Tech,L (31-34),24,38,63.2,304,2,46,265,5.8,2,84,569,6.8,12,14,1,27,3,35,1,0,1
2288,11,2014-11-29,iowa-state,,West Virginia,L (24-37),26,50,52.0,275,2,40,135,3.4,1,90,410,4.6,12,8,2,22,4,35,0,2,2
2289,12,2014-12-06,iowa-state,@,Texas Christian,L (3-55),16,41,39.0,152,0,32,84,2.6,0,73,236,3.2,8,4,1,13,2,19,0,2,2
2290,,12 Games,iowa-state,,,,282,510,55.3,2981,21,402,1489,3.7,12,912,4470,4.9,141,92,23,256,51,490,5,11,16
2291,1,2015-09-05,iowa-state,,Northern Iowa,W (31-7),21,29,72.4,233,2,32,77,2.4,1,61,310,5.1,10,3,2,15,5,48,2,0,2
2292,2,2015-09-12,iowa-state,,Iowa,L (17-31),19,35,54.3,247,2,27,63,2.3,0,62,310,5.0,8,5,5,18,4,45,0,1,1
2293,3,2015-09-19,iowa-state,@,Toledo,L (23-30),26,43,60.5,274,1,49,207,4.2,1,92,481,5.2,13,13,1,27,14,113,1,0,1
2294,4,2015-10-03,iowa-state,,Kansas,W (38-13),27,37,73.0,269,2,37,243,6.6,3,74,512,6.9,12,11,1,24,2,10,0,2,2
2295,5,2015-10-10,iowa-state,@,Texas Tech,L (31-66),15,30,50.0,180,1,45,315,7.0,3,75,495,6.6,6,13,0,19,4,45,0,3,3
2296,6,2015-10-17,iowa-state,,Texas Christian,L (21-45),24,38,63.2,346,1,38,115,3.0,2,76,461,6.1,12,8,4,24,8,55,2,0,2
2297,7,2015-10-24,iowa-state,@,Baylor,L (27-45),15,29,51.7,156,3,55,232,4.2,1,84,388,4.6,7,15,1,23,4,30,2,2,4
2298,8,2015-10-31,iowa-state,,Texas,W (24-0),19,38,50.0,188,1,54,238,4.4,2,92,426,4.6,12,13,3,28,4,45,0,0,0
2299,9,2015-11-07,iowa-state,@,Oklahoma,L (16-52),26,51,51.0,260,1,38,114,3.0,0,89,374,4.2,11,11,0,22,5,23,0,1,1
2300,10,2015-11-14,iowa-state,,Oklahoma State,L (31-35),11,22,50.0,162,1,38,249,6.6,3,60,411,6.9,6,12,1,19,3,30,0,1,1
2301,11,2015-11-21,iowa-state,@,Kansas State,L (35-38),15,20,75.0,210,3,44,238,5.4,2,64,448,7.0,11,10,0,21,2,15,4,0,4
2302,12,2015-11-28,iowa-state,@,West Virginia,L (6-30),19,39,48.7,191,0,41,93,2.3,0,80,284,3.6,10,6,1,17,4,30,1,2,3
2303,,12 Games,iowa-state,,,,237,411,57.7,2716,18,498,2184,4.4,18,909,4900,5.4,118,120,19,257,59,489,12,12,24
2304,1,2016-09-03,iowa-state,,Northern Iowa,L (20-25),18,28,64.3,256,3,25,51,2.0,0,53,307,5.8,10,3,3,16,9,89,2,2,4
2305,2,2016-09-10,iowa-state,@,Iowa,L (3-42),14,35,40.0,165,0,35,126,3.6,0,70,291,4.2,8,7,1,16,10,73,0,1,1
2306,3,2016-09-17,iowa-state,@,Texas Christian,L (20-41),19,36,52.8,217,0,47,138,2.9,2,83,355,4.3,7,10,1,18,7,44,0,0,0
2307,4,2016-09-24,iowa-state,,San Jose State,W (44-10),22,29,75.9,316,5,32,187,5.8,1,61,503,8.2,13,9,1,23,3,25,1,0,1
2308,5,2016-10-01,iowa-state,,Baylor,L (42-45),17,23,73.9,261,2,54,204,3.8,4,77,465,6.0,12,12,2,26,9,80,0,0,0
2309,6,2016-10-08,iowa-state,@,Oklahoma State,L (31-38),25,44,56.8,283,3,42,165,3.9,1,86,448,5.2,14,9,3,26,7,41,1,2,3
2310,7,2016-10-15,iowa-state,@,Texas,L (6-27),19,34,55.9,182,0,43,98,2.3,0,77,280,3.6,7,9,3,19,6,64,1,0,1
2311,8,2016-10-29,iowa-state,,Kansas State,L (26-31),24,43,55.8,339,2,31,154,5.0,1,74,493,6.7,16,8,1,25,6,51,0,1,1
2312,9,2016-11-03,iowa-state,,Oklahoma,L (24-34),16,30,53.3,160,2,26,130,5.0,1,56,290,5.2,8,6,1,15,5,45,0,0,0
2313,10,2016-11-12,iowa-state,@,Kansas,W (31-24),21,30,70.0,220,2,46,238,5.2,2,76,458,6.0,12,11,1,24,5,59,0,1,1
2314,11,2016-11-19,iowa-state,,Texas Tech,W (66-10),17,22,77.3,336,2,43,272,6.3,6,65,608,9.4,14,10,0,24,2,25,0,0,0
2315,12,2016-11-26,iowa-state,,West Virginia,L (19-49),23,44,52.3,371,0,34,190,5.6,0,78,561,7.2,12,9,0,21,7,85,3,1,4
2316,,12 Games,iowa-state,,,,235,398,59.0,3106,21,458,1953,4.3,18,856,5059,5.9,133,103,17,253,76,681,8,8,16
2317,1,2017-09-02,iowa-state,,Northern Iowa,W (42-24),27,36,75.0,271,2,35,134,3.8,2,71,405,5.7,16,7,1,24,7,74,0,1,1
2318,2,2017-09-09,iowa-state,,Iowa,L (41-44),25,46,54.3,347,4,26,120,4.6,1,72,467,6.5,14,5,3,22,2,15,0,1,1
2319,3,2017-09-16,iowa-state,@,Akron,W (41-14),24,33,72.7,317,2,37,191,5.2,3,70,508,7.3,12,7,4,23,7,72,0,0,0
2320,4,2017-09-28,iowa-state,,Texas,L (7-17),24,49,49.0,246,1,15,10,0.7,0,64,256,4.0,15,2,1,18,4,40,0,3,3
2321,5,2017-10-07,iowa-state,@,Oklahoma,W (38-31),20,27,74.1,368,3,32,81,2.5,1,59,449,7.6,10,6,5,21,3,17,0,0,0
2322,6,2017-10-14,iowa-state,,Kansas,W (45-0),18,30,60.0,212,1,43,106,2.5,4,73,318,4.4,8,5,2,15,4,38,0,0,0
2323,7,2017-10-21,iowa-state,@,Texas Tech,W (31-13),22,32,68.8,192,3,36,208,5.8,0,68,400,5.9,11,8,1,20,0,0,0,1,1
2324,8,2017-10-28,iowa-state,,Texas Christian,W (14-7),21,35,60.0,202,2,33,53,1.6,0,68,255,3.8,11,2,4,17,4,35,0,1,1
2325,9,2017-11-04,iowa-state,@,West Virginia,L (16-20),27,40,67.5,249,1,29,101,3.5,0,69,350,5.1,13,5,5,23,3,30,0,1,1
2326,10,2017-11-11,iowa-state,,Oklahoma State,L (42-49),30,47,63.8,386,2,29,105,3.6,4,76,491,6.5,18,5,7,30,7,40,0,1,1
2327,11,2017-11-18,iowa-state,@,Baylor,W (23-13),14,28,50.0,180,2,40,214,5.4,0,68,394,5.8,7,13,1,21,4,50,0,0,0
2328,12,2017-11-25,iowa-state,@,Kansas State,L (19-20),24,36,66.7,264,2,30,115,3.8,0,66,379,5.7,10,7,1,18,9,85,0,0,0
2329,13,2017-12-30,iowa-state,@,Memphis*,W (21-20),24,38,63.2,314,2,42,32,0.8,1,80,346,4.3,15,5,2,22,3,20,1,0,1
2330,,13 Games,iowa-state,,,,300,477,62.9,3548,27,427,1470,3.4,16,904,5018,5.6,160,77,37,274,57,516,1,9,10
2331,1,2018-09-08,iowa-state,@,Iowa,L (3-13),19,31,61.3,169,0,25,19,0.8,0,56,188,3.4,6,4,1,11,7,65,1,0,1
2332,2,2018-09-15,iowa-state,,Oklahoma,L (27-37),25,36,69.4,360,2,29,87,3.0,1,65,447,6.9,12,6,2,20,4,35,0,1,1
2333,3,2018-09-22,iowa-state,,Akron,W (26-13),26,34,76.5,233,1,35,132,3.8,1,69,365,5.3,12,8,1,21,5,50,2,0,2
2334,4,2018-09-29,iowa-state,@,Texas Christian,L (14-17),14,28,50.0,79,1,28,119,4.3,1,56,198,3.5,6,6,3,15,1,15,1,0,1
2335,5,2018-10-06,iowa-state,@,Oklahoma State,W (48-42),19,25,76.0,325,4,38,140,3.7,2,63,465,7.4,11,7,3,21,5,36,1,1,2
2336,6,2018-10-13,iowa-state,,West Virginia,W (30-14),18,25,72.0,254,3,47,244,5.2,1,72,498,6.9,11,10,4,25,10,95,0,1,1
2337,7,2018-10-27,iowa-state,,Texas Tech,W (40-31),13,27,48.1,250,2,51,172,3.4,2,78,422,5.4,9,10,5,24,4,25,1,0,1
2338,8,2018-11-03,iowa-state,@,Kansas,W (27-3),17,24,70.8,273,3,38,121,3.2,0,62,394,6.4,10,9,1,20,2,12,0,0,0
2339,9,2018-11-10,iowa-state,,Baylor,W (28-14),18,23,78.3,230,1,30,127,4.2,2,53,357,6.7,12,8,1,21,4,30,0,0,0
2340,10,2018-11-17,iowa-state,@,Texas,L (10-24),13,29,44.8,148,0,30,62,2.1,1,59,210,3.6,5,7,0,12,3,20,1,1,2
2341,,10 Games,iowa-state,,,,182,282,64.5,2321,17,351,1223,3.5,11,633,3544,5.6,94,75,21,190,45,383,7,4,11
2342,1,2014-08-31,baylor,,Southern Methodist,W (45-0),27,47,57.4,313,3,50,261,5.2,3,97,574,5.9,15,15,1,31,11,96,1,1,2
2343,2,2014-09-06,baylor,,Northwestern State,W (70-6),19,28,67.9,455,5,50,265,5.3,5,78,720,9.2,12,19,1,32,10,91,2,0,2
2344,3,2014-09-12,baylor,@,Buffalo,W (63-21),25,37,67.6,480,5,41,189,4.6,4,78,669,8.6,17,10,0,27,5,40,0,0,0
2345,4,2014-09-27,baylor,@,Iowa State,W (49-28),32,50,64.0,357,1,47,244,5.2,6,97,601,6.2,17,12,3,32,10,78,0,1,1
2346,5,2014-10-04,baylor,@,Texas,W (28-7),7,22,31.8,111,2,60,278,4.6,1,82,389,4.7,5,17,0,22,10,95,0,0,0
2347,6,2014-10-11,baylor,,Texas Christian,W (61-58),28,55,50.9,510,6,54,272,5.0,1,109,782,7.2,17,18,4,39,12,117,1,2,3
2348,7,2014-10-18,baylor,@,West Virginia,L (27-41),16,37,43.2,223,2,42,95,2.3,1,79,318,4.0,10,5,7,22,18,215,0,0,0
2349,8,2014-11-01,baylor,,Kansas,W (60-14),21,36,58.3,343,3,52,326,6.3,4,88,669,7.6,12,17,1,30,6,54,0,0,0
2350,9,2014-11-08,baylor,@,Oklahoma,W (48-14),33,43,76.7,396,1,52,148,2.8,5,95,544,5.7,20,9,2,31,7,40,0,0,0
2351,10,2014-11-22,baylor,,Oklahoma State,W (49-28),18,29,62.1,262,2,58,317,5.5,5,87,579,6.7,10,19,0,29,12,68,0,2,2
2352,11,2014-11-29,baylor,N,Texas Tech,W (48-46),26,42,61.9,292,3,54,255,4.7,3,96,547,5.7,17,14,6,37,8,80,1,0,1
2353,12,2014-12-06,baylor,,Kansas State,W (38-27),34,41,82.9,412,1,37,172,4.6,4,78,584,7.5,24,10,0,34,7,70,0,1,1
2354,13,2015-01-01,baylor,N,Michigan State*,L (41-42),37,52,71.2,603,4,22,-20,-0.9,1,74,583,7.9,17,6,2,25,11,105,0,1,1
2355,,13 Games,baylor,,,,323,519,62.2,4757,38,619,2802,4.5,43,1138,7559,6.6,193,171,27,391,127,1149,5,8,13
2356,1,2015-09-04,baylor,@,Southern Methodist,W (56-21),17,32,53.1,423,6,37,300,8.1,2,69,723,10.5,12,14,1,27,13,105,0,1,1
2357,2,2015-09-12,baylor,,Lamar,W (66-31),26,38,68.4,373,4,56,412,7.4,5,94,785,8.4,16,21,1,38,12,93,1,3,4
2358,3,2015-09-26,baylor,,Rice,W (70-17),19,25,76.0,366,7,53,427,8.1,3,78,793,10.2,15,23,1,39,14,145,1,0,1
2359,4,2015-10-03,baylor,N,Texas Tech,W (63-35),16,24,66.7,312,4,52,368,7.1,5,76,680,8.9,12,12,2,26,8,72,0,1,1
2360,5,2015-10-10,baylor,@,Kansas,W (66-7),27,37,73.0,363,5,45,281,6.2,3,82,644,7.9,16,17,1,34,4,33,1,0,1
2361,6,2015-10-17,baylor,,West Virginia,W (62-38),21,34,61.8,389,6,50,304,6.1,2,84,693,8.3,15,16,3,34,6,80,0,0,0
2362,7,2015-10-24,baylor,,Iowa State,W (45-27),17,38,44.7,209,3,49,276,5.6,3,87,485,5.6,10,16,1,27,9,48,1,1,2
2363,8,2015-11-05,baylor,@,Kansas State,W (31-24),23,33,69.7,419,3,34,103,3.0,1,67,522,7.8,14,5,1,20,11,119,0,0,0
2364,9,2015-11-14,baylor,,Oklahoma,L (34-44),16,27,59.3,257,2,44,159,3.6,3,71,416,5.9,9,7,2,18,6,66,1,2,3
2365,10,2015-11-21,baylor,@,Oklahoma State,W (45-35),17,31,54.8,396,3,73,304,4.2,3,104,700,6.7,11,21,0,32,8,55,2,1,3
2366,11,2015-11-27,baylor,@,Texas Christian,L (21-28),7,24,29.2,62,1,71,273,3.8,2,95,335,3.5,3,16,2,21,6,50,4,1,5
2367,12,2015-12-05,baylor,,Texas,L (17-23),13,28,46.4,84,0,66,395,6.0,2,94,479,5.1,5,22,2,29,10,60,2,2,4
2368,13,2015-12-29,baylor,N,North Carolina*,W (49-38),10,18,55.6,111,0,82,651,7.9,7,100,762,7.6,6,30,2,38,11,117,0,1,1
2369,,13 Games,baylor,,,,229,389,58.9,3764,44,712,4253,6.0,41,1101,8017,7.3,144,220,19,383,118,1043,13,13,26
2370,1,2016-09-02,baylor,,Northwestern State,W (55-7),19,29,65.5,223,5,43,275,6.4,2,72,498,6.9,10,13,0,23,12,93,1,0,1
2371,2,2016-09-10,baylor,,Southern Methodist,W (40-13),26,48,54.2,261,2,55,275,5.0,2,103,536,5.2,9,18,2,29,14,101,1,2,3
2372,3,2016-09-16,baylor,@,Rice,W (38-10),23,42,54.8,342,3,54,296,5.5,2,96,638,6.6,15,16,0,31,8,85,0,1,1
2373,4,2016-09-24,baylor,,Oklahoma State,W (35-24),18,28,64.3,387,4,37,136,3.7,1,65,523,8.0,11,8,1,20,7,70,1,1,2
2374,5,2016-10-01,baylor,@,Iowa State,W (45-42),12,22,54.5,178,1,62,469,7.6,5,84,647,7.7,6,22,2,30,9,79,0,0,0
2375,6,2016-10-15,baylor,,Kansas,W (49-7),13,30,43.3,207,2,49,246,5.0,4,79,453,5.7,4,15,1,20,6,38,1,0,1
2376,7,2016-10-29,baylor,@,Texas,L (34-35),14,28,50.0,226,2,68,398,5.9,2,96,624,6.5,9,22,0,31,10,39,1,1,2
2377,8,2016-11-05,baylor,,Texas Christian,L (22-62),22,43,51.2,282,1,45,133,3.0,2,88,415,4.7,11,7,1,19,11,121,0,1,1
2378,9,2016-11-12,baylor,@,Oklahoma,L (24-45),21,46,45.7,292,2,45,212,4.7,1,91,504,5.5,12,11,1,24,9,55,1,2,3
2379,10,2016-11-19,baylor,,Kansas State,L (21-42),27,46,58.7,258,3,33,110,3.3,0,79,368,4.7,11,8,3,22,9,84,1,3,4
2380,11,2016-11-25,baylor,N,Texas Tech,L (35-54),30,47,63.8,377,3,53,257,4.8,2,100,634,6.3,15,15,2,32,11,78,3,1,4
2381,12,2016-12-03,baylor,@,West Virginia,L (21-24),15,31,48.4,244,2,41,196,4.8,1,72,440,6.1,12,7,0,19,12,100,2,2,4
2382,13,2016-12-27,baylor,N,Boise State*,W (31-12),29,40,72.5,375,3,43,140,3.3,1,83,515,6.2,16,12,1,29,11,125,0,1,1
2383,,13 Games,baylor,,,,269,480,56.0,3652,33,628,3143,5.0,25,1108,6795,6.1,141,174,14,329,129,1068,12,15,27
2384,1,2017-09-02,baylor,,Liberty,L (45-48),14,30,46.7,278,3,34,254,7.5,3,64,532,8.3,9,10,3,22,7,61,0,2,2
2385,2,2017-09-09,baylor,,Texas-San Antonio,L (10-17),11,27,40.7,137,1,31,137,4.4,0,58,274,4.7,5,7,2,14,10,98,0,1,1
2386,3,2017-09-16,baylor,@,Duke,L (20-34),12,34,35.3,263,3,27,57,2.1,0,61,320,5.2,6,3,0,9,11,100,1,3,4
2387,4,2017-09-23,baylor,,Oklahoma,L (41-49),33,50,66.0,463,4,35,60,1.7,0,85,523,6.2,19,2,1,22,6,29,1,0,1
2388,5,2017-09-30,baylor,@,Kansas State,L (20-33),26,44,59.1,291,1,27,84,3.1,1,71,375,5.3,13,4,1,18,10,60,1,1,2
2389,6,2017-10-14,baylor,@,Oklahoma State,L (16-59),14,36,38.9,168,0,46,219,4.8,1,82,387,4.7,10,11,1,22,5,39,1,2,3
2390,7,2017-10-21,baylor,,West Virginia,L (36-38),24,40,60.0,370,2,42,127,3.0,2,82,497,6.1,13,9,8,30,6,20,0,0,0
2391,8,2017-10-28,baylor,,Texas,L (7-38),21,38,55.3,218,0,37,31,0.8,1,75,249,3.3,5,6,1,12,6,34,2,1,3
2392,9,2017-11-04,baylor,@,Kansas,W (38-9),24,30,80.0,335,3,39,120,3.1,2,69,455,6.6,13,7,0,20,7,60,0,0,0
2393,10,2017-11-11,baylor,N,Texas Tech,L (24-38),43,63,68.3,417,3,29,106,3.7,0,92,523,5.7,21,7,3,31,6,65,3,1,4
2394,11,2017-11-18,baylor,,Iowa State,L (13-23),26,36,72.2,198,1,38,133,3.5,0,74,331,4.5,13,10,2,25,4,30,1,1,2
2395,12,2017-11-24,baylor,@,Texas Christian,L (22-45),21,34,61.8,314,2,29,79,2.7,0,63,393,6.2,10,4,0,14,10,75,1,2,3
2396,,12 Games,baylor,,,,269,462,58.2,3452,23,414,1407,3.4,10,876,4859,5.5,137,80,22,239,88,671,11,14,25
2397,1,2018-09-01,baylor,,Abilene Christian,W (55-27),18,28,64.3,311,2,36,295,8.2,5,64,606,9.5,12,14,0,26,5,53,0,1,1
2398,2,2018-09-08,baylor,@,Texas-San Antonio,W (37-20),27,41,65.9,403,3,31,91,2.9,1,72,494,6.9,16,7,3,26,7,70,1,0,1
2399,3,2018-09-15,baylor,,Duke,L (27-40),24,42,57.1,270,1,32,130,4.1,2,74,400,5.4,12,9,0,21,6,62,1,1,2
2400,4,2018-09-22,baylor,,Kansas,W (26-7),20,29,69.0,257,3,39,190,4.9,0,68,447,6.6,10,10,2,22,13,141,0,0,0
2401,5,2018-09-29,baylor,@,Oklahoma,L (33-66),40,63,63.5,416,2,38,77,2.0,2,101,493,4.9,18,11,4,33,9,75,1,0,1
2402,6,2018-10-06,baylor,,Kansas State,W (37-34),30,45,66.7,296,1,48,261,5.4,3,93,557,6.0,19,17,2,38,2,10,0,2,2
2403,7,2018-10-13,baylor,@,Texas,L (17-23),20,39,51.3,240,1,34,88,2.6,1,73,328,4.5,10,8,1,19,10,142,0,1,1
2404,8,2018-10-25,baylor,@,West Virginia,L (14-58),17,29,58.6,205,0,36,82,2.3,2,65,287,4.4,9,7,1,17,8,75,1,3,4
2405,9,2018-11-03,baylor,,Oklahoma State,W (35-31),14,26,53.8,158,2,39,244,6.3,2,65,402,6.2,6,12,8,26,6,69,0,1,1
2406,10,2018-11-10,baylor,@,Iowa State,L (14-28),29,48,60.4,359,2,32,146,4.6,0,80,505,6.3,15,9,1,25,7,70,0,0,0
2407,11,2018-11-17,baylor,,Texas Christian,L (9-16),14,29,48.3,163,0,40,140,3.5,1,69,303,4.4,7,10,3,20,9,66,2,1,3
2408,,11 Games,baylor,,,,253,419,60.4,3078,17,405,1744,4.3,19,824,4822,5.9,134,114,25,273,82,833,6,10,16
2409,1,2014-09-06,kansas,,Southeast Missouri State,W (34-28),12,24,50.0,196,3,49,261,5.3,1,73,457,6.3,8,11,1,20,9,80,0,0,0
2410,2,2014-09-13,kansas,@,Duke,L (3-41),12,29,41.4,95,0,47,202,4.3,0,76,297,3.9,2,13,2,17,7,74,0,2,2
2411,3,2014-09-20,kansas,,Central Michigan,W (24-10),24,34,70.6,231,2,35,138,3.9,1,69,369,5.3,10,5,0,15,8,65,0,1,1
2412,4,2014-09-27,kansas,,Texas,L (0-23),12,31,38.7,140,0,51,173,3.4,0,82,313,3.8,6,12,1,19,7,52,0,4,4
2413,5,2014-10-04,kansas,@,West Virginia,L (14-33),13,28,46.4,111,0,34,65,1.9,1,62,176,2.8,4,4,1,9,11,101,0,0,0
2414,6,2014-10-11,kansas,,Oklahoma State,L (20-27),20,37,54.1,288,0,41,91,2.2,2,78,379,4.9,12,5,1,18,8,65,0,1,1
2415,7,2014-10-18,kansas,@,Texas Tech,L (21-34),20,32,62.5,235,2,40,128,3.2,1,72,363,5.0,11,8,0,19,4,37,1,1,2
2416,8,2014-11-01,kansas,@,Baylor,L (14-60),21,30,70.0,288,2,27,16,0.6,0,57,304,5.3,8,1,3,12,6,60,3,0,3
2417,9,2014-11-08,kansas,,Iowa State,W (34-14),26,43,60.5,286,1,48,228,4.8,3,91,514,5.6,18,11,0,29,4,32,0,0,0
2418,10,2014-11-15,kansas,,Texas Christian,L (30-34),20,38,52.6,342,2,36,76,2.1,2,74,418,5.6,13,5,1,19,7,55,0,1,1
2419,11,2014-11-22,kansas,@,Oklahoma,L (7-44),8,23,34.8,84,0,36,19,0.5,0,59,103,1.7,4,2,1,7,2,20,1,1,2
2420,12,2014-11-29,kansas,@,Kansas State,L (13-51),16,27,59.3,139,2,22,57,2.6,0,49,196,4.0,8,4,1,13,3,28,0,2,2
2421,,12 Games,kansas,,,,204,376,54.3,2435,14,466,1454,3.1,11,842,3889,4.6,104,81,12,197,76,669,5,13,18
2422,1,2015-09-05,kansas,,South Dakota State,L (38-41),25,40,62.5,291,1,51,285,5.6,3,91,576,6.3,15,14,0,29,7,75,1,1,2
2423,2,2015-09-12,kansas,,Memphis,L (23-55),18,38,47.4,165,0,46,194,4.2,2,84,359,4.3,0,0,0,23,7,68,0,0,0
2424,3,2015-09-26,kansas,@,Rutgers,L (14-27),19,32,59.4,278,0,29,64,2.2,2,61,342,5.6,15,1,2,18,4,46,0,1,1
2425,4,2015-10-03,kansas,@,Iowa State,L (13-38),23,37,62.2,250,1,33,38,1.2,0,70,288,4.1,11,4,0,15,5,37,1,0,1
2426,5,2015-10-10,kansas,,Baylor,L (7-66),20,36,55.6,158,1,39,69,1.8,0,75,227,3.0,7,5,2,14,4,50,2,1,3
2427,6,2015-10-17,kansas,,Texas Tech,L (20-30),35,50,70.0,330,2,40,145,3.6,1,90,475,5.3,17,7,2,26,5,41,2,1,3
2428,7,2015-10-24,kansas,@,Oklahoma State,L (10-58),12,31,38.7,191,1,27,30,1.1,0,58,221,3.8,7,2,0,9,10,102,0,2,2
2429,8,2015-10-31,kansas,,Oklahoma,L (7-62),20,34,58.8,181,1,36,35,1.0,0,70,216,3.1,10,3,2,15,6,81,2,0,2
2430,9,2015-11-07,kansas,@,Texas,L (20-59),19,41,46.3,234,1,48,192,4.0,1,89,426,4.8,10,13,0,23,3,15,1,3,4
2431,10,2015-11-14,kansas,@,Texas Christian,L (17-23),20,41,48.8,203,1,30,121,4.0,1,71,324,4.6,7,5,1,13,8,53,0,1,1
2432,11,2015-11-21,kansas,,West Virginia,L (0-49),13,37,35.1,127,0,30,82,2.7,0,67,209,3.1,3,5,2,10,5,46,1,3,4
2433,12,2015-11-28,kansas,,Kansas State,L (14-45),19,35,54.3,215,2,35,100,2.9,0,70,315,4.5,10,7,0,17,6,50,0,1,1
2434,,12 Games,kansas,,,,243,452,53.8,2623,11,444,1355,3.1,10,896,3978,4.4,112,66,11,212,70,664,10,14,24
2435,1,2016-09-03,kansas,,Rhode Island,W (55-6),28,38,73.7,399,6,35,171,4.9,2,73,570,7.8,16,12,0,28,4,37,1,1,2
2436,2,2016-09-10,kansas,,Ohio,L (21-37),18,29,62.1,206,2,15,26,1.7,0,44,232,5.3,7,1,1,9,4,50,2,1,3
2437,3,2016-09-17,kansas,@,Memphis,L (7-43),26,41,63.4,193,0,31,121,3.9,1,72,314,4.4,6,5,3,14,8,41,4,2,6
2438,4,2016-09-29,kansas,@,Texas Tech,L (19-55),25,48,52.1,250,2,28,46,1.6,0,76,296,3.9,13,4,0,17,7,55,1,1,2
2439,5,2016-10-08,kansas,,Texas Christian,L (23-24),31,45,68.9,348,0,44,122,2.8,2,89,470,5.3,13,8,2,23,5,61,1,3,4
2440,6,2016-10-15,kansas,@,Baylor,L (7-49),13,27,48.1,134,0,48,83,1.7,1,75,217,2.9,4,9,2,15,4,35,1,4,5
2441,7,2016-10-22,kansas,,Oklahoma State,L (20-44),24,40,60.0,250,1,33,204,6.2,1,73,454,6.2,11,8,1,20,5,46,1,2,3
2442,8,2016-10-29,kansas,@,Oklahoma,L (3-56),21,37,56.8,121,0,28,49,1.8,0,65,170,2.6,4,5,2,11,6,40,0,2,2
2443,9,2016-11-05,kansas,@,West Virginia,L (21-48),21,36,58.3,291,2,37,150,4.1,1,73,441,6.0,10,6,2,18,9,104,0,2,2
2444,10,2016-11-12,kansas,,Iowa State,L (24-31),26,38,68.4,171,1,40,244,6.1,2,78,415,5.3,7,16,2,25,1,15,1,1,2
2445,11,2016-11-19,kansas,,Texas,W (24-21),21,42,50.0,220,0,39,112,2.9,1,81,332,4.1,7,6,2,15,9,85,1,1,2
2446,12,2016-11-26,kansas,@,Kansas State,L (19-34),24,44,54.5,302,2,27,101,3.7,0,71,403,5.7,8,9,1,18,9,85,1,2,3
2447,,12 Games,kansas,,,,278,465,59.8,2885,16,405,1429,3.5,11,870,4314,5.0,106,89,18,213,71,654,14,22,36
2448,1,2017-09-02,kansas,,Southeast Missouri State,W (38-16),23,37,62.2,364,4,25,73,2.9,1,62,437,7.0,12,4,1,17,5,49,1,2,3
2449,2,2017-09-09,kansas,,Central Michigan,L (27-45),32,62,51.6,323,0,34,147,4.3,3,96,470,4.9,20,7,2,29,9,65,0,2,2
2450,3,2017-09-16,kansas,@,Ohio,L (30-42),30,47,63.8,343,2,32,108,3.4,2,79,451,5.7,17,5,1,23,7,50,0,1,1
2451,4,2017-09-23,kansas,,West Virginia,L (34-56),17,34,50.0,197,1,50,367,7.3,3,84,564,6.7,8,13,3,24,8,43,1,2,3
2452,5,2017-10-07,kansas,,Texas Tech,L (19-65),23,43,53.5,256,1,33,112,3.4,1,76,368,4.8,9,7,1,17,4,35,2,2,4
2453,6,2017-10-14,kansas,@,Iowa State,L (0-45),11,26,42.3,44,0,33,62,1.9,0,59,106,1.8,1,3,1,5,8,75,1,1,2
2454,7,2017-10-21,kansas,@,Texas Christian,L (0-43),8,18,44.4,46,0,31,-25,-0.8,0,49,21,0.4,1,1,2,4,4,40,0,0,0
2455,8,2017-10-28,kansas,,Kansas State,L (20-30),23,48,47.9,418,1,28,64,2.3,1,76,482,6.3,14,6,0,20,4,42,1,1,2
2456,9,2017-11-04,kansas,,Baylor,L (9-38),19,36,52.8,163,0,33,126,3.8,0,69,289,4.2,6,8,1,15,4,30,1,1,2
2457,10,2017-11-11,kansas,@,Texas,L (27-42),27,43,62.8,268,3,35,96,2.7,0,78,364,4.7,11,7,1,19,5,45,1,3,4
2458,11,2017-11-18,kansas,,Oklahoma,L (3-41),19,34,55.9,123,0,27,32,1.2,0,61,155,2.5,6,2,2,10,5,60,1,1,2
2459,12,2017-11-25,kansas,@,Oklahoma State,L (17-58),17,32,53.1,172,2,30,69,2.3,0,62,241,3.9,8,3,0,11,3,19,0,1,1
2460,,12 Games,kansas,,,,249,460,54.1,2717,14,391,1231,3.1,11,851,3948,4.6,113,66,15,194,66,553,9,17,26
2461,1,2018-09-01,kansas,,Nicholls State,L (23-26),21,38,55.3,199,2,32,56,1.8,0,70,255,3.6,8,5,1,14,7,54,1,0,1
2462,2,2018-09-08,kansas,@,Central Michigan,W (31-7),18,27,66.7,145,1,45,216,4.8,2,72,361,5.0,8,10,2,20,7,55,0,0,0
2463,3,2018-09-15,kansas,,Rutgers,W (55-14),15,25,60.0,144,1,48,400,8.3,4,73,544,7.5,9,12,1,22,7,67,0,0,0
2464,4,2018-09-22,kansas,@,Baylor,L (7-26),16,27,59.3,149,1,28,122,4.4,0,55,271,4.9,5,5,4,14,7,55,0,0,0
2465,5,2018-09-29,kansas,,Oklahoma State,L (28-48),24,32,75.0,247,3,32,121,3.8,1,64,368,5.8,11,5,2,18,4,43,1,0,1
2466,6,2018-10-06,kansas,@,West Virginia,L (22-38),21,34,61.8,206,2,26,80,3.1,1,60,286,4.8,9,5,2,16,6,45,1,2,3
2467,7,2018-10-20,kansas,@,Texas Tech,L (16-48),18,41,43.9,221,2,29,98,3.4,0,70,319,4.6,9,6,1,16,6,62,1,1,2
2468,8,2018-10-27,kansas,,Texas Christian,W (27-26),19,29,65.5,249,2,38,58,1.5,1,67,307,4.6,12,4,1,17,8,59,0,0,0
2469,9,2018-11-03,kansas,,Iowa State,L (3-27),19,43,44.2,185,0,40,147,3.7,0,83,332,4.0,11,8,1,20,3,25,1,0,1
2470,10,2018-11-10,kansas,@,Kansas State,L (17-21),21,34,61.8,232,2,35,115,3.3,0,69,347,5.0,13,4,2,19,8,53,2,0,2
2471,11,2018-11-17,kansas,@,Oklahoma,L (40-55),20,28,71.4,176,1,36,348,9.7,4,64,524,8.2,8,17,0,25,6,53,0,0,0
2472,,11 Games,kansas,,,,212,358,59.2,2153,17,389,1761,4.5,13,747,3914,5.2,103,81,17,201,69,571,7,3,10
2473,1,2014-08-30,missouri,,South Dakota State,W (38-18),13,21,61.9,178,3,39,215,5.5,1,60,393,6.6,6,13,0,19,5,27,0,0,0
2474,2,2014-09-06,missouri,@,Toledo,W (49-24),21,33,63.6,325,5,47,177,3.8,2,80,502,6.3,15,9,1,25,2,25,0,2,2
2475,3,2014-09-13,missouri,,Central Florida,W (38-10),14,24,58.3,144,4,35,178,5.1,0,59,322,5.5,8,10,1,19,4,47,0,1,1
2476,4,2014-09-20,missouri,,Indiana,L (27-31),29,48,60.4,331,2,35,172,4.9,1,83,503,6.1,18,8,2,27,10,75,0,1,1
2477,5,2014-09-27,missouri,@,South Carolina,W (21-20),12,34,35.3,132,0,36,148,4.1,3,70,280,4.0,5,9,2,16,8,74,0,0,0
2478,6,2014-10-11,missouri,,Georgia,L (0-34),9,21,42.9,97,0,22,50,2.3,0,43,147,3.4,5,4,1,10,4,30,1,4,5
2479,7,2014-10-18,missouri,@,Florida,W (42-13),6,18,33.3,20,0,31,99,3.2,1,49,119,2.4,1,6,0,7,11,74,0,1,1
2480,8,2014-10-25,missouri,,Vanderbilt,W (24-14),11,23,47.8,141,2,46,244,5.3,1,69,385,5.6,7,12,1,20,14,100,0,0,0
2481,9,2014-11-01,missouri,,Kentucky,W (20-10),18,33,54.5,164,2,45,156,3.5,0,78,320,4.1,10,8,3,21,5,50,0,0,0
2482,10,2014-11-15,missouri,@,Texas A&M,W (34-27),23,40,57.5,252,1,49,335,6.8,3,89,587,6.6,13,16,3,32,12,81,0,1,1
2483,11,2014-11-22,missouri,@,Tennessee,W (29-21),12,25,48.0,230,2,45,180,4.0,2,70,410,5.9,8,9,2,19,12,82,0,0,0
2484,12,2014-11-28,missouri,,Arkansas,W (21-14),25,42,59.5,265,1,41,158,3.9,1,83,423,5.1,12,12,2,26,7,75,1,1,2
2485,13,2014-12-06,missouri,N,Alabama,L (13-42),16,34,47.1,272,1,23,41,1.8,0,57,313,5.5,9,1,0,10,6,60,1,0,1
2486,14,2015-01-01,missouri,N,Minnesota*,W (33-17),12,19,63.2,97,2,45,337,7.5,2,64,434,6.8,5,12,1,18,2,15,0,2,2
2487,,14 Games,missouri,,,,221,415,53.3,2648,25,539,2490,4.6,17,954,5138,5.4,122,129,19,269,102,815,3,13,16
2488,1,2015-09-05,missouri,,Southeast Missouri State,W (34-3),18,32,56.3,319,3,33,98,3.0,0,65,417,6.4,11,5,3,19,6,54,0,1,1
2489,2,2015-09-12,missouri,@,Arkansas State,W (27-20),16,37,43.2,148,3,34,140,4.1,0,71,288,4.1,8,8,3,19,9,75,0,3,3
2490,3,2015-09-19,missouri,,Connecticut,W (9-6),20,31,64.5,185,0,34,85,2.5,1,65,270,4.2,7,7,2,16,3,30,1,1,2
2491,4,2015-09-26,missouri,@,Kentucky,L (13-21),18,35,51.4,227,1,33,111,3.4,0,68,338,5.0,12,7,5,24,3,30,0,0,0
2492,5,2015-10-03,missouri,,South Carolina,W (24-10),21,28,75.0,136,2,42,163,3.9,1,70,299,4.3,5,13,0,18,3,29,0,0,0
2493,6,2015-10-10,missouri,,Florida,L (3-21),16,39,41.0,151,0,26,106,4.1,0,65,257,4.0,6,6,0,12,6,38,0,2,2
2494,7,2015-10-17,missouri,@,Georgia,L (6-9),11,26,42.3,143,0,22,21,1.0,0,48,164,3.4,5,0,1,6,4,27,1,0,1
2495,8,2015-10-24,missouri,@,Vanderbilt,L (3-10),14,34,41.2,108,0,19,80,4.2,0,53,188,3.5,5,3,2,10,6,37,1,0,1
2496,9,2015-11-05,missouri,,Mississippi State,L (13-31),11,26,42.3,107,0,45,215,4.8,1,71,322,4.5,6,9,1,16,6,38,0,2,2
2497,10,2015-11-14,missouri,N,Brigham Young,W (20-16),19,28,67.9,244,1,55,190,3.5,1,83,434,5.2,12,9,2,23,8,91,1,1,2
2498,11,2015-11-21,missouri,,Tennessee,L (8-19),13,30,43.3,135,0,29,88,3.0,1,59,223,3.8,5,4,1,10,7,50,1,1,2
2499,12,2015-11-27,missouri,@,Arkansas,L (3-28),9,27,33.3,83,0,25,88,3.5,0,52,171,3.3,3,5,0,8,2,18,0,1,1
2500,,12 Games,missouri,,,,186,373,49.9,1986,10,397,1385,3.5,5,770,3371,4.4,85,76,20,181,63,517,5,12,17
2501,1,2016-09-03,missouri,@,West Virginia,L (11-26),24,53,45.3,282,1,47,180,3.8,0,100,462,4.6,11,13,2,26,6,51,1,0,1
2502,2,2016-09-10,missouri,,Eastern Michigan,W (61-21),27,40,67.5,477,5,38,170,4.5,2,78,647,8.3,15,12,3,30,8,75,2,0,2
2503,3,2016-09-17,missouri,,Georgia,L (27-28),23,38,60.5,376,3,37,95,2.6,0,75,471,6.3,10,8,0,18,7,50,2,3,5
2504,4,2016-09-24,missouri,,Delaware State,W (79-0),29,39,74.4,430,6,39,268,6.9,5,78,698,8.9,15,17,2,34,6,60,0,0,0
2505,5,2016-10-01,missouri,@,Louisiana State,L (7-42),18,38,47.4,188,1,22,77,3.5,0,60,265,4.4,10,3,1,14,5,50,0,1,1
2506,6,2016-10-15,missouri,@,Florida,L (14-40),7,22,31.8,98,0,46,265,5.8,2,68,363,5.3,4,11,1,16,5,24,1,2,3
2507,7,2016-10-22,missouri,,Middle Tennessee State,L (45-51),20,40,50.0,281,2,64,348,5.4,4,104,629,6.0,13,21,2,36,13,125,2,0,2
2508,8,2016-10-29,missouri,,Kentucky,L (21-35),19,32,59.4,229,2,37,157,4.2,1,69,386,5.6,9,8,1,18,9,65,0,0,0
2509,9,2016-11-05,missouri,@,South Carolina,L (21-31),23,40,57.5,302,1,36,163,4.5,2,76,465,6.1,12,11,1,24,5,45,1,2,3
2510,10,2016-11-12,missouri,,Vanderbilt,W (26-17),22,37,59.5,294,2,37,187,5.1,1,74,481,6.5,10,7,3,20,7,90,1,0,1
2511,11,2016-11-19,missouri,@,Tennessee,L (37-63),21,43,48.8,320,1,67,420,6.3,4,110,740,6.7,13,27,1,41,7,51,2,2,4
2512,12,2016-11-25,missouri,,Arkansas,W (28-24),16,26,61.5,268,1,30,131,4.4,3,56,399,7.1,8,6,1,15,2,10,1,0,1
2513,,12 Games,missouri,,,,249,448,55.6,3545,25,500,2461,4.9,24,948,6006,6.3,130,144,18,292,80,696,13,10,23
2514,1,2017-09-02,missouri,,Missouri State,W (72-43),21,34,61.8,521,7,41,294,7.2,3,75,815,10.9,19,15,1,35,6,52,1,1,2
2515,2,2017-09-09,missouri,,South Carolina,L (13-31),14,32,43.8,245,1,37,178,4.8,0,69,423,6.1,10,11,0,21,4,24,1,2,3
2516,3,2017-09-16,missouri,,Purdue,L (3-35),12,28,42.9,133,0,24,70,2.9,0,52,203,3.9,5,4,1,10,6,46,1,2,3
2517,4,2017-09-23,missouri,,Auburn,L (14-51),23,39,59.0,216,2,30,124,4.1,0,69,340,4.9,12,7,2,21,7,55,3,1,4
2518,5,2017-10-07,missouri,@,Kentucky,L (34-40),22,43,51.2,355,3,33,213,6.5,1,76,568,7.5,11,13,0,24,7,55,2,0,2
2519,6,2017-10-14,missouri,@,Georgia,L (28-53),15,25,60.0,253,4,24,59,2.5,0,49,312,6.4,6,4,0,10,4,40,0,1,1
2520,7,2017-10-21,missouri,,Idaho,W (68-21),24,34,70.6,475,6,30,183,6.1,2,64,658,10.3,20,7,1,28,6,45,0,1,1
2521,8,2017-10-28,missouri,@,Connecticut,W (52-12),34,43,79.1,408,5,34,175,5.1,2,77,583,7.6,16,12,3,31,12,107,0,1,1
2522,9,2017-11-04,missouri,,Florida,W (45-16),15,21,71.4,228,3,46,227,4.9,3,67,455,6.8,10,12,4,26,7,71,0,1,1
2523,10,2017-11-11,missouri,,Tennessee,W (50-17),14,30,46.7,226,4,53,433,8.2,2,83,659,7.9,7,20,2,29,7,60,0,1,1
2524,11,2017-11-18,missouri,@,Vanderbilt,W (45-17),10,25,40.0,235,3,39,191,4.9,1,64,426,6.7,7,9,1,17,11,56,0,0,0
2525,12,2017-11-24,missouri,@,Arkansas,W (48-45),25,42,59.5,448,5,60,248,4.1,1,102,696,6.8,17,14,4,35,10,77,0,2,2
2526,13,2017-12-27,missouri,N,Texas*,L (16-33),18,34,52.9,269,1,33,134,4.1,1,67,403,6.0,10,5,2,17,9,86,3,1,4
2527,,13 Games,missouri,,,,247,430,57.4,4012,44,484,2529,5.2,16,914,6541,7.2,150,133,21,304,96,774,11,14,25
2528,1,2018-09-01,missouri,,Tennessee-Martin,W (51-14),23,34,67.6,394,4,44,164,3.7,2,78,558,7.2,13,8,5,26,4,45,0,0,0
2529,2,2018-09-08,missouri,,Wyoming,W (40-13),33,45,73.3,398,4,46,203,4.4,1,91,601,6.6,23,10,0,33,8,79,1,0,1
2530,3,2018-09-15,missouri,@,Purdue,W (40-37),26,43,60.5,375,3,46,233,5.1,1,89,608,6.8,14,14,3,31,4,27,0,1,1
2531,4,2018-09-22,missouri,,Georgia,L (29-43),23,48,47.9,221,0,37,172,4.6,4,85,393,4.6,15,9,2,26,5,30,2,1,3
2532,5,2018-10-06,missouri,@,South Carolina,L (35-37),17,36,47.2,204,0,46,286,6.2,3,82,490,6.0,9,10,4,23,10,83,0,2,2
2533,6,2018-10-13,missouri,@,Alabama,L (10-39),13,26,50.0,142,1,35,70,2.0,0,61,212,3.5,6,5,2,13,5,53,1,2,3
2534,7,2018-10-20,missouri,,Memphis,W (65-33),24,32,75.0,373,4,40,273,6.8,4,72,646,9.0,13,14,3,30,12,122,0,0,0
2535,8,2018-10-27,missouri,,Kentucky,L (14-15),15,27,55.6,165,0,35,84,2.4,2,62,249,4.0,7,3,3,13,8,69,0,0,0
2536,9,2018-11-03,missouri,@,Florida,W (38-17),24,32,75.0,250,3,42,221,5.3,2,74,471,6.4,12,10,0,22,11,84,0,0,0
2537,10,2018-11-10,missouri,,Vanderbilt,W (33-28),22,33,66.7,253,2,49,253,5.2,2,82,506,6.2,12,17,1,30,2,15,0,2,2
2538,11,2018-11-17,missouri,@,Tennessee,W (50-17),21,30,70.0,257,2,49,227,4.6,3,79,484,6.1,14,12,3,29,10,79,1,0,1
2539,,11 Games,missouri,,,,241,386,62.4,3032,23,469,2186,4.7,24,855,5218,6.1,138,112,26,276,79,686,5,8,13
2540,1,2014-08-30,nebraska,,Florida Atlantic,W (55-7),17,35,48.6,286,2,57,498,8.7,5,92,784,8.5,11,24,0,35,6,60,0,0,0
2541,2,2014-09-06,nebraska,,McNeese State,W (31-24),16,31,51.6,242,2,33,195,5.9,2,64,437,6.8,9,7,1,17,5,40,0,1,1
2542,3,2014-09-13,nebraska,@,Fresno State,W (55-19),14,24,58.3,282,4,42,280,6.7,2,66,562,8.5,13,7,2,22,6,61,1,0,1
2543,4,2014-09-20,nebraska,,Miami (FL),W (41-31),9,13,69.2,113,2,54,343,6.4,2,67,456,6.8,5,17,5,27,7,69,1,1,2
2544,5,2014-09-27,nebraska,,Illinois,W (45-14),10,21,47.6,166,1,70,458,6.5,5,91,624,6.9,6,26,3,35,8,70,1,1,2
2545,6,2014-10-04,nebraska,@,Michigan State,L (22-27),21,45,46.7,282,0,37,47,1.3,2,82,329,4.0,12,5,3,20,6,48,2,2,4
2546,7,2014-10-18,nebraska,@,Northwestern,W (38-17),19,30,63.3,237,1,44,234,5.3,4,74,471,6.4,11,12,2,25,7,68,0,0,0
2547,8,2014-10-25,nebraska,,Rutgers,W (42-24),14,22,63.6,163,2,41,292,7.1,4,63,455,7.2,8,11,2,21,5,35,1,1,2
2548,9,2014-11-01,nebraska,,Purdue,W (35-14),8,21,38.1,118,1,51,179,3.5,4,72,297,4.1,6,10,1,17,3,30,1,2,3
2549,10,2014-11-15,nebraska,@,Wisconsin,L (24-59),6,18,33.3,62,1,46,118,2.6,2,64,180,2.8,3,7,2,12,7,55,4,1,5
2550,11,2014-11-22,nebraska,,Minnesota,L (24-28),12,20,60.0,223,1,38,174,4.6,1,58,397,6.8,7,10,1,18,3,25,2,0,2
2551,12,2014-11-28,nebraska,@,Iowa,W (37-34),12,28,42.9,202,4,31,161,5.2,0,59,363,6.2,8,4,1,13,5,49,0,2,2
2552,13,2014-12-27,nebraska,N,Southern California*,L (42-45),32,51,62.7,381,3,43,144,3.3,2,94,525,5.6,16,9,3,28,7,45,0,1,1
2553,,13 Games,nebraska,,,,190,359,52.9,2757,24,587,3123,5.3,35,946,5880,6.2,115,149,26,290,75,655,13,12,25
2554,1,2015-09-05,nebraska,,Brigham Young,L (28-33),24,41,58.5,319,3,37,126,3.4,1,78,445,5.7,16,9,0,25,12,90,1,1,2
2555,2,2015-09-12,nebraska,,South Alabama,W (48-9),26,38,68.4,303,3,37,258,7.0,3,75,561,7.5,16,14,1,31,7,80,0,1,1
2556,3,2015-09-19,nebraska,@,Miami (FL),L (33-36),21,45,46.7,309,4,32,153,4.8,0,77,462,6.0,12,8,4,24,12,98,0,3,3
2557,4,2015-09-26,nebraska,,Southern Mississippi,W (36-28),23,35,65.7,368,2,39,242,6.2,1,74,610,8.2,14,10,1,25,12,98,1,1,2
2558,5,2015-10-03,nebraska,@,Illinois,L (13-14),10,31,32.3,105,0,34,187,5.5,1,65,292,4.5,2,9,1,12,6,42,1,1,2
2559,6,2015-10-10,nebraska,,Wisconsin,L (21-23),11,28,39.3,129,1,37,196,5.3,2,65,325,5.0,7,5,1,13,9,89,1,0,1
2560,7,2015-10-17,nebraska,@,Minnesota,W (48-25),18,26,69.2,261,3,39,203,5.2,2,65,464,7.1,14,8,1,23,2,25,0,0,0
2561,8,2015-10-24,nebraska,,Northwestern,L (28-30),24,48,50.0,291,1,38,82,2.2,2,86,373,4.3,13,6,3,22,6,64,0,1,1
2562,9,2015-10-31,nebraska,@,Purdue,L (45-55),29,48,60.4,407,4,29,77,2.7,2,77,484,6.3,22,3,3,28,7,40,1,4,5
2563,10,2015-11-07,nebraska,,Michigan State,W (39-38),19,33,57.6,320,2,36,179,5.0,3,69,499,7.2,12,11,1,24,5,55,0,2,2
2564,11,2015-11-14,nebraska,@,Rutgers,W (31-14),14,21,66.7,188,3,38,174,4.6,1,59,362,6.1,8,7,1,16,2,15,0,3,3
2565,12,2015-11-27,nebraska,,Iowa,L (20-28),25,45,55.6,296,0,38,137,3.6,2,83,433,5.2,14,7,1,22,8,95,0,4,4
2566,13,2015-12-26,nebraska,N,UCLA*,W (37-29),12,19,63.2,174,1,62,326,5.3,4,81,500,6.2,10,17,4,31,6,38,1,0,1
2567,,13 Games,nebraska,,,,256,458,55.9,3470,27,496,2340,4.7,24,954,5810,6.1,160,114,22,296,94,829,6,21,27
2568,1,2016-09-03,nebraska,,Fresno State,W (43-10),6,13,46.2,114,1,51,292,5.7,5,64,406,6.3,4,15,1,20,7,80,0,0,0
2569,2,2016-09-10,nebraska,,Wyoming,W (52-17),21,35,60.0,412,4,43,138,3.2,2,78,550,7.1,17,5,3,25,7,93,0,1,1
2570,3,2016-09-17,nebraska,,Oregon,W (35-32),17,35,48.6,200,3,47,228,4.9,2,82,428,5.2,10,12,4,26,7,55,1,0,1
2571,4,2016-09-24,nebraska,@,Northwestern,W (24-13),18,29,62.1,246,1,47,310,6.6,2,76,556,7.3,12,12,2,26,4,60,2,0,2
2572,5,2016-10-01,nebraska,,Illinois,W (31-16),16,23,69.6,220,1,49,203,4.1,3,72,423,5.9,12,9,2,23,3,35,1,1,2
2573,6,2016-10-15,nebraska,@,Indiana,W (27-22),10,26,38.5,208,1,45,152,3.4,1,71,360,5.1,8,9,0,17,9,53,0,2,2
2574,7,2016-10-22,nebraska,,Purdue,W (27-14),17,31,54.8,252,1,36,158,4.4,2,67,410,6.1,11,10,1,22,7,67,0,1,1
2575,8,2016-10-29,nebraska,@,Wisconsin,L (17-23),12,31,38.7,153,0,44,152,3.5,2,75,305,4.1,9,7,0,16,2,10,0,2,2
2576,9,2016-11-05,nebraska,@,Ohio State,L (3-62),9,33,27.3,126,0,24,78,3.3,0,57,204,3.6,6,2,1,9,4,43,0,2,2
2577,10,2016-11-12,nebraska,,Minnesota,W (24-17),19,28,67.9,217,2,32,157,4.9,1,60,374,6.2,10,9,0,19,8,81,0,0,0
2578,11,2016-11-19,nebraska,,Maryland,W (28-7),23,37,62.2,220,1,45,181,4.0,3,82,401,4.9,13,11,4,28,2,20,0,0,0
2579,12,2016-11-25,nebraska,@,Iowa,L (10-40),14,37,37.8,127,1,31,90,2.9,0,68,217,3.2,8,6,3,17,8,57,0,0,0
2580,13,2016-12-30,nebraska,N,Tennessee*,L (24-38),19,42,45.2,257,2,28,61,2.2,1,70,318,4.5,12,5,1,18,7,41,1,0,1
2581,,13 Games,nebraska,,,,201,400,50.3,2752,18,522,2200,4.2,24,922,4952,5.4,132,112,22,266,75,695,5,9,14
2582,1,2017-09-02,nebraska,,Arkansas State,W (43-36),19,32,59.4,238,2,38,225,5.9,2,70,463,6.6,14,10,1,25,8,75,0,0,0
2583,2,2017-09-09,nebraska,@,Oregon,L (35-42),19,41,46.3,252,3,29,109,3.8,2,70,361,5.2,11,6,2,19,3,25,0,4,4
2584,3,2017-09-16,nebraska,,Northern Illinois,L (17-21),25,47,53.2,299,0,36,85,2.4,2,83,384,4.6,12,6,0,18,5,48,0,3,3
2585,4,2017-09-23,nebraska,,Rutgers,W (27-17),13,26,50.0,109,2,47,197,4.2,1,73,306,4.2,8,11,2,21,6,46,0,2,2
2586,5,2017-09-29,nebraska,@,Illinois,W (28-6),17,24,70.8,246,3,38,165,4.3,1,62,411,6.6,12,9,2,23,5,70,1,0,1
2587,6,2017-10-07,nebraska,,Wisconsin,L (17-38),18,35,51.4,271,1,26,110,4.2,0,61,381,6.2,10,5,1,16,4,35,1,1,2
2588,7,2017-10-14,nebraska,,Ohio State,L (14-56),27,47,57.4,349,2,16,44,2.8,0,63,393,6.2,12,2,0,14,12,104,0,1,1
2589,8,2017-10-28,nebraska,@,Purdue,W (25-24),32,50,64.0,431,2,27,40,1.5,0,77,471,6.1,16,5,4,25,9,95,0,0,0
2590,9,2017-11-04,nebraska,,Northwestern,L (24-31),21,38,55.3,225,2,31,112,3.6,0,69,337,4.9,12,7,2,21,7,68,0,3,3
2591,10,2017-11-11,nebraska,@,Minnesota,L (21-54),25,36,69.4,311,1,33,69,2.1,2,69,380,5.5,13,5,2,20,4,54,0,0,0
2592,11,2017-11-18,nebraska,@,Penn State,L (44-56),26,41,63.4,399,2,26,67,2.6,3,67,466,7.0,16,4,1,21,9,89,0,0,0
2593,12,2017-11-24,nebraska,,Iowa,L (14-56),23,42,54.8,200,2,21,67,3.2,0,63,267,4.2,9,3,0,12,3,19,0,3,3
2594,,12 Games,nebraska,,,,265,459,57.7,3330,22,368,1290,3.5,13,827,4620,5.6,145,73,17,235,75,728,2,17,19
2595,1,2018-09-08,nebraska,,Colorado,L (28-33),19,29,65.5,236,1,54,329,6.1,3,83,565,6.8,9,13,3,25,11,95,2,1,3
2596,2,2018-09-15,nebraska,,Troy,L (19-24),19,27,70.4,177,2,48,187,3.9,0,75,364,4.9,7,12,3,22,10,77,1,2,3
2597,3,2018-09-22,nebraska,@,Michigan,L (10-56),13,24,54.2,93,0,30,39,1.3,1,54,132,2.4,4,5,3,12,10,79,1,1,2
2598,4,2018-09-29,nebraska,,Purdue,L (28-42),25,42,59.5,323,2,39,259,6.6,2,81,582,7.2,16,14,1,31,11,136,0,1,1
2599,5,2018-10-06,nebraska,@,Wisconsin,L (24-41),26,44,59.1,407,2,24,111,4.6,1,68,518,7.6,17,7,2,26,10,100,1,0,1
2600,6,2018-10-13,nebraska,@,Northwestern,L (31-34),25,35,71.4,251,1,47,231,4.9,3,82,482,5.9,9,15,0,24,9,89,1,2,3
2601,7,2018-10-20,nebraska,,Minnesota,W (53-28),25,30,83.3,276,3,43,383,8.9,4,73,659,9.0,9,18,1,28,6,43,1,0,1
2602,8,2018-10-27,nebraska,,Bethune-Cookman,W (45-9),17,31,54.8,242,2,33,226,6.8,3,64,468,7.3,11,12,0,23,5,35,0,2,2
2603,9,2018-11-03,nebraska,@,Ohio State,L (31-36),22,33,66.7,266,1,49,184,3.8,3,82,450,5.5,14,11,2,27,5,44,1,0,1
2604,10,2018-11-10,nebraska,,Illinois,W (54-35),24,34,70.6,290,3,34,316,9.3,4,68,606,8.9,12,9,1,22,7,72,1,1,2
2605,11,2018-11-17,nebraska,,Michigan State,W (9-6),16,37,43.2,145,0,30,103,3.4,0,67,248,3.7,8,5,1,14,5,45,2,0,2
2606,,11 Games,nebraska,,,,231,366,63.1,2706,17,431,2368,5.5,24,797,5074,6.4,116,121,17,254,89,815,11,10,21
2607,1,2014-08-29,colorado,N,Colorado State,L (17-31),24,39,61.5,241,2,34,134,3.9,0,73,375,5.1,11,8,3,22,6,65,0,0,0
2608,2,2014-09-06,colorado,N,Massachusetts,W (41-38),26,42,61.9,318,3,47,156,3.3,2,89,474,5.3,15,9,5,29,12,124,0,1,1
2609,3,2014-09-13,colorado,,Arizona State,L (24-38),35,54,64.8,313,3,37,232,6.3,0,91,545,6.0,17,8,3,28,8,75,1,2,3
2610,4,2014-09-20,colorado,,Hawaii,W (21-12),29,45,64.4,287,2,36,118,3.3,1,81,405,5.0,15,4,1,20,9,83,0,2,2
2611,5,2014-09-27,colorado,@,California,L (56-59),46,67,68.7,449,7,43,180,4.2,1,110,629,5.7,26,8,5,39,9,75,0,1,1
2612,6,2014-10-04,colorado,,Oregon State,L (31-36),32,49,65.3,308,2,28,123,4.4,2,77,431,5.6,14,9,2,25,6,67,0,1,1
2613,7,2014-10-18,colorado,@,Southern California,L (28-56),31,49,63.3,231,2,46,172,3.7,2,95,403,4.2,12,11,4,27,7,61,0,2,2
2614,8,2014-10-25,colorado,,UCLA,L (37-40),28,46,60.9,267,2,45,233,5.2,2,91,500,5.5,11,15,5,31,6,50,0,2,2
2615,9,2014-11-01,colorado,,Washington,L (23-38),36,52,69.2,314,2,37,181,4.9,0,89,495,5.6,14,10,0,24,5,39,3,1,4
2616,10,2014-11-08,colorado,@,Arizona,L (20-38),25,39,64.1,259,2,36,94,2.6,0,75,353,4.7,9,8,2,19,10,103,2,2,4
2617,11,2014-11-22,colorado,@,Oregon,L (10-44),16,32,50.0,105,1,30,121,4.0,0,62,226,3.6,5,5,4,14,4,36,0,0,0
2618,12,2014-11-29,colorado,,Utah,L (34-38),20,31,64.5,317,1,32,116,3.6,3,63,433,6.9,10,6,2,18,4,35,0,1,1
2619,,12 Games,colorado,,,,348,545,63.9,3409,29,451,1860,4.1,13,996,5269,5.3,159,101,36,296,86,813,6,15,21
2620,1,2015-09-03,colorado,@,Hawaii,L (20-28),23,40,57.5,156,0,53,215,4.1,2,93,371,4.0,8,14,1,23,5,70,2,1,3
2621,2,2015-09-12,colorado,,Massachusetts,W (48-14),15,24,62.5,168,1,59,390,6.6,5,83,558,6.7,8,22,2,32,7,65,0,0,0
2622,3,2015-09-19,colorado,N,Colorado State,W (27-24),15,29,51.7,220,2,32,125,3.9,0,61,345,5.7,9,6,3,18,6,65,0,0,0
2623,4,2015-09-26,colorado,,Nicholls State,W (48-0),18,31,58.1,278,1,62,358,5.8,5,93,636,6.8,14,16,3,33,4,30,1,0,1
2624,5,2015-10-03,colorado,,Oregon,L (24-41),25,42,59.5,231,1,36,77,2.1,2,78,308,3.9,13,5,0,18,6,41,2,1,3
2625,6,2015-10-10,colorado,@,Arizona State,L (23-48),26,41,63.4,401,1,28,49,1.8,2,69,450,6.5,13,5,1,19,9,88,1,1,2
2626,7,2015-10-17,colorado,,Arizona,L (31-38),28,44,63.6,339,2,43,128,3.0,2,87,467,5.4,15,6,1,22,9,65,1,0,1
2627,8,2015-10-24,colorado,@,Oregon State,W (17-13),16,23,69.6,140,1,45,188,4.2,1,68,328,4.8,8,11,1,20,9,80,0,0,0
2628,9,2015-10-31,colorado,@,UCLA,L (31-35),37,58,63.8,312,0,56,242,4.3,2,114,554,4.9,14,18,2,34,7,68,0,2,2
2629,10,2015-11-07,colorado,,Stanford,L (10-42),13,23,56.5,148,0,30,83,2.8,1,53,231,4.4,7,7,1,15,3,21,0,2,2
2630,11,2015-11-13,colorado,,Southern California,L (24-27),24,31,77.4,222,2,36,59,1.6,1,67,281,4.2,12,7,2,21,5,39,1,0,1
2631,12,2015-11-21,colorado,@,Washington State,L (3-27),26,41,63.4,238,0,30,85,2.8,0,71,323,4.5,12,4,1,17,7,61,0,2,2
2632,13,2015-11-28,colorado,@,Utah,L (14-20),19,38,50.0,258,2,33,49,1.5,0,71,307,4.3,11,5,3,19,3,31,1,3,4
2633,,13 Games,colorado,,,,285,465,61.3,3111,13,543,2048,3.8,23,1008,5159,5.1,144,126,21,291,80,724,9,12,21
2634,1,2016-09-02,colorado,N,Colorado State,W (44-7),23,33,69.7,318,1,56,260,4.6,3,89,578,6.5,12,15,1,28,4,35,2,0,2
2635,2,2016-09-10,colorado,,Idaho State,W (56-7),22,31,71.0,335,4,57,262,4.6,4,88,597,6.8,13,15,4,32,5,37,1,0,1
2636,3,2016-09-17,colorado,@,Michigan,L (28-45),18,34,52.9,261,3,33,64,1.9,0,67,325,4.9,8,5,2,15,7,46,0,0,0
2637,4,2016-09-24,colorado,@,Oregon,W (41-38),23,32,71.9,333,3,52,260,5.0,2,84,593,7.1,15,14,3,32,5,47,0,2,2
2638,5,2016-10-01,colorado,,Oregon State,W (47-6),21,30,70.0,316,3,54,247,4.6,2,84,563,6.7,13,13,0,26,5,55,0,0,0
2639,6,2016-10-08,colorado,@,Southern California,L (17-21),28,44,63.6,275,2,29,96,3.3,0,73,371,5.1,15,4,1,20,5,26,0,1,1
2640,7,2016-10-15,colorado,,Arizona State,W (40-16),23,32,71.9,265,0,52,315,6.1,5,84,580,6.9,9,18,0,27,3,20,2,0,2
2641,8,2016-10-22,colorado,@,Stanford,W (10-5),12,25,48.0,135,1,44,241,5.5,0,69,376,5.4,7,15,1,23,6,60,0,0,0
2642,9,2016-11-03,colorado,,UCLA,W (20-10),20,33,60.6,160,0,52,144,2.8,1,85,304,3.6,10,8,6,24,12,128,1,3,4
2643,10,2016-11-12,colorado,@,Arizona,W (49-24),19,27,70.4,213,3,46,175,3.8,4,73,388,5.3,8,11,6,25,7,62,0,1,1
2644,11,2016-11-19,colorado,,Washington State,W (38-24),27,41,65.9,345,0,59,258,4.4,5,100,603,6.0,15,15,1,31,9,75,1,0,1
2645,12,2016-11-26,colorado,,Utah,W (27-22),23,44,52.3,270,1,38,108,2.8,1,82,378,4.6,10,6,2,18,0,0,2,0,2
2646,13,2016-12-02,colorado,N,Washington,L (10-41),8,25,32.0,81,0,29,82,2.8,1,54,163,3.0,3,4,2,9,3,35,0,3,3
2647,14,2016-12-29,colorado,N,Oklahoma State*,L (8-38),22,38,57.9,256,0,29,62,2.1,1,67,318,4.7,11,6,1,18,5,35,0,1,1
2648,,14 Games,colorado,,,,289,469,61.6,3563,21,630,2574,4.1,29,1099,6137,5.6,149,149,30,328,76,661,9,11,20
2649,1,2017-09-01,colorado,N,Colorado State,W (17-3),21,29,72.4,202,1,36,145,4.0,1,65,347,5.3,9,7,3,19,7,59,0,2,2
2650,2,2017-09-09,colorado,,Texas State,W (37-3),23,36,63.9,339,1,39,94,2.4,2,75,433,5.8,14,6,1,21,5,35,0,0,0
2651,3,2017-09-16,colorado,,Northern Colorado,W (41-21),29,41,70.7,357,4,39,212,5.4,1,80,569,7.1,16,12,2,30,14,114,2,1,3
2652,4,2017-09-23,colorado,,Washington,L (10-37),22,30,73.3,191,0,42,131,3.1,1,72,322,4.5,9,11,0,20,3,35,0,3,3
2653,5,2017-09-30,colorado,@,UCLA,L (23-27),17,38,44.7,243,1,38,191,5.0,1,76,434,5.7,10,9,5,24,6,53,0,0,0
2654,6,2017-10-07,colorado,,Arizona,L (42-45),19,32,59.4,251,3,58,300,5.2,3,90,551,6.1,11,18,0,29,12,110,0,0,0
2655,7,2017-10-14,colorado,@,Oregon State,W (36-33),15,25,60.0,179,3,41,206,5.0,2,66,385,5.8,9,13,3,25,3,14,0,0,0
2656,8,2017-10-21,colorado,@,Washington State,L (0-28),13,34,38.2,94,0,40,80,2.0,0,74,174,2.4,3,8,2,13,5,45,1,0,1
2657,9,2017-10-28,colorado,,California,W (44-28),21,27,77.8,353,3,53,200,3.8,1,80,553,6.9,10,16,1,27,7,58,1,0,1
2658,10,2017-11-04,colorado,@,Arizona State,L (30-41),23,41,56.1,345,1,39,109,2.8,2,80,454,5.7,15,8,0,23,3,25,0,1,1
2659,11,2017-11-11,colorado,,Southern California,L (24-38),27,49,55.1,376,2,34,110,3.2,1,83,486,5.9,15,7,1,23,4,45,0,2,2
2660,12,2017-11-25,colorado,@,Utah,L (13-34),14,28,50.0,195,0,35,124,3.5,2,63,319,5.1,7,9,1,17,6,75,1,0,1
2661,,12 Games,colorado,,,,244,410,59.5,3125,19,494,1902,3.9,17,904,5027,5.6,128,124,19,271,75,668,5,9,14
2662,1,2018-08-31,colorado,N,Colorado State,W (45-13),22,25,88.0,338,4,40,258,6.5,2,65,596,9.2,11,12,0,23,6,44,1,1,2
2663,2,2018-09-08,colorado,@,Nebraska,W (33-28),33,50,66.0,351,3,35,44,1.3,1,85,395,4.6,16,7,3,26,8,46,0,0,0
2664,3,2018-09-15,colorado,,New Hampshire,W (45-14),17,24,70.8,180,1,51,311,6.1,4,75,491,6.5,9,12,0,21,6,60,0,2,2
2665,4,2018-09-28,colorado,,UCLA,W (38-16),23,27,85.2,268,1,48,209,4.4,4,75,477,6.4,12,11,3,26,6,60,0,0,0
2666,5,2018-10-06,colorado,,Arizona State,W (28-21),24,33,72.7,328,2,45,166,3.7,2,78,494,6.3,12,12,1,25,6,60,0,0,0
2667,6,2018-10-13,colorado,@,Southern California,L (20-31),26,47,55.3,170,0,37,95,2.6,3,84,265,3.2,7,6,4,17,8,81,0,1,1
2668,7,2018-10-20,colorado,@,Washington,L (13-27),17,28,60.7,144,1,35,119,3.4,0,63,263,4.2,8,6,1,15,4,48,0,1,1
2669,8,2018-10-27,colorado,,Oregon State,L (34-41),24,39,61.5,319,2,36,217,6.0,1,75,536,7.1,13,8,2,23,7,70,0,0,0
2670,9,2018-11-02,colorado,@,Arizona,L (34-42),27,43,62.8,343,3,32,40,1.3,1,75,383,5.1,18,3,6,27,5,52,1,1,2
2671,10,2018-11-10,colorado,,Washington State,L (7-31),21,38,55.3,222,0,16,75,4.7,1,54,297,5.5,10,2,0,12,4,51,2,1,3
2672,11,2018-11-17,colorado,,Utah,L (7-30),21,33,63.6,162,0,34,34,1.0,1,67,196,2.9,8,3,3,14,4,38,1,2,3
2673,,11 Games,colorado,,,,255,387,65.9,2825,17,409,1568,3.8,20,796,4393,5.5,124,82,23,229,64,610,5,9,14
2674,1,2014-08-30,ohio-state,N,Navy,W (34-17),12,15,80.0,226,2,40,194,4.9,1,55,420,7.6,7,12,0,19,2,20,0,1,1
2675,2,2014-09-06,ohio-state,,Virginia Tech,L (21-35),9,29,31.0,219,1,40,108,2.7,2,69,327,4.7,7,9,3,19,7,62,0,3,3
2676,3,2014-09-13,ohio-state,,Kent State,W (66-0),25,34,73.5,344,6,53,284,5.4,3,87,628,7.2,15,15,3,33,6,63,2,1,3
2677,4,2014-09-27,ohio-state,,Cincinnati,W (50-28),26,36,72.2,330,4,65,380,5.8,2,101,710,7.0,17,27,1,45,7,40,1,0,1
2678,5,2014-10-04,ohio-state,@,Maryland,W (52-24),19,24,79.2,264,4,53,269,5.1,2,77,533,6.9,10,15,1,26,7,66,0,0,0
2679,6,2014-10-18,ohio-state,,Rutgers,W (56-17),19,31,61.3,261,3,40,324,8.1,4,71,585,8.2,12,19,0,31,4,28,1,0,1
2680,7,2014-10-25,ohio-state,@,Penn State,W (31-24),12,19,63.2,74,1,57,219,3.8,3,76,293,3.9,4,14,1,19,8,70,0,2,2
2681,8,2014-11-01,ohio-state,,Illinois,W (55-14),20,34,58.8,249,4,44,296,6.7,3,78,545,7.0,12,16,0,28,6,56,1,0,1
2682,9,2014-11-08,ohio-state,@,Michigan State,W (49-37),16,26,61.5,300,3,41,268,6.5,4,67,568,8.5,9,14,2,25,7,50,2,0,2
2683,10,2014-11-15,ohio-state,@,Minnesota,W (31-24),15,25,60.0,200,3,38,289,7.6,1,63,489,7.8,8,12,2,22,4,49,2,1,3
2684,11,2014-11-22,ohio-state,,Indiana,W (42-27),25,35,71.4,302,4,39,225,5.8,1,74,527,7.1,13,11,0,24,3,25,1,2,3
2685,12,2014-11-29,ohio-state,,Michigan,W (42-28),15,24,62.5,183,1,39,233,6.0,4,63,416,6.6,8,11,1,20,9,84,0,0,0
2686,13,2014-12-06,ohio-state,N,Wisconsin,W (59-0),12,18,66.7,257,3,38,301,7.9,4,56,558,10.0,10,12,2,24,5,44,0,0,0
2687,14,2015-01-01,ohio-state,N,Alabama*,W (42-35),19,36,52.8,256,2,42,281,6.7,2,78,537,6.9,10,12,1,23,4,24,1,1,2
2688,15,2015-01-12,ohio-state,N,Oregon*,W (42-20),16,23,69.6,242,1,61,296,4.9,5,84,538,6.4,8,18,2,28,5,30,3,1,4
2689,,15 Games,ohio-state,,,,260,409,63.6,3707,42,690,3967,5.7,41,1099,7674,7.0,150,217,19,386,84,711,14,12,26
2690,1,2015-09-07,ohio-state,@,Virginia Tech,W (42-24),10,19,52.6,212,3,37,360,9.7,3,56,572,10.2,8,11,2,21,6,58,2,1,3
2691,2,2015-09-12,ohio-state,,Hawaii,W (38-0),20,34,58.8,181,0,49,182,3.7,4,83,363,4.4,11,13,2,26,7,115,0,0,0
2692,3,2015-09-19,ohio-state,,Northern Illinois,W (20-13),16,29,55.2,136,1,37,162,4.4,0,66,298,4.5,6,8,0,14,6,39,2,3,5
2693,4,2015-09-26,ohio-state,,Western Michigan,W (38-12),20,36,55.6,288,2,34,223,6.6,2,70,511,7.3,13,11,1,25,12,86,0,2,2
2694,5,2015-10-03,ohio-state,@,Indiana,W (34-27),18,27,66.7,245,1,34,272,8.0,3,61,517,8.5,8,5,0,13,8,109,2,1,3
2695,6,2015-10-10,ohio-state,,Maryland,W (49-28),23,30,76.7,317,2,47,182,3.9,5,77,499,6.5,15,13,3,31,6,45,0,0,0
2696,7,2015-10-17,ohio-state,,Penn State,W (38-10),13,19,68.4,114,2,50,315,6.3,3,69,429,6.2,7,18,0,25,5,70,0,0,0
2697,8,2015-10-24,ohio-state,@,Rutgers,W (49-7),17,21,81.0,247,3,49,281,5.7,4,70,528,7.5,12,13,2,27,0,0,1,0,1
2698,9,2015-11-07,ohio-state,,Minnesota,W (28-14),12,22,54.5,187,1,44,189,4.3,2,66,376,5.7,9,9,0,18,5,45,1,0,1
2699,10,2015-11-14,ohio-state,@,Illinois,W (28-3),17,25,68.0,157,1,50,283,5.7,3,75,440,5.9,8,14,1,23,7,40,1,1,2
2700,11,2015-11-21,ohio-state,,Michigan State,L (14-17),9,16,56.3,46,1,29,86,3.0,1,45,132,2.9,1,4,0,5,4,20,0,0,0
2701,12,2015-11-28,ohio-state,@,Michigan,W (42-13),9,15,60.0,113,1,54,369,6.8,5,69,482,7.0,4,18,3,25,5,39,0,0,0
2702,13,2016-01-01,ohio-state,N,Notre Dame*,W (44-28),19,31,61.3,211,1,54,285,5.3,4,85,496,5.8,12,14,1,27,4,45,0,1,1
2703,,13 Games,ohio-state,,,,203,324,62.7,2454,19,568,3189,5.6,39,892,5643,6.3,114,151,15,280,75,711,9,9,18
2704,1,2016-09-03,ohio-state,,Bowling Green State,W (77-10),27,39,69.2,417,7,55,359,6.5,3,94,776,8.3,14,25,2,41,9,66,0,1,1
2705,2,2016-09-10,ohio-state,,Tulsa,W (48-3),14,22,63.6,149,0,48,268,5.6,4,70,417,6.0,7,12,1,20,9,67,1,0,1
2706,3,2016-09-17,ohio-state,@,Oklahoma,W (45-24),14,20,70.0,152,4,48,291,6.1,1,68,443,6.5,7,14,1,22,11,75,0,0,0
2707,4,2016-10-01,ohio-state,,Rutgers,W (58-0),25,36,69.4,259,4,53,410,7.7,4,89,669,7.5,10,21,1,32,6,64,0,1,1
2708,5,2016-10-08,ohio-state,,Indiana,W (38-17),9,21,42.9,93,1,50,290,5.8,4,71,383,5.4,3,15,0,18,9,83,1,1,2
2709,6,2016-10-15,ohio-state,@,Wisconsin,W (30-23),17,29,58.6,226,1,45,185,4.1,2,74,411,5.6,10,12,1,23,4,40,0,1,1
2710,7,2016-10-22,ohio-state,@,Penn State,L (21-24),28,43,65.1,245,1,40,168,4.2,1,83,413,5.0,9,9,1,19,8,45,0,0,0
2711,8,2016-10-29,ohio-state,,Northwestern,W (24-20),21,32,65.6,223,0,41,208,5.1,3,73,431,5.9,10,13,0,23,2,10,0,0,0
2712,9,2016-11-05,ohio-state,,Nebraska,W (62-3),32,44,72.7,352,4,42,238,5.7,2,86,590,6.9,17,15,2,34,4,35,1,0,1
2713,10,2016-11-12,ohio-state,@,Maryland,W (62-3),24,36,66.7,328,3,43,253,5.9,5,79,581,7.4,15,13,4,32,6,55,0,0,0
2714,11,2016-11-19,ohio-state,@,Michigan State,W (17-16),10,22,45.5,86,1,45,224,5.0,1,67,310,4.6,3,11,2,16,4,40,1,0,1
2715,12,2016-11-26,ohio-state,,Michigan,W (30-27),15,32,46.9,124,0,50,206,4.1,3,82,330,4.0,7,13,3,23,2,6,0,1,1
2716,13,2016-12-31,ohio-state,N,Clemson,L (0-31),19,33,57.6,127,0,23,88,3.8,0,56,215,3.8,4,3,2,9,8,72,1,2,3
2717,,13 Games,ohio-state,,,,255,409,62.3,2781,26,583,3188,5.5,33,992,5969,6.0,116,176,20,312,82,658,5,7,12
2718,1,2017-08-31,ohio-state,@,Indiana,W (49-21),20,35,57.1,304,3,51,292,5.7,3,86,596,6.9,10,14,2,26,5,50,0,0,0
2719,2,2017-09-09,ohio-state,,Oklahoma,L (16-31),19,35,54.3,183,0,34,167,4.9,1,69,350,5.1,9,11,1,21,9,87,0,1,1
2720,3,2017-09-16,ohio-state,,Army,W (38-7),29,37,78.4,316,2,32,270,8.4,3,69,586,8.5,12,18,0,30,5,55,0,0,0
2721,4,2017-09-23,ohio-state,,Nevada-Las Vegas,W (54-21),31,44,70.5,474,7,40,190,4.8,0,84,664,7.9,17,16,1,34,8,85,2,1,3
2722,5,2017-09-30,ohio-state,@,Rutgers,W (56-0),20,31,64.5,353,4,36,278,7.7,4,67,631,9.4,11,11,2,24,10,106,0,0,0
2723,6,2017-10-07,ohio-state,,Maryland,W (62-14),23,36,63.9,303,3,50,281,5.6,5,86,584,6.8,15,13,5,33,8,85,2,0,2
2724,7,2017-10-14,ohio-state,@,Nebraska,W (56-14),31,39,79.5,354,5,47,279,5.9,3,86,633,7.4,19,18,4,41,7,53,0,0,0
2725,8,2017-10-28,ohio-state,,Penn State,W (39-38),33,39,84.6,328,4,39,201,5.2,1,78,529,6.8,14,10,3,27,10,79,2,0,2
2726,9,2017-11-04,ohio-state,@,Iowa,L (24-55),18,34,52.9,208,3,30,163,5.4,0,64,371,5.8,9,10,1,20,9,95,0,4,4
2727,10,2017-11-11,ohio-state,,Michigan State,W (48-3),15,23,65.2,189,2,42,335,8.0,4,65,524,8.1,9,13,3,25,2,27,0,2,2
2728,11,2017-11-18,ohio-state,,Illinois,W (52-14),16,29,55.2,218,3,59,325,5.5,4,88,543,6.2,11,14,2,27,7,68,1,0,1
2729,12,2017-11-25,ohio-state,@,Michigan,W (31-20),9,15,60.0,124,1,48,226,4.7,3,63,350,5.6,4,11,2,17,9,75,0,0,0
2730,13,2017-12-02,ohio-state,N,Wisconsin,W (27-21),12,26,46.2,211,2,42,238,5.7,1,68,449,6.6,5,9,2,16,5,48,1,2,3
2731,14,2017-12-29,ohio-state,N,Southern California*,W (24-7),11,17,64.7,114,0,38,163,4.3,2,55,277,5.0,5,6,2,13,3,30,1,0,1
2732,,14 Games,ohio-state,,,,287,440,65.2,3679,39,588,3408,5.8,34,1028,7087,6.9,150,174,30,354,97,943,9,10,19
2733,1,2018-09-01,ohio-state,,Oregon State,W (77-31),25,34,73.5,346,5,52,377,7.3,5,86,723,8.4,14,18,3,35,6,50,1,1,2
2734,2,2018-09-08,ohio-state,,Rutgers,W (52-3),30,33,90.9,354,5,40,225,5.6,2,73,579,7.9,15,12,5,32,11,120,0,0,0
2735,3,2018-09-15,ohio-state,N,Texas Christian,W (40-28),24,38,63.2,344,2,42,182,4.3,1,80,526,6.6,14,13,2,29,5,39,0,0,0
2736,4,2018-09-22,ohio-state,,Tulane,W (49-6),31,38,81.6,419,5,38,151,4.0,2,76,570,7.5,22,8,2,32,10,89,0,0,0
2737,5,2018-09-29,ohio-state,@,Penn State,W (27-26),22,39,56.4,270,3,37,119,3.2,1,76,389,5.1,11,8,2,21,10,105,0,1,1
2738,6,2018-10-06,ohio-state,,Indiana,W (49-26),33,44,75.0,455,6,48,154,3.2,1,92,609,6.6,19,13,1,33,9,82,1,2,3
2739,7,2018-10-13,ohio-state,,Minnesota,W (30-14),33,44,75.0,412,3,32,92,2.9,0,76,504,6.6,20,6,3,29,5,36,0,0,0
2740,8,2018-10-20,ohio-state,@,Purdue,L (20-49),49,73,67.1,470,2,25,76,3.0,0,98,546,5.6,24,4,3,31,10,86,0,1,1
2741,9,2018-11-03,ohio-state,,Nebraska,W (36-31),18,32,56.3,252,2,40,229,5.7,3,72,481,6.7,10,11,2,23,6,46,2,1,3
2742,10,2018-11-10,ohio-state,@,Michigan State,W (26-6),24,39,61.5,227,1,45,120,2.7,1,84,347,4.1,12,8,1,21,4,30,1,0,1
2743,11,2018-11-17,ohio-state,@,Maryland,W (52-51),28,38,73.7,405,3,56,283,5.1,4,94,688,7.3,17,12,7,36,10,79,2,1,3
2744,,11 Games,ohio-state,,,,317,452,70.1,3954,37,455,2008,4.4,20,907,5962,6.6,178,113,31,322,86,762,7,7,14
2745,1,2014-08-30,michigan,,Appalachian State,W (52-14),16,19,84.2,210,3,36,350,9.7,3,55,560,10.2,10,12,2,24,4,44,0,1,1
2746,2,2014-09-06,michigan,@,Notre Dame,L (0-31),19,32,59.4,189,0,35,100,2.9,0,67,289,4.3,12,6,0,18,5,50,1,3,4
2747,3,2014-09-13,michigan,,Miami (OH),W (34-10),13,22,59.1,184,2,45,276,6.1,2,67,460,6.9,8,15,0,23,3,20,2,1,3
2748,4,2014-09-20,michigan,,Utah,L (10-26),18,39,46.2,190,0,36,118,3.3,0,75,308,4.1,8,11,0,19,3,20,1,3,4
2749,5,2014-09-27,michigan,,Minnesota,L (14-30),10,25,40.0,88,0,28,83,3.0,2,53,171,3.2,4,5,3,12,2,23,1,1,2
2750,6,2014-10-04,michigan,@,Rutgers,L (24-26),13,22,59.1,178,0,35,158,4.5,3,57,336,5.9,8,7,3,18,3,30,0,1,1
2751,7,2014-10-11,michigan,,Penn State,W (18-13),16,26,61.5,192,1,31,64,2.1,0,57,256,4.5,7,5,0,12,3,30,0,1,1
2752,8,2014-10-25,michigan,@,Michigan State,L (11-35),15,31,48.4,125,0,26,61,2.3,1,57,186,3.3,7,3,3,13,4,27,1,2,3
2753,9,2014-11-01,michigan,,Indiana,W (34-10),22,29,75.9,220,2,35,184,5.3,2,64,404,6.3,11,8,1,20,3,25,0,1,1
2754,10,2014-11-08,michigan,@,Northwestern,W (10-9),11,24,45.8,109,0,35,147,4.2,1,59,256,4.3,7,6,0,13,5,50,1,2,3
2755,11,2014-11-22,michigan,,Maryland,L (16-23),13,24,54.2,106,0,45,292,6.5,1,69,398,5.8,8,13,2,23,3,24,0,1,1
2756,12,2014-11-29,michigan,@,Ohio State,L (28-42),23,33,69.7,251,2,38,121,3.2,2,71,372,5.2,14,10,3,27,4,38,1,1,2
2757,,12 Games,michigan,,,,189,326,58.0,2042,10,425,1954,4.6,17,751,3996,5.3,104,101,17,222,42,381,8,18,26
2758,1,2015-09-03,michigan,@,Utah,L (17-24),27,43,62.8,279,2,29,76,2.6,0,72,355,4.9,15,3,2,20,3,25,0,3,3
2759,2,2015-09-12,michigan,,Oregon State,W (35-7),18,26,69.2,180,0,48,225,4.7,4,74,405,5.5,9,12,0,21,10,105,1,1,2
2760,3,2015-09-19,michigan,,Nevada-Las Vegas,W (28-7),14,25,56.0,123,1,39,254,6.5,3,64,377,5.9,6,11,0,17,3,34,0,1,1
2761,4,2015-09-26,michigan,,Brigham Young,W (31-0),14,25,56.0,194,1,51,254,5.0,3,76,448,5.9,11,8,3,22,5,53,0,0,0
2762,5,2015-10-03,michigan,@,Maryland,W (28-0),16,33,48.5,180,1,40,198,5.0,2,73,378,5.2,7,7,0,14,7,65,2,1,3
2763,6,2015-10-10,michigan,,Northwestern,W (38-0),17,23,73.9,179,0,46,201,4.4,3,69,380,5.5,10,11,0,21,3,28,0,0,0
2764,7,2015-10-17,michigan,,Michigan State,L (23-27),15,25,60.0,168,0,33,62,1.9,2,58,230,4.0,6,3,1,10,8,70,1,0,1
2765,8,2015-10-31,michigan,@,Minnesota,W (29-26),16,27,59.3,169,2,34,127,3.7,2,61,296,4.9,9,8,3,20,5,47,1,1,2
2766,9,2015-11-07,michigan,,Rutgers,W (49-16),18,26,69.2,337,2,42,150,3.6,4,68,487,7.2,14,8,3,25,6,60,0,0,0
2767,10,2015-11-14,michigan,@,Indiana,W (48-41),33,46,71.7,440,6,28,141,5.0,0,74,581,7.9,20,6,2,28,13,72,0,1,1
2768,11,2015-11-21,michigan,@,Penn State,W (28-16),25,38,65.8,256,2,30,87,2.9,2,68,343,5.0,12,5,2,19,13,117,1,1,2
2769,12,2015-11-28,michigan,,Ohio State,L (13-42),25,47,53.2,307,1,25,57,2.3,0,72,364,5.1,16,3,1,20,7,72,0,1,1
2770,13,2016-01-01,michigan,N,Florida*,W (41-7),20,31,64.5,278,3,46,225,4.9,2,77,503,6.5,14,11,3,28,4,30,0,0,0
2771,,13 Games,michigan,,,,258,415,62.2,3090,21,491,2057,4.2,27,906,5147,5.7,149,96,20,265,87,778,6,10,16
2772,1,2016-09-03,michigan,,Hawaii,W (63-3),17,20,85.0,206,3,39,306,7.8,4,59,512,8.7,9,17,0,26,3,33,0,1,1
2773,2,2016-09-10,michigan,,Central Florida,W (51-14),27,41,65.9,328,4,41,119,2.9,2,82,447,5.5,13,8,2,23,2,20,0,0,0
2774,3,2016-09-17,michigan,,Colorado,W (45-28),16,30,53.3,229,1,41,168,4.1,3,71,397,5.6,11,8,1,20,5,41,1,0,1
2775,4,2016-09-24,michigan,,Penn State,W (49-10),21,35,60.0,189,1,49,326,6.7,6,84,515,6.1,10,14,1,25,7,80,0,0,0
2776,5,2016-10-01,michigan,,Wisconsin,W (14-7),20,32,62.5,219,1,44,130,3.0,1,76,349,4.6,8,11,2,21,6,45,0,1,1
2777,6,2016-10-08,michigan,@,Rutgers,W (78-0),8,16,50.0,119,2,53,486,9.2,9,69,605,8.8,4,18,1,23,3,25,1,0,1
2778,7,2016-10-22,michigan,,Illinois,W (41-8),20,28,71.4,291,2,59,270,4.6,3,87,561,6.4,12,15,2,29,5,41,1,0,1
2779,8,2016-10-29,michigan,@,Michigan State,W (32-23),16,25,64.0,244,0,42,192,4.6,3,67,436,6.5,11,9,4,24,5,62,0,1,1
2780,9,2016-11-05,michigan,,Maryland,W (59-3),21,27,77.8,387,3,39,273,7.0,5,66,660,10.0,14,14,3,31,6,62,0,0,0
2781,10,2016-11-12,michigan,@,Iowa,L (13-14),11,26,42.3,103,0,35,98,2.8,1,61,201,3.3,7,5,2,14,5,48,1,1,2
2782,11,2016-11-19,michigan,,Indiana,W (20-10),7,16,43.8,59,0,50,225,4.5,2,66,284,4.3,2,12,1,15,5,40,0,0,0
2783,12,2016-11-26,michigan,@,Ohio State,L (27-30),23,36,63.9,219,2,43,91,2.1,1,79,310,3.9,9,7,0,16,7,59,1,2,3
2784,13,2016-12-30,michigan,N,Florida State*,L (32-33),21,38,55.3,163,1,36,89,2.5,1,74,252,3.4,10,5,1,16,4,37,0,1,1
2785,,13 Games,michigan,,,,228,370,61.6,2756,20,571,2773,4.9,41,941,5529,5.9,120,143,20,283,63,593,5,7,12
2786,1,2017-09-02,michigan,N,Florida,W (33-17),12,26,46.2,218,1,49,215,4.4,1,75,433,5.8,8,10,1,19,7,55,0,2,2
2787,2,2017-09-09,michigan,,Cincinnati,W (36-14),17,29,58.6,221,2,37,193,5.2,0,66,414,6.3,7,9,0,16,7,68,2,0,2
2788,3,2017-09-16,michigan,,Air Force,W (29-13),14,23,60.9,169,0,42,190,4.5,1,65,359,5.5,6,11,0,17,7,72,1,0,1
2789,4,2017-09-23,michigan,@,Purdue,W (28-10),21,31,67.7,284,1,44,139,3.2,3,75,423,5.6,14,6,4,24,7,57,1,1,2
2790,5,2017-10-07,michigan,,Michigan State,L (10-14),16,35,45.7,198,0,39,102,2.6,1,74,300,4.1,7,8,2,17,7,53,2,3,5
2791,6,2017-10-14,michigan,@,Indiana,W (27-20),10,20,50.0,58,0,44,271,6.2,3,64,329,5.1,3,12,2,17,16,141,0,0,0
2792,7,2017-10-21,michigan,@,Penn State,L (13-42),16,28,57.1,166,0,42,103,2.5,2,70,269,3.8,8,8,0,16,6,59,1,0,1
2793,8,2017-10-28,michigan,,Rutgers,W (35-14),13,20,65.0,137,1,51,334,6.5,4,71,471,6.6,9,16,0,25,3,25,0,1,1
2794,9,2017-11-04,michigan,,Minnesota,W (33-10),8,13,61.5,56,1,37,371,10.0,4,50,427,8.5,2,12,0,14,9,85,0,0,0
2795,10,2017-11-11,michigan,@,Maryland,W (35-10),9,18,50.0,145,2,38,160,4.2,3,56,305,5.4,6,8,2,16,1,10,0,0,0
2796,11,2017-11-18,michigan,@,Wisconsin,L (10-24),11,26,42.3,176,0,37,58,1.6,1,63,234,3.7,7,5,1,13,4,28,1,0,1
2797,12,2017-11-25,michigan,,Ohio State,L (20-31),17,32,53.1,195,1,36,100,2.8,2,68,295,4.3,8,7,1,16,6,50,0,1,1
2798,13,2018-01-01,michigan,N,South Carolina*,L (19-26),21,45,46.7,203,0,33,74,2.2,1,78,277,3.6,11,3,3,17,6,40,3,2,5
2799,,13 Games,michigan,,,,185,346,53.5,2226,9,529,2310,4.4,26,875,4536,5.2,96,115,16,227,86,743,11,10,21
2800,1,2018-09-01,michigan,@,Notre Dame,L (17-24),24,36,66.7,249,0,33,58,1.8,1,69,307,4.4,14,4,2,20,7,52,1,1,2
2801,2,2018-09-08,michigan,,Western Michigan,W (49-3),13,18,72.2,143,4,35,308,8.8,3,53,451,8.5,7,12,1,20,7,55,0,0,0
2802,3,2018-09-15,michigan,,Southern Methodist,W (45-20),14,18,77.8,237,3,41,197,4.8,2,59,434,7.4,8,10,3,21,13,137,0,1,1
2803,4,2018-09-22,michigan,,Nebraska,W (56-10),18,31,58.1,206,2,45,285,6.3,4,76,491,6.5,9,12,1,22,8,77,0,1,1
2804,5,2018-09-29,michigan,@,Northwestern,W (20-17),15,24,62.5,196,0,42,180,4.3,2,66,376,5.7,7,10,1,18,11,100,0,0,0
2805,6,2018-10-06,michigan,,Maryland,W (42-21),20,28,71.4,294,3,40,171,4.3,1,68,465,6.8,11,11,2,24,6,52,0,1,1
2806,7,2018-10-13,michigan,,Wisconsin,W (38-13),14,21,66.7,124,0,48,320,6.7,3,69,444,6.4,5,14,2,21,1,15,0,0,0
2807,8,2018-10-20,michigan,@,Michigan State,W (21-7),14,25,56.0,212,2,53,183,3.5,1,78,395,5.1,8,11,0,19,9,99,2,0,2
2808,9,2018-11-03,michigan,,Penn State,W (42-7),11,17,64.7,144,2,52,259,5.0,3,69,403,5.8,6,14,0,20,9,80,0,0,0
2809,10,2018-11-10,michigan,@,Rutgers,W (42-7),18,27,66.7,260,3,40,193,4.8,3,67,453,6.8,14,10,0,24,2,20,0,0,0
2810,11,2018-11-17,michigan,,Indiana,W (31-20),16,28,57.1,250,1,50,257,5.1,1,78,507,6.5,10,13,2,25,4,45,0,1,1
2811,,11 Games,michigan,,,,177,273,64.8,2315,20,479,2411,5.0,24,752,4726,6.3,99,121,14,234,77,732,3,5,8
2812,1,2014-08-30,penn-state,N,Central Florida,W (26-24),32,47,68.1,454,1,28,57,2.0,1,75,511,6.8,14,7,3,24,9,90,1,2,3
2813,2,2014-09-06,penn-state,,Akron,W (21-3),22,37,59.5,319,3,31,106,3.4,0,68,425,6.3,16,7,4,27,3,25,1,2,3
2814,3,2014-09-13,penn-state,@,Rutgers,W (13-10),25,44,56.8,309,0,33,64,1.9,1,77,373,4.8,13,4,2,19,5,40,0,1,1
2815,4,2014-09-20,penn-state,,Massachusetts,W (48-7),18,32,56.3,236,1,45,228,5.1,5,77,464,6.0,11,11,1,23,6,52,0,0,0
2816,5,2014-09-27,penn-state,,Northwestern,L (6-29),22,46,47.8,216,0,25,50,2.0,0,71,266,3.7,9,3,2,14,4,35,1,1,2
2817,6,2014-10-11,penn-state,@,Michigan,L (13-18),21,33,63.6,160,1,35,54,1.5,0,68,214,3.1,8,7,1,16,5,23,0,1,1
2818,7,2014-10-25,penn-state,,Ohio State,L (24-31),31,50,62.0,224,1,31,16,0.5,1,81,240,3.0,11,5,4,20,4,42,0,2,2
2819,8,2014-11-01,penn-state,,Maryland,L (19-20),18,42,42.9,177,1,41,42,1.0,0,83,219,2.6,10,4,2,16,8,64,3,1,4
2820,9,2014-11-08,penn-state,@,Indiana,W (13-7),12,29,41.4,168,0,37,162,4.4,1,66,330,5.0,7,6,2,15,7,55,0,2,2
2821,10,2014-11-15,penn-state,,Temple,W (30-13),12,26,46.2,112,0,47,254,5.4,2,73,366,5.0,5,13,1,19,5,45,1,2,3
2822,11,2014-11-22,penn-state,@,Illinois,L (14-16),8,16,50.0,93,1,47,172,3.7,1,63,265,4.2,5,8,2,15,5,34,1,0,1
2823,12,2014-11-29,penn-state,,Michigan State,L (10-34),21,45,46.7,195,0,22,38,1.7,1,67,233,3.5,11,4,1,16,4,35,1,1,2
2824,13,2014-12-27,penn-state,N,Boston College*,W (31-30),34,50,68.0,371,4,29,82,2.8,0,79,453,5.7,17,5,3,25,10,60,2,0,2
2825,,13 Games,penn-state,,,,276,497,55.5,3034,13,451,1325,2.9,13,948,4359,4.6,137,84,28,249,75,600,11,15,26
2826,1,2015-09-05,penn-state,@,Temple,L (10-27),11,25,44.0,103,0,27,77,2.9,1,52,180,3.5,4,4,1,9,6,39,0,1,1
2827,2,2015-09-12,penn-state,,Buffalo,W (27-14),14,27,51.9,128,1,39,200,5.1,2,66,328,5.0,5,9,1,15,7,65,0,0,0
2828,3,2015-09-19,penn-state,,Rutgers,W (28-3),10,19,52.6,141,0,41,330,8.0,4,60,471,7.9,4,13,0,17,8,80,0,1,1
2829,4,2015-09-26,penn-state,,San Diego State,W (37-21),22,36,61.1,328,3,34,72,2.1,0,70,400,5.7,14,2,3,19,5,37,1,0,1
2830,5,2015-10-03,penn-state,,Army,W (20-14),10,19,52.6,156,1,34,108,3.2,1,53,264,5.0,5,7,0,12,3,20,0,0,0
2831,6,2015-10-10,penn-state,,Indiana,W (29-7),22,40,55.0,266,2,32,154,4.8,2,72,420,5.8,14,5,3,22,3,30,1,0,1
2832,7,2015-10-17,penn-state,@,Ohio State,L (10-38),7,13,53.8,120,1,40,195,4.9,0,53,315,5.9,2,8,4,14,3,22,1,0,1
2833,8,2015-10-24,penn-state,N,Maryland,W (31-30),13,30,43.3,315,3,31,48,1.5,1,61,363,6.0,11,4,1,16,6,39,3,0,3
2834,9,2015-10-31,penn-state,,Illinois,W (39-0),22,33,66.7,280,3,37,120,3.2,2,70,400,5.7,12,9,2,23,3,25,2,0,2
2835,10,2015-11-07,penn-state,@,Northwestern,L (21-23),22,41,53.7,237,1,30,125,4.2,2,71,362,5.1,8,6,3,17,9,70,1,1,2
2836,11,2015-11-21,penn-state,,Michigan,L (16-28),13,32,40.6,137,1,22,70,3.2,0,54,207,3.8,4,4,6,14,3,30,1,0,1
2837,12,2015-11-28,penn-state,@,Michigan State,L (16-55),27,47,57.4,296,2,25,122,4.9,0,72,418,5.8,10,9,1,20,6,45,2,2,4
2838,13,2016-01-02,penn-state,N,Georgia*,L (17-24),22,42,52.4,281,2,32,120,3.8,0,74,401,5.4,12,3,1,16,6,39,0,1,1
2839,,13 Games,penn-state,,,,215,404,53.2,2788,20,424,1741,4.1,15,828,4529,5.5,105,83,26,214,68,541,12,6,18
2840,1,2016-09-03,penn-state,,Kent State,W (33-13),16,31,51.6,209,2,38,145,3.8,1,69,354,5.1,9,9,1,19,5,55,1,0,1
2841,2,2016-09-10,penn-state,@,Pittsburgh,L (39-42),24,35,68.6,332,1,31,74,2.4,4,66,406,6.2,12,6,2,20,4,35,3,1,4
2842,3,2016-09-17,penn-state,,Temple,W (34-27),18,24,75.0,287,1,37,116,3.1,3,61,403,6.6,8,8,5,21,7,62,2,1,3
2843,4,2016-09-24,penn-state,@,Michigan,L (10-49),16,27,59.3,121,1,28,70,2.5,0,55,191,3.5,6,3,3,12,2,13,1,1,2
2844,5,2016-10-01,penn-state,,Minnesota,W (29-26),19,42,45.2,335,1,28,136,4.9,2,70,471,6.7,8,7,4,19,5,65,0,0,0
2845,6,2016-10-08,penn-state,,Maryland,W (38-14),10,19,52.6,152,2,62,372,6.0,3,81,524,6.5,5,21,2,28,6,45,1,0,1
2846,7,2016-10-22,penn-state,,Ohio State,W (24-21),8,23,34.8,154,1,33,165,5.0,1,56,319,5.7,6,6,1,13,1,5,1,0,1
2847,8,2016-10-29,penn-state,@,Purdue,W (62-24),13,25,52.0,254,3,38,257,6.8,5,63,511,8.1,10,11,3,24,11,91,0,0,0
2848,9,2016-11-05,penn-state,,Iowa,W (41-14),11,18,61.1,240,2,52,359,6.9,3,70,599,8.6,9,15,0,24,9,86,0,0,0
2849,10,2016-11-12,penn-state,@,Indiana,W (45-31),16,30,53.3,332,2,45,77,1.7,3,75,409,5.5,11,5,2,18,5,40,0,2,2
2850,11,2016-11-19,penn-state,@,Rutgers,W (39-0),17,33,51.5,210,1,49,339,6.9,3,82,549,6.7,8,16,1,25,3,15,1,0,1
2851,12,2016-11-26,penn-state,,Michigan State,W (45-12),18,24,75.0,386,4,33,77,2.3,2,57,463,8.1,14,4,0,18,1,15,0,0,0
2852,13,2016-12-03,penn-state,N,Wisconsin,W (38-31),22,31,71.0,384,4,29,51,1.8,1,60,435,7.3,16,3,2,21,3,25,2,0,2
2853,14,2017-01-02,penn-state,N,Southern California*,L (49-52),18,29,62.1,254,4,33,211,6.4,3,62,465,7.5,12,8,3,23,5,65,0,3,3
2854,,14 Games,penn-state,,,,226,391,57.8,3650,29,536,2449,4.6,34,927,6099,6.6,134,122,29,285,67,617,12,8,20
2855,1,2017-09-02,penn-state,,Akron,W (52-0),21,31,67.7,322,2,34,247,7.3,4,65,569,8.8,14,7,3,24,5,45,0,1,1
2856,2,2017-09-09,penn-state,,Pittsburgh,W (33-14),15,28,53.6,164,3,24,148,6.2,1,52,312,6.0,7,6,1,14,1,15,0,1,1
2857,3,2017-09-16,penn-state,,Georgia State,W (56-0),21,29,72.4,360,5,24,166,6.9,3,53,526,9.9,11,8,0,19,5,45,0,0,0
2858,4,2017-09-23,penn-state,@,Iowa,W (21-19),31,48,64.6,284,1,51,295,5.8,1,99,579,5.8,14,15,0,29,8,90,1,1,2
2859,5,2017-09-30,penn-state,,Indiana,W (45-14),24,37,64.9,331,3,37,39,1.1,1,74,370,5.0,15,4,1,20,2,7,0,1,1
2860,6,2017-10-07,penn-state,@,Northwestern,W (31-7),29,41,70.7,286,1,38,95,2.5,3,79,381,4.8,14,6,3,23,3,30,0,0,0
2861,7,2017-10-21,penn-state,,Michigan,W (42-13),17,26,65.4,282,1,35,224,6.4,5,61,506,8.3,12,10,3,25,1,10,0,1,1
2862,8,2017-10-28,penn-state,@,Ohio State,L (38-39),17,29,58.6,192,2,35,91,2.6,2,64,283,4.4,9,5,3,17,9,73,0,0,0
2863,9,2017-11-04,penn-state,@,Michigan State,L (24-27),27,48,56.3,401,3,21,65,3.1,0,69,466,6.8,17,4,1,22,7,86,0,3,3
2864,10,2017-11-11,penn-state,,Rutgers,W (35-6),16,21,76.2,214,2,31,90,2.9,3,52,304,5.8,11,6,1,18,4,20,0,0,0
2865,11,2017-11-18,penn-state,,Nebraska,W (56-44),26,39,66.7,346,4,35,263,7.5,4,74,609,8.2,18,9,5,32,5,39,1,0,1
2866,12,2017-11-25,penn-state,@,Maryland,W (66-3),25,40,62.5,248,3,48,286,6.0,6,88,534,6.1,12,13,3,28,2,10,0,0,0
2867,13,2017-12-30,penn-state,N,Washington*,W (35-28),32,41,78.0,342,2,38,203,5.3,3,79,545,6.9,18,6,1,25,2,20,1,2,3
2868,,13 Games,penn-state,,,,301,458,65.7,3772,32,451,2212,4.9,36,909,5984,6.6,172,99,25,296,54,490,3,10,13
2869,1,2018-09-01,penn-state,,Appalachian State,W (45-38),21,36,58.3,230,1,43,204,4.7,5,79,434,5.5,11,10,3,24,2,10,0,0,0
2870,2,2018-09-08,penn-state,@,Pittsburgh,W (51-6),15,31,48.4,179,3,33,211,6.4,3,64,390,6.1,8,10,5,23,4,45,2,0,2
2871,3,2018-09-15,penn-state,,Kent State,W (63-10),14,25,56.0,346,3,45,297,6.6,6,70,643,9.2,9,14,3,26,9,85,0,1,1
2872,4,2018-09-21,penn-state,@,Illinois,W (63-24),13,20,65.0,204,3,51,387,7.6,6,71,591,8.3,7,20,4,31,8,72,1,1,2
2873,5,2018-09-29,penn-state,,Ohio State,L (26-27),16,32,50.0,286,2,44,206,4.7,1,76,492,6.5,9,9,4,22,7,64,1,0,1
2874,6,2018-10-13,penn-state,,Michigan State,L (17-21),19,32,59.4,192,1,32,205,6.4,1,64,397,6.2,9,5,0,14,6,41,1,0,1
2875,7,2018-10-20,penn-state,@,Indiana,W (33-28),20,37,54.1,243,1,36,174,4.8,3,73,417,5.7,12,8,0,20,3,40,1,1,2
2876,8,2018-10-27,penn-state,,Iowa,W (30-24),13,29,44.8,194,1,35,118,3.4,2,64,312,4.9,10,6,0,16,6,47,1,1,2
2877,9,2018-11-03,penn-state,@,Michigan,L (7-42),8,17,47.1,118,0,30,68,2.3,1,47,186,4.0,5,5,1,11,4,35,1,2,3
2878,10,2018-11-10,penn-state,,Wisconsin,W (22-10),19,25,76.0,160,1,47,183,3.9,1,72,343,4.8,8,13,2,23,3,22,2,0,2
2879,11,2018-11-17,penn-state,@,Rutgers,W (20-7),17,37,45.9,183,2,39,139,3.6,0,76,322,4.2,8,9,2,19,3,43,1,1,2
2880,,11 Games,penn-state,,,,175,321,54.5,2335,18,435,2192,5.0,29,756,4527,6.0,96,109,24,229,55,504,11,7,18
2881,1,2014-08-29,michigan-state,,Jacksonville State,W (45-7),18,24,75.0,354,3,50,211,4.2,3,74,565,7.6,11,11,3,25,2,13,0,0,0
2882,2,2014-09-06,michigan-state,@,Oregon,L (27-46),29,47,61.7,343,2,36,123,3.4,1,83,466,5.6,18,7,0,25,5,38,0,2,2
2883,3,2014-09-20,michigan-state,,Eastern Michigan,W (73-14),14,19,73.7,160,3,60,336,5.6,7,79,496,6.3,8,14,2,24,4,25,0,1,1
2884,4,2014-09-27,michigan-state,,Wyoming,W (56-14),16,20,80.0,195,3,52,338,6.5,5,72,533,7.4,7,18,0,25,9,84,0,0,0
2885,5,2014-10-04,michigan-state,,Nebraska,W (27-22),11,29,37.9,234,1,44,188,4.3,2,73,422,5.8,8,9,0,17,9,94,2,1,3
2886,6,2014-10-11,michigan-state,@,Purdue,W (45-31),19,37,51.4,238,3,43,294,6.8,2,80,532,6.7,13,14,1,28,4,55,0,1,1
2887,7,2014-10-18,michigan-state,@,Indiana,W (56-17),24,32,75.0,332,3,51,330,6.5,5,83,662,8.0,14,15,1,30,3,37,0,1,1
2888,8,2014-10-25,michigan-state,,Michigan,W (35-11),12,22,54.5,227,1,46,219,4.8,3,68,446,6.6,7,14,1,22,8,88,2,0,2
2889,9,2014-11-08,michigan-state,,Ohio State,L (37-49),25,45,55.6,358,2,34,178,5.2,3,79,536,6.8,18,10,1,29,11,105,0,0,0
2890,10,2014-11-15,michigan-state,@,Maryland,W (37-15),14,31,45.2,240,0,47,242,5.1,3,78,482,6.2,11,12,0,23,10,75,0,0,0
2891,11,2014-11-22,michigan-state,,Rutgers,W (45-3),17,26,65.4,278,2,44,242,5.5,4,70,520,7.4,13,12,1,26,3,35,2,0,2
2892,12,2014-11-29,michigan-state,@,Penn State,W (34-10),13,26,50.0,180,1,41,118,2.9,2,67,298,4.4,11,6,1,18,5,30,0,1,1
2893,13,2015-01-01,michigan-state,N,Baylor*,W (42-41),24,42,57.1,314,2,46,238,5.2,4,88,552,6.3,15,11,3,29,7,75,0,2,2
2894,,13 Games,michigan-state,,,,236,400,59.0,3453,26,594,3057,5.1,44,994,6510,6.5,154,153,14,321,80,754,6,9,15
2895,1,2015-09-04,michigan-state,@,Western Michigan,W (37-24),15,31,48.4,256,2,40,196,4.9,3,71,452,6.4,13,11,2,26,3,25,1,0,1
2896,2,2015-09-12,michigan-state,,Oregon,W (31-28),20,32,62.5,192,2,37,197,5.3,2,69,389,5.6,11,9,1,21,2,15,0,1,1
2897,3,2015-09-19,michigan-state,,Air Force,W (35-21),15,23,65.2,247,4,42,77,1.8,0,65,324,5.0,14,5,3,22,6,38,0,0,0
2898,4,2015-09-26,michigan-state,,Central Michigan,W (30-10),11,19,57.9,143,1,36,181,5.0,3,55,324,5.9,6,11,1,18,8,78,0,0,0
2899,5,2015-10-03,michigan-state,,Purdue,W (24-21),13,19,68.4,139,1,47,267,5.7,2,66,406,6.2,7,12,1,20,8,51,0,0,0
2900,6,2015-10-10,michigan-state,@,Rutgers,W (31-24),24,39,61.5,367,2,36,123,3.4,2,75,490,6.5,16,6,0,22,1,5,0,1,1
2901,7,2015-10-17,michigan-state,@,Michigan,W (27-23),18,39,46.2,328,1,33,58,1.8,2,72,386,5.4,13,3,4,20,5,44,0,0,0
2902,8,2015-10-24,michigan-state,,Indiana,W (52-26),30,52,57.7,398,4,44,142,3.2,3,96,540,5.6,21,10,2,33,5,56,1,0,1
2903,9,2015-11-07,michigan-state,@,Nebraska,L (38-39),24,39,61.5,348,4,34,143,4.2,1,73,491,6.7,17,5,3,25,8,76,0,1,1
2904,10,2015-11-14,michigan-state,,Maryland,W (24-7),12,32,37.5,121,1,41,141,3.4,1,73,262,3.6,7,9,0,16,7,50,1,2,3
2905,11,2015-11-21,michigan-state,@,Ohio State,W (17-14),8,16,50.0,91,1,51,203,4.0,1,67,294,4.4,3,14,0,17,4,30,2,0,2
2906,12,2015-11-28,michigan-state,,Penn State,W (55-16),19,27,70.4,248,3,38,188,4.9,3,65,436,6.7,14,10,0,24,4,19,1,0,1
2907,13,2015-12-05,michigan-state,N,Iowa,W (16-13),16,33,48.5,191,0,46,174,3.8,1,79,365,4.6,10,9,1,20,8,80,0,1,1
2908,14,2015-12-31,michigan-state,N,Alabama*,L (0-38),19,39,48.7,210,0,26,29,1.1,0,65,239,3.7,11,2,3,16,6,33,0,2,2
2909,,14 Games,michigan-state,,,,244,440,55.5,3279,26,551,2119,3.8,24,991,5398,5.4,163,116,21,300,75,600,6,8,14
2910,1,2016-09-02,michigan-state,,Furman,W (28-13),13,18,72.2,190,3,40,171,4.3,1,58,361,6.2,9,9,1,19,10,120,1,1,2
2911,2,2016-09-17,michigan-state,@,Notre Dame,W (36-28),19,26,73.1,241,2,52,260,5.0,3,78,501,6.4,12,9,1,22,3,45,0,1,1
2912,3,2016-09-24,michigan-state,,Wisconsin,L (6-30),20,43,46.5,250,0,27,75,2.8,0,70,325,4.6,15,4,2,21,5,35,1,3,4
2913,4,2016-10-01,michigan-state,@,Indiana,L (21-24),21,35,60.0,263,3,41,175,4.3,0,76,438,5.8,10,10,1,21,11,98,1,0,1
2914,5,2016-10-08,michigan-state,,Brigham Young,L (14-31),13,21,61.9,121,0,32,85,2.7,2,53,206,3.9,7,5,1,13,4,39,0,1,1
2915,6,2016-10-15,michigan-state,,Northwestern,L (40-54),27,42,64.3,424,4,23,51,2.2,0,65,475,7.3,15,3,0,18,5,34,1,1,2
2916,7,2016-10-22,michigan-state,@,Maryland,L (17-28),11,24,45.8,156,0,44,270,6.1,2,68,426,6.3,9,13,0,22,7,84,1,1,2
2917,8,2016-10-29,michigan-state,,Michigan,L (23-32),13,28,46.4,184,2,42,217,5.2,1,70,401,5.7,7,12,4,23,7,57,0,1,1
2918,9,2016-11-05,michigan-state,@,Illinois,L (27-31),29,47,61.7,315,1,43,175,4.1,1,90,490,5.4,17,11,0,28,10,89,1,0,1
2919,10,2016-11-12,michigan-state,,Rutgers,W (49-0),12,19,63.2,163,3,50,277,5.5,3,69,440,6.4,6,13,1,20,5,40,0,0,0
2920,11,2016-11-19,michigan-state,,Ohio State,L (16-17),8,21,38.1,127,1,35,207,5.9,1,56,334,6.0,4,9,0,13,6,60,0,2,2
2921,12,2016-11-26,michigan-state,@,Penn State,L (12-45),25,46,54.3,234,0,42,109,2.6,0,88,343,3.9,14,11,1,26,4,23,1,0,1
2922,,12 Games,michigan-state,,,,211,370,57.0,2668,19,471,2072,4.4,14,841,4740,5.6,125,109,12,246,77,724,7,11,18
2923,1,2017-09-02,michigan-state,,Bowling Green State,W (35-10),22,36,61.1,250,3,46,215,4.7,1,82,465,5.7,11,13,1,25,4,25,3,0,3
2924,2,2017-09-09,michigan-state,,Western Michigan,W (28-14),13,21,61.9,161,1,49,296,6.0,3,70,457,6.5,9,12,0,21,3,30,1,1,2
2925,3,2017-09-23,michigan-state,,Notre Dame,L (18-38),32,53,60.4,345,2,32,151,4.7,0,85,496,5.8,17,6,3,26,9,97,2,1,3
2926,4,2017-09-30,michigan-state,,Iowa,W (17-10),18,28,64.3,212,2,40,88,2.2,0,68,300,4.4,12,4,3,19,9,65,0,0,0
2927,5,2017-10-07,michigan-state,@,Michigan,W (14-10),11,22,50.0,94,1,40,158,4.0,1,62,252,4.1,3,8,2,13,11,81,0,0,0
2928,6,2017-10-14,michigan-state,@,Minnesota,W (30-27),9,18,50.0,120,0,50,245,4.9,3,68,365,5.4,6,12,1,19,5,40,2,1,3
2929,7,2017-10-21,michigan-state,,Indiana,W (17-9),16,30,53.3,185,1,44,89,2.0,1,74,274,3.7,10,5,4,19,3,35,1,0,1
2930,8,2017-10-28,michigan-state,@,Northwestern,L (31-39),39,57,68.4,445,4,30,97,3.2,0,87,542,6.2,22,6,0,28,9,84,1,1,2
2931,9,2017-11-04,michigan-state,,Penn State,W (27-24),33,56,58.9,400,2,24,74,3.1,1,80,474,5.9,17,4,4,25,8,87,0,1,1
2932,10,2017-11-11,michigan-state,@,Ohio State,L (3-48),18,36,50.0,131,0,34,64,1.9,0,70,195,2.8,7,6,2,15,5,58,1,2,3
2933,11,2017-11-18,michigan-state,,Maryland,W (17-7),2,14,14.3,20,0,51,271,5.3,2,65,291,4.5,1,15,3,19,3,36,1,0,1
2934,12,2017-11-25,michigan-state,@,Rutgers,W (40-7),21,31,67.7,222,1,56,214,3.8,3,87,436,5.0,15,11,1,27,9,80,0,0,0
2935,13,2017-12-28,michigan-state,N,Washington State*,W (42-17),13,22,59.1,213,3,48,227,4.7,3,70,440,6.3,9,15,1,25,6,50,0,1,1
2936,,13 Games,michigan-state,,,,247,424,58.3,2798,20,544,2189,4.0,18,968,4987,5.2,139,117,25,281,84,768,12,8,20
2937,1,2018-08-31,michigan-state,,Utah State,W (38-31),23,33,69.7,287,2,42,165,3.9,2,75,452,6.0,11,9,3,23,9,62,1,1,2
2938,2,2018-09-08,michigan-state,@,Arizona State,L (13-16),27,39,69.2,314,1,27,63,2.3,0,66,377,5.7,17,5,1,23,9,82,0,1,1
2939,3,2018-09-22,michigan-state,@,Indiana,W (35-21),15,26,57.7,219,2,40,131,3.3,2,66,350,5.3,11,6,2,19,8,72,2,2,4
2940,4,2018-09-29,michigan-state,,Central Michigan,W (31-20),16,25,64.0,185,0,47,160,3.4,4,72,345,4.8,9,11,3,23,5,55,0,1,1
2941,5,2018-10-06,michigan-state,,Northwestern,L (19-29),31,51,60.8,329,1,24,96,4.0,1,75,425,5.7,17,4,1,22,5,49,0,1,1
2942,6,2018-10-13,michigan-state,@,Penn State,W (21-17),25,53,47.2,295,2,36,123,3.4,1,89,418,4.7,17,5,3,25,3,20,0,1,1
2943,7,2018-10-20,michigan-state,,Michigan,L (7-21),7,28,25.0,79,1,23,15,0.7,0,51,94,1.8,4,2,5,11,4,40,1,0,1
2944,8,2018-10-27,michigan-state,,Purdue,W (23-13),26,46,56.5,318,2,40,108,2.7,0,86,426,5.0,18,8,0,26,6,61,1,0,1
2945,9,2018-11-03,michigan-state,@,Maryland,W (24-3),11,22,50.0,87,0,46,269,5.8,3,68,356,5.2,5,13,1,19,4,33,0,2,2
2946,10,2018-11-10,michigan-state,,Ohio State,L (6-26),18,48,37.5,220,0,18,54,3.0,0,66,274,4.2,9,3,0,12,7,46,2,1,3
2947,11,2018-11-17,michigan-state,@,Nebraska,L (6-9),15,41,36.6,146,0,38,143,3.8,0,79,289,3.7,7,8,3,18,7,87,1,1,2
2948,,11 Games,michigan-state,,,,214,412,51.9,2479,11,381,1327,3.5,13,793,3806,4.8,125,74,22,221,67,607,8,11,19
2949,1,2014-08-30,wisconsin,N,Louisiana State,L (24-28),8,24,33.3,50,0,39,268,6.9,3,63,318,5.0,3,10,1,14,3,26,0,2,2
2950,2,2014-09-06,wisconsin,,Western Illinois,W (37-3),24,29,82.8,289,4,39,167,4.3,1,68,456,6.7,17,8,0,25,4,38,0,1,1
2951,3,2014-09-20,wisconsin,,Bowling Green State,W (68-17),9,18,50.0,112,1,60,644,10.7,8,78,756,9.7,3,26,0,29,5,55,2,1,3
2952,4,2014-09-27,wisconsin,,South Florida,W (27-10),11,18,61.1,160,1,57,294,5.2,2,75,454,6.1,8,14,4,26,4,35,1,0,1
2953,5,2014-10-04,wisconsin,@,Northwestern,L (14-20),12,29,41.4,138,1,37,284,7.7,1,66,422,6.4,6,13,0,19,6,49,0,4,4
2954,6,2014-10-11,wisconsin,,Illinois,W (38-28),10,18,55.6,97,0,47,401,8.5,5,65,498,7.7,5,15,2,22,4,53,0,0,0
2955,7,2014-10-25,wisconsin,,Maryland,W (52-7),15,23,65.2,216,2,49,311,6.3,5,72,527,7.3,10,14,1,25,2,20,0,0,0
2956,8,2014-11-01,wisconsin,@,Rutgers,W (37-0),8,20,40.0,87,0,46,298,6.5,4,66,385,5.8,3,13,0,16,7,56,0,1,1
2957,9,2014-11-08,wisconsin,@,Purdue,W (34-16),20,30,66.7,225,2,42,264,6.3,2,72,489,6.8,13,12,0,25,4,40,1,1,2
2958,10,2014-11-15,wisconsin,,Nebraska,W (59-24),7,11,63.6,46,1,53,581,11.0,7,64,627,9.8,3,17,0,20,6,55,4,0,4
2959,11,2014-11-22,wisconsin,@,Iowa,W (26-24),11,14,78.6,139,0,42,266,6.3,3,56,405,7.2,7,11,0,18,7,60,0,0,0
2960,12,2014-11-29,wisconsin,,Minnesota,W (34-24),11,18,61.1,215,2,46,233,5.1,2,64,448,7.0,7,10,3,20,7,69,1,0,1
2961,13,2014-12-06,wisconsin,N,Ohio State,L (0-59),17,43,39.5,187,0,37,71,1.9,0,80,258,3.2,11,6,1,18,3,23,1,3,4
2962,14,2015-01-01,wisconsin,N,Auburn*,W (34-31),14,27,51.9,121,1,54,400,7.4,3,81,521,6.4,7,20,4,31,3,28,0,3,3
2963,,14 Games,wisconsin,,,,177,322,55.0,2082,15,648,4482,6.9,46,970,6564,6.8,103,189,16,308,65,607,10,16,26
2964,1,2015-09-05,wisconsin,N,Alabama,L (17-35),26,39,66.7,228,2,21,40,1.9,0,60,268,4.5,12,2,3,17,5,50,0,1,1
2965,2,2015-09-12,wisconsin,,Miami (OH),W (58-0),23,36,63.9,263,4,45,188,4.2,3,81,451,5.6,14,11,1,26,8,65,0,1,1
2966,3,2015-09-19,wisconsin,,Troy,W (28-3),13,18,72.2,202,1,35,199,5.7,3,53,401,7.6,6,11,0,17,6,63,0,0,0
2967,4,2015-09-26,wisconsin,,Hawaii,W (28-0),15,25,60.0,186,1,54,326,6.0,3,79,512,6.5,11,18,2,31,6,52,0,0,0
2968,5,2015-10-03,wisconsin,,Iowa,L (6-10),21,38,55.3,234,0,34,86,2.5,0,72,320,4.4,15,3,3,21,8,90,2,2,4
2969,6,2015-10-10,wisconsin,@,Nebraska,W (23-21),24,50,48.0,322,1,34,147,4.3,1,84,469,5.6,16,6,4,26,6,45,0,0,0
2970,7,2015-10-17,wisconsin,,Purdue,W (24-7),30,39,76.9,322,0,37,96,2.6,3,76,418,5.5,17,6,3,26,7,65,0,1,1
2971,8,2015-10-24,wisconsin,@,Illinois,W (24-13),25,40,62.5,281,2,40,138,3.5,1,80,419,5.2,16,5,2,23,4,45,0,2,2
2972,9,2015-10-31,wisconsin,,Rutgers,W (48-10),13,28,46.4,217,1,38,209,5.5,5,66,426,6.5,9,6,0,15,5,40,0,2,2
2973,10,2015-11-07,wisconsin,@,Maryland,W (31-24),15,24,62.5,188,1,40,117,2.9,2,64,305,4.8,10,5,3,18,7,54,0,1,1
2974,11,2015-11-21,wisconsin,,Northwestern,L (7-13),20,36,55.6,229,0,26,-26,-1.0,1,62,203,3.3,11,3,0,14,2,25,3,2,5
2975,12,2015-11-28,wisconsin,@,Minnesota,W (31-21),9,17,52.9,79,0,62,257,4.1,4,79,336,4.3,6,13,1,20,6,59,0,1,1
2976,13,2015-12-30,wisconsin,N,Southern California*,W (23-21),18,29,62.1,217,1,46,177,3.8,1,75,394,5.3,14,6,2,22,5,36,0,0,0
2977,,13 Games,wisconsin,,,,252,419,60.1,2968,14,512,1954,3.8,27,931,4922,5.3,157,95,24,276,75,689,5,13,18
2978,1,2016-09-03,wisconsin,N,Louisiana State,W (16-14),19,31,61.3,205,0,42,134,3.2,1,73,339,4.6,11,8,2,21,5,55,1,2,3
2979,2,2016-09-10,wisconsin,,Akron,W (54-10),20,27,74.1,292,3,55,294,5.3,4,82,586,7.1,18,12,2,32,3,40,0,0,0
2980,3,2016-09-17,wisconsin,,Georgia State,W (23-17),18,30,60.0,213,1,49,187,3.8,1,79,400,5.1,13,11,1,25,0,0,1,1,2
2981,4,2016-09-24,wisconsin,@,Michigan State,W (30-6),16,26,61.5,195,1,41,122,3.0,2,67,317,4.7,9,5,1,15,7,67,1,1,2
2982,5,2016-10-01,wisconsin,@,Michigan,L (7-14),9,25,36.0,88,1,28,71,2.5,0,53,159,3.0,4,4,0,8,3,30,0,3,3
2983,6,2016-10-15,wisconsin,,Ohio State,L (23-30),16,28,57.1,214,1,46,236,5.1,1,74,450,6.1,9,13,0,22,4,35,0,1,1
2984,7,2016-10-22,wisconsin,@,Iowa,W (17-9),15,25,60.0,256,1,48,167,3.5,1,73,423,5.8,10,9,1,20,0,0,1,0,1
2985,8,2016-10-29,wisconsin,,Nebraska,W (23-17),14,23,60.9,114,1,38,223,5.9,2,61,337,5.5,7,9,0,16,1,5,0,2,2
2986,9,2016-11-05,wisconsin,@,Northwestern,W (21-7),13,22,59.1,143,0,57,190,3.3,2,79,333,4.2,8,11,1,20,1,10,0,0,0
2987,10,2016-11-12,wisconsin,,Illinois,W (48-3),8,14,57.1,92,2,64,363,5.7,4,78,455,5.8,5,18,0,23,4,34,0,0,0
2988,11,2016-11-19,wisconsin,@,Purdue,W (49-20),12,15,80.0,191,2,56,221,3.9,4,71,412,5.8,10,12,1,23,8,69,1,0,1
2989,12,2016-11-26,wisconsin,,Minnesota,W (31-17),13,22,59.1,152,0,47,210,4.5,4,69,362,5.2,8,10,1,19,3,35,1,0,1
2990,13,2016-12-03,wisconsin,N,Penn State,L (31-38),16,21,76.2,174,0,49,241,4.9,3,70,415,5.9,9,11,2,22,4,40,0,0,0
2991,14,2017-01-02,wisconsin,N,Western Michigan*,W (24-16),13,14,92.9,178,1,38,184,4.8,2,52,362,7.0,9,9,0,18,5,35,0,0,0
2992,,14 Games,wisconsin,,,,202,323,62.5,2507,14,658,2843,4.3,31,981,5350,5.5,130,142,12,284,48,455,6,10,16
2993,1,2017-09-01,wisconsin,,Utah State,W (59-10),15,23,65.2,244,3,45,234,5.2,4,68,478,7.0,12,9,4,25,9,73,2,0,2
2994,2,2017-09-09,wisconsin,,Florida Atlantic,W (31-14),17,30,56.7,207,1,54,357,6.6,3,84,564,6.7,10,18,1,29,1,10,1,1,2
2995,3,2017-09-16,wisconsin,@,Brigham Young,W (40-6),18,19,94.7,256,4,49,235,4.8,1,68,491,7.2,9,19,0,28,6,56,0,0,0
2996,4,2017-09-30,wisconsin,,Northwestern,W (33-24),11,20,55.0,197,1,37,109,2.9,2,57,306,5.4,6,7,0,13,5,47,1,2,3
2997,5,2017-10-07,wisconsin,@,Nebraska,W (38-17),9,17,52.9,113,1,49,353,7.2,3,66,466,7.1,4,14,1,19,8,78,0,1,1
2998,6,2017-10-14,wisconsin,,Purdue,W (17-9),13,18,72.2,199,1,50,299,6.0,1,68,498,7.3,10,13,1,24,8,65,1,2,3
2999,7,2017-10-21,wisconsin,,Maryland,W (38-13),16,24,66.7,225,2,41,215,5.2,2,65,440,6.8,12,10,1,23,6,49,1,1,2
3000,8,2017-10-28,wisconsin,@,Illinois,W (24-10),10,19,52.6,135,0,45,168,3.7,3,64,303,4.7,8,9,2,19,4,50,0,1,1
3001,9,2017-11-04,wisconsin,@,Indiana,W (45-17),15,22,68.2,170,2,52,237,4.6,4,74,407,5.5,9,12,3,24,6,62,0,1,1
3002,10,2017-11-11,wisconsin,,Iowa,W (38-14),11,18,61.1,135,2,49,247,5.0,2,67,382,5.7,8,8,2,18,6,54,1,3,4
3003,11,2017-11-18,wisconsin,,Michigan,W (24-10),9,19,47.4,143,1,40,182,4.6,1,59,325,5.5,5,7,2,14,4,35,0,1,1
3004,12,2017-11-25,wisconsin,@,Minnesota,W (31-0),17,21,81.0,169,3,39,287,7.4,1,60,456,7.6,10,10,0,20,3,34,1,0,1
3005,13,2017-12-02,wisconsin,N,Ohio State,L (21-27),20,41,48.8,238,0,32,60,1.9,1,73,298,4.1,10,5,1,16,6,55,0,2,2
3006,14,2017-12-30,wisconsin,@,Miami (FL)*,W (34-24),23,34,67.6,258,4,44,142,3.2,0,78,400,5.1,15,7,2,24,3,35,1,0,1
3007,,14 Games,wisconsin,,,,204,325,62.8,2689,25,626,3125,5.0,28,951,5814,6.1,128,148,20,296,75,703,9,15,24
3008,1,2018-08-31,wisconsin,,Western Kentucky,W (34-3),17,31,54.8,257,2,39,234,6.0,2,70,491,7.0,14,9,1,24,8,70,1,0,1
3009,2,2018-09-08,wisconsin,,New Mexico,W (45-14),9,13,69.2,151,2,59,417,7.1,4,72,568,7.9,5,24,0,29,4,39,1,1,2
3010,3,2018-09-15,wisconsin,,Brigham Young,L (21-24),18,28,64.3,190,0,43,204,4.7,3,71,394,5.5,9,13,1,23,6,33,0,1,1
3011,4,2018-09-22,wisconsin,@,Iowa,W (28-17),17,22,77.3,205,3,44,210,4.8,1,66,415,6.3,8,11,0,19,8,68,0,0,0
3012,5,2018-10-06,wisconsin,,Nebraska,W (41-24),13,24,54.2,163,1,48,370,7.7,4,72,533,7.4,9,15,2,26,5,50,1,0,1
3013,6,2018-10-13,wisconsin,@,Michigan,L (13-38),7,20,35.0,100,1,29,183,6.3,1,49,283,5.8,4,7,0,11,3,30,0,2,2
3014,7,2018-10-20,wisconsin,,Illinois,W (49-20),13,22,59.1,188,3,54,357,6.6,4,76,545,7.2,10,20,1,31,5,50,0,2,2
3015,8,2018-10-27,wisconsin,@,Northwestern,L (17-31),20,33,60.6,158,1,32,165,5.2,1,65,323,5.0,6,11,0,17,5,54,3,0,3
3016,9,2018-11-03,wisconsin,,Rutgers,W (31-17),12,23,52.2,156,1,46,317,6.9,3,69,473,6.9,9,16,1,26,4,19,0,2,2
3017,10,2018-11-10,wisconsin,@,Penn State,L (10-22),9,20,45.0,60,0,37,209,5.6,1,57,269,4.7,4,7,1,12,6,50,2,2,4
3018,11,2018-11-17,wisconsin,@,Purdue,W (47-44),16,24,66.7,206,2,51,385,7.5,4,75,591,7.9,7,16,1,24,13,171,1,0,1
3019,,11 Games,wisconsin,,,,151,260,58.1,1834,16,482,3051,6.3,28,742,4885,6.6,85,149,8,242,67,634,9,10,19
3020,1,2014-08-28,minnesota,,Eastern Illinois,W (42-20),10,18,55.6,156,1,40,182,4.6,4,58,338,5.8,6,11,1,18,5,50,1,0,1
3021,2,2014-09-06,minnesota,,Middle Tennessee State,W (35-24),5,11,45.5,67,1,50,284,5.7,3,61,351,5.8,3,14,1,18,3,24,0,1,1
3022,3,2014-09-13,minnesota,@,Texas Christian,L (7-30),14,29,48.3,169,1,39,99,2.5,0,68,268,3.9,8,5,1,14,4,40,2,3,5
3023,4,2014-09-20,minnesota,,San Jose State,W (24-7),1,7,14.3,7,0,58,380,6.6,3,65,387,6.0,1,18,0,19,10,80,1,1,2
3024,5,2014-09-27,minnesota,@,Michigan,W (30-14),14,23,60.9,167,1,47,206,4.4,1,70,373,5.3,9,11,0,20,7,65,0,0,0
3025,6,2014-10-11,minnesota,,Northwestern,W (24-17),10,15,66.7,153,0,39,121,3.1,2,54,274,5.1,5,7,2,14,6,47,0,1,1
3026,7,2014-10-18,minnesota,,Purdue,W (39-38),9,18,50.0,165,2,52,285,5.5,3,70,450,6.4,6,15,1,22,7,66,1,0,1
3027,8,2014-10-25,minnesota,@,Illinois,L (24-28),12,30,40.0,240,1,41,171,4.2,2,71,411,5.8,8,9,2,19,4,30,2,1,3
3028,9,2014-11-08,minnesota,,Iowa,W (51-14),10,14,71.4,138,4,59,291,4.9,3,73,429,5.9,4,18,1,23,2,17,0,0,0
3029,10,2014-11-15,minnesota,,Ohio State,L (24-31),7,20,35.0,85,0,44,218,5.0,3,64,303,4.7,5,9,3,17,7,54,0,2,2
3030,11,2014-11-22,minnesota,@,Nebraska,W (28-24),8,18,44.4,135,0,53,281,5.3,4,71,416,5.9,7,15,1,23,1,15,0,0,0
3031,12,2014-11-29,minnesota,@,Wisconsin,L (24-34),5,18,27.8,95,0,44,177,4.0,3,62,272,4.4,3,8,1,12,7,72,1,0,1
3032,13,2015-01-01,minnesota,N,Missouri*,L (17-33),22,33,66.7,267,1,33,106,3.2,1,66,373,5.7,11,8,0,19,6,45,3,0,3
3033,,13 Games,minnesota,,,,127,254,50.0,1844,12,599,2801,4.7,32,853,4645,5.4,76,148,14,238,69,605,11,9,20
3034,1,2015-09-03,minnesota,,Texas Christian,L (17-23),19,35,54.3,197,1,39,144,3.7,1,74,341,4.6,12,6,0,18,7,60,2,0,2
3035,2,2015-09-12,minnesota,@,Colorado State,W (23-20),23,45,51.1,233,2,41,180,4.4,0,86,413,4.8,11,9,3,23,8,60,2,0,2
3036,3,2015-09-19,minnesota,,Kent State,W (10-7),17,27,63.0,184,1,44,104,2.4,0,71,288,4.1,9,3,1,13,8,85,1,2,3
3037,4,2015-09-26,minnesota,,Ohio,W (27-24),22,31,71.0,264,0,36,204,5.7,3,67,468,7.0,14,8,2,24,4,31,1,0,1
3038,5,2015-10-03,minnesota,@,Northwestern,L (0-27),15,32,46.9,99,0,33,74,2.2,0,65,173,2.7,5,6,0,11,2,10,1,1,2
3039,6,2015-10-10,minnesota,@,Purdue,W (41-13),11,18,61.1,82,2,48,326,6.8,2,66,408,6.2,4,13,0,17,6,55,0,1,1
3040,7,2015-10-17,minnesota,,Nebraska,L (25-48),26,40,65.0,301,1,26,65,2.5,2,66,366,5.5,15,3,0,18,6,55,1,2,3
3041,8,2015-10-31,minnesota,,Michigan,L (26-29),16,33,48.5,317,1,35,144,4.1,1,68,461,6.8,13,5,2,20,7,53,0,0,0
3042,9,2015-11-07,minnesota,@,Ohio State,L (14-28),27,45,60.0,281,2,26,33,1.3,0,71,314,4.4,12,0,1,13,3,25,0,1,1
3043,10,2015-11-14,minnesota,@,Iowa,L (35-40),20,28,71.4,301,2,29,133,4.6,3,57,434,7.6,14,8,2,24,12,87,0,0,0
3044,11,2015-11-21,minnesota,,Illinois,W (32-23),15,26,57.7,88,1,32,255,8.0,3,58,343,5.9,5,9,2,16,5,30,1,0,1
3045,12,2015-11-28,minnesota,,Wisconsin,L (21-31),16,37,43.2,223,1,18,53,2.9,1,55,276,5.0,6,3,2,11,4,35,2,3,5
3046,13,2015-12-28,minnesota,N,Central Michigan*,W (21-14),24,30,80.0,223,1,39,158,4.1,1,69,381,5.5,13,7,1,21,1,5,0,1,1
3047,,13 Games,minnesota,,,,251,427,58.8,2793,15,446,1873,4.2,17,873,4666,5.3,133,80,16,229,73,591,11,11,22
3048,1,2016-09-01,minnesota,,Oregon State,W (30-23),13,27,48.1,130,0,47,150,3.2,4,74,280,3.8,8,11,2,21,8,70,1,0,1
3049,2,2016-09-10,minnesota,,Indiana State,W (58-28),21,32,65.6,301,4,44,292,6.6,3,76,593,7.8,16,14,1,31,10,82,0,0,0
3050,3,2016-09-24,minnesota,,Colorado State,W (31-24),16,20,80.0,174,0,45,243,5.4,4,65,417,6.4,10,10,1,21,9,68,0,1,1
3051,4,2016-10-01,minnesota,@,Penn State,L (26-29),24,41,58.5,241,1,48,228,4.8,1,89,469,5.3,14,13,4,31,8,83,0,1,1
3052,5,2016-10-08,minnesota,,Iowa,L (7-14),13,33,39.4,166,0,29,102,3.5,1,62,268,4.3,8,5,0,13,8,58,1,2,3
3053,6,2016-10-15,minnesota,@,Maryland,W (31-10),7,15,46.7,82,1,48,229,4.8,2,63,311,4.9,5,9,2,16,7,50,0,0,0
3054,7,2016-10-22,minnesota,,Rutgers,W (34-32),11,19,57.9,156,0,53,243,4.6,3,72,399,5.5,6,13,0,19,6,55,1,1,2
3055,8,2016-10-29,minnesota,@,Illinois,W (40-17),10,19,52.6,112,0,48,171,3.6,5,67,283,4.2,4,10,1,15,6,56,0,0,0
3056,9,2016-11-05,minnesota,,Purdue,W (44-31),14,23,60.9,231,0,43,235,5.5,5,66,466,7.1,6,12,0,18,5,65,0,1,1
3057,10,2016-11-12,minnesota,@,Nebraska,L (17-24),18,28,64.3,180,0,34,85,2.5,2,62,265,4.3,8,4,3,15,2,15,0,1,1
3058,11,2016-11-19,minnesota,,Northwestern,W (29-12),14,25,56.0,197,1,40,131,3.3,2,65,328,5.0,7,8,0,15,6,50,1,1,2
3059,12,2016-11-26,minnesota,@,Wisconsin,L (17-31),9,26,34.6,158,1,38,128,3.4,1,64,286,4.5,7,9,2,18,3,26,0,4,4
3060,13,2016-12-27,minnesota,N,Washington State*,W (17-12),11,20,55.0,129,1,41,150,3.7,1,61,279,4.6,8,8,1,17,10,65,1,0,1
3061,,13 Games,minnesota,,,,181,328,55.2,2257,9,558,2387,4.3,34,886,4644,5.2,107,126,17,250,88,743,5,12,17
3062,1,2017-08-31,minnesota,,Buffalo,W (17-7),19,32,59.4,239,1,51,169,3.3,1,83,408,4.9,10,10,1,21,4,35,0,1,1
3063,2,2017-09-09,minnesota,@,Oregon State,W (48-14),7,8,87.5,158,1,58,253,4.4,5,66,411,6.2,5,12,4,21,6,70,1,0,1
3064,3,2017-09-16,minnesota,,Middle Tennessee State,W (34-3),11,18,61.1,122,0,47,221,4.7,3,65,343,5.3,4,14,0,18,3,22,0,0,0
3065,4,2017-09-30,minnesota,,Maryland,L (24-31),13,26,50.0,229,1,31,80,2.6,2,57,309,5.4,11,4,3,18,3,29,0,2,2
3066,5,2017-10-07,minnesota,@,Purdue,L (17-31),11,25,44.0,101,2,47,227,4.8,0,72,328,4.6,4,11,1,16,5,47,1,1,2
3067,6,2017-10-14,minnesota,,Michigan State,L (27-30),16,32,50.0,216,3,27,74,2.7,0,59,290,4.9,10,4,0,14,1,15,1,1,2
3068,7,2017-10-21,minnesota,,Illinois,W (24-17),5,15,33.3,47,1,55,292,5.3,1,70,339,4.8,2,19,1,22,3,12,1,2,3
3069,8,2017-10-28,minnesota,@,Iowa,L (10-17),9,29,31.0,139,0,43,142,3.3,1,72,281,3.9,4,10,1,15,5,37,0,1,1
3070,9,2017-11-04,minnesota,@,Michigan,L (10-33),5,12,41.7,74,0,44,90,2.0,1,56,164,2.9,3,8,2,13,3,10,1,0,1
3071,10,2017-11-11,minnesota,,Nebraska,W (54-21),9,16,56.3,105,0,45,409,9.1,6,61,514,8.4,5,17,2,24,3,35,0,0,0
3072,11,2017-11-18,minnesota,@,Northwestern,L (0-39),2,11,18.2,43,0,38,139,3.7,0,49,182,3.7,1,6,0,7,2,18,2,3,5
3073,12,2017-11-25,minnesota,,Wisconsin,L (0-31),3,9,33.3,40,0,39,93,2.4,0,48,133,2.8,2,5,1,8,1,10,0,0,0
3074,,12 Games,minnesota,,,,110,233,47.2,1513,9,525,2189,4.2,20,758,3702,4.9,61,120,16,197,39,340,7,11,18
3075,1,2018-08-30,minnesota,,New Mexico State,W (48-10),17,34,50.0,227,2,46,300,6.5,3,80,527,6.6,9,14,0,23,9,92,1,0,1
3076,2,2018-09-08,minnesota,,Fresno State,W (21-14),16,26,61.5,175,0,45,132,2.9,2,71,307,4.3,12,7,1,20,3,30,1,0,1
3077,3,2018-09-15,minnesota,,Miami (OH),W (26-3),14,26,53.8,177,3,44,118,2.7,0,70,295,4.2,8,12,2,22,5,52,1,1,2
3078,4,2018-09-22,minnesota,@,Maryland,L (13-42),14,32,43.8,169,1,40,94,2.4,0,72,263,3.7,9,8,6,23,1,15,1,2,3
3079,5,2018-10-06,minnesota,,Iowa,L (31-48),18,36,50.0,234,3,31,86,2.8,1,67,320,4.8,9,8,3,20,2,10,0,4,4
3080,6,2018-10-13,minnesota,@,Ohio State,L (14-30),13,23,56.5,218,0,33,178,5.4,2,56,396,7.1,10,7,2,19,4,60,1,2,3
3081,7,2018-10-20,minnesota,@,Nebraska,L (28-53),20,36,55.6,349,1,36,125,3.5,3,72,474,6.6,16,5,1,22,8,80,0,1,1
3082,8,2018-10-26,minnesota,,Indiana,W (38-31),17,24,70.8,302,3,40,180,4.5,2,64,482,7.5,12,8,2,22,3,20,3,1,4
3083,9,2018-11-03,minnesota,@,Illinois,L (31-55),15,28,53.6,260,2,42,178,4.2,2,70,438,6.3,7,10,3,20,2,15,2,0,2
3084,10,2018-11-10,minnesota,,Purdue,W (41-10),11,20,55.0,150,2,41,265,6.5,2,61,415,6.8,6,11,5,22,5,50,0,1,1
3085,11,2018-11-17,minnesota,,Northwestern,L (14-24),19,32,59.4,197,1,35,109,3.1,1,67,306,4.6,9,7,2,18,3,34,1,2,3
3086,,11 Games,minnesota,,,,174,317,54.9,2458,18,433,1765,4.1,18,750,4223,5.6,107,97,27,231,45,458,11,14,25
3087,1,2014-08-30,nebraska,,Florida Atlantic,W (55-7),17,35,48.6,286,2,57,498,8.7,5,92,784,8.5,11,24,0,35,6,60,0,0,0
3088,2,2014-09-06,nebraska,,McNeese State,W (31-24),16,31,51.6,242,2,33,195,5.9,2,64,437,6.8,9,7,1,17,5,40,0,1,1
3089,3,2014-09-13,nebraska,@,Fresno State,W (55-19),14,24,58.3,282,4,42,280,6.7,2,66,562,8.5,13,7,2,22,6,61,1,0,1
3090,4,2014-09-20,nebraska,,Miami (FL),W (41-31),9,13,69.2,113,2,54,343,6.4,2,67,456,6.8,5,17,5,27,7,69,1,1,2
3091,5,2014-09-27,nebraska,,Illinois,W (45-14),10,21,47.6,166,1,70,458,6.5,5,91,624,6.9,6,26,3,35,8,70,1,1,2
3092,6,2014-10-04,nebraska,@,Michigan State,L (22-27),21,45,46.7,282,0,37,47,1.3,2,82,329,4.0,12,5,3,20,6,48,2,2,4
3093,7,2014-10-18,nebraska,@,Northwestern,W (38-17),19,30,63.3,237,1,44,234,5.3,4,74,471,6.4,11,12,2,25,7,68,0,0,0
3094,8,2014-10-25,nebraska,,Rutgers,W (42-24),14,22,63.6,163,2,41,292,7.1,4,63,455,7.2,8,11,2,21,5,35,1,1,2
3095,9,2014-11-01,nebraska,,Purdue,W (35-14),8,21,38.1,118,1,51,179,3.5,4,72,297,4.1,6,10,1,17,3,30,1,2,3
3096,10,2014-11-15,nebraska,@,Wisconsin,L (24-59),6,18,33.3,62,1,46,118,2.6,2,64,180,2.8,3,7,2,12,7,55,4,1,5
3097,11,2014-11-22,nebraska,,Minnesota,L (24-28),12,20,60.0,223,1,38,174,4.6,1,58,397,6.8,7,10,1,18,3,25,2,0,2
3098,12,2014-11-28,nebraska,@,Iowa,W (37-34),12,28,42.9,202,4,31,161,5.2,0,59,363,6.2,8,4,1,13,5,49,0,2,2
3099,13,2014-12-27,nebraska,N,Southern California*,L (42-45),32,51,62.7,381,3,43,144,3.3,2,94,525,5.6,16,9,3,28,7,45,0,1,1
3100,,13 Games,nebraska,,,,190,359,52.9,2757,24,587,3123,5.3,35,946,5880,6.2,115,149,26,290,75,655,13,12,25
3101,1,2015-09-05,nebraska,,Brigham Young,L (28-33),24,41,58.5,319,3,37,126,3.4,1,78,445,5.7,16,9,0,25,12,90,1,1,2
3102,2,2015-09-12,nebraska,,South Alabama,W (48-9),26,38,68.4,303,3,37,258,7.0,3,75,561,7.5,16,14,1,31,7,80,0,1,1
3103,3,2015-09-19,nebraska,@,Miami (FL),L (33-36),21,45,46.7,309,4,32,153,4.8,0,77,462,6.0,12,8,4,24,12,98,0,3,3
3104,4,2015-09-26,nebraska,,Southern Mississippi,W (36-28),23,35,65.7,368,2,39,242,6.2,1,74,610,8.2,14,10,1,25,12,98,1,1,2
3105,5,2015-10-03,nebraska,@,Illinois,L (13-14),10,31,32.3,105,0,34,187,5.5,1,65,292,4.5,2,9,1,12,6,42,1,1,2
3106,6,2015-10-10,nebraska,,Wisconsin,L (21-23),11,28,39.3,129,1,37,196,5.3,2,65,325,5.0,7,5,1,13,9,89,1,0,1
3107,7,2015-10-17,nebraska,@,Minnesota,W (48-25),18,26,69.2,261,3,39,203,5.2,2,65,464,7.1,14,8,1,23,2,25,0,0,0
3108,8,2015-10-24,nebraska,,Northwestern,L (28-30),24,48,50.0,291,1,38,82,2.2,2,86,373,4.3,13,6,3,22,6,64,0,1,1
3109,9,2015-10-31,nebraska,@,Purdue,L (45-55),29,48,60.4,407,4,29,77,2.7,2,77,484,6.3,22,3,3,28,7,40,1,4,5
3110,10,2015-11-07,nebraska,,Michigan State,W (39-38),19,33,57.6,320,2,36,179,5.0,3,69,499,7.2,12,11,1,24,5,55,0,2,2
3111,11,2015-11-14,nebraska,@,Rutgers,W (31-14),14,21,66.7,188,3,38,174,4.6,1,59,362,6.1,8,7,1,16,2,15,0,3,3
3112,12,2015-11-27,nebraska,,Iowa,L (20-28),25,45,55.6,296,0,38,137,3.6,2,83,433,5.2,14,7,1,22,8,95,0,4,4
3113,13,2015-12-26,nebraska,N,UCLA*,W (37-29),12,19,63.2,174,1,62,326,5.3,4,81,500,6.2,10,17,4,31,6,38,1,0,1
3114,,13 Games,nebraska,,,,256,458,55.9,3470,27,496,2340,4.7,24,954,5810,6.1,160,114,22,296,94,829,6,21,27
3115,1,2016-09-03,nebraska,,Fresno State,W (43-10),6,13,46.2,114,1,51,292,5.7,5,64,406,6.3,4,15,1,20,7,80,0,0,0
3116,2,2016-09-10,nebraska,,Wyoming,W (52-17),21,35,60.0,412,4,43,138,3.2,2,78,550,7.1,17,5,3,25,7,93,0,1,1
3117,3,2016-09-17,nebraska,,Oregon,W (35-32),17,35,48.6,200,3,47,228,4.9,2,82,428,5.2,10,12,4,26,7,55,1,0,1
3118,4,2016-09-24,nebraska,@,Northwestern,W (24-13),18,29,62.1,246,1,47,310,6.6,2,76,556,7.3,12,12,2,26,4,60,2,0,2
3119,5,2016-10-01,nebraska,,Illinois,W (31-16),16,23,69.6,220,1,49,203,4.1,3,72,423,5.9,12,9,2,23,3,35,1,1,2
3120,6,2016-10-15,nebraska,@,Indiana,W (27-22),10,26,38.5,208,1,45,152,3.4,1,71,360,5.1,8,9,0,17,9,53,0,2,2
3121,7,2016-10-22,nebraska,,Purdue,W (27-14),17,31,54.8,252,1,36,158,4.4,2,67,410,6.1,11,10,1,22,7,67,0,1,1
3122,8,2016-10-29,nebraska,@,Wisconsin,L (17-23),12,31,38.7,153,0,44,152,3.5,2,75,305,4.1,9,7,0,16,2,10,0,2,2
3123,9,2016-11-05,nebraska,@,Ohio State,L (3-62),9,33,27.3,126,0,24,78,3.3,0,57,204,3.6,6,2,1,9,4,43,0,2,2
3124,10,2016-11-12,nebraska,,Minnesota,W (24-17),19,28,67.9,217,2,32,157,4.9,1,60,374,6.2,10,9,0,19,8,81,0,0,0
3125,11,2016-11-19,nebraska,,Maryland,W (28-7),23,37,62.2,220,1,45,181,4.0,3,82,401,4.9,13,11,4,28,2,20,0,0,0
3126,12,2016-11-25,nebraska,@,Iowa,L (10-40),14,37,37.8,127,1,31,90,2.9,0,68,217,3.2,8,6,3,17,8,57,0,0,0
3127,13,2016-12-30,nebraska,N,Tennessee*,L (24-38),19,42,45.2,257,2,28,61,2.2,1,70,318,4.5,12,5,1,18,7,41,1,0,1
3128,,13 Games,nebraska,,,,201,400,50.3,2752,18,522,2200,4.2,24,922,4952,5.4,132,112,22,266,75,695,5,9,14
3129,1,2017-09-02,nebraska,,Arkansas State,W (43-36),19,32,59.4,238,2,38,225,5.9,2,70,463,6.6,14,10,1,25,8,75,0,0,0
3130,2,2017-09-09,nebraska,@,Oregon,L (35-42),19,41,46.3,252,3,29,109,3.8,2,70,361,5.2,11,6,2,19,3,25,0,4,4
3131,3,2017-09-16,nebraska,,Northern Illinois,L (17-21),25,47,53.2,299,0,36,85,2.4,2,83,384,4.6,12,6,0,18,5,48,0,3,3
3132,4,2017-09-23,nebraska,,Rutgers,W (27-17),13,26,50.0,109,2,47,197,4.2,1,73,306,4.2,8,11,2,21,6,46,0,2,2
3133,5,2017-09-29,nebraska,@,Illinois,W (28-6),17,24,70.8,246,3,38,165,4.3,1,62,411,6.6,12,9,2,23,5,70,1,0,1
3134,6,2017-10-07,nebraska,,Wisconsin,L (17-38),18,35,51.4,271,1,26,110,4.2,0,61,381,6.2,10,5,1,16,4,35,1,1,2
3135,7,2017-10-14,nebraska,,Ohio State,L (14-56),27,47,57.4,349,2,16,44,2.8,0,63,393,6.2,12,2,0,14,12,104,0,1,1
3136,8,2017-10-28,nebraska,@,Purdue,W (25-24),32,50,64.0,431,2,27,40,1.5,0,77,471,6.1,16,5,4,25,9,95,0,0,0
3137,9,2017-11-04,nebraska,,Northwestern,L (24-31),21,38,55.3,225,2,31,112,3.6,0,69,337,4.9,12,7,2,21,7,68,0,3,3
3138,10,2017-11-11,nebraska,@,Minnesota,L (21-54),25,36,69.4,311,1,33,69,2.1,2,69,380,5.5,13,5,2,20,4,54,0,0,0
3139,11,2017-11-18,nebraska,@,Penn State,L (44-56),26,41,63.4,399,2,26,67,2.6,3,67,466,7.0,16,4,1,21,9,89,0,0,0
3140,12,2017-11-24,nebraska,,Iowa,L (14-56),23,42,54.8,200,2,21,67,3.2,0,63,267,4.2,9,3,0,12,3,19,0,3,3
3141,,12 Games,nebraska,,,,265,459,57.7,3330,22,368,1290,3.5,13,827,4620,5.6,145,73,17,235,75,728,2,17,19
3142,1,2018-09-08,nebraska,,Colorado,L (28-33),19,29,65.5,236,1,54,329,6.1,3,83,565,6.8,9,13,3,25,11,95,2,1,3
3143,2,2018-09-15,nebraska,,Troy,L (19-24),19,27,70.4,177,2,48,187,3.9,0,75,364,4.9,7,12,3,22,10,77,1,2,3
3144,3,2018-09-22,nebraska,@,Michigan,L (10-56),13,24,54.2,93,0,30,39,1.3,1,54,132,2.4,4,5,3,12,10,79,1,1,2
3145,4,2018-09-29,nebraska,,Purdue,L (28-42),25,42,59.5,323,2,39,259,6.6,2,81,582,7.2,16,14,1,31,11,136,0,1,1
3146,5,2018-10-06,nebraska,@,Wisconsin,L (24-41),26,44,59.1,407,2,24,111,4.6,1,68,518,7.6,17,7,2,26,10,100,1,0,1
3147,6,2018-10-13,nebraska,@,Northwestern,L (31-34),25,35,71.4,251,1,47,231,4.9,3,82,482,5.9,9,15,0,24,9,89,1,2,3
3148,7,2018-10-20,nebraska,,Minnesota,W (53-28),25,30,83.3,276,3,43,383,8.9,4,73,659,9.0,9,18,1,28,6,43,1,0,1
3149,8,2018-10-27,nebraska,,Bethune-Cookman,W (45-9),17,31,54.8,242,2,33,226,6.8,3,64,468,7.3,11,12,0,23,5,35,0,2,2
3150,9,2018-11-03,nebraska,@,Ohio State,L (31-36),22,33,66.7,266,1,49,184,3.8,3,82,450,5.5,14,11,2,27,5,44,1,0,1
3151,10,2018-11-10,nebraska,,Illinois,W (54-35),24,34,70.6,290,3,34,316,9.3,4,68,606,8.9,12,9,1,22,7,72,1,1,2
3152,11,2018-11-17,nebraska,,Michigan State,W (9-6),16,37,43.2,145,0,30,103,3.4,0,67,248,3.7,8,5,1,14,5,45,2,0,2
3153,,11 Games,nebraska,,,,231,366,63.1,2706,17,431,2368,5.5,24,797,5074,6.4,116,121,17,254,89,815,11,10,21
3154,1,2014-08-30,iowa,,Northern Iowa,W (31-23),31,41,75.6,250,2,36,151,4.2,2,77,401,5.2,11,9,6,26,4,35,1,0,1
3155,2,2014-09-06,iowa,,Ball State,W (17-13),35,55,63.6,342,2,29,113,3.9,0,84,455,5.4,17,9,1,27,3,30,2,0,2
3156,3,2014-09-13,iowa,,Iowa State,L (17-20),16,24,66.7,146,0,44,129,2.9,2,68,275,4.0,5,12,1,18,6,50,1,1,2
3157,4,2014-09-20,iowa,@,Pittsburgh,W (24-20),12,18,66.7,178,1,35,133,3.8,2,53,311,5.9,7,8,2,17,2,20,0,1,1
3158,5,2014-09-27,iowa,@,Purdue,W (24-10),17,37,45.9,245,1,51,175,3.4,2,88,420,4.8,10,11,1,22,3,14,0,1,1
3159,6,2014-10-11,iowa,,Indiana,W (45-29),21,32,65.6,219,2,44,207,4.7,3,76,426,5.6,6,12,4,22,4,30,0,0,0
3160,7,2014-10-18,iowa,@,Maryland,L (31-38),32,56,57.1,317,2,31,116,3.7,2,87,433,5.0,11,8,0,19,7,65,2,1,3
3161,8,2014-11-01,iowa,,Northwestern,W (48-7),17,25,68.0,262,1,46,221,4.8,4,71,483,6.8,12,11,1,24,5,35,1,0,1
3162,9,2014-11-08,iowa,@,Minnesota,L (14-51),13,26,50.0,121,1,30,84,2.8,1,56,205,3.7,6,6,1,13,1,15,2,1,3
3163,10,2014-11-15,iowa,@,Illinois,W (30-14),17,24,70.8,283,3,55,304,5.5,1,79,587,7.4,12,13,1,26,1,10,1,0,1
3164,11,2014-11-22,iowa,,Wisconsin,L (24-26),20,30,66.7,311,2,28,101,3.6,1,58,412,7.1,12,4,3,19,3,22,1,0,1
3165,12,2014-11-28,iowa,,Nebraska,L (34-37),19,38,50.0,230,2,50,142,2.8,0,88,372,4.2,11,11,2,24,3,21,3,1,4
3166,13,2015-01-02,iowa,N,Tennessee*,L (28-45),15,31,48.4,177,2,35,244,7.0,2,66,421,6.4,10,9,4,23,4,37,1,1,2
3167,,13 Games,iowa,,,,265,437,60.6,3081,21,514,2120,4.1,22,951,5201,5.5,130,123,27,280,46,384,15,7,22
3168,1,2015-09-05,iowa,,Illinois State,W (31-14),16,25,64.0,221,1,44,210,4.8,3,69,431,6.2,10,12,0,22,5,51,1,0,1
3169,2,2015-09-12,iowa,@,Iowa State,W (31-17),15,25,60.0,215,3,45,260,5.8,1,70,475,6.8,9,13,0,22,6,50,1,0,1
3170,3,2015-09-19,iowa,,Pittsburgh,W (27-24),27,40,67.5,258,0,29,105,3.6,3,69,363,5.3,11,9,2,22,5,50,0,1,1
3171,4,2015-09-26,iowa,,North Texas,W (62-16),19,22,86.4,278,2,43,210,4.9,5,65,488,7.5,11,11,1,23,4,24,2,0,2
3172,5,2015-10-03,iowa,@,Wisconsin,W (10-6),9,21,42.9,77,1,40,144,3.6,0,61,221,3.6,3,8,3,14,6,54,1,1,2
3173,6,2015-10-10,iowa,,Illinois,W (29-20),15,31,48.4,200,2,51,278,5.5,1,82,478,5.8,6,15,2,23,6,80,0,0,0
3174,7,2015-10-17,iowa,@,Northwestern,W (40-10),16,27,59.3,198,0,51,294,5.8,5,78,492,6.3,9,14,1,24,5,47,0,1,1
3175,8,2015-10-31,iowa,,Maryland,W (31-15),12,24,50.0,183,0,44,110,2.5,3,68,293,4.3,9,6,3,18,7,53,1,0,1
3176,9,2015-11-07,iowa,@,Indiana,W (35-27),19,31,61.3,233,1,44,234,5.3,4,75,467,6.2,13,11,2,26,5,55,0,0,0
3177,10,2015-11-14,iowa,,Minnesota,W (40-35),19,27,70.4,234,0,48,272,5.7,5,75,506,6.7,12,12,3,27,4,50,0,0,0
3178,11,2015-11-21,iowa,,Purdue,W (40-20),12,20,60.0,213,3,39,174,4.5,3,59,387,6.6,10,9,2,21,2,20,1,0,1
3179,12,2015-11-27,iowa,@,Nebraska,W (28-20),9,16,56.3,97,1,28,153,5.5,2,44,250,5.7,3,4,4,11,6,54,1,0,1
3180,13,2015-12-05,iowa,N,Michigan State,L (13-16),18,27,66.7,216,1,24,52,2.2,0,51,268,5.3,6,5,2,13,5,45,2,1,3
3181,14,2016-01-01,iowa,N,Stanford*,L (16-45),21,33,63.6,239,2,38,48,1.3,0,71,287,4.0,11,6,1,18,7,50,1,1,2
3182,,14 Games,iowa,,,,227,369,61.5,2862,17,568,2544,4.5,35,937,5406,5.8,123,135,26,284,73,683,11,5,16
3183,1,2016-09-03,iowa,,Miami (OH),W (45-21),13,21,61.9,192,1,29,212,7.3,5,50,404,8.1,6,11,0,17,3,35,0,0,0
3184,2,2016-09-10,iowa,,Iowa State,W (42-3),20,30,66.7,237,3,36,198,5.5,3,66,435,6.6,12,10,3,25,5,35,0,0,0
3185,3,2016-09-17,iowa,,North Dakota State,L (21-23),13,24,54.2,197,3,25,34,1.4,0,49,231,4.7,5,6,1,12,3,16,0,1,1
3186,4,2016-09-24,iowa,@,Rutgers,W (14-7),12,23,52.2,162,1,38,193,5.1,1,61,355,5.8,8,11,0,19,7,57,0,0,0
3187,5,2016-10-01,iowa,,Northwestern,L (31-38),19,27,70.4,204,1,41,79,1.9,3,68,283,4.2,9,6,0,15,6,70,0,1,1
3188,6,2016-10-08,iowa,@,Minnesota,W (14-7),17,31,54.8,142,0,41,179,4.4,1,72,321,4.5,7,9,1,17,4,32,1,2,3
3189,7,2016-10-15,iowa,@,Purdue,W (49-35),12,20,60.0,155,2,53,365,6.9,4,73,520,7.1,5,17,2,24,12,94,0,0,0
3190,8,2016-10-22,iowa,,Wisconsin,L (9-17),17,33,51.5,153,0,27,83,3.1,0,60,236,3.9,9,5,0,14,5,30,0,0,0
3191,9,2016-11-05,iowa,@,Penn State,L (14-41),18,26,69.2,204,2,26,30,1.2,0,52,234,4.5,8,2,4,14,4,24,0,1,1
3192,10,2016-11-12,iowa,,Michigan,W (14-13),8,19,42.1,66,1,49,164,3.3,0,68,230,3.4,2,13,2,17,3,24,0,1,1
3193,11,2016-11-19,iowa,@,Illinois,W (28-0),9,17,52.9,80,0,49,262,5.3,3,66,342,5.2,5,11,0,16,5,40,1,1,2
3194,12,2016-11-25,iowa,,Nebraska,W (40-10),10,15,66.7,144,3,47,264,5.6,3,62,408,6.6,5,7,1,13,7,70,0,0,0
3195,13,2017-01-02,iowa,N,Florida*,L (3-30),7,24,29.2,55,0,41,171,4.2,0,65,226,3.5,3,9,2,14,1,10,0,3,3
3196,,13 Games,iowa,,,,175,310,56.5,1991,17,502,2234,4.5,23,812,4225,5.2,84,117,16,217,65,537,2,10,12
3197,1,2017-09-02,iowa,,Wyoming,W (24-3),8,15,53.3,125,3,41,138,3.4,0,56,263,4.7,5,9,2,16,3,25,3,1,4
3198,2,2017-09-09,iowa,@,Iowa State,W (44-41),27,41,65.9,333,5,41,164,4.0,1,82,497,6.1,16,12,1,29,10,84,0,0,0
3199,3,2017-09-16,iowa,,North Texas,W (31-14),16,27,59.3,197,2,59,238,4.0,2,86,435,5.1,10,15,3,28,6,63,2,0,2
3200,4,2017-09-23,iowa,,Penn State,L (19-21),13,22,59.1,191,2,23,82,3.6,1,45,273,6.1,6,3,2,11,3,25,1,0,1
3201,5,2017-09-30,iowa,@,Michigan State,L (10-17),17,32,53.1,207,0,25,19,0.8,1,57,226,4.0,9,2,0,11,7,47,2,0,2
3202,6,2017-10-07,iowa,,Illinois,W (45-16),18,34,52.9,250,4,38,191,5.0,1,72,441,6.1,10,10,0,20,3,18,1,1,2
3203,7,2017-10-21,iowa,@,Northwestern,L (10-17),19,33,57.6,223,1,33,89,2.7,0,66,312,4.7,9,5,0,14,6,50,0,1,1
3204,8,2017-10-28,iowa,,Minnesota,W (17-10),15,27,55.6,190,1,33,125,3.8,1,60,315,5.3,7,6,2,15,6,50,1,1,2
3205,9,2017-11-04,iowa,,Ohio State,W (55-24),21,32,65.6,244,5,38,243,6.4,1,70,487,7.0,13,8,3,24,5,34,0,0,0
3206,10,2017-11-11,iowa,@,Wisconsin,L (14-38),8,24,33.3,41,0,26,25,1.0,0,50,66,1.3,2,3,0,5,5,32,2,1,3
3207,11,2017-11-18,iowa,,Purdue,L (15-24),16,33,48.5,176,1,38,82,2.2,1,71,258,3.6,10,6,1,17,6,56,1,1,2
3208,12,2017-11-24,iowa,@,Nebraska,W (56-14),13,20,65.0,192,2,47,313,6.7,6,67,505,7.5,4,18,1,23,3,30,0,0,0
3209,13,2017-12-27,iowa,N,Boston College*,W (27-20),8,15,53.3,99,1,39,101,2.6,2,54,200,3.7,5,6,2,13,3,20,0,0,0
3210,,13 Games,iowa,,,,199,355,56.1,2468,27,481,1810,3.8,17,836,4278,5.1,106,103,17,226,66,534,13,6,19
3211,1,2018-09-01,iowa,,Northern Illinois,W (33-7),13,25,52.0,143,1,48,209,4.4,3,73,352,4.8,6,8,4,18,8,66,0,1,1
3212,2,2018-09-08,iowa,,Iowa State,W (13-3),16,28,57.1,166,0,36,105,2.9,1,64,271,4.2,7,6,1,14,6,55,0,0,0
3213,3,2018-09-15,iowa,,Northern Iowa,W (38-14),25,31,80.6,338,2,50,207,4.1,3,81,545,6.7,15,12,0,27,10,88,0,2,2
3214,4,2018-09-22,iowa,,Wisconsin,L (17-28),14,23,60.9,256,2,31,148,4.8,0,54,404,7.5,11,5,3,19,1,5,2,1,3
3215,5,2018-10-06,iowa,@,Minnesota,W (48-31),23,39,59.0,314,4,40,106,2.7,2,79,420,5.3,13,5,0,18,5,45,1,1,2
3216,6,2018-10-13,iowa,@,Indiana,W (42-16),21,33,63.6,320,6,32,159,5.0,0,65,479,7.4,12,7,7,26,11,110,0,1,1
3217,7,2018-10-20,iowa,,Maryland,W (23-0),11,24,45.8,86,1,52,224,4.3,0,76,310,4.1,7,14,1,22,0,0,0,1,1
3218,8,2018-10-27,iowa,@,Penn State,L (24-30),19,50,38.0,215,1,38,135,3.6,0,88,350,4.0,13,8,2,23,6,25,0,2,2
3219,9,2018-11-03,iowa,@,Purdue,L (36-38),21,32,65.6,275,1,37,118,3.2,4,69,393,5.7,15,5,2,22,8,75,1,0,1
3220,10,2018-11-10,iowa,,Northwestern,L (10-14),27,41,65.9,269,1,22,64,2.9,0,63,333,5.3,12,3,1,16,3,35,2,0,2
3221,11,2018-11-17,iowa,@,Illinois,W (63-0),14,23,60.9,197,3,37,203,5.5,4,60,400,6.7,9,11,0,20,2,28,0,1,1
3222,,11 Games,iowa,,,,204,349,58.5,2579,22,423,1678,4.0,17,772,4257,5.5,120,84,21,225,60,532,6,10,16
3223,1,2014-08-30,illinois,,Youngstown State,W (28-17),24,38,63.2,285,4,22,78,3.5,0,60,363,6.1,12,2,0,14,7,55,1,0,1
3224,2,2014-09-06,illinois,,Western Kentucky,W (42-34),35,50,70.0,456,3,35,64,1.8,2,85,520,6.1,19,6,3,28,9,69,2,1,3
3225,3,2014-09-13,illinois,@,Washington,L (19-44),20,30,66.7,279,2,26,72,2.8,0,56,351,6.3,9,5,1,15,11,110,2,1,3
3226,4,2014-09-20,illinois,,Texas State,W (42-35),25,39,64.1,266,2,27,219,8.1,3,66,485,7.3,12,7,2,21,4,19,0,1,1
3227,5,2014-09-27,illinois,@,Nebraska,L (14-45),17,38,44.7,261,1,24,78,3.3,1,62,339,5.5,10,4,2,16,7,53,0,3,3
3228,6,2014-10-04,illinois,,Purdue,L (27-38),36,53,67.9,450,2,25,65,2.6,2,78,515,6.6,16,6,4,26,2,20,1,1,2
3229,7,2014-10-11,illinois,@,Wisconsin,L (28-38),14,24,58.3,135,2,39,153,3.9,2,63,288,4.6,5,11,4,20,4,50,0,1,1
3230,8,2014-10-25,illinois,,Minnesota,W (28-24),15,23,65.2,140,1,41,123,3.0,2,64,263,4.1,7,8,1,16,4,36,1,0,1
3231,9,2014-11-01,illinois,@,Ohio State,L (14-55),13,27,48.1,137,1,42,106,2.5,1,69,243,3.5,5,6,4,15,5,50,2,2,4
3232,10,2014-11-15,illinois,,Iowa,L (14-30),17,31,54.8,147,2,25,88,3.5,0,56,235,4.2,8,4,0,12,8,59,0,0,0
3233,11,2014-11-22,illinois,,Penn State,W (16-14),26,42,61.9,215,1,27,68,2.5,0,69,283,4.1,8,5,3,16,3,30,0,0,0
3234,12,2014-11-29,illinois,@,Northwestern,W (47-33),17,28,60.7,147,3,47,291,6.2,2,75,438,5.8,6,14,3,23,6,50,0,1,1
3235,13,2014-12-26,illinois,N,Louisiana Tech*,L (18-35),28,47,59.6,329,1,33,122,3.7,1,80,451,5.6,18,6,2,26,9,68,1,1,2
3236,,13 Games,illinois,,,,287,470,61.1,3247,25,413,1527,3.7,16,883,4774,5.4,135,84,29,248,79,669,10,12,22
3237,1,2015-09-05,illinois,,Kent State,W (52-3),14,29,48.3,208,5,36,134,3.7,2,65,342,5.3,9,7,3,19,8,80,0,1,1
3238,2,2015-09-12,illinois,,Western Illinois,W (44-0),38,54,70.4,353,2,40,147,3.7,2,94,500,5.3,19,7,1,27,3,25,3,1,4
3239,3,2015-09-19,illinois,@,North Carolina,L (14-48),19,38,50.0,172,0,45,227,5.0,2,83,399,4.8,10,10,2,22,8,75,0,1,1
3240,4,2015-09-26,illinois,,Middle Tennessee State,W (27-25),29,49,59.2,238,1,39,140,3.6,1,88,378,4.3,11,11,3,25,6,55,0,0,0
3241,5,2015-10-03,illinois,,Nebraska,W (14-13),23,45,51.1,251,2,32,131,4.1,0,77,382,5.0,11,4,2,17,3,35,0,0,0
3242,6,2015-10-10,illinois,@,Iowa,L (20-29),25,43,58.1,317,1,24,46,1.9,1,67,363,5.4,14,2,4,20,5,45,1,1,2
3243,7,2015-10-24,illinois,,Wisconsin,L (13-24),22,43,51.2,278,0,13,55,4.2,1,56,333,5.9,13,1,1,15,7,50,1,1,2
3244,8,2015-10-31,illinois,@,Penn State,L (0-39),17,44,38.6,130,0,27,37,1.4,0,71,167,2.4,8,4,0,12,8,60,0,1,1
3245,9,2015-11-07,illinois,@,Purdue,W (48-14),21,38,55.3,213,3,41,382,9.3,3,79,595,7.5,10,17,2,29,8,69,0,0,0
3246,10,2015-11-14,illinois,,Ohio State,L (3-28),23,47,48.9,241,0,25,20,0.8,0,72,261,3.6,10,4,1,15,2,10,2,0,2
3247,11,2015-11-21,illinois,@,Minnesota,L (23-32),34,48,70.8,279,2,35,154,4.4,0,83,433,5.2,15,11,2,28,3,30,2,1,3
3248,12,2015-11-28,illinois,N,Northwestern,L (14-24),20,41,48.8,241,0,31,78,2.5,1,72,319,4.4,11,5,0,16,5,55,0,1,1
3249,,12 Games,illinois,,,,285,519,54.9,2921,16,388,1551,4.0,13,907,4472,4.9,141,83,21,245,66,589,9,8,17
3250,1,2016-09-03,illinois,,Murray State,W (52-3),16,24,66.7,228,3,40,287,7.2,4,64,515,8.0,9,10,2,21,7,55,0,0,0
3251,2,2016-09-10,illinois,,North Carolina,L (23-48),17,35,48.6,127,2,36,182,5.1,1,71,309,4.4,5,8,2,15,13,99,1,0,1
3252,3,2016-09-17,illinois,,Western Michigan,L (10-34),29,42,69.0,312,1,15,3,0.2,0,57,315,5.5,14,1,0,15,7,48,1,1,2
3253,4,2016-10-01,illinois,@,Nebraska,L (16-31),14,23,60.9,146,0,21,124,5.9,1,44,270,6.1,7,4,1,12,7,48,0,0,0
3254,5,2016-10-08,illinois,,Purdue,L (31-34),14,23,60.9,184,0,46,315,6.8,3,69,499,7.2,9,12,3,24,12,125,1,0,1
3255,6,2016-10-15,illinois,@,Rutgers,W (24-7),6,14,42.9,92,1,43,228,5.3,1,57,320,5.6,1,9,0,10,6,60,0,1,1
3256,7,2016-10-22,illinois,@,Michigan,L (8-41),4,15,26.7,95,1,23,77,3.3,0,38,172,4.5,2,3,1,6,5,45,1,1,2
3257,8,2016-10-29,illinois,,Minnesota,L (17-40),16,34,47.1,156,1,34,89,2.6,1,68,245,3.6,7,7,3,17,3,33,3,0,3
3258,9,2016-11-05,illinois,,Michigan State,W (31-27),13,29,44.8,140,2,24,164,6.8,2,53,304,5.7,7,5,2,14,2,10,0,0,0
3259,10,2016-11-12,illinois,@,Wisconsin,L (3-48),7,24,29.2,101,0,21,99,4.7,0,45,200,4.4,5,5,1,11,5,46,0,4,4
3260,11,2016-11-19,illinois,,Iowa,L (0-28),19,41,46.3,137,0,24,61,2.5,0,65,198,3.0,7,3,0,10,2,10,1,1,2
3261,12,2016-11-26,illinois,@,Northwestern,L (21-42),28,54,51.9,377,2,26,57,2.2,1,80,434,5.4,18,6,1,25,6,60,3,1,4
3262,,12 Games,illinois,,,,183,358,51.1,2095,13,353,1686,4.8,14,711,3781,5.3,91,73,16,180,75,639,11,9,20
3263,1,2017-09-02,illinois,,Ball State,W (24-21),10,19,52.6,145,1,30,71,2.4,2,49,216,4.4,8,5,1,14,3,30,0,1,1
3264,2,2017-09-09,illinois,,Western Kentucky,W (20-7),14,25,56.0,107,0,50,193,3.9,1,75,300,4.0,5,12,2,19,9,95,0,1,1
3265,3,2017-09-15,illinois,@,South Florida,L (23-47),20,40,50.0,287,1,15,67,4.5,2,55,354,6.4,8,3,4,15,15,138,0,3,3
3266,4,2017-09-29,illinois,,Nebraska,L (6-28),10,16,62.5,106,0,37,93,2.5,0,53,199,3.8,7,6,2,15,5,49,0,1,1
3267,5,2017-10-07,illinois,@,Iowa,L (16-45),22,45,48.9,246,0,30,200,6.7,1,75,446,5.9,9,10,1,20,5,50,1,3,4
3268,6,2017-10-14,illinois,,Rutgers,L (24-35),20,38,52.6,308,2,29,86,3.0,1,67,394,5.9,13,4,1,18,8,68,1,2,3
3269,7,2017-10-21,illinois,@,Minnesota,L (17-24),20,27,74.1,161,1,36,121,3.4,1,63,282,4.5,8,7,0,15,5,45,1,1,2
3270,8,2017-10-28,illinois,,Wisconsin,L (10-24),9,31,29.0,152,0,33,134,4.1,1,64,286,4.5,6,8,3,17,5,40,1,2,3
3271,9,2017-11-04,illinois,@,Purdue,L (10-29),12,27,44.4,170,1,35,80,2.3,0,62,250,4.0,4,8,3,15,9,66,0,1,1
3272,10,2017-11-11,illinois,,Indiana,L (14-24),13,26,50.0,261,2,30,33,1.1,0,56,294,5.3,8,1,1,10,8,73,1,2,3
3273,11,2017-11-18,illinois,@,Ohio State,L (14-52),4,14,28.6,16,0,28,89,3.2,1,42,105,2.5,1,3,1,5,7,55,1,0,1
3274,12,2017-11-25,illinois,,Northwestern,L (7-42),14,31,45.2,139,0,33,100,3.0,1,64,239,3.7,6,5,0,11,6,59,1,2,3
3275,,12 Games,illinois,,,,168,339,49.6,2098,8,386,1267,3.3,11,725,3365,4.6,83,72,19,174,85,768,7,19,26
3276,1,2018-09-01,illinois,,Kent State,W (31-24),13,23,56.5,190,0,47,284,6.0,4,70,474,6.8,10,12,0,22,3,25,1,0,1
3277,2,2018-09-08,illinois,,Western Illinois,W (34-14),14,23,60.9,138,2,47,238,5.1,1,70,376,5.4,8,9,3,20,14,145,0,0,0
3278,3,2018-09-15,illinois,N,South Florida,L (19-25),20,31,64.5,168,0,48,212,4.4,1,79,380,4.8,8,10,3,21,6,65,1,0,1
3279,4,2018-09-21,illinois,,Penn State,L (24-63),18,31,58.1,166,2,45,245,5.4,1,76,411,5.4,11,12,3,26,7,81,0,2,2
3280,5,2018-10-06,illinois,@,Rutgers,W (38-17),10,19,52.6,89,1,43,330,7.7,4,62,419,6.8,4,11,2,17,7,80,0,0,0
3281,6,2018-10-13,illinois,,Purdue,L (7-46),15,29,51.7,181,0,31,69,2.2,1,60,250,4.2,7,7,0,14,7,57,0,1,1
3282,7,2018-10-20,illinois,@,Wisconsin,L (20-49),9,21,42.9,90,0,36,210,5.8,2,57,300,5.3,2,9,2,13,3,25,2,3,5
3283,8,2018-10-27,illinois,@,Maryland,L (33-63),14,32,43.8,261,2,35,232,6.6,1,67,493,7.4,8,11,1,20,2,25,0,1,1
3284,9,2018-11-03,illinois,,Minnesota,W (55-31),18,25,72.0,216,2,35,430,12.3,5,60,646,10.8,9,11,0,20,7,70,2,1,3
3285,10,2018-11-10,illinois,@,Nebraska,L (35-54),11,25,44.0,126,0,48,384,8.0,5,73,510,7.0,7,16,2,25,7,66,3,2,5
3286,11,2018-11-17,illinois,,Iowa,L (0-63),12,30,40.0,82,0,43,149,3.5,0,73,231,3.2,3,8,0,11,6,68,1,3,4
3287,,11 Games,illinois,,,,154,289,53.3,1707,9,458,2783,6.1,25,747,4490,6.0,77,116,16,209,69,707,10,13,23
3288,1,2014-08-30,purdue,,Western Michigan,W (43-34),19,38,50.0,181,2,39,226,5.8,3,77,407,5.3,10,11,1,22,7,52,0,0,0
3289,2,2014-09-06,purdue,,Central Michigan,L (17-38),24,49,49.0,204,1,34,122,3.6,1,83,326,3.9,9,10,0,19,7,69,1,2,3
3290,3,2014-09-13,purdue,N,Notre Dame,L (14-30),27,40,67.5,234,2,26,56,2.2,0,66,290,4.4,11,5,1,17,5,41,1,2,3
3291,4,2014-09-20,purdue,,Southern Illinois,W (35-13),15,26,57.7,198,2,44,183,4.2,2,70,381,5.4,9,11,3,23,4,26,1,0,1
3292,5,2014-09-27,purdue,,Iowa,L (10-24),13,32,40.6,72,0,30,84,2.8,0,62,156,2.5,2,7,0,9,3,19,0,2,2
3293,6,2014-10-04,purdue,@,Illinois,W (38-27),15,20,75.0,202,1,45,349,7.8,4,65,551,8.5,8,10,1,19,6,64,0,0,0
3294,7,2014-10-11,purdue,,Michigan State,L (31-45),24,37,64.9,211,1,25,129,5.2,3,62,340,5.5,11,5,2,18,4,21,1,1,2
3295,8,2014-10-18,purdue,@,Minnesota,L (38-39),16,26,61.5,153,3,35,298,8.5,2,61,451,7.4,6,10,1,17,7,55,0,2,2
3296,9,2014-11-01,purdue,@,Nebraska,L (14-35),18,46,39.1,216,1,32,124,3.9,1,78,340,4.4,8,8,0,16,5,51,0,2,2
3297,10,2014-11-08,purdue,,Wisconsin,L (16-34),17,37,45.9,204,1,26,26,1.0,0,63,230,3.7,7,3,1,11,2,15,0,0,0
3298,11,2014-11-22,purdue,,Northwestern,L (14-38),26,48,54.2,251,2,32,61,1.9,0,80,312,3.9,13,6,1,20,4,41,3,2,5
3299,12,2014-11-29,purdue,@,Indiana,L (16-23),19,35,54.3,123,0,34,228,6.7,1,69,351,5.1,6,9,1,16,5,49,1,3,4
3300,,12 Games,purdue,,,,233,434,53.7,2249,16,402,1886,4.7,17,836,4135,4.9,100,95,12,207,59,503,8,16,24
3301,1,2015-09-06,purdue,@,Marshall,L (31-41),31,48,64.6,270,1,47,184,3.9,3,95,454,4.8,14,10,4,28,4,53,0,4,4
3302,2,2015-09-12,purdue,,Indiana State,W (38-14),20,36,55.6,289,4,45,251,5.6,1,81,540,6.7,10,12,2,24,5,42,2,0,2
3303,3,2015-09-19,purdue,,Virginia Tech,L (24-51),12,35,34.3,121,0,29,144,5.0,2,64,265,4.1,3,4,2,9,10,79,1,2,3
3304,4,2015-09-26,purdue,,Bowling Green State,L (28-35),30,40,75.0,349,2,38,77,2.0,2,78,426,5.5,15,6,4,25,9,92,0,1,1
3305,5,2015-10-03,purdue,@,Michigan State,L (21-24),15,31,48.4,136,1,32,165,5.2,2,63,301,4.8,7,6,3,16,2,20,2,1,3
3306,6,2015-10-10,purdue,,Minnesota,L (13-41),21,49,42.9,207,1,28,68,2.4,1,77,275,3.6,11,4,2,17,0,0,1,3,4
3307,7,2015-10-17,purdue,@,Wisconsin,L (7-24),15,26,57.7,136,0,29,55,1.9,1,55,191,3.5,7,4,1,12,7,67,1,0,1
3308,8,2015-10-31,purdue,,Nebraska,W (55-45),28,43,65.1,274,4,37,183,4.9,4,80,457,5.7,10,8,2,20,6,58,0,0,0
3309,9,2015-11-07,purdue,,Illinois,L (14-48),29,47,61.7,174,1,28,89,3.2,1,75,263,3.5,7,8,2,17,3,34,0,2,2
3310,10,2015-11-14,purdue,@,Northwestern,L (14-21),26,45,57.8,287,1,30,73,2.4,1,75,360,4.8,12,5,1,18,6,60,0,1,1
3311,11,2015-11-21,purdue,@,Iowa,L (20-40),26,46,56.5,268,1,38,137,3.6,1,84,405,4.8,13,7,1,21,5,43,1,0,1
3312,12,2015-11-28,purdue,,Indiana,L (36-54),37,58,63.8,336,2,36,150,4.2,3,94,486,5.2,18,11,1,30,8,99,2,2,4
3313,,12 Games,purdue,,,,290,504,57.5,2847,18,417,1576,3.8,22,921,4423,4.8,127,85,25,237,65,647,10,16,26
3314,1,2016-09-03,purdue,,Eastern Kentucky,W (45-24),26,44,59.1,251,1,39,261,6.7,4,83,512,6.2,15,9,1,25,2,17,0,1,1
3315,2,2016-09-10,purdue,,Cincinnati,L (20-38),32,57,56.1,401,2,25,103,4.1,1,82,504,6.1,20,7,2,29,2,24,0,5,5
3316,3,2016-09-24,purdue,,Nevada,W (24-14),21,31,67.7,300,2,44,166,3.8,1,75,466,6.2,14,11,0,25,4,50,3,1,4
3317,4,2016-10-01,purdue,@,Maryland,L (7-50),22,53,41.5,195,1,27,10,0.4,0,80,205,2.6,10,3,3,16,8,69,0,1,1
3318,5,2016-10-08,purdue,@,Illinois,W (34-31),23,37,62.2,228,1,41,231,5.6,3,78,459,5.9,8,14,3,25,5,45,0,2,2
3319,6,2016-10-15,purdue,,Iowa,L (35-49),30,59,50.8,458,5,21,47,2.2,0,80,505,6.3,17,3,4,24,6,38,0,1,1
3320,7,2016-10-22,purdue,@,Nebraska,L (14-27),25,45,55.6,309,2,21,26,1.2,0,66,335,5.1,9,4,0,13,4,32,0,2,2
3321,8,2016-10-29,purdue,,Penn State,L (24-62),36,55,65.5,295,2,26,46,1.8,1,81,341,4.2,12,4,4,20,8,76,2,2,4
3322,9,2016-11-05,purdue,@,Minnesota,L (31-44),29,49,59.2,391,4,28,23,0.8,0,77,414,5.4,13,4,2,19,2,10,2,1,3
3323,10,2016-11-12,purdue,,Northwestern,L (17-45),29,51,56.9,264,1,32,130,4.1,1,83,394,4.7,13,9,0,22,2,15,0,4,4
3324,11,2016-11-19,purdue,,Wisconsin,L (20-49),15,31,48.4,222,2,22,71,3.2,0,53,293,5.5,8,5,3,16,4,20,0,3,3
3325,12,2016-11-26,purdue,@,Indiana,L (24-26),24,45,53.3,225,2,34,42,1.2,1,79,267,3.4,13,5,2,20,5,51,1,2,3
3326,,12 Games,purdue,,,,312,557,56.0,3539,25,360,1156,3.2,12,917,4695,5.1,152,78,24,254,52,447,8,25,33
3327,1,2017-09-02,purdue,N,Louisville,L (28-35),33,57,57.9,293,4,21,51,2.4,0,78,344,4.4,17,5,3,25,6,69,1,3,4
3328,2,2017-09-08,purdue,,Ohio,W (44-21),16,24,66.7,295,4,44,263,6.0,1,68,558,8.2,10,14,1,25,4,45,0,0,0
3329,3,2017-09-16,purdue,@,Missouri,W (35-3),26,34,76.5,272,2,50,205,4.1,3,84,477,5.7,13,12,1,26,3,25,0,1,1
3330,4,2017-09-23,purdue,,Michigan,L (10-28),13,30,43.3,159,1,20,30,1.5,0,50,189,3.8,6,2,1,9,10,82,1,0,1
3331,5,2017-10-07,purdue,,Minnesota,W (31-17),25,36,69.4,307,2,29,132,4.6,1,65,439,6.8,8,12,2,22,6,61,2,2,4
3332,6,2017-10-14,purdue,@,Wisconsin,L (9-17),13,29,44.8,155,0,26,66,2.5,0,55,221,4.0,8,4,2,14,7,45,0,1,1
3333,7,2017-10-21,purdue,@,Rutgers,L (12-14),23,44,52.3,195,1,41,279,6.8,0,85,474,5.6,10,13,2,25,9,55,0,2,2
3334,8,2017-10-28,purdue,,Nebraska,L (24-25),16,28,57.1,164,1,38,199,5.2,2,66,363,5.5,9,8,3,20,7,63,0,0,0
3335,9,2017-11-04,purdue,,Illinois,W (29-10),18,28,64.3,226,1,44,209,4.8,2,72,435,6.0,13,11,1,25,8,66,1,0,1
3336,10,2017-11-11,purdue,@,Northwestern,L (13-23),38,61,62.3,398,2,22,40,1.8,0,83,438,5.3,18,3,1,22,5,50,0,1,1
3337,11,2017-11-18,purdue,@,Iowa,W (24-15),22,37,59.5,229,3,29,65,2.2,0,66,294,4.5,11,6,3,20,3,30,0,0,0
3338,12,2017-11-25,purdue,,Indiana,W (31-24),16,30,53.3,181,2,43,272,6.3,2,73,453,6.2,6,13,3,22,4,17,1,0,1
3339,13,2017-12-27,purdue,N,Arizona*,W (38-35),33,53,62.3,396,4,40,159,4.0,1,93,555,6.0,15,11,1,27,5,50,0,1,1
3340,,13 Games,purdue,,,,292,491,59.5,3270,27,447,1970,4.4,12,938,5240,5.6,144,114,24,282,77,658,6,11,17
3341,1,2018-08-30,purdue,,Northwestern,L (27-31),30,46,65.2,270,1,25,202,8.1,2,71,472,6.6,13,8,2,23,9,95,0,3,3
3342,2,2018-09-08,purdue,,Eastern Michigan,L (19-20),14,24,58.3,135,1,42,341,8.1,1,66,476,7.2,6,13,0,19,7,85,2,0,2
3343,3,2018-09-15,purdue,,Missouri,L (37-40),39,55,70.9,572,3,16,42,2.6,1,71,614,8.6,21,2,0,23,7,65,0,1,1
3344,4,2018-09-22,purdue,,Boston College,W (30-13),21,28,75.0,296,3,41,76,1.9,1,69,372,5.4,10,6,1,17,2,25,2,0,2
3345,5,2018-09-29,purdue,@,Nebraska,W (42-28),25,42,59.5,328,1,37,188,5.1,4,79,516,6.5,11,10,6,27,10,75,0,0,0
3346,6,2018-10-13,purdue,@,Illinois,W (46-7),26,37,70.3,384,4,44,227,5.2,2,81,611,7.5,14,11,4,29,5,45,0,1,1
3347,7,2018-10-20,purdue,,Ohio State,W (49-20),25,43,58.1,378,3,29,161,5.6,3,72,539,7.5,12,9,3,24,7,95,0,0,0
3348,8,2018-10-27,purdue,@,Michigan State,L (13-23),29,49,59.2,277,0,13,62,4.8,1,62,339,5.5,13,2,1,16,4,30,0,3,3
3349,9,2018-11-03,purdue,,Iowa,W (38-36),23,32,71.9,333,4,31,101,3.3,1,63,434,6.9,9,10,2,21,6,60,0,2,2
3350,10,2018-11-10,purdue,@,Minnesota,L (10-41),21,32,65.6,145,1,30,88,2.9,0,62,233,3.8,7,6,1,14,7,81,1,0,1
3351,11,2018-11-17,purdue,,Wisconsin,L (44-47),31,48,64.6,386,4,31,76,2.5,1,79,462,5.8,16,6,6,28,5,48,1,0,1
3352,,11 Games,purdue,,,,284,436,65.1,3504,25,339,1564,4.6,17,775,5068,6.5,132,83,26,241,69,704,6,10,16
3353,1,2014-08-30,northwestern,,California,L (24-31),24,44,54.5,246,2,36,108,3.0,1,80,354,4.4,10,11,1,22,1,0,0,2,2
3354,2,2014-09-06,northwestern,,Northern Illinois,L (15-23),28,43,65.1,322,2,37,72,1.9,0,80,394,4.9,15,4,2,21,9,93,0,1,1
3355,3,2014-09-20,northwestern,,Western Illinois,W (24-7),15,25,60.0,117,0,41,166,4.0,3,66,283,4.3,7,7,1,15,5,35,2,0,2
3356,4,2014-09-27,northwestern,@,Penn State,W (29-6),21,37,56.8,258,0,38,103,2.7,3,75,361,4.8,14,3,0,17,8,75,0,1,1
3357,5,2014-10-04,northwestern,,Wisconsin,W (20-14),15,29,51.7,182,1,46,203,4.4,1,75,385,5.1,11,10,1,22,4,20,0,0,0
3358,6,2014-10-11,northwestern,@,Minnesota,L (17-24),32,50,64.0,269,1,34,124,3.6,1,84,393,4.7,16,9,3,28,6,41,0,1,1
3359,7,2014-10-18,northwestern,,Nebraska,L (17-38),18,39,46.2,173,0,34,117,3.4,2,73,290,4.0,9,8,4,21,8,65,0,1,1
3360,8,2014-11-01,northwestern,@,Iowa,L (7-48),9,24,37.5,75,0,43,105,2.4,1,67,180,2.7,6,7,0,13,5,53,1,0,1
3361,9,2014-11-08,northwestern,,Michigan,L (9-10),32,49,65.3,273,1,35,-9,-0.3,0,84,264,3.1,14,3,1,18,3,101,1,2,3
3362,10,2014-11-15,northwestern,@,Notre Dame,W (43-40),30,48,62.5,284,1,48,263,5.5,3,96,547,5.7,12,14,2,28,5,62,2,2,4
3363,11,2014-11-22,northwestern,@,Purdue,W (38-14),13,24,54.2,181,1,56,233,4.2,3,80,414,5.2,10,8,2,20,4,35,1,1,2
3364,12,2014-11-29,northwestern,,Illinois,L (33-47),24,42,57.1,218,1,38,154,4.1,2,80,372,4.7,11,7,1,19,4,48,2,3,5
3365,,12 Games,northwestern,,,,261,454,57.5,2598,10,486,1639,3.4,20,940,4237,4.5,135,91,18,244,62,628,9,14,23
3366,1,2015-09-05,northwestern,,Stanford,W (16-6),12,25,48.0,105,0,54,225,4.2,1,79,330,4.2,8,9,0,17,5,57,0,0,0
3367,2,2015-09-12,northwestern,,Eastern Illinois,W (41-0),11,16,68.8,152,1,69,344,5.0,3,85,496,5.8,9,18,1,28,3,26,1,0,1
3368,3,2015-09-19,northwestern,@,Duke,W (19-10),9,23,39.1,70,0,54,201,3.7,1,77,271,3.5,4,11,0,15,2,10,0,2,2
3369,4,2015-09-26,northwestern,,Ball State,W (24-19),18,31,58.1,256,3,57,290,5.1,0,88,546,6.2,11,12,0,23,8,57,2,1,3
3370,5,2015-10-03,northwestern,,Minnesota,W (27-0),14,19,73.7,128,0,51,184,3.6,2,70,312,4.5,9,7,0,16,3,20,0,0,0
3371,6,2015-10-10,northwestern,@,Michigan,L (0-38),15,33,45.5,130,0,25,38,1.5,0,58,168,2.9,9,3,1,13,5,39,0,1,1
3372,7,2015-10-17,northwestern,,Iowa,L (10-40),20,43,46.5,147,1,26,51,2.0,0,69,198,2.9,6,5,2,13,5,55,2,1,3
3373,8,2015-10-24,northwestern,@,Nebraska,W (30-28),13,28,46.4,177,1,28,156,5.6,1,56,333,5.9,8,5,2,15,5,58,0,0,0
3374,9,2015-11-07,northwestern,,Penn State,W (23-21),16,32,50.0,169,1,47,227,4.8,1,79,396,5.0,12,8,2,22,7,80,0,1,1
3375,10,2015-11-14,northwestern,,Purdue,W (21-14),11,24,45.8,132,0,48,250,5.2,3,72,382,5.3,7,11,3,21,4,23,1,2,3
3376,11,2015-11-21,northwestern,@,Wisconsin,W (13-7),9,20,45.0,60,0,50,149,3.0,1,70,209,3.0,6,5,1,12,7,46,0,0,0
3377,12,2015-11-28,northwestern,N,Illinois,W (24-14),12,25,48.0,146,1,54,204,3.8,2,79,350,4.4,7,8,3,18,1,10,1,1,2
3378,13,2016-01-01,northwestern,N,Tennessee*,L (6-45),14,33,42.4,129,0,37,132,3.6,1,70,261,3.7,5,10,3,18,3,35,0,4,4
3379,,13 Games,northwestern,,,,174,352,49.4,1801,8,600,2451,4.1,16,952,4252,4.5,101,112,18,231,58,516,7,13,20
3380,1,2016-09-03,northwestern,,Western Michigan,L (21-22),15,22,68.2,196,0,31,123,4.0,3,53,319,6.0,8,7,0,15,2,20,1,0,1
3381,2,2016-09-10,northwestern,,Illinois State,L (7-9),17,41,41.5,191,1,31,86,2.8,0,72,277,3.8,10,4,2,16,6,70,0,0,0
3382,3,2016-09-17,northwestern,,Duke,W (24-13),18,39,46.2,320,3,44,86,2.0,0,83,406,4.9,11,7,4,22,5,37,0,2,2
3383,4,2016-09-24,northwestern,,Nebraska,L (13-24),25,38,65.8,251,1,32,137,4.3,1,70,388,5.5,12,9,2,23,4,36,0,2,2
3384,5,2016-10-01,northwestern,@,Iowa,W (38-31),18,30,60.0,164,3,42,198,4.7,2,72,362,5.0,9,8,3,20,1,5,1,0,1
3385,6,2016-10-15,northwestern,@,Michigan State,W (54-40),27,35,77.1,281,3,51,209,4.1,3,86,490,5.7,12,13,1,26,4,25,0,1,1
3386,7,2016-10-22,northwestern,,Indiana,W (24-14),24,44,54.5,285,3,44,123,2.8,0,88,408,4.6,16,8,2,26,6,43,0,0,0
3387,8,2016-10-29,northwestern,@,Ohio State,L (20-24),23,44,52.3,258,1,29,148,5.1,1,73,406,5.6,15,6,0,21,2,20,0,1,1
3388,9,2016-11-05,northwestern,,Wisconsin,L (7-21),28,52,53.8,277,1,19,39,2.1,0,71,316,4.5,12,2,0,14,5,28,1,0,1
3389,10,2016-11-12,northwestern,@,Purdue,W (45-17),23,37,62.2,352,3,46,253,5.5,3,83,605,7.3,14,14,0,28,0,0,0,2,2
3390,11,2016-11-19,northwestern,@,Minnesota,L (12-29),28,45,62.2,276,1,33,63,1.9,1,78,339,4.3,13,6,2,21,3,20,2,0,2
3391,12,2016-11-26,northwestern,,Illinois,W (42-21),13,20,65.0,121,1,49,278,5.7,5,69,399,5.8,9,10,3,22,5,50,1,0,1
3392,13,2016-12-28,northwestern,N,Pittsburgh*,W (31-24),23,36,63.9,214,1,50,248,5.0,3,86,462,5.4,15,10,2,27,4,35,1,1,2
3393,,13 Games,northwestern,,,,282,483,58.4,3186,22,501,1991,4.0,22,984,5177,5.3,156,104,21,281,47,389,7,9,16
3394,1,2017-09-02,northwestern,,Nevada,W (31-20),28,38,73.7,352,2,50,156,3.1,2,88,508,5.8,14,9,4,26,8,90,1,1,2
3395,2,2017-09-09,northwestern,@,Duke,L (17-41),14,33,42.4,169,1,21,22,1.0,1,54,191,3.5,10,3,2,15,3,26,1,2,3
3396,3,2017-09-16,northwestern,,Bowling Green State,W (49-7),24,31,77.4,375,2,43,303,7.0,5,74,678,9.2,15,15,0,30,4,23,2,0,2
3397,4,2017-09-30,northwestern,@,Wisconsin,L (24-33),29,45,64.4,219,3,34,25,0.7,0,79,244,3.1,14,4,2,20,5,50,0,2,2
3398,5,2017-10-07,northwestern,,Penn State,L (7-31),23,43,53.5,198,0,30,67,2.2,1,73,265,3.6,9,6,0,15,8,74,1,2,3
3399,6,2017-10-14,northwestern,@,Maryland,W (37-21),27,49,55.1,293,1,44,238,5.4,3,93,531,5.7,15,14,1,30,7,90,0,2,2
3400,7,2017-10-21,northwestern,,Iowa,W (17-10),21,36,58.3,192,0,46,147,3.2,2,82,339,4.1,8,12,1,21,5,40,0,0,0
3401,8,2017-10-28,northwestern,,Michigan State,W (39-31),34,49,69.4,368,3,28,64,2.3,2,77,432,5.6,21,4,3,28,1,9,1,0,1
3402,9,2017-11-04,northwestern,@,Nebraska,W (31-24),19,35,54.3,243,0,45,232,5.2,4,80,475,5.9,9,14,3,26,6,65,0,2,2
3403,10,2017-11-11,northwestern,,Purdue,W (23-13),26,46,56.5,296,1,38,94,2.5,1,84,390,4.6,17,4,1,22,4,40,0,0,0
3404,11,2017-11-18,northwestern,,Minnesota,W (39-0),9,13,69.2,86,3,55,277,5.0,3,68,363,5.3,7,14,1,22,3,30,0,0,0
3405,12,2017-11-25,northwestern,@,Illinois,W (42-7),13,21,61.9,140,1,47,306,6.5,4,68,446,6.6,6,13,2,21,3,30,0,1,1
3406,13,2017-12-29,northwestern,N,Kentucky*,W (24-23),9,21,42.9,109,0,56,333,5.9,2,77,442,5.7,5,13,2,20,7,70,0,0,0
3407,,13 Games,northwestern,,,,276,460,60.0,3040,17,537,2264,4.2,30,997,5304,5.3,150,125,22,296,64,637,6,12,18
3408,1,2018-08-30,northwestern,@,Purdue,W (31-27),23,37,62.2,235,0,42,166,4.0,4,79,401,5.1,11,7,4,22,6,56,0,0,0
3409,2,2018-09-08,northwestern,,Duke,L (7-21),31,56,55.4,282,0,32,99,3.1,1,88,381,4.3,16,5,3,24,2,20,0,2,2
3410,3,2018-09-15,northwestern,,Akron,L (34-39),37,58,63.8,405,3,36,86,2.4,2,94,491,5.2,19,7,4,30,3,35,1,2,3
3411,4,2018-09-29,northwestern,,Michigan,L (17-20),16,29,55.2,174,0,34,28,0.8,2,63,202,3.2,7,5,3,15,2,25,0,0,0
3412,5,2018-10-06,northwestern,@,Michigan State,W (29-19),31,47,66.0,373,3,20,8,0.4,1,67,381,5.7,14,3,2,19,3,35,0,2,2
3413,6,2018-10-13,northwestern,,Nebraska,W (34-31),41,64,64.1,455,3,23,32,1.4,0,87,487,5.6,21,4,5,30,1,5,0,2,2
3414,7,2018-10-20,northwestern,@,Rutgers,W (18-15),17,34,50.0,150,0,47,128,2.7,2,81,278,3.4,8,8,4,20,6,49,1,0,1
3415,8,2018-10-27,northwestern,,Wisconsin,W (31-17),17,30,56.7,167,1,49,182,3.7,3,79,349,4.4,8,9,2,19,3,20,0,3,3
3416,9,2018-11-03,northwestern,,Notre Dame,L (21-31),16,29,55.2,141,1,40,108,2.7,2,69,249,3.6,10,5,1,16,0,0,0,0,0
3417,10,2018-11-10,northwestern,@,Iowa,W (14-10),15,30,50.0,122,1,46,184,4.0,1,76,306,4.0,6,12,1,19,5,40,0,2,2
3418,11,2018-11-17,northwestern,@,Minnesota,W (24-14),15,21,71.4,230,0,39,95,2.4,3,60,325,5.4,11,4,1,16,2,20,0,0,0
3419,,11 Games,northwestern,,,,259,435,59.5,2734,12,408,1116,2.7,21,843,3850,4.6,131,69,30,230,33,305,2,13,15
3420,1,2014-08-30,indiana,,Indiana State,W (28-10),11,18,61.1,111,0,69,455,6.6,4,87,566,6.5,4,24,1,29,4,30,1,1,2
3421,2,2014-09-13,indiana,@,Bowling Green State,L (42-45),31,41,75.6,347,1,37,235,6.4,5,78,582,7.5,16,11,3,30,11,143,1,0,1
3422,3,2014-09-20,indiana,@,Missouri,W (31-27),18,33,54.5,252,1,50,241,4.8,3,83,493,5.9,13,11,3,27,5,50,0,0,0
3423,4,2014-09-27,indiana,,Maryland,L (15-37),14,37,37.8,126,0,47,206,4.4,1,84,332,4.0,6,11,5,22,9,55,0,1,1
3424,5,2014-10-04,indiana,,North Texas,W (49-24),23,29,79.3,230,3,44,363,8.3,4,73,593,8.1,6,16,0,22,6,55,1,0,1
3425,6,2014-10-11,indiana,@,Iowa,L (29-45),7,21,33.3,116,1,39,316,8.1,3,60,432,7.2,5,8,0,13,9,110,0,3,3
3426,7,2014-10-18,indiana,,Michigan State,L (17-56),5,16,31.3,11,0,33,213,6.5,2,49,224,4.6,1,4,2,7,4,25,1,0,1
3427,8,2014-11-01,indiana,@,Michigan,L (10-34),5,8,62.5,24,0,45,167,3.7,1,53,191,3.6,0,10,0,10,3,25,2,0,2
3428,9,2014-11-08,indiana,,Penn State,L (7-13),13,28,46.4,68,0,40,153,3.8,0,68,221,3.3,2,9,2,13,10,82,0,2,2
3429,10,2014-11-15,indiana,@,Rutgers,L (23-45),15,31,48.4,179,1,53,294,5.5,1,84,473,5.6,6,15,1,22,9,82,2,1,3
3430,11,2014-11-22,indiana,@,Ohio State,L (27-42),11,27,40.7,114,0,36,281,7.8,3,63,395,6.3,6,6,1,13,2,10,0,1,1
3431,12,2014-11-29,indiana,,Purdue,W (23-16),15,24,62.5,119,0,46,239,5.2,2,70,358,5.1,8,9,1,18,6,61,2,0,2
3432,,12 Games,indiana,,,,168,313,53.7,1697,7,539,3163,5.9,29,852,4860,5.7,73,134,19,226,78,728,10,9,19
3433,1,2015-09-05,indiana,,Southern Illinois,W (48-47),19,32,59.4,349,1,42,246,5.9,5,74,595,8.0,13,9,1,23,6,43,0,0,0
3434,2,2015-09-12,indiana,,Florida International,W (36-22),19,33,57.6,234,1,52,205,3.9,2,85,439,5.2,10,14,1,25,11,110,0,1,1
3435,3,2015-09-19,indiana,,Western Kentucky,W (38-35),20,27,74.1,355,3,59,284,4.8,1,86,639,7.4,13,18,3,34,5,50,1,0,1
3436,4,2015-09-26,indiana,@,Wake Forest,W (31-24),19,34,55.9,205,2,52,211,4.1,1,86,416,4.8,12,13,1,26,11,119,0,0,0
3437,5,2015-10-03,indiana,,Ohio State,L (27-34),17,36,47.2,226,0,55,176,3.2,3,91,402,4.4,11,5,5,21,7,50,0,0,0
3438,6,2015-10-10,indiana,@,Penn State,L (7-29),15,33,45.5,155,0,33,79,2.4,1,66,234,3.5,7,7,0,14,8,65,0,1,1
3439,7,2015-10-17,indiana,,Rutgers,L (52-55),32,42,76.2,464,4,34,163,4.8,3,76,627,8.3,21,7,0,28,4,19,1,2,3
3440,8,2015-10-24,indiana,@,Michigan State,L (26-52),23,37,62.2,308,3,23,81,3.5,1,60,389,6.5,15,3,2,20,6,45,1,1,2
3441,9,2015-11-07,indiana,,Iowa,L (27-35),16,37,43.2,180,1,39,227,5.8,2,76,407,5.4,13,11,2,26,3,35,0,1,1
3442,10,2015-11-14,indiana,,Michigan,L (41-48),20,34,58.8,220,1,55,307,5.6,2,89,527,5.9,9,20,3,32,9,79,0,0,0
3443,11,2015-11-21,indiana,@,Maryland,W (47-28),23,35,65.7,385,4,45,170,3.8,1,80,555,6.9,15,6,3,24,7,55,1,0,1
3444,12,2015-11-28,indiana,@,Purdue,W (54-36),18,29,62.1,350,4,56,309,5.5,3,85,659,7.8,13,14,4,31,7,54,1,0,1
3445,13,2015-12-26,indiana,N,Duke*,L (41-44),28,52,53.8,389,3,47,278,5.9,2,99,667,6.7,16,14,3,33,7,54,1,2,3
3446,,13 Games,indiana,,,,269,461,58.4,3820,27,592,2736,4.6,27,1053,6556,6.2,168,141,28,337,91,778,6,8,14
3447,1,2016-09-01,indiana,@,Florida International,W (34-13),18,28,64.3,240,1,52,246,4.7,1,80,486,6.1,10,15,1,26,9,74,1,0,1
3448,2,2016-09-10,indiana,,Ball State,W (30-20),17,27,63.0,266,3,45,187,4.2,0,72,453,6.3,8,11,0,19,8,69,0,0,0
3449,3,2016-09-24,indiana,,Wake Forest,L (28-33),28,47,59.6,496,3,32,115,3.6,1,79,611,7.7,18,5,2,25,9,84,0,5,5
3450,4,2016-10-01,indiana,,Michigan State,W (24-21),17,28,60.7,281,3,39,156,4.0,0,67,437,6.5,12,6,1,19,7,60,0,1,1
3451,5,2016-10-08,indiana,@,Ohio State,L (17-38),14,28,50.0,182,2,40,99,2.5,0,68,281,4.1,6,7,1,14,5,40,1,1,2
3452,6,2016-10-15,indiana,,Nebraska,L (22-27),24,39,61.5,245,1,30,88,2.9,1,69,333,4.8,12,4,2,18,1,10,0,2,2
3453,7,2016-10-22,indiana,@,Northwestern,L (14-24),35,59,59.3,317,0,27,84,3.1,1,86,401,4.7,14,6,3,23,5,53,0,2,2
3454,8,2016-10-29,indiana,,Maryland,W (42-36),17,26,65.4,236,0,57,414,7.3,6,83,650,7.8,14,18,2,34,6,65,0,0,0
3455,9,2016-11-05,indiana,@,Rutgers,W (33-27),29,41,70.7,420,3,44,147,3.3,2,85,567,6.7,17,6,4,27,4,22,2,2,4
3456,10,2016-11-12,indiana,,Penn State,L (31-45),24,41,58.5,344,2,41,110,2.7,2,82,454,5.5,15,5,0,20,8,80,5,0,5
3457,11,2016-11-19,indiana,@,Michigan,L (10-20),14,30,46.7,191,0,36,64,1.8,1,66,255,3.9,9,4,2,15,4,35,0,0,0
3458,12,2016-11-26,indiana,,Purdue,W (26-24),11,22,50.0,117,1,54,152,2.8,2,76,269,3.5,6,10,1,17,9,70,0,4,4
3459,13,2016-12-28,indiana,N,Utah*,L (24-26),15,40,37.5,224,2,37,117,3.2,1,77,341,4.4,11,8,3,22,4,24,2,1,3
3460,,13 Games,indiana,,,,263,456,57.7,3559,21,534,1979,3.7,18,990,5538,5.6,152,105,22,279,79,686,11,18,29
3461,1,2017-08-31,indiana,,Ohio State,L (21-49),42,68,61.8,420,3,27,17,0.6,0,95,437,4.6,22,1,2,25,5,33,1,2,3
3462,2,2017-09-09,indiana,@,Virginia,W (34-17),19,30,63.3,197,2,41,111,2.7,1,71,308,4.3,11,7,1,19,7,78,0,1,1
3463,3,2017-09-23,indiana,,Georgia Southern,W (52-17),11,22,50.0,185,2,47,282,6.0,3,69,467,6.8,5,12,3,20,5,30,0,0,0
3464,4,2017-09-30,indiana,@,Penn State,L (14-45),15,32,46.9,175,1,47,177,3.8,1,79,352,4.5,8,10,1,19,2,20,3,1,4
3465,5,2017-10-07,indiana,,Charleston Southern,W (27-0),32,41,78.0,321,2,45,157,3.5,1,86,478,5.6,15,9,1,25,7,60,2,1,3
3466,6,2017-10-14,indiana,,Michigan,L (20-27),21,43,48.8,198,1,29,80,2.8,1,72,278,3.9,8,3,3,14,5,55,0,2,2
3467,7,2017-10-21,indiana,@,Michigan State,L (9-17),22,34,64.7,158,0,35,94,2.7,0,69,252,3.7,8,3,3,14,10,115,0,0,0
3468,8,2017-10-28,indiana,@,Maryland,L (39-42),43,62,69.4,410,5,35,73,2.1,0,97,483,5.0,21,7,7,35,7,70,0,1,1
3469,9,2017-11-04,indiana,,Wisconsin,L (17-45),20,34,58.8,226,2,21,40,1.9,0,55,266,4.8,9,5,2,16,10,98,1,2,3
3470,10,2017-11-11,indiana,@,Illinois,W (24-14),32,48,66.7,289,2,42,139,3.3,1,90,428,4.8,13,7,2,22,5,49,0,1,1
3471,11,2017-11-18,indiana,,Rutgers,W (41-0),17,28,60.7,236,2,48,267,5.6,3,76,503,6.6,11,11,1,23,1,15,0,1,1
3472,12,2017-11-25,indiana,@,Purdue,L (24-31),32,60,53.3,373,3,32,124,3.9,0,92,497,5.4,13,5,2,20,7,84,0,1,1
3473,,12 Games,indiana,,,,306,502,61.0,3188,25,449,1561,3.5,11,951,4749,5.0,144,80,28,252,71,707,7,13,20
3474,1,2018-09-01,indiana,@,Florida International,W (38-28),28,37,75.7,252,4,45,213,4.7,0,82,465,5.7,14,12,5,31,8,90,0,1,1
3475,2,2018-09-08,indiana,,Virginia,W (20-16),16,22,72.7,150,2,44,237,5.4,1,66,387,5.9,7,12,2,21,6,42,0,1,1
3476,3,2018-09-15,indiana,,Ball State,W (38-10),24,32,75.0,202,0,44,255,5.8,4,76,457,6.0,9,13,4,26,5,45,1,0,1
3477,4,2018-09-22,indiana,,Michigan State,L (21-35),32,46,69.6,272,2,32,29,0.9,0,78,301,3.9,15,1,2,18,6,85,0,2,2
3478,5,2018-09-29,indiana,@,Rutgers,W (24-17),27,40,67.5,288,1,42,163,3.9,2,82,451,5.5,14,8,2,24,5,60,1,1,2
3479,6,2018-10-06,indiana,@,Ohio State,L (26-49),26,49,53.1,322,3,21,84,4.0,0,70,406,5.8,14,4,4,22,3,35,2,0,2
3480,7,2018-10-13,indiana,,Iowa,L (16-42),31,42,73.8,263,1,25,67,2.7,1,67,330,4.9,10,8,4,22,10,99,0,2,2
3481,8,2018-10-20,indiana,,Penn State,L (28-33),35,55,63.6,330,1,45,224,5.0,3,100,554,5.5,17,13,2,32,7,55,2,1,3
3482,9,2018-10-26,indiana,@,Minnesota,L (31-38),29,44,65.9,232,2,30,153,5.1,1,74,385,5.2,11,9,0,20,5,37,1,2,3
3483,10,2018-11-10,indiana,,Maryland,W (34-32),16,28,57.1,243,2,30,131,4.4,2,58,374,6.4,8,7,3,18,3,39,0,1,1
3484,11,2018-11-17,indiana,@,Michigan,L (20-31),16,35,45.7,195,1,40,190,4.8,1,75,385,5.1,8,10,3,21,7,62,1,1,2
3485,,11 Games,indiana,,,,280,430,65.1,2749,19,398,1746,4.4,15,828,4495,5.4,127,97,31,255,65,649,8,12,20
3486,1,2014-08-30,maryland,,James Madison,W (52-7),18,35,51.4,186,2,50,285,5.7,5,85,471,5.5,11,16,3,30,5,35,0,1,1
3487,2,2014-09-06,maryland,@,South Florida,W (24-17),17,28,60.7,201,2,40,116,2.9,0,68,317,4.7,9,8,0,17,4,35,4,2,6
3488,3,2014-09-13,maryland,,West Virginia,L (37-40),21,38,55.3,284,2,27,163,6.0,1,65,447,6.9,11,5,0,16,7,71,0,1,1
3489,4,2014-09-20,maryland,@,Syracuse,W (34-20),16,26,61.5,280,2,32,89,2.8,1,58,369,6.4,10,6,1,17,8,75,0,0,0
3490,5,2014-09-27,maryland,@,Indiana,W (37-15),22,33,66.7,361,3,36,123,3.4,1,69,484,7.0,14,8,1,23,8,83,0,0,0
3491,6,2014-10-04,maryland,,Ohio State,L (24-52),24,40,60.0,244,1,24,66,2.8,2,64,310,4.8,8,6,3,17,2,23,0,4,4
3492,7,2014-10-18,maryland,,Iowa,W (38-31),17,33,51.5,206,1,46,212,4.6,3,79,418,5.3,8,11,3,22,6,50,0,2,2
3493,8,2014-10-25,maryland,@,Wisconsin,L (7-52),13,29,44.8,129,1,28,46,1.6,0,57,175,3.1,6,3,1,10,7,45,1,0,1
3494,9,2014-11-01,maryland,@,Penn State,W (20-19),18,38,47.4,161,1,30,33,1.1,1,68,194,2.9,7,5,3,15,6,89,2,0,2
3495,10,2014-11-15,maryland,,Michigan State,L (15-37),20,43,46.5,246,2,17,6,0.4,0,60,252,4.2,9,0,2,11,5,30,1,3,4
3496,11,2014-11-22,maryland,@,Michigan,W (23-16),13,24,54.2,165,0,35,147,4.2,2,59,312,5.3,8,8,1,17,4,30,0,0,0
3497,12,2014-11-29,maryland,,Rutgers,L (38-41),14,24,58.3,195,2,36,281,7.8,3,60,476,7.9,8,11,1,20,10,72,0,0,0
3498,13,2014-12-30,maryland,N,Stanford*,L (21-45),15,27,55.6,205,0,27,17,0.6,2,54,222,4.1,10,1,1,12,5,39,0,1,1
3499,,13 Games,maryland,,,,228,418,54.5,2863,19,428,1584,3.7,21,846,4447,5.3,119,88,20,227,77,677,8,14,22
3500,1,2015-09-05,maryland,,Richmond,W (50-21),12,22,54.5,138,2,45,341,7.6,3,67,479,7.1,6,18,0,24,5,39,0,1,1
3501,2,2015-09-12,maryland,,Bowling Green State,L (27-48),16,33,48.5,185,2,26,156,6.0,0,59,341,5.8,8,7,1,16,6,57,1,3,4
3502,3,2015-09-19,maryland,,South Florida,W (35-17),21,34,61.8,297,4,34,114,3.4,1,68,411,6.0,12,4,2,18,12,120,0,3,3
3503,4,2015-09-26,maryland,@,West Virginia,L (6-45),14,36,38.9,153,1,29,173,6.0,0,65,326,5.0,7,4,3,14,10,100,1,5,6
3504,5,2015-10-03,maryland,,Michigan,L (0-28),10,36,27.8,76,0,26,29,1.1,0,62,105,1.7,5,1,1,7,5,66,0,3,3
3505,6,2015-10-10,maryland,@,Ohio State,L (28-49),10,27,37.0,133,1,42,253,6.0,3,69,386,5.6,6,13,1,20,9,63,0,2,2
3506,7,2015-10-24,maryland,N,Penn State,L (30-31),19,28,67.9,225,1,48,241,5.0,2,76,466,6.1,9,11,1,21,6,55,2,3,5
3507,8,2015-10-31,maryland,@,Iowa,L (15-31),11,23,47.8,74,1,34,167,4.9,0,57,241,4.2,3,10,2,15,8,72,1,3,4
3508,9,2015-11-07,maryland,,Wisconsin,L (24-31),13,34,38.2,204,2,32,112,3.5,1,66,316,4.8,9,6,1,16,11,79,0,2,2
3509,10,2015-11-14,maryland,@,Michigan State,L (7-24),17,36,47.2,182,0,37,107,2.9,1,73,289,4.0,8,7,1,16,1,8,2,3,5
3510,11,2015-11-21,maryland,,Indiana,L (28-47),21,41,51.2,170,1,46,314,6.8,3,87,484,5.6,11,11,1,23,8,52,0,0,0
3511,12,2015-11-28,maryland,@,Rutgers,W (46-41),19,38,50.0,255,0,42,401,9.5,6,80,656,8.2,12,13,2,27,3,31,0,1,1
3512,,12 Games,maryland,,,,183,388,47.2,2092,15,441,2408,5.5,20,829,4500,5.4,96,105,16,217,84,742,7,29,36
3513,1,2016-09-03,maryland,,Howard,W (52-13),20,29,69.0,204,0,44,315,7.2,6,73,519,7.1,10,14,1,25,2,25,0,0,0
3514,2,2016-09-09,maryland,@,Florida International,W (41-14),15,21,71.4,238,3,45,239,5.3,1,66,477,7.2,11,11,0,22,8,85,0,0,0
3515,3,2016-09-17,maryland,@,Central Florida,W (30-24),10,23,43.5,127,0,50,246,4.9,4,73,373,5.1,4,16,0,20,6,47,0,0,0
3516,4,2016-10-01,maryland,,Purdue,W (50-7),9,17,52.9,96,3,46,400,8.7,4,63,496,7.9,5,13,1,19,11,92,1,1,2
3517,5,2016-10-08,maryland,@,Penn State,L (14-38),10,16,62.5,100,1,38,170,4.5,1,54,270,5.0,3,8,0,11,5,49,1,1,2
3518,6,2016-10-15,maryland,,Minnesota,L (10-31),18,37,48.6,161,1,36,130,3.6,0,73,291,4.0,8,8,0,16,9,75,2,2,4
3519,7,2016-10-22,maryland,,Michigan State,W (28-17),21,28,75.0,200,2,42,247,5.9,2,70,447,6.4,8,10,4,22,3,25,1,0,1
3520,8,2016-10-29,maryland,@,Indiana,L (36-42),22,34,64.7,248,2,50,269,5.4,3,84,517,6.2,14,13,2,29,6,60,1,1,2
3521,9,2016-11-05,maryland,@,Michigan,L (3-59),17,28,60.7,289,0,38,78,2.1,0,66,367,5.6,12,6,1,19,6,46,0,2,2
3522,10,2016-11-12,maryland,,Ohio State,L (3-62),15,27,55.6,133,0,40,43,1.1,0,67,176,2.6,7,3,0,10,7,74,1,1,2
3523,11,2016-11-19,maryland,@,Nebraska,L (7-28),15,31,48.4,196,1,25,11,0.4,0,56,207,3.7,7,2,0,9,5,65,0,0,0
3524,12,2016-11-26,maryland,,Rutgers,W (31-13),9,16,56.3,96,0,45,318,7.1,3,61,414,6.8,4,12,1,17,9,60,0,0,0
3525,13,2016-12-26,maryland,N,Boston College*,L (30-36),15,35,42.9,229,2,34,128,3.8,2,69,357,5.2,9,7,1,17,11,86,3,1,4
3526,,13 Games,maryland,,,,196,342,57.3,2317,15,533,2594,4.9,26,875,4911,5.6,102,123,11,236,88,789,10,9,19
3527,1,2017-09-02,maryland,@,Texas,W (51-41),12,15,80.0,219,2,43,263,6.1,4,58,482,8.3,7,10,1,18,10,53,0,1,1
3528,2,2017-09-09,maryland,,Towson,W (63-17),14,18,77.8,167,2,36,367,10.2,6,54,534,9.9,7,14,2,23,5,55,0,0,0
3529,3,2017-09-23,maryland,,Central Florida,L (10-38),17,28,60.7,155,1,37,42,1.1,0,65,197,3.0,7,5,6,18,7,53,0,2,2
3530,4,2017-09-30,maryland,@,Minnesota,W (31-24),18,28,64.3,154,2,47,262,5.6,2,75,416,5.5,9,13,1,23,6,70,0,0,0
3531,5,2017-10-07,maryland,@,Ohio State,L (14-62),3,13,23.1,16,0,42,50,1.2,1,55,66,1.2,0,3,3,6,6,66,2,0,2
3532,6,2017-10-14,maryland,,Northwestern,L (21-37),17,38,44.7,255,3,31,85,2.7,0,69,340,4.9,9,7,3,19,2,30,0,0,0
3533,7,2017-10-21,maryland,@,Wisconsin,L (13-38),13,30,43.3,125,1,35,143,4.1,0,65,268,4.1,6,10,2,18,4,54,1,1,2
3534,8,2017-10-28,maryland,,Indiana,W (42-39),10,16,62.5,171,2,40,174,4.4,3,56,345,6.2,6,8,4,18,12,133,0,1,1
3535,9,2017-11-04,maryland,N,Rutgers,L (24-31),19,32,59.4,218,1,37,167,4.5,2,69,385,5.6,11,6,3,20,10,65,0,1,1
3536,10,2017-11-11,maryland,,Michigan,L (10-35),18,38,47.4,160,1,32,180,5.6,0,70,340,4.9,7,8,0,15,7,59,0,2,2
3537,11,2017-11-18,maryland,@,Michigan State,L (7-17),13,25,52.0,121,0,31,83,2.7,1,56,204,3.6,6,5,1,12,6,45,1,0,1
3538,12,2017-11-25,maryland,,Penn State,L (3-66),21,37,56.8,179,0,25,124,5.0,0,62,303,4.9,7,3,1,11,8,91,2,0,2
3539,,12 Games,maryland,,,,175,318,55.0,1940,15,436,1940,4.4,19,754,3880,5.1,82,92,27,201,83,774,6,8,14
3540,1,2018-09-01,maryland,N,Texas,W (34-29),21,34,61.8,264,2,46,143,3.1,2,80,407,5.1,8,8,5,21,8,70,0,0,0
3541,2,2018-09-08,maryland,@,Bowling Green State,W (45-14),8,16,50.0,121,1,53,444,8.4,5,69,565,8.2,4,19,1,24,14,139,1,0,1
3542,3,2018-09-15,maryland,,Temple,L (14-35),8,21,38.1,63,0,31,132,4.3,0,52,195,3.8,2,7,2,11,5,35,0,2,2
3543,4,2018-09-22,maryland,,Minnesota,W (42-13),10,14,71.4,117,1,37,315,8.5,4,51,432,8.5,2,12,1,15,10,118,0,0,0
3544,5,2018-10-06,maryland,@,Michigan,L (21-42),7,13,53.8,73,0,37,147,4.0,2,50,220,4.4,5,5,1,11,12,107,0,1,1
3545,6,2018-10-13,maryland,,Rutgers,W (34-7),9,20,45.0,85,3,40,290,7.3,1,60,375,6.3,4,12,0,16,9,85,1,0,1
3546,7,2018-10-20,maryland,@,Iowa,L (0-23),6,16,37.5,47,0,23,68,3.0,0,39,115,2.9,3,4,0,7,6,46,1,1,2
3547,8,2018-10-27,maryland,,Illinois,W (63-33),13,21,61.9,281,3,48,431,9.0,5,69,712,10.3,10,19,1,30,7,85,0,0,0
3548,9,2018-11-03,maryland,,Michigan State,L (3-24),8,24,33.3,74,0,29,26,0.9,0,53,100,1.9,4,3,2,9,3,25,2,0,2
3549,10,2018-11-10,maryland,@,Indiana,L (32-34),14,25,56.0,189,1,59,353,6.0,2,84,542,6.5,8,18,1,27,10,93,3,1,4
3550,11,2018-11-17,maryland,,Ohio State,L (51-52),7,14,50.0,196,1,47,340,7.2,4,61,536,8.8,5,12,2,19,9,88,1,0,1
3551,,11 Games,maryland,,,,111,218,50.9,1510,12,450,2689,6.0,25,668,4199,6.3,55,119,16,190,93,891,9,5,14
3552,1,2014-08-28,rutgers,N,Washington State,W (41-38),16,27,59.3,281,2,43,215,5.0,3,70,496,7.1,10,11,1,22,8,78,0,1,1
3553,2,2014-09-06,rutgers,,Howard,W (38-25),16,22,72.7,288,4,38,109,2.9,1,60,397,6.6,10,8,2,20,3,41,1,0,1
3554,3,2014-09-13,rutgers,,Penn State,L (10-13),15,31,48.4,192,0,31,102,3.3,1,62,294,4.7,8,7,0,15,9,75,0,5,5
3555,4,2014-09-20,rutgers,@,Navy,W (31-24),11,14,78.6,151,0,56,284,5.1,4,70,435,6.2,7,16,1,24,2,24,1,0,1
3556,5,2014-09-27,rutgers,,Tulane,W (31-6),14,21,66.7,291,4,40,171,4.3,0,61,462,7.6,8,11,1,20,4,30,0,1,1
3557,6,2014-10-04,rutgers,,Michigan,W (26-24),23,40,57.5,402,3,30,74,2.5,0,70,476,6.8,13,5,0,18,9,85,0,0,0
3558,7,2014-10-18,rutgers,@,Ohio State,L (17-56),18,29,62.1,196,0,38,149,3.9,2,67,345,5.1,10,7,1,18,0,0,2,1,3
3559,8,2014-10-25,rutgers,@,Nebraska,L (24-42),12,26,46.2,205,1,38,143,3.8,2,64,348,5.4,8,7,0,15,4,26,0,1,1
3560,9,2014-11-01,rutgers,,Wisconsin,L (0-37),7,27,25.9,63,0,29,76,2.6,0,56,139,2.5,3,5,0,8,4,35,0,1,1
3561,10,2014-11-15,rutgers,,Indiana,W (45-23),16,27,59.3,217,2,40,212,5.3,4,67,429,6.4,8,9,2,19,5,41,1,0,1
3562,11,2014-11-22,rutgers,@,Michigan State,L (3-45),14,31,45.2,139,0,29,95,3.3,0,60,234,3.9,6,8,1,15,3,25,0,3,3
3563,12,2014-11-29,rutgers,@,Maryland,W (41-38),28,42,66.7,347,4,35,144,4.1,1,77,491,6.4,15,8,1,24,7,60,2,0,2
3564,13,2014-12-26,rutgers,N,North Carolina*,W (40-21),9,20,45.0,184,2,42,340,8.1,3,62,524,8.5,8,15,0,23,3,25,0,0,0
3565,,13 Games,rutgers,,,,199,357,55.7,2956,22,489,2114,4.3,21,846,5070,6.0,114,117,10,241,61,545,7,13,20
3566,1,2015-09-05,rutgers,,Norfolk State,W (63-13),13,15,86.7,248,4,47,291,6.2,4,62,539,8.7,8,17,1,26,9,60,1,0,1
3567,2,2015-09-12,rutgers,,Washington State,L (34-37),23,29,79.3,204,1,37,198,5.4,1,66,402,6.1,12,12,2,26,11,100,2,1,3
3568,3,2015-09-19,rutgers,@,Penn State,L (3-28),27,42,64.3,251,0,32,43,1.3,0,74,294,4.0,14,5,1,20,8,29,1,2,3
3569,4,2015-09-26,rutgers,,Kansas,W (27-14),18,25,72.0,201,2,58,312,5.4,2,83,513,6.2,13,15,3,31,10,80,1,2,3
3570,5,2015-10-10,rutgers,,Michigan State,L (24-31),15,26,57.7,208,3,32,141,4.4,0,58,349,6.0,7,8,0,15,3,20,0,0,0
3571,6,2015-10-17,rutgers,@,Indiana,W (55-52),28,43,65.1,386,3,40,210,5.3,4,83,596,7.2,15,10,0,25,1,10,0,1,1
3572,7,2015-10-24,rutgers,,Ohio State,L (7-49),13,27,48.1,189,1,29,104,3.6,0,56,293,5.2,6,6,0,12,7,55,0,1,1
3573,8,2015-10-31,rutgers,@,Wisconsin,L (10-48),6,20,30.0,82,0,38,83,2.2,0,58,165,2.8,3,5,0,8,6,40,1,1,2
3574,9,2015-11-07,rutgers,@,Michigan,L (16-49),11,27,40.7,97,0,32,128,4.0,0,59,225,3.8,6,7,4,17,7,80,0,1,1
3575,10,2015-11-14,rutgers,,Nebraska,L (14-31),14,28,50.0,170,1,39,89,2.3,1,67,259,3.9,8,7,0,15,4,23,0,2,2
3576,11,2015-11-21,rutgers,@,Army,W (31-21),13,21,61.9,105,0,39,254,6.5,4,60,359,6.0,6,11,1,18,4,35,0,0,0
3577,12,2015-11-28,rutgers,,Maryland,L (41-46),21,33,63.6,344,4,47,186,4.0,1,80,530,6.6,14,8,1,23,9,92,0,1,1
3578,,12 Games,rutgers,,,,202,336,60.1,2485,19,470,2039,4.3,17,806,4524,5.6,112,111,13,236,79,624,6,12,18
3579,1,2016-09-03,rutgers,@,Washington,L (13-48),24,40,60.0,168,0,48,136,2.8,1,88,304,3.5,9,9,3,21,4,35,2,1,3
3580,2,2016-09-10,rutgers,,Howard,W (52-14),11,23,47.8,137,3,52,379,7.3,3,75,516,6.9,8,18,0,26,6,61,0,1,1
3581,3,2016-09-17,rutgers,,New Mexico,W (37-28),12,30,40.0,173,2,32,177,5.5,1,62,350,5.6,7,6,1,14,5,37,1,0,1
3582,4,2016-09-24,rutgers,,Iowa,L (7-14),13,24,54.2,190,1,53,193,3.6,0,77,383,5.0,8,13,0,21,4,50,1,0,1
3583,5,2016-10-01,rutgers,@,Ohio State,L (0-58),3,16,18.8,33,0,38,83,2.2,0,54,116,2.1,2,6,1,9,4,21,0,0,0
3584,6,2016-10-08,rutgers,,Michigan,L (0-78),2,18,11.1,5,0,36,34,0.9,0,54,39,0.7,0,2,0,2,7,41,1,0,1
3585,7,2016-10-15,rutgers,,Illinois,L (7-24),17,30,56.7,182,1,50,203,4.1,0,80,385,4.8,11,11,1,23,4,36,4,1,5
3586,8,2016-10-22,rutgers,@,Minnesota,L (32-34),23,40,57.5,222,3,36,150,4.2,0,76,372,4.9,13,8,1,22,6,30,1,2,3
3587,9,2016-11-05,rutgers,,Indiana,L (27-33),19,36,52.8,258,1,34,93,2.7,1,70,351,5.0,8,5,0,13,8,80,1,0,1
3588,10,2016-11-12,rutgers,@,Michigan State,L (0-49),6,18,33.3,40,0,36,109,3.0,0,54,149,2.8,3,5,0,8,6,50,0,2,2
3589,11,2016-11-19,rutgers,,Penn State,L (0-39),7,17,41.2,48,0,33,39,1.2,0,50,87,1.7,2,3,0,5,6,50,0,0,0
3590,12,2016-11-26,rutgers,@,Maryland,L (13-31),22,40,55.0,203,0,40,147,3.7,2,80,350,4.4,10,10,2,22,3,25,1,0,1
3591,,12 Games,rutgers,,,,159,332,47.9,1659,11,488,1743,3.6,8,820,3402,4.1,81,96,9,186,63,516,12,7,19
3592,1,2017-09-01,rutgers,,Washington,L (14-30),24,35,68.6,178,2,42,131,3.1,0,77,309,4.0,9,9,1,19,4,25,0,2,2
3593,2,2017-09-09,rutgers,,Eastern Michigan,L (13-16),17,38,44.7,198,0,30,128,4.3,1,68,326,4.8,7,5,3,15,9,88,0,2,2
3594,3,2017-09-16,rutgers,,Morgan State,W (65-0),13,19,68.4,152,2,54,326,6.0,7,73,478,6.5,6,15,4,25,8,60,1,0,1
3595,4,2017-09-23,rutgers,@,Nebraska,L (17-27),15,29,51.7,126,0,24,68,2.8,1,53,194,3.7,7,4,1,12,4,35,0,2,2
3596,5,2017-09-30,rutgers,,Ohio State,L (0-56),11,27,40.7,92,0,41,117,2.9,0,68,209,3.1,7,4,2,13,10,80,0,2,2
3597,6,2017-10-14,rutgers,@,Illinois,W (35-24),6,12,50.0,102,0,47,274,5.8,5,59,376,6.4,4,10,3,17,8,75,3,0,3
3598,7,2017-10-21,rutgers,,Purdue,W (14-12),9,18,50.0,87,1,37,130,3.5,1,55,217,3.9,3,5,0,8,4,35,0,0,0
3599,8,2017-10-28,rutgers,@,Michigan,L (14-35),8,16,50.0,101,0,31,94,3.0,2,47,195,4.1,4,4,1,9,3,20,0,0,0
3600,9,2017-11-04,rutgers,N,Maryland,W (31-24),8,18,44.4,107,1,46,239,5.2,2,64,346,5.4,4,16,1,21,6,49,1,1,2
3601,10,2017-11-11,rutgers,@,Penn State,L (6-35),7,20,35.0,43,0,40,175,4.4,0,60,218,3.6,2,8,0,10,4,41,1,0,1
3602,11,2017-11-18,rutgers,@,Indiana,L (0-41),11,24,45.8,103,0,33,87,2.6,0,57,190,3.3,4,6,1,11,6,49,2,0,2
3603,12,2017-11-25,rutgers,,Michigan State,L (7-40),6,19,31.6,98,1,12,14,1.2,0,31,112,3.6,2,1,2,5,5,44,1,2,3
3604,,12 Games,rutgers,,,,135,275,49.1,1387,7,437,1783,4.1,19,712,3170,4.5,59,87,19,165,71,601,9,11,20
3605,1,2018-09-01,rutgers,,Texas State,W (35-7),20,29,69.0,205,1,46,218,4.7,3,75,423,5.6,11,10,2,23,7,50,1,3,4
3606,2,2018-09-08,rutgers,@,Ohio State,L (3-52),11,30,36.7,65,0,31,69,2.2,0,61,134,2.2,4,4,4,12,7,72,0,2,2
3607,3,2018-09-15,rutgers,@,Kansas,L (14-55),14,31,45.2,124,0,33,150,4.5,1,64,274,4.3,6,7,1,14,5,60,3,3,6
3608,4,2018-09-22,rutgers,,Buffalo,L (13-42),18,37,48.6,168,0,38,116,3.1,1,75,284,3.8,7,6,1,14,9,97,0,0,0
3609,5,2018-09-29,rutgers,,Indiana,L (17-24),19,36,52.8,193,1,23,98,4.3,1,59,291,4.9,10,6,3,19,6,63,0,1,1
3610,6,2018-10-06,rutgers,,Illinois,L (17-38),29,46,63.0,267,1,30,119,4.0,1,76,386,5.1,14,8,3,25,10,105,0,3,3
3611,7,2018-10-13,rutgers,@,Maryland,L (7-34),2,17,11.8,8,0,45,171,3.8,1,62,179,2.9,0,11,3,14,4,23,0,5,5
3612,8,2018-10-20,rutgers,,Northwestern,L (15-18),15,31,48.4,81,0,26,107,4.1,1,57,188,3.3,2,7,1,10,7,60,0,0,0
3613,9,2018-11-03,rutgers,@,Wisconsin,L (17-31),20,39,51.3,261,1,26,72,2.8,1,65,333,5.1,10,2,1,13,4,50,0,0,0
3614,10,2018-11-10,rutgers,,Michigan,L (7-42),9,20,45.0,59,0,33,193,5.8,1,53,252,4.8,3,7,1,11,3,30,1,1,2
3615,11,2018-11-17,rutgers,,Penn State,L (7-20),5,16,31.3,46,0,55,188,3.4,1,71,234,3.3,1,13,3,17,5,62,1,2,3
3616,,11 Games,rutgers,,,,162,332,48.8,1477,4,386,1501,3.9,12,718,2978,4.1,68,81,23,172,67,672,6,20,26
3617,1,2014-08-30,southern-mississippi,@,Mississippi State,L (0-49),20,42,47.6,212,0,33,71,2.2,0,75,283,3.8,6,8,1,15,6,37,1,2,3
3618,2,2014-09-06,southern-mississippi,,Alcorn State,W (26-20),21,33,63.6,208,2,42,207,4.9,0,75,415,5.5,7,11,4,22,4,40,0,0,0
3619,3,2014-09-13,southern-mississippi,@,Alabama,L (12-52),19,37,51.4,207,0,18,56,3.1,0,55,263,4.8,9,3,1,13,6,50,0,0,0
3620,4,2014-09-20,southern-mississippi,,Appalachian State,W (21-20),22,36,61.1,268,1,25,61,2.4,2,61,329,5.4,9,5,2,16,9,103,0,2,2
3621,5,2014-09-27,southern-mississippi,,Rice,L (23-41),24,46,52.2,283,2,23,40,1.7,1,69,323,4.7,12,2,4,18,6,55,1,2,3
3622,6,2014-10-04,southern-mississippi,@,Middle Tennessee State,L (31-37),36,55,65.5,426,3,34,111,3.3,1,89,537,6.0,23,7,0,30,6,48,1,1,2
3623,7,2014-10-18,southern-mississippi,@,North Texas,W (30-20),27,41,65.9,305,2,41,201,4.9,1,82,506,6.2,16,12,2,30,6,70,0,2,2
3624,8,2014-10-25,southern-mississippi,,Louisiana Tech,L (20-31),32,49,65.3,379,1,26,-31,-1.2,1,75,348,4.6,19,2,1,22,9,83,0,2,2
3625,9,2014-11-01,southern-mississippi,@,Texas-El Paso,L (14-35),20,47,42.6,309,1,27,93,3.4,0,74,402,5.4,11,6,0,17,9,95,3,2,5
3626,10,2014-11-08,southern-mississippi,,Marshall,L (17-63),11,20,55.0,114,0,54,186,3.4,2,74,300,4.1,7,11,5,23,7,68,2,1,3
3627,11,2014-11-13,southern-mississippi,@,Texas-San Antonio,L (10-12),21,34,61.8,257,1,25,57,2.3,0,59,314,5.3,10,4,3,17,7,62,2,1,3
3628,12,2014-11-29,southern-mississippi,,Alabama-Birmingham,L (24-45),24,42,57.1,263,1,28,97,3.5,1,70,360,5.1,13,6,7,26,2,20,1,0,1
3629,,12 Games,southern-mississippi,,,,277,482,57.5,3231,14,376,1149,3.1,9,858,4380,5.1,142,77,30,249,77,731,11,15,26
3630,1,2015-09-05,southern-mississippi,,Mississippi State,L (16-34),30,44,68.2,311,1,36,102,2.8,0,80,413,5.2,15,4,1,20,7,59,0,2,2
3631,2,2015-09-12,southern-mississippi,,Austin Peay,W (52-6),22,40,55.0,275,3,30,239,8.0,3,70,514,7.3,12,9,3,24,6,70,0,1,1
3632,3,2015-09-19,southern-mississippi,@,Texas State,W (56-50),19,27,70.4,333,4,46,280,6.1,4,73,613,8.4,14,6,2,22,15,130,1,0,1
3633,4,2015-09-26,southern-mississippi,@,Nebraska,L (28-36),26,42,61.9,447,2,23,11,0.5,2,65,458,7.0,15,1,3,19,9,80,1,0,1
3634,5,2015-10-03,southern-mississippi,,North Texas,W (49-14),27,36,75.0,325,4,33,248,7.5,3,69,573,8.3,11,11,2,24,8,87,0,0,0
3635,6,2015-10-09,southern-mississippi,@,Marshall,L (10-31),29,58,50.0,314,1,35,125,3.6,0,93,439,4.7,13,8,5,26,8,55,4,1,5
3636,7,2015-10-17,southern-mississippi,,Texas-San Antonio,W (32-10),23,31,74.2,343,2,44,213,4.8,1,75,556,7.4,11,9,3,23,8,85,1,3,4
3637,8,2015-10-24,southern-mississippi,@,UNC Charlotte,W (44-10),25,40,62.5,268,4,38,212,5.6,1,78,480,6.2,10,10,2,22,7,63,2,0,2
3638,9,2015-10-31,southern-mississippi,,Texas-El Paso,W (34-13),23,33,69.7,277,4,36,246,6.8,1,69,523,7.6,14,7,3,24,4,41,1,0,1
3639,10,2015-11-14,southern-mississippi,@,Rice,W (65-10),28,37,75.7,501,7,35,181,5.2,2,72,682,9.5,18,7,1,26,6,59,1,0,1
3640,11,2015-11-21,southern-mississippi,,Old Dominion,W (56-31),21,37,56.8,302,2,48,310,6.5,6,85,612,7.2,15,15,3,33,4,40,1,1,2
3641,12,2015-11-28,southern-mississippi,@,Louisiana Tech,W (58-24),24,37,64.9,386,3,36,169,4.7,4,73,555,7.6,18,6,1,25,6,65,0,1,1
3642,13,2015-12-05,southern-mississippi,@,Western Kentucky,L (28-45),15,30,50.0,181,1,32,159,5.0,2,62,340,5.5,8,6,0,14,5,52,1,3,4
3643,14,2015-12-26,southern-mississippi,N,Washington*,L (31-44),26,39,66.7,353,2,30,22,0.7,2,69,375,5.4,14,5,3,22,4,45,0,0,0
3644,,14 Games,southern-mississippi,,,,338,531,63.7,4616,40,502,2517,5.0,31,1033,7133,6.9,188,104,32,324,97,931,13,12,25
3645,1,2016-09-03,southern-mississippi,@,Kentucky,W (44-35),18,28,64.3,258,2,67,296,4.4,3,95,554,5.8,10,18,4,32,7,50,0,3,3
3646,2,2016-09-10,southern-mississippi,,Savannah State,W (56-0),21,29,72.4,246,4,48,371,7.7,3,77,617,8.0,10,18,0,28,5,40,0,1,1
3647,3,2016-09-17,southern-mississippi,,Troy,L (31-37),24,52,46.2,263,1,29,158,5.4,2,81,421,5.2,13,5,2,20,16,135,1,2,3
3648,4,2016-09-24,southern-mississippi,@,Texas-El Paso,W (34-7),16,27,59.3,176,3,39,202,5.2,0,66,378,5.7,9,8,1,18,4,30,2,0,2
3649,5,2016-10-01,southern-mississippi,,Rice,W (44-28),25,36,69.4,591,4,34,111,3.3,1,70,702,10.0,15,6,2,23,7,52,2,1,3
3650,6,2016-10-08,southern-mississippi,@,Texas-San Antonio,L (32-55),25,50,50.0,378,3,39,179,4.6,1,89,557,6.3,18,10,3,31,5,57,2,1,3
3651,7,2016-10-15,southern-mississippi,@,Louisiana State,L (10-45),25,37,67.6,161,0,36,81,2.3,1,73,242,3.3,9,4,3,16,6,42,1,0,1
3652,8,2016-10-29,southern-mississippi,,Marshall,W (24-14),22,40,55.0,300,1,45,174,3.9,2,85,474,5.6,14,10,2,26,4,44,1,0,1
3653,9,2016-11-05,southern-mississippi,,UNC Charlotte,L (27-38),32,53,60.4,404,2,29,94,3.2,2,82,498,6.1,15,7,3,25,8,60,0,3,3
3654,10,2016-11-12,southern-mississippi,@,Old Dominion,L (35-51),12,24,50.0,230,1,55,222,4.0,4,79,452,5.7,9,12,0,21,4,34,4,1,5
3655,11,2016-11-19,southern-mississippi,@,North Texas,L (23-29),11,27,40.7,182,0,43,203,4.7,3,70,385,5.5,6,9,4,19,9,79,1,3,4
3656,12,2016-11-25,southern-mississippi,,Louisiana Tech,W (39-24),29,33,87.9,342,3,44,84,1.9,2,77,426,5.5,17,6,3,26,9,85,1,0,1
3657,13,2016-12-17,southern-mississippi,N,Louisiana*,W (28-21),25,42,59.5,346,2,32,135,4.2,2,74,481,6.5,12,8,2,22,13,131,1,1,2
3658,,13 Games,southern-mississippi,,,,285,478,59.6,3877,26,540,2310,4.3,26,1018,6187,6.1,157,121,29,307,97,839,16,16,32
3659,1,2017-09-02,southern-mississippi,,Kentucky,L (17-24),22,40,55.0,309,2,38,55,1.4,0,78,364,4.7,10,7,2,19,8,69,3,0,3
3660,2,2017-09-09,southern-mississippi,,Southern,W (45-0),20,32,62.5,280,2,44,197,4.5,2,76,477,6.3,15,9,3,27,5,35,2,0,2
3661,3,2017-09-16,southern-mississippi,@,Louisiana-Monroe,W (28-17),17,32,53.1,250,3,48,284,5.9,1,80,534,6.7,8,12,3,23,12,125,0,1,1
3662,4,2017-09-30,southern-mississippi,,North Texas,L (28-43),19,42,45.2,270,1,29,145,5.0,3,71,415,5.8,10,7,1,18,6,64,0,0,0
3663,5,2017-10-07,southern-mississippi,@,Texas-San Antonio,W (31-29),15,21,71.4,212,3,30,246,8.2,1,51,458,9.0,9,9,0,18,3,35,2,0,2
3664,6,2017-10-14,southern-mississippi,,Texas-El Paso,W (24-0),16,27,59.3,221,1,45,202,4.5,2,72,423,5.9,8,11,1,20,10,94,1,2,3
3665,7,2017-10-21,southern-mississippi,@,Louisiana Tech,W (34-27),32,53,60.4,301,3,45,190,4.2,0,98,491,5.0,16,10,1,30,6,40,1,2,3
3666,8,2017-10-28,southern-mississippi,,Alabama-Birmingham,L (12-30),19,38,50.0,266,1,26,81,3.1,0,64,347,5.4,7,5,2,14,5,41,0,1,1
3667,9,2017-11-04,southern-mississippi,@,Tennessee,L (10-24),13,34,38.2,161,0,42,118,2.8,1,76,279,3.7,7,8,3,18,14,120,1,1,2
3668,10,2017-11-11,southern-mississippi,@,Rice,W (43-34),22,31,71.0,331,3,36,186,5.2,2,67,517,7.7,16,12,0,28,10,86,0,0,0
3669,11,2017-11-18,southern-mississippi,,UNC Charlotte,W (66-21),20,27,74.1,221,1,42,363,8.6,5,69,584,8.5,11,13,3,27,5,34,0,0,0
3670,12,2017-11-25,southern-mississippi,@,Marshall,W (28-27),16,35,45.7,170,3,45,201,4.5,1,80,371,4.6,8,10,4,22,8,85,1,0,1
3671,13,2017-12-27,southern-mississippi,N,Florida State*,L (13-42),15,27,55.6,129,1,28,131,4.7,1,55,260,4.7,7,4,1,12,7,44,1,0,1
3672,,13 Games,southern-mississippi,,,,246,439,56.0,3121,24,498,2399,4.8,19,937,5520,5.9,132,117,24,276,99,872,12,7,19
3673,1,2018-09-01,southern-mississippi,,Jackson State,W (55-7),25,33,75.8,255,4,45,202,4.5,1,78,457,5.9,15,13,1,29,4,35,1,2,3
3674,2,2018-09-08,southern-mississippi,,Louisiana-Monroe,L (20-21),31,46,67.4,378,2,34,58,1.7,0,80,436,5.5,18,4,1,23,4,45,2,2,4
3675,3,2018-09-22,southern-mississippi,,Rice,W (40-22),25,34,73.5,428,4,31,138,4.5,1,65,566,8.7,16,9,0,25,5,39,0,1,1
3676,4,2018-09-29,southern-mississippi,@,Auburn,L (13-24),30,44,68.2,215,1,21,45,2.1,0,65,260,4.0,11,2,2,15,7,46,1,2,3
3677,5,2018-10-13,southern-mississippi,@,North Texas,L (7-30),30,44,68.2,317,1,28,50,1.8,0,72,367,5.1,14,4,2,20,3,32,1,1,2
3678,6,2018-10-20,southern-mississippi,,Texas-San Antonio,W (27-17),28,33,84.8,269,1,46,218,4.7,2,79,487,6.2,14,10,0,24,7,60,2,1,3
3679,7,2018-10-27,southern-mississippi,@,UNC Charlotte,L (17-20),27,39,69.2,297,2,34,129,3.8,0,73,426,5.8,14,8,3,25,6,43,0,3,3
3680,8,2018-11-03,southern-mississippi,,Marshall,W (26-24),16,25,64.0,134,1,45,88,2.0,1,70,222,3.2,4,4,5,13,10,90,2,0,2
3681,9,2018-11-10,southern-mississippi,@,Alabama-Birmingham,L (23-26),16,39,41.0,160,1,34,5,0.1,1,73,165,2.3,6,5,4,15,8,58,0,1,1
3682,10,2018-11-17,southern-mississippi,,Louisiana Tech,W (21-20),26,31,83.9,226,1,33,54,1.6,2,64,280,4.4,14,3,2,19,4,38,1,0,1
3683,,10 Games,southern-mississippi,,,,254,368,69.0,2679,18,351,987,2.8,8,719,3666,5.1,126,62,20,208,58,486,10,13,23
3684,1,2014-08-29,western-kentucky,,Bowling Green State,W (59-31),46,56,82.1,569,6,40,139,3.5,2,96,708,7.4,29,9,2,40,7,66,0,0,0
3685,2,2014-09-06,western-kentucky,@,Illinois,L (34-42),28,48,58.3,297,2,30,103,3.4,1,78,400,5.1,17,5,1,23,5,24,2,1,3
3686,3,2014-09-13,western-kentucky,@,Middle Tennessee State,L (47-50),43,66,65.2,593,4,36,125,3.5,1,102,718,7.0,22,9,2,33,10,92,0,1,1
3687,4,2014-09-27,western-kentucky,@,Navy,W (36-27),38,54,70.4,387,2,34,164,4.8,1,88,551,6.3,19,11,0,30,7,66,0,1,1
3688,5,2014-10-04,western-kentucky,,Alabama-Birmingham,L (39-42),25,37,67.6,319,2,28,184,6.6,3,65,503,7.7,14,9,2,25,6,50,0,0,0
3689,6,2014-10-18,western-kentucky,@,Florida Atlantic,L (38-45),28,44,63.6,335,3,26,67,2.6,2,70,402,5.7,16,4,3,23,3,25,1,1,2
3690,7,2014-10-25,western-kentucky,,Old Dominion,W (66-51),23,26,88.5,371,5,45,230,5.1,2,71,601,8.5,17,13,2,32,3,40,2,0,2
3691,8,2014-11-01,western-kentucky,@,Louisiana Tech,L (10-59),16,39,41.0,145,1,33,152,4.6,0,72,297,4.1,6,9,0,15,8,93,1,4,5
3692,9,2014-11-08,western-kentucky,,Texas-El Paso,W (35-27),23,34,67.6,324,3,21,34,1.6,1,55,358,6.5,13,2,1,16,3,24,0,0,0
3693,10,2014-11-15,western-kentucky,,Army,W (52-24),16,25,64.0,178,3,41,383,9.3,4,66,561,8.5,6,16,0,22,7,80,0,0,0
3694,11,2014-11-22,western-kentucky,,Texas-San Antonio,W (45-7),26,35,74.3,346,5,28,120,4.3,1,63,466,7.4,13,6,6,25,4,40,0,0,0
3695,12,2014-11-28,western-kentucky,@,Marshall,W (67-66),35,51,68.6,516,8,35,222,6.3,1,86,738,8.6,22,13,2,37,4,38,0,2,2
3696,13,2014-12-24,western-kentucky,N,Central Michigan*,W (49-48),31,42,73.8,486,5,32,161,5.0,2,74,647,8.7,22,6,2,30,9,105,2,0,2
3697,,13 Games,western-kentucky,,,,378,557,67.9,4866,49,429,2084,4.9,21,986,6950,7.0,216,112,23,351,76,743,8,10,18
3698,1,2015-09-03,western-kentucky,@,Vanderbilt,W (14-12),19,30,63.3,209,1,23,37,1.6,1,53,246,4.6,7,4,0,11,9,70,0,0,0
3699,2,2015-09-10,western-kentucky,,Louisiana Tech,W (41-38),28,38,73.7,441,1,33,149,4.5,2,71,590,8.3,18,6,0,24,10,109,1,0,1
3700,3,2015-09-19,western-kentucky,@,Indiana,L (35-38),35,46,76.1,484,3,26,84,3.2,2,72,568,7.9,21,5,2,28,6,65,0,2,2
3701,4,2015-09-26,western-kentucky,,Miami (OH),W (56-14),34,42,81.0,464,6,32,105,3.3,2,74,569,7.7,20,6,1,27,6,50,0,0,0
3702,5,2015-10-03,western-kentucky,@,Rice,W (49-10),29,39,74.4,424,4,32,80,2.5,3,71,504,7.1,16,4,4,24,3,20,0,0,0
3703,6,2015-10-10,western-kentucky,,Middle Tennessee State,W (58-28),29,37,78.4,428,6,40,165,4.1,1,77,593,7.7,14,8,2,24,3,35,1,1,2
3704,7,2015-10-15,western-kentucky,@,North Texas,W (55-28),31,43,72.1,400,4,40,283,7.1,3,83,683,8.2,17,17,1,35,7,55,0,1,1
3705,8,2015-10-24,western-kentucky,@,Louisiana State,L (20-48),37,61,60.7,325,3,23,103,4.5,0,84,428,5.1,16,7,1,24,7,62,1,1,2
3706,9,2015-10-31,western-kentucky,@,Old Dominion,W (55-30),22,29,75.9,284,3,31,239,7.7,4,60,523,8.7,12,9,1,22,1,5,0,0,0
3707,10,2015-11-07,western-kentucky,,Florida Atlantic,W (35-19),25,30,83.3,287,5,34,229,6.7,0,64,516,8.1,10,14,1,25,7,85,0,1,1
3708,11,2015-11-21,western-kentucky,@,Florida International,W (63-7),16,21,76.2,224,3,37,253,6.8,5,58,477,8.2,8,14,1,23,5,70,3,0,3
3709,12,2015-11-27,western-kentucky,,Marshall,W (49-28),27,40,67.5,370,5,43,176,4.1,1,83,546,6.6,18,10,3,31,8,102,2,0,2
3710,13,2015-12-05,western-kentucky,,Southern Mississippi,W (45-28),34,52,65.4,410,3,36,111,3.1,3,88,521,5.9,16,7,1,24,2,15,0,1,1
3711,14,2015-12-21,western-kentucky,N,South Florida*,W (45-35),32,46,69.6,461,3,33,151,4.6,3,79,612,7.7,17,9,1,27,9,66,0,2,2
3712,,14 Games,western-kentucky,,,,398,554,71.8,5211,50,463,2165,4.7,30,1017,7376,7.3,210,120,19,349,83,809,8,9,17
3713,1,2016-09-01,western-kentucky,,Rice,W (46-14),26,35,74.3,552,3,30,97,3.2,2,65,649,10.0,17,4,2,23,8,77,0,0,0
3714,2,2016-09-10,western-kentucky,@,Alabama,L (10-38),19,38,50.0,216,1,22,23,1.0,0,60,239,4.0,9,2,1,12,2,16,0,2,2
3715,3,2016-09-17,western-kentucky,@,Miami (OH),W (31-24),19,31,61.3,268,2,35,136,3.9,1,66,404,6.1,10,7,2,19,9,126,2,1,3
3716,4,2016-09-24,western-kentucky,,Vanderbilt,L (30-31),24,40,60.0,291,2,33,205,6.2,2,73,496,6.8,12,12,3,27,11,88,2,1,3
3717,5,2016-10-01,western-kentucky,,,W (50-3),16,22,72.7,283,3,30,252,8.4,3,52,535,10.3,12,11,0,23,3,35,0,0,0
3718,6,2016-10-06,western-kentucky,@,Louisiana Tech,L (52-55),36,50,72.0,340,5,23,87,3.8,1,73,427,5.8,18,7,1,26,5,58,2,0,2
3719,7,2016-10-15,western-kentucky,@,Middle Tennessee State,W (44-43),29,40,72.5,391,2,37,130,3.5,3,77,521,6.8,15,12,1,28,7,64,0,1,1
3720,8,2016-10-22,western-kentucky,,Old Dominion,W (59-24),28,33,84.8,378,4,35,246,7.0,4,68,624,9.2,17,11,1,29,7,81,0,1,1
3721,9,2016-10-29,western-kentucky,@,Florida Atlantic,W (52-3),16,25,64.0,393,5,45,268,6.0,2,70,661,9.4,11,11,0,22,8,80,1,0,1
3722,10,2016-11-05,western-kentucky,,Florida International,W (49-21),18,32,56.3,284,1,37,225,6.1,5,69,509,7.4,14,10,0,24,3,15,2,0,2
3723,11,2016-11-12,western-kentucky,,North Texas,W (45-7),17,33,51.5,329,5,41,214,5.2,1,74,543,7.3,12,11,2,25,9,55,0,0,0
3724,12,2016-11-26,western-kentucky,@,Marshall,W (60-6),16,31,51.6,233,3,30,229,7.6,3,61,462,7.6,11,14,2,27,6,80,0,0,0
3725,13,2016-12-03,western-kentucky,,Louisiana Tech,W (58-44),21,31,67.7,421,3,41,235,5.7,4,72,656,9.1,15,13,3,31,7,75,2,1,3
3726,14,2016-12-20,western-kentucky,N,Memphis*,W (51-31),20,30,66.7,336,3,48,262,5.5,4,78,598,7.7,11,14,3,28,8,84,0,1,1
3727,,14 Games,western-kentucky,,,,305,471,64.8,4715,42,487,2609,5.4,35,958,7324,7.6,184,139,21,344,93,934,11,8,19
3728,1,2017-09-02,western-kentucky,,Eastern Kentucky,W (31-17),20,31,64.5,264,1,40,100,2.5,3,71,364,5.1,10,8,2,20,3,25,1,0,1
3729,2,2017-09-09,western-kentucky,@,Illinois,L (7-20),28,43,65.1,238,0,16,6,0.4,1,59,244,4.1,8,2,4,14,11,100,1,1,2
3730,3,2017-09-16,western-kentucky,,Louisiana Tech,L (22-23),25,35,71.4,226,0,41,141,3.4,3,76,367,4.8,13,9,1,23,3,22,0,0,0
3731,4,2017-09-23,western-kentucky,,Ball State,W (33-21),28,44,63.6,319,1,30,52,1.7,2,74,371,5.0,16,5,1,22,4,35,0,2,2
3732,5,2017-10-07,western-kentucky,@,Texas-El Paso,W (15-14),24,37,64.9,208,0,33,74,2.2,2,70,282,4.0,12,4,2,18,6,49,0,0,0
3733,6,2017-10-14,western-kentucky,,UNC Charlotte,W (45-14),43,58,74.1,506,5,34,121,3.6,1,92,627,6.8,22,10,2,34,7,58,1,0,1
3734,7,2017-10-20,western-kentucky,@,Old Dominion,W (35-31),25,35,71.4,343,5,33,73,2.2,0,68,416,6.1,15,7,1,23,5,25,1,1,2
3735,8,2017-10-28,western-kentucky,,Florida Atlantic,L (28-42),32,56,57.1,371,2,33,99,3.0,2,89,470,5.3,21,8,3,32,3,35,2,2,4
3736,9,2017-11-04,western-kentucky,@,Vanderbilt,L (17-31),33,53,62.3,355,1,30,-6,-0.2,1,83,349,4.2,15,4,3,22,5,31,0,1,1
3737,10,2017-11-11,western-kentucky,@,Marshall,L (23-30),28,42,66.7,334,3,19,34,1.8,0,61,368,6.0,14,6,1,21,6,63,1,1,2
3738,11,2017-11-17,western-kentucky,,Middle Tennessee State,W (41-38),39,54,72.2,485,5,33,53,1.6,0,87,538,6.2,16,6,3,25,7,69,2,0,2
3739,12,2017-11-24,western-kentucky,@,Florida International,L (17-41),30,49,61.2,355,2,28,46,1.6,0,77,401,5.2,17,5,1,23,4,32,3,0,3
3740,13,2017-12-16,western-kentucky,N,Georgia State*,L (17-27),26,40,65.0,351,2,21,-2,-0.1,0,61,349,5.7,14,3,0,17,10,89,1,2,3
3741,,13 Games,western-kentucky,,,,381,577,66.0,4355,27,391,791,2.0,15,968,5146,5.3,193,77,24,294,74,633,13,10,23
3742,1,2018-08-31,western-kentucky,@,Wisconsin,L (3-34),17,30,56.7,181,0,34,124,3.6,0,64,305,4.8,8,6,1,15,6,65,1,1,2
3743,2,2018-09-08,western-kentucky,,Maine,L (28-31),23,41,56.1,347,3,31,42,1.4,0,72,389,5.4,6,11,0,17,4,38,2,0,2
3744,3,2018-09-15,western-kentucky,@,Louisville,L (17-20),25,38,65.8,260,1,43,168,3.9,1,81,428,5.3,14,11,1,26,8,69,0,1,1
3745,4,2018-09-22,western-kentucky,@,Ball State,W (28-20),25,35,71.4,252,2,40,192,4.8,2,75,444,5.9,12,14,3,29,11,102,0,0,0
3746,5,2018-09-29,western-kentucky,,Marshall,L (17-20),24,39,61.5,263,1,32,61,1.9,1,71,324,4.6,10,4,3,17,6,43,2,1,3
3747,6,2018-10-13,western-kentucky,@,UNC Charlotte,L (14-40),27,39,69.2,214,1,17,42,2.5,1,56,256,4.6,11,4,2,17,7,55,1,2,3
3748,7,2018-10-20,western-kentucky,,Old Dominion,L (34-37),24,32,75.0,257,2,45,207,4.6,2,77,464,6.0,14,11,4,29,10,83,0,0,0
3749,8,2018-10-27,western-kentucky,,Florida International,L (17-38),18,34,52.9,144,0,38,168,4.4,2,72,312,4.3,7,12,4,23,4,34,0,1,1
3750,9,2018-11-02,western-kentucky,@,Middle Tennessee State,L (10-29),16,47,34.0,270,1,25,109,4.4,0,72,379,5.3,10,6,1,17,7,80,1,1,2
3751,10,2018-11-10,western-kentucky,@,Florida Atlantic,L (15-34),25,42,59.5,228,1,34,123,3.6,1,76,351,4.6,15,4,2,21,2,10,0,1,1
3752,11,2018-11-17,western-kentucky,,Texas-El Paso,W (40-16),19,31,61.3,214,2,50,208,4.2,2,81,422,5.2,9,12,1,22,7,62,0,1,1
3753,,11 Games,western-kentucky,,,,243,408,59.6,2630,14,389,1444,3.7,12,797,4074,5.1,116,95,22,233,72,641,7,9,16
3754,1,2014-08-30,louisiana-tech,@,Oklahoma,L (16-48),22,36,61.1,191,2,29,54,1.9,0,65,245,3.8,10,3,2,15,5,32,0,1,1
3755,2,2014-09-06,louisiana-tech,@,Louisiana,W (48-20),22,33,66.7,295,2,35,238,6.8,3,68,533,7.8,9,9,2,20,5,35,0,0,0
3756,3,2014-09-11,louisiana-tech,@,North Texas,W (42-21),23,36,63.9,260,5,30,98,3.3,1,66,358,5.4,14,5,2,21,7,73,0,1,1
3757,4,2014-09-20,louisiana-tech,,Northwestern State,L (27-30),20,34,58.8,280,1,33,133,4.0,2,67,413,6.2,13,8,1,22,8,74,2,3,5
3758,5,2014-09-27,louisiana-tech,@,Auburn,L (17-45),20,35,57.1,216,0,33,105,3.2,2,68,321,4.7,7,5,2,14,5,40,1,1,2
3759,6,2014-10-04,louisiana-tech,,Texas-El Paso,W (55-3),7,17,41.2,187,3,43,256,6.0,3,60,443,7.4,7,12,0,19,4,35,1,1,2
3760,7,2014-10-18,louisiana-tech,,Texas-San Antonio,W (27-20),14,33,42.4,157,1,35,121,3.5,1,68,278,4.1,7,6,3,16,10,85,0,1,1
3761,8,2014-10-25,louisiana-tech,@,Southern Mississippi,W (31-20),27,46,58.7,423,3,26,30,1.2,1,72,453,6.3,17,3,3,23,4,40,2,0,2
3762,9,2014-11-01,louisiana-tech,,Western Kentucky,W (59-10),34,49,69.4,378,5,34,129,3.8,2,83,507,6.1,17,10,4,31,2,15,2,1,3
3763,10,2014-11-08,louisiana-tech,@,Alabama-Birmingham,W (40-24),19,34,55.9,200,2,46,228,5.0,3,80,428,5.4,11,11,2,24,2,15,2,1,3
3764,11,2014-11-22,louisiana-tech,@,Old Dominion,L (27-30),19,31,61.3,217,1,34,109,3.2,2,65,326,5.0,11,7,1,19,4,25,1,1,2
3765,12,2014-11-29,louisiana-tech,,Rice,W (76-31),22,35,62.9,408,4,36,269,7.5,6,71,677,9.5,14,10,2,26,3,15,0,1,1
3766,13,2014-12-06,louisiana-tech,@,Marshall,L (23-26),7,20,35.0,72,0,45,196,4.4,3,65,268,4.1,2,9,3,14,4,26,1,1,2
3767,14,2014-12-26,louisiana-tech,N,Illinois*,W (35-18),14,28,50.0,247,1,31,114,3.7,3,59,361,6.1,7,8,3,16,6,45,1,0,1
3768,,14 Games,louisiana-tech,,,,270,467,57.8,3531,30,490,2080,4.2,32,957,5611,5.9,146,106,30,280,69,555,13,13,26
3769,1,2015-09-05,louisiana-tech,,Southern,W (62-15),21,29,72.4,380,5,32,207,6.5,2,61,587,9.6,13,7,1,21,3,35,0,2,2
3770,2,2015-09-10,louisiana-tech,@,Western Kentucky,L (38-41),28,49,57.1,357,2,31,223,7.2,3,80,580,7.3,19,6,3,28,5,40,1,1,2
3771,3,2015-09-19,louisiana-tech,@,Kansas State,L (33-39),30,51,58.8,314,1,38,137,3.6,2,89,451,5.1,11,12,0,23,6,41,2,0,2
3772,4,2015-09-26,louisiana-tech,,Florida International,W (27-17),18,32,56.3,226,1,42,246,5.9,2,74,472,6.4,11,15,3,29,7,45,0,0,0
3773,5,2015-10-03,louisiana-tech,,Louisiana,W (43-14),20,33,60.6,290,2,35,138,3.9,2,68,428,6.3,13,9,5,27,8,76,1,0,1
3774,6,2015-10-10,louisiana-tech,@,Texas-San Antonio,W (34-31),28,44,63.6,351,1,31,93,3.0,2,75,444,5.9,17,5,2,24,5,40,0,2,2
3775,7,2015-10-17,louisiana-tech,@,Mississippi State,L (20-45),25,41,61.0,303,2,32,110,3.4,0,73,413,5.7,14,8,2,24,7,60,0,1,1
3776,8,2015-10-24,louisiana-tech,,Middle Tennessee State,W (45-16),19,33,57.6,301,2,35,169,4.8,3,68,470,6.9,10,10,2,22,5,46,0,0,0
3777,9,2015-10-30,louisiana-tech,@,Rice,W (42-17),17,27,63.0,320,4,33,135,4.1,2,60,455,7.6,12,7,2,21,2,20,0,0,0
3778,10,2015-11-07,louisiana-tech,,North Texas,W (56-13),18,27,66.7,299,0,36,274,7.6,7,63,573,9.1,10,14,1,25,3,32,2,1,3
3779,11,2015-11-21,louisiana-tech,@,Texas-El Paso,W (17-15),13,22,59.1,188,2,28,119,4.3,0,50,307,6.1,7,5,0,12,6,68,1,0,1
3780,12,2015-11-28,louisiana-tech,,Southern Mississippi,L (24-58),32,51,62.7,407,3,23,-2,-0.1,0,74,405,5.5,23,2,2,27,2,6,3,4,7
3781,13,2015-12-19,louisiana-tech,N,Arkansas State*,W (47-28),26,38,68.4,458,3,36,229,6.4,2,74,687,9.3,14,9,3,26,13,154,0,0,0
3782,,13 Games,louisiana-tech,,,,295,477,61.8,4194,28,432,2078,4.8,27,909,6272,6.9,174,109,26,309,72,663,10,11,21
3783,1,2016-09-03,louisiana-tech,@,Arkansas,L (20-21),19,31,61.3,212,0,23,79,3.4,2,54,291,5.4,10,5,1,16,3,20,0,1,1
3784,2,2016-09-10,louisiana-tech,,South Carolina State,W (53-24),41,60,68.3,518,5,30,209,7.0,1,90,727,8.1,24,10,0,34,6,62,2,2,4
3785,3,2016-09-17,louisiana-tech,@,Texas Tech,L (45-59),20,32,62.5,311,3,36,261,7.3,3,68,572,8.4,10,16,1,27,8,89,0,0,0
3786,4,2016-09-24,louisiana-tech,@,Middle Tennessee State,L (34-38),36,59,61.0,504,3,37,118,3.2,1,96,622,6.5,24,8,3,35,3,28,1,0,1
3787,5,2016-10-01,louisiana-tech,,Texas-El Paso,W (28-7),19,28,67.9,191,2,22,196,8.9,2,50,387,7.7,8,11,0,19,2,12,0,0,0
3788,6,2016-10-06,louisiana-tech,,Western Kentucky,W (55-52),33,45,73.3,454,5,27,107,4.0,2,72,561,7.8,15,7,4,26,5,64,0,0,0
3789,7,2016-10-15,louisiana-tech,@,Massachusetts,W (56-28),27,34,79.4,491,5,35,199,5.7,2,69,690,10.0,21,7,1,29,5,41,3,1,4
3790,8,2016-10-22,louisiana-tech,@,Florida International,W (44-24),22,30,73.3,269,2,25,145,5.8,2,55,414,7.5,10,8,0,18,8,60,0,0,0
3791,9,2016-10-29,louisiana-tech,,Rice,W (61-16),24,31,77.4,434,3,39,301,7.7,5,70,735,10.5,15,13,0,28,3,25,1,0,1
3792,10,2016-11-05,louisiana-tech,@,North Texas,W (45-24),18,30,60.0,253,4,40,226,5.7,2,70,479,6.8,11,12,7,30,3,30,0,1,1
3793,11,2016-11-12,louisiana-tech,,Texas-San Antonio,W (63-35),17,27,63.0,293,4,30,180,6.0,3,57,473,8.3,11,8,4,23,6,80,0,0,0
3794,12,2016-11-25,louisiana-tech,@,Southern Mississippi,L (24-39),22,39,56.4,246,0,16,8,0.5,2,55,254,4.6,12,2,2,16,7,50,0,3,3
3795,13,2016-12-03,louisiana-tech,@,Western Kentucky,L (44-58),35,57,61.4,502,3,22,5,0.2,1,79,507,6.4,20,5,1,26,8,64,0,1,1
3796,14,2016-12-23,louisiana-tech,N,Navy*,W (48-45),29,40,72.5,409,4,33,88,2.7,2,73,497,6.8,19,7,5,31,4,50,1,0,1
3797,,14 Games,louisiana-tech,,,,362,543,66.7,5087,43,415,2122,5.1,30,958,7209,7.5,210,119,29,358,71,675,8,9,17
3798,1,2017-09-02,louisiana-tech,,Northwestern State,W (52-24),18,35,51.4,276,2,37,221,6.0,3,72,497,6.9,12,9,1,22,5,50,3,0,3
3799,2,2017-09-09,louisiana-tech,,Mississippi State,L (21-57),13,30,43.3,163,1,50,152,3.0,1,80,315,3.9,5,12,3,20,3,28,2,1,3
3800,3,2017-09-16,louisiana-tech,@,Western Kentucky,W (23-22),22,39,56.4,306,1,30,122,4.1,1,69,428,6.2,14,4,2,20,3,25,0,1,1
3801,4,2017-09-23,louisiana-tech,@,South Carolina,L (16-17),23,33,69.7,281,1,28,80,2.9,0,61,361,5.9,12,4,1,17,3,18,0,1,1
3802,5,2017-09-30,louisiana-tech,,South Alabama,W (34-16),24,39,61.5,317,3,33,162,4.9,1,72,479,6.7,13,12,1,26,3,11,1,0,1
3803,6,2017-10-07,louisiana-tech,@,Alabama-Birmingham,L (22-23),17,29,58.6,209,2,34,154,4.5,1,63,363,5.8,10,9,2,21,10,95,0,0,0
3804,7,2017-10-21,louisiana-tech,,Southern Mississippi,L (27-34),11,28,39.3,194,0,34,161,4.7,2,62,355,5.7,6,8,0,15,4,30,1,1,2
3805,8,2017-10-28,louisiana-tech,@,Rice,W (42-28),21,32,65.6,237,1,39,180,4.6,4,71,417,5.9,13,10,1,24,4,25,0,0,0
3806,9,2017-11-04,louisiana-tech,,North Texas,L (23-24),16,28,57.1,168,0,41,147,3.6,2,69,315,4.6,9,7,3,19,5,37,0,0,0
3807,10,2017-11-11,louisiana-tech,,Florida Atlantic,L (23-48),30,51,58.8,326,1,45,186,4.1,1,96,512,5.3,20,10,2,32,5,58,0,0,0
3808,11,2017-11-18,louisiana-tech,@,Texas-El Paso,W (42-21),15,28,53.6,203,2,49,343,7.0,3,77,546,7.1,7,19,2,28,8,70,2,0,2
3809,12,2017-11-25,louisiana-tech,,Texas-San Antonio,W (20-6),7,21,33.3,101,0,37,193,5.2,2,58,294,5.1,6,10,3,19,3,30,1,1,2
3810,13,2017-12-20,louisiana-tech,N,Southern Methodist*,W (51-10),16,27,59.3,216,3,38,141,3.7,1,65,357,5.5,8,7,3,18,5,50,0,0,0
3811,,13 Games,louisiana-tech,,,,233,420,55.5,2997,17,495,2242,4.5,22,915,5239,5.7,135,121,24,281,61,527,10,5,15
3812,1,2018-09-01,louisiana-tech,@,South Alabama,W (30-26),19,29,65.5,209,2,48,231,4.8,2,77,440,5.7,8,11,3,22,6,55,0,3,3
3813,2,2018-09-08,louisiana-tech,,Southern,W (54-17),27,42,64.3,427,3,33,186,5.6,4,75,613,8.2,18,11,3,32,4,34,1,0,1
3814,3,2018-09-22,louisiana-tech,@,Louisiana State,L (21-38),27,50,54.0,330,3,26,87,3.3,0,76,417,5.5,14,5,2,21,6,48,1,1,2
3815,4,2018-09-29,louisiana-tech,@,North Texas,W (29-27),20,39,51.3,230,2,32,129,4.0,0,71,359,5.1,10,6,3,19,1,10,0,0,0
3816,5,2018-10-06,louisiana-tech,,Alabama-Birmingham,L (7-28),9,23,39.1,107,0,41,151,3.7,1,64,258,4.0,5,9,1,15,2,17,2,1,3
3817,6,2018-10-13,louisiana-tech,@,Texas-San Antonio,W (31-3),25,37,67.6,309,1,38,75,2.0,3,75,384,5.1,14,6,1,21,4,40,1,1,2
3818,7,2018-10-20,louisiana-tech,,Texas-El Paso,W (31-24),17,29,58.6,156,1,31,169,5.5,2,60,325,5.4,8,8,3,19,6,55,0,0,0
3819,8,2018-10-26,louisiana-tech,@,Florida Atlantic,W (21-13),17,35,48.6,217,1,40,113,2.8,2,75,330,4.4,11,7,3,21,4,44,0,0,0
3820,9,2018-11-03,louisiana-tech,@,Mississippi State,L (3-45),14,31,45.2,98,0,32,140,4.4,0,63,238,3.8,5,10,0,15,5,35,0,1,1
3821,10,2018-11-10,louisiana-tech,,Rice,W (28-13),21,34,61.8,314,1,33,110,3.3,3,67,424,6.3,10,10,0,20,5,37,1,2,3
3822,11,2018-11-17,louisiana-tech,@,Southern Mississippi,L (20-21),27,43,62.8,243,1,23,68,3.0,1,66,311,4.7,13,4,3,20,3,45,0,0,0
3823,,11 Games,louisiana-tech,,,,223,392,56.9,2640,15,377,1459,3.9,18,769,4099,5.3,116,87,22,225,46,420,6,9,15
3824,1,2014-08-30,middle-tennessee-state,,Savannah State,W (61-7),17,20,85.0,291,1,46,228,5.0,6,66,519,7.9,8,13,1,22,9,70,2,1,3
3825,2,2014-09-06,middle-tennessee-state,@,Minnesota,L (24-35),22,38,57.9,255,1,43,190,4.4,2,81,445,5.5,15,7,1,23,9,80,0,3,3
3826,3,2014-09-13,middle-tennessee-state,,Western Kentucky,W (50-47),17,28,60.7,218,1,61,323,5.3,5,89,541,6.1,11,16,1,28,7,62,0,0,0
3827,4,2014-09-20,middle-tennessee-state,@,Memphis,L (17-36),24,35,68.6,237,0,34,88,2.6,2,69,325,4.7,12,5,0,17,4,36,2,1,3
3828,5,2014-09-26,middle-tennessee-state,@,Old Dominion,W (41-28),25,30,83.3,259,2,57,280,4.9,2,87,539,6.2,11,18,0,29,9,85,2,0,2
3829,6,2014-10-04,middle-tennessee-state,,Southern Mississippi,W (37-31),22,27,81.5,344,2,39,239,6.1,3,66,583,8.8,13,9,0,22,6,49,1,0,1
3830,7,2014-10-11,middle-tennessee-state,@,Marshall,L (24-49),25,37,67.6,201,2,37,169,4.6,1,74,370,5.0,8,10,2,20,8,101,1,1,2
3831,8,2014-10-18,middle-tennessee-state,,Alabama-Birmingham,W (34-22),6,19,31.6,141,2,41,229,5.6,3,60,370,6.2,3,8,2,13,8,70,0,0,0
3832,9,2014-11-01,middle-tennessee-state,,Brigham Young,L (7-27),16,32,50.0,119,1,37,109,2.9,0,69,228,3.3,6,9,2,17,2,12,0,2,2
3833,10,2014-11-15,middle-tennessee-state,@,Florida International,L (28-38),21,33,63.6,286,3,45,142,3.2,1,78,428,5.5,12,9,1,22,7,70,2,3,5
3834,11,2014-11-22,middle-tennessee-state,,Florida Atlantic,W (35-34),20,27,74.1,160,2,46,310,6.7,3,73,470,6.4,7,15,0,22,3,20,1,1,2
3835,12,2014-11-29,middle-tennessee-state,@,Texas-El Paso,L (21-24),9,17,52.9,99,0,44,259,5.9,3,61,358,5.9,4,14,1,19,6,35,0,1,1
3836,,12 Games,middle-tennessee-state,,,,224,343,65.3,2610,17,530,2566,4.8,31,873,5176,5.9,110,133,11,254,78,690,11,13,24
3837,1,2015-09-05,middle-tennessee-state,,Jackson State,W (70-14),25,32,78.1,351,4,63,282,4.5,4,95,633,6.7,14,20,2,36,1,15,1,1,2
3838,2,2015-09-12,middle-tennessee-state,@,Alabama,L (10-37),23,43,53.5,189,1,31,86,2.8,0,74,275,3.7,11,3,1,15,8,67,3,1,4
3839,3,2015-09-19,middle-tennessee-state,,UNC Charlotte,W (73-14),24,29,82.8,379,5,49,316,6.4,4,78,695,8.9,12,12,1,25,3,36,2,0,2
3840,4,2015-09-26,middle-tennessee-state,@,Illinois,L (25-27),29,43,67.4,330,3,37,38,1.0,0,80,368,4.6,12,6,1,19,7,59,1,0,1
3841,5,2015-10-03,middle-tennessee-state,,Vanderbilt,L (13-17),32,51,62.7,286,1,23,34,1.5,0,74,320,4.3,13,4,1,18,5,30,2,0,2
3842,6,2015-10-10,middle-tennessee-state,@,Western Kentucky,L (28-58),28,43,65.1,296,3,30,123,4.1,1,73,419,5.7,13,7,2,22,4,41,1,1,2
3843,7,2015-10-17,middle-tennessee-state,,Florida International,W (42-34),17,26,65.4,261,0,43,200,4.7,6,69,461,6.7,10,12,0,22,8,87,1,1,2
3844,8,2015-10-24,middle-tennessee-state,@,Louisiana Tech,L (16-45),36,56,64.3,381,2,24,33,1.4,0,80,414,5.2,15,5,1,21,7,59,1,2,3
3845,9,2015-11-07,middle-tennessee-state,,Marshall,W (27-24),21,35,60.0,353,3,51,201,3.9,0,86,554,6.4,15,10,2,27,7,66,2,1,3
3846,10,2015-11-14,middle-tennessee-state,@,Florida Atlantic,W (24-17),18,32,56.3,301,2,45,178,4.0,1,77,479,6.2,12,8,2,22,5,45,1,1,2
3847,11,2015-11-21,middle-tennessee-state,,North Texas,W (41-7),30,41,73.2,329,3,39,165,4.2,2,80,494,6.2,14,14,2,30,1,5,1,1,2
3848,12,2015-11-28,middle-tennessee-state,@,Texas-San Antonio,W (42-7),24,30,80.0,257,1,43,199,4.6,4,73,456,6.2,8,18,2,28,1,5,2,0,2
3849,13,2015-12-24,middle-tennessee-state,N,Western Michigan*,L (31-45),26,39,66.7,327,3,26,115,4.4,1,65,442,6.8,11,7,0,18,5,40,1,1,2
3850,,13 Games,middle-tennessee-state,,,,333,500,66.6,4040,31,504,1970,3.9,23,1004,6010,6.0,160,126,17,303,62,555,19,10,29
3851,1,2016-09-03,middle-tennessee-state,,Alabama A&M,W (55-0),40,53,75.5,435,6,40,246,6.2,1,93,681,7.3,22,12,1,35,9,87,0,2,2
3852,2,2016-09-10,middle-tennessee-state,@,Vanderbilt,L (24-47),38,65,58.5,399,3,21,96,4.6,0,86,495,5.8,19,6,0,25,9,92,1,1,2
3853,3,2016-09-17,middle-tennessee-state,@,Bowling Green State,W (41-21),18,30,60.0,278,3,37,158,4.3,3,67,436,6.5,8,8,4,20,3,36,1,1,2
3854,4,2016-09-24,middle-tennessee-state,,Louisiana Tech,W (38-34),27,46,58.7,356,2,33,197,6.0,3,79,553,7.0,15,9,1,25,4,35,0,0,0
3855,5,2016-10-01,middle-tennessee-state,@,North Texas,W (30-13),24,45,53.3,295,2,32,182,5.7,1,77,477,6.2,13,7,4,24,9,79,0,1,1
3856,6,2016-10-15,middle-tennessee-state,,Western Kentucky,L (43-44),42,54,77.8,434,3,32,171,5.3,2,86,605,7.0,22,7,3,32,4,30,0,1,1
3857,7,2016-10-22,middle-tennessee-state,@,Missouri,W (51-45),24,42,57.1,284,4,39,316,8.1,2,81,600,7.4,11,11,5,27,9,65,0,0,0
3858,8,2016-10-29,middle-tennessee-state,@,Florida International,W (42-35),22,35,62.9,332,4,19,134,7.1,1,54,466,8.6,13,10,0,23,2,30,0,0,0
3859,9,2016-11-05,middle-tennessee-state,,Texas-San Antonio,L (25-45),22,38,57.9,259,2,28,110,3.9,1,66,369,5.6,9,9,1,19,4,32,1,3,4
3860,10,2016-11-12,middle-tennessee-state,@,Marshall,L (17-42),25,37,67.6,220,1,25,63,2.5,1,62,283,4.6,11,3,1,15,5,42,2,2,4
3861,11,2016-11-19,middle-tennessee-state,@,UNC Charlotte,W (38-31),26,44,59.1,250,4,30,221,7.4,1,74,471,6.4,12,8,1,21,8,90,0,2,2
3862,12,2016-11-26,middle-tennessee-state,,Florida Atlantic,W (77-56),11,16,68.8,262,1,57,495,8.7,9,73,757,10.4,10,18,0,28,3,22,0,0,0
3863,13,2016-12-24,middle-tennessee-state,N,Hawaii*,L (35-52),30,51,58.8,432,4,23,110,4.8,1,74,542,7.3,18,6,5,29,9,90,1,2,3
3864,,13 Games,middle-tennessee-state,,,,349,556,62.8,4236,39,416,2499,6.0,26,972,6735,6.9,183,114,26,323,78,730,6,15,21
3865,1,2017-09-02,middle-tennessee-state,,Vanderbilt,L (6-28),18,31,58.1,166,1,26,64,2.5,0,57,230,4.0,9,4,3,16,4,14,0,1,1
3866,2,2017-09-09,middle-tennessee-state,@,Syracuse,W (30-23),22,36,61.1,269,3,33,94,2.8,1,69,363,5.3,11,7,2,20,9,113,2,1,3
3867,3,2017-09-16,middle-tennessee-state,@,Minnesota,L (3-34),25,42,59.5,184,0,15,46,3.1,0,57,230,4.0,9,2,0,11,6,45,0,2,2
3868,4,2017-09-23,middle-tennessee-state,,Bowling Green State,W (24-13),24,32,75.0,290,2,43,243,5.7,1,75,533,7.1,14,12,1,27,3,23,2,1,3
3869,5,2017-09-30,middle-tennessee-state,@,Florida Atlantic,L (20-38),32,52,61.5,385,2,24,69,2.9,0,76,454,6.0,18,3,2,23,7,64,0,3,3
3870,6,2017-10-07,middle-tennessee-state,,Florida International,W (37-17),25,31,80.6,250,1,34,176,5.2,3,65,426,6.6,14,12,2,25,4,35,0,0,0
3871,7,2017-10-14,middle-tennessee-state,@,Alabama-Birmingham,L (23-25),24,44,54.5,263,1,32,131,4.1,0,76,394,5.2,14,9,3,26,10,88,0,2,2
3872,8,2017-10-20,middle-tennessee-state,,Marshall,L (10-38),14,33,42.4,220,1,31,53,1.7,0,64,273,4.3,8,3,4,15,5,60,1,1,2
3873,9,2017-11-04,middle-tennessee-state,,Texas-El Paso,W (30-3),13,30,43.3,190,3,36,210,5.8,1,66,400,6.1,7,9,2,18,9,92,0,1,1
3874,10,2017-11-11,middle-tennessee-state,@,UNC Charlotte,W (35-21),18,31,58.1,255,3,41,202,4.9,2,72,457,6.3,7,12,2,21,9,85,0,0,0
3875,11,2017-11-17,middle-tennessee-state,@,Western Kentucky,L (38-41),27,46,58.7,294,1,33,137,4.2,3,79,431,5.5,13,11,3,27,5,68,1,0,1
3876,12,2017-11-25,middle-tennessee-state,,Old Dominion,W (41-10),21,30,70.0,266,3,50,320,6.4,2,80,586,7.3,13,15,2,30,4,50,0,2,2
3877,13,2017-12-16,middle-tennessee-state,N,Arkansas State*,W (35-30),19,35,54.3,232,2,29,120,4.1,2,64,352,5.5,10,5,2,17,10,87,0,3,3
3878,,13 Games,middle-tennessee-state,,,,282,473,59.6,3264,23,427,1865,4.4,15,900,5129,5.7,147,104,28,276,85,824,6,17,23
3879,1,2018-09-01,middle-tennessee-state,@,Vanderbilt,L (7-35),24,36,66.7,178,1,36,116,3.2,0,72,294,4.1,8,10,3,21,6,40,1,1,2
3880,2,2018-09-08,middle-tennessee-state,,Tennessee-Martin,W (61-37),23,32,71.9,396,5,32,79,2.5,2,64,475,7.4,14,5,1,20,6,68,1,0,1
3881,3,2018-09-15,middle-tennessee-state,@,Georgia,L (7-49),20,30,66.7,130,1,38,158,4.2,0,68,288,4.2,4,10,0,14,3,35,1,1,2
3882,4,2018-09-29,middle-tennessee-state,,Florida Atlantic,W (25-24),27,40,67.5,259,1,36,137,3.8,2,76,396,5.2,14,8,0,22,3,29,1,1,2
3883,5,2018-10-05,middle-tennessee-state,@,Marshall,W (34-24),25,40,62.5,317,2,35,103,2.9,2,75,420,5.6,13,8,4,25,11,127,1,0,1
3884,6,2018-10-13,middle-tennessee-state,@,Florida International,L (21-24),15,27,55.6,142,0,40,187,4.7,3,67,329,4.9,8,11,2,21,5,52,0,1,1
3885,7,2018-10-20,middle-tennessee-state,,UNC Charlotte,W (21-13),14,20,70.0,111,3,32,33,1.0,0,52,144,2.8,6,3,0,9,2,20,1,1,2
3886,8,2018-10-27,middle-tennessee-state,@,Old Dominion,W (51-17),25,33,75.8,280,2,38,208,5.5,3,71,488,6.9,12,9,5,26,5,38,0,1,1
3887,9,2018-11-02,middle-tennessee-state,,Western Kentucky,W (29-10),24,42,57.1,228,2,43,256,6.0,0,85,484,5.7,12,13,2,27,3,34,0,0,0
3888,10,2018-11-10,middle-tennessee-state,@,Texas-El Paso,W (48-32),31,40,77.5,352,4,36,139,3.9,2,76,491,6.5,13,8,0,21,6,63,2,0,2
3889,11,2018-11-17,middle-tennessee-state,@,Kentucky,L (23-34),30,33,90.9,293,3,38,99,2.6,0,71,392,5.5,14,8,2,24,6,57,1,1,2
3890,,11 Games,middle-tennessee-state,,,,258,373,69.2,2686,24,404,1515,3.8,14,777,4201,5.4,118,93,19,230,56,563,9,7,16
3891,1,2014-08-30,marshall,@,Miami (OH),W (42-27),20,32,62.5,261,3,36,171,4.8,3,68,432,6.4,13,4,3,20,9,98,1,0,1
3892,2,2014-09-06,marshall,,Rhode Island,W (48-7),18,35,51.4,292,2,46,432,9.4,4,81,724,8.9,11,18,0,29,8,64,3,0,3
3893,3,2014-09-13,marshall,,Ohio,W (44-14),20,33,60.6,448,4,46,257,5.6,1,79,705,8.9,14,16,1,31,7,60,0,1,1
3894,4,2014-09-20,marshall,@,Akron,W (48-17),20,38,52.6,242,1,38,284,7.5,5,76,526,6.9,11,13,4,28,20,188,0,1,1
3895,5,2014-10-04,marshall,@,Old Dominion,W (56-14),21,27,77.8,237,2,50,354,7.1,5,77,591,7.7,13,15,0,28,6,54,1,2,3
3896,6,2014-10-11,marshall,,Middle Tennessee State,W (49-24),17,33,51.5,337,3,52,252,4.8,4,85,589,6.9,12,12,4,28,8,101,1,1,2
3897,7,2014-10-18,marshall,@,Florida International,W (45-13),15,27,55.6,214,4,26,243,9.3,1,53,457,8.6,10,6,2,18,9,65,0,1,1
3898,8,2014-10-25,marshall,,Florida Atlantic,W (35-16),13,24,54.2,218,1,35,328,9.4,4,59,546,9.3,9,9,2,20,6,60,0,0,0
3899,9,2014-11-08,marshall,@,Southern Mississippi,W (63-17),13,19,68.4,186,2,38,335,8.8,7,57,521,9.1,10,13,2,25,7,80,0,0,0
3900,10,2014-11-15,marshall,,Rice,W (41-14),23,37,62.2,297,4,44,284,6.5,1,81,581,7.2,17,13,0,30,7,70,1,1,2
3901,11,2014-11-22,marshall,@,Alabama-Birmingham,W (23-18),20,39,51.3,284,2,39,231,5.9,0,78,515,6.6,13,9,2,24,11,90,1,1,2
3902,12,2014-11-28,marshall,,Western Kentucky,L (66-67),29,46,63.0,417,7,36,291,8.1,2,82,708,8.6,19,17,1,37,6,59,0,4,4
3903,13,2014-12-06,marshall,,Louisiana Tech,W (26-23),25,46,54.3,308,2,35,121,3.5,0,81,429,5.3,16,4,0,20,9,75,3,1,4
3904,14,2014-12-23,marshall,N,Northern Illinois*,W (52-23),25,37,67.6,281,3,38,224,5.9,3,75,505,6.7,15,12,1,28,6,60,0,0,0
3905,,14 Games,marshall,,,,279,473,59.0,4022,40,559,3807,6.8,40,1032,7829,7.6,183,161,22,366,119,1124,11,13,24
3906,1,2015-09-06,marshall,,Purdue,W (41-31),23,36,63.9,234,2,29,163,5.6,1,65,397,6.1,11,5,4,20,6,57,2,1,3
3907,2,2015-09-12,marshall,@,Ohio,L (10-21),16,33,48.5,106,0,25,157,6.3,1,58,263,4.5,5,4,1,10,16,150,2,2,4
3908,3,2015-09-19,marshall,,Norfolk State,W (45-7),25,34,73.5,279,4,43,216,5.0,2,77,495,6.4,15,14,0,29,5,60,1,1,2
3909,4,2015-09-26,marshall,@,Kent State,W (36-29),14,36,38.9,151,2,44,126,2.9,2,80,277,3.5,9,5,3,17,4,45,1,2,3
3910,5,2015-10-03,marshall,,Old Dominion,W (27-7),21,35,60.0,212,2,40,112,2.8,1,75,324,4.3,9,7,1,17,7,77,2,0,2
3911,6,2015-10-09,marshall,,Southern Mississippi,W (31-10),11,21,52.4,163,2,35,114,3.3,1,56,277,4.9,6,7,1,14,8,96,0,1,1
3912,7,2015-10-17,marshall,@,Florida Atlantic,W (33-17),17,28,60.7,174,1,47,326,6.9,3,75,500,6.7,11,13,2,26,3,15,0,1,1
3913,8,2015-10-24,marshall,,North Texas,W (30-13),19,34,55.9,189,1,43,213,5.0,2,77,402,5.2,7,11,3,21,4,50,0,0,0
3914,9,2015-10-31,marshall,@,UNC Charlotte,W (34-10),35,53,66.0,494,2,39,136,3.5,2,92,630,6.8,21,8,2,31,14,100,0,0,0
3915,10,2015-11-07,marshall,@,Middle Tennessee State,L (24-27),35,58,60.3,376,3,45,139,3.1,0,103,515,5.0,18,9,3,30,11,86,0,1,1
3916,11,2015-11-14,marshall,,Florida International,W (52-0),17,26,65.4,174,3,39,289,7.4,3,65,463,7.1,8,16,2,26,3,14,1,1,2
3917,12,2015-11-27,marshall,@,Western Kentucky,L (28-49),20,41,48.8,242,2,25,31,1.2,1,66,273,4.1,11,3,2,16,6,65,2,2,4
3918,13,2015-12-26,marshall,N,Connecticut*,W (16-10),23,36,63.9,218,1,41,171,4.2,0,77,389,5.1,13,10,1,24,4,45,0,1,1
3919,,13 Games,marshall,,,,276,471,58.6,3012,25,495,2193,4.4,19,966,5205,5.4,144,112,25,281,91,860,11,13,24
3920,1,2016-09-10,marshall,,Morgan State,W (62-0),14,22,63.6,313,6,40,217,5.4,1,62,530,8.5,10,10,1,21,8,70,1,0,1
3921,2,2016-09-17,marshall,,Akron,L (38-65),33,59,55.9,446,4,38,114,3.0,1,97,560,5.8,17,8,6,31,17,180,1,3,4
3922,3,2016-09-24,marshall,,Louisville,L (28-59),9,21,42.9,59,2,43,148,3.4,1,64,207,3.2,2,10,4,16,9,95,1,1,2
3923,4,2016-10-01,marshall,@,Pittsburgh,L (27-43),20,32,62.5,240,2,30,104,3.5,2,62,344,5.5,7,9,2,18,5,67,0,1,1
3924,5,2016-10-08,marshall,@,North Texas,L (21-38),20,42,47.6,258,1,28,13,0.5,1,70,271,3.9,12,2,2,16,6,70,0,1,1
3925,6,2016-10-15,marshall,,Florida Atlantic,W (27-21),27,39,69.2,330,1,42,106,2.5,2,81,436,5.4,16,6,3,25,4,40,0,1,1
3926,7,2016-10-22,marshall,,UNC Charlotte,L (24-27),32,46,69.6,262,2,24,88,3.7,1,70,350,5.0,13,5,4,22,12,115,1,1,2
3927,8,2016-10-29,marshall,@,Southern Mississippi,L (14-24),20,34,58.8,166,1,25,60,2.4,1,59,226,3.8,8,2,1,11,5,65,0,0,0
3928,9,2016-11-05,marshall,@,Old Dominion,L (14-38),20,29,69.0,138,2,20,76,3.8,0,49,214,4.4,5,5,0,10,5,39,0,0,0
3929,10,2016-11-12,marshall,,Middle Tennessee State,W (42-17),21,37,56.8,246,4,41,207,5.0,2,78,453,5.8,13,13,3,29,3,35,0,0,0
3930,11,2016-11-19,marshall,@,Florida International,L (14-31),29,42,69.0,301,2,26,78,3.0,0,68,379,5.6,18,5,1,24,5,55,0,2,2
3931,12,2016-11-26,marshall,,Western Kentucky,L (6-60),19,35,54.3,143,1,39,87,2.2,0,74,230,3.1,4,10,4,18,11,90,0,2,2
3932,,12 Games,marshall,,,,264,438,60.3,2902,28,396,1298,3.3,12,834,4200,5.0,125,85,31,241,90,921,4,12,16
3933,1,2017-09-02,marshall,,Miami (OH),W (31-26),20,30,66.7,208,1,25,59,2.4,0,55,267,4.9,8,5,2,15,6,43,1,1,2
3934,2,2017-09-09,marshall,@,North Carolina State,L (20-37),26,43,60.5,350,2,25,101,4.0,0,68,451,6.6,13,5,0,18,9,86,1,1,2
3935,3,2017-09-16,marshall,,Kent State,W (21-0),23,43,53.5,223,1,33,158,4.8,2,76,381,5.0,11,10,2,23,8,75,0,1,1
3936,4,2017-09-30,marshall,@,Cincinnati,W (38-21),21,34,61.8,233,4,44,133,3.0,1,78,366,4.7,12,5,5,22,6,85,1,0,1
3937,5,2017-10-07,marshall,@,UNC Charlotte,W (14-3),19,28,67.9,192,2,42,212,5.0,0,70,404,5.8,11,10,2,23,5,30,2,0,2
3938,6,2017-10-14,marshall,,Old Dominion,W (35-3),12,23,52.2,176,3,40,195,4.9,1,63,371,5.9,7,8,3,18,3,25,0,0,0
3939,7,2017-10-20,marshall,@,Middle Tennessee State,W (38-10),16,24,66.7,168,0,43,202,4.7,4,67,370,5.5,9,10,2,21,7,63,0,0,0
3940,8,2017-10-28,marshall,,Florida International,L (30-41),33,52,63.5,363,3,29,142,4.9,1,81,505,6.2,19,8,2,29,3,35,1,2,3
3941,9,2017-11-03,marshall,@,Florida Atlantic,L (25-30),20,39,51.3,253,2,41,128,3.1,1,80,381,4.8,11,6,4,21,7,37,0,4,4
3942,10,2017-11-11,marshall,,Western Kentucky,W (30-23),17,28,60.7,190,0,49,144,2.9,2,77,334,4.3,10,11,1,22,7,69,0,1,1
3943,11,2017-11-18,marshall,@,Texas-San Antonio,L (7-9),16,23,69.6,189,1,23,40,1.7,0,46,229,5.0,9,2,1,12,7,70,1,1,2
3944,12,2017-11-25,marshall,,Southern Mississippi,L (27-28),26,44,59.1,308,4,26,74,2.8,0,70,382,5.5,12,6,5,23,6,52,2,1,3
3945,13,2017-12-16,marshall,N,Colorado State*,W (31-28),17,32,53.1,262,2,33,239,7.2,2,65,501,7.7,10,8,0,18,11,107,0,2,2
3946,,13 Games,marshall,,,,266,443,60.0,3115,25,453,1827,4.0,14,896,4942,5.5,142,94,29,265,85,777,9,14,23
3947,1,2018-09-01,marshall,@,Miami (OH),W (35-28),24,37,64.9,272,2,38,171,4.5,3,75,443,5.9,11,11,2,24,7,62,0,0,0
3948,2,2018-09-08,marshall,,Eastern Kentucky,W (32-16),23,39,59.0,278,3,28,89,3.2,1,67,367,5.5,10,6,1,17,8,70,3,1,4
3949,3,2018-09-22,marshall,,North Carolina State,L (20-37),22,43,51.2,270,1,22,54,2.5,0,65,324,5.0,11,3,1,15,4,20,1,2,3
3950,4,2018-09-29,marshall,@,Western Kentucky,W (20-17),18,39,46.2,288,2,33,113,3.4,0,72,401,5.6,11,6,0,17,6,70,1,3,4
3951,5,2018-10-05,marshall,,Middle Tennessee State,L (24-34),17,35,48.6,173,2,53,209,3.9,1,88,382,4.3,9,14,5,28,6,59,2,1,3
3952,6,2018-10-13,marshall,@,Old Dominion,W (42-20),18,29,62.1,182,1,45,319,7.1,5,74,501,6.8,9,13,2,24,8,101,0,1,1
3953,7,2018-10-20,marshall,,Florida Atlantic,W (31-7),13,24,54.2,102,2,48,233,4.9,2,72,335,4.7,4,14,0,18,5,55,0,0,0
3954,8,2018-11-03,marshall,@,Southern Mississippi,L (24-26),17,38,44.7,218,1,22,31,1.4,1,60,249,4.2,9,4,2,15,7,79,3,2,5
3955,9,2018-11-10,marshall,,UNC Charlotte,W (30-13),15,26,57.7,178,1,38,147,3.9,2,64,325,5.1,8,8,0,16,3,20,1,0,1
3956,10,2018-11-17,marshall,,Texas-San Antonio,W (23-0),19,36,52.8,387,2,37,118,3.2,0,73,505,6.9,14,6,2,22,6,49,0,0,0
3957,,10 Games,marshall,,,,186,346,53.8,2348,17,364,1484,4.1,15,710,3832,5.4,96,85,15,196,60,585,11,10,21
3958,1,2014-08-30,florida-atlantic,@,Nebraska,L (7-55),11,30,36.7,95,1,30,105,3.5,0,60,200,3.3,5,7,1,13,3,22,0,0,0
3959,2,2014-09-06,florida-atlantic,@,Alabama,L (0-41),12,19,63.2,88,0,24,57,2.4,0,43,145,3.4,4,3,2,9,3,23,1,0,1
3960,3,2014-09-13,florida-atlantic,,Tulsa,W (50-21),18,23,78.3,341,4,42,177,4.2,1,65,518,8.0,11,7,0,18,4,37,0,0,0
3961,4,2014-09-20,florida-atlantic,@,Wyoming,L (19-20),15,29,51.7,108,0,39,188,4.8,1,68,296,4.4,5,10,1,16,4,23,3,0,3
3962,5,2014-09-27,florida-atlantic,,Texas-San Antonio,W (41-37),24,34,70.6,295,3,33,114,3.5,2,67,409,6.1,14,9,2,25,5,52,2,0,2
3963,6,2014-10-02,florida-atlantic,@,Florida International,L (10-38),19,42,45.2,225,0,30,158,5.3,1,72,383,5.3,13,7,2,22,4,40,3,1,4
3964,7,2014-10-18,florida-atlantic,,Western Kentucky,W (45-38),24,35,68.6,341,3,54,278,5.1,3,89,619,7.0,18,10,1,29,6,59,1,0,1
3965,8,2014-10-25,florida-atlantic,@,Marshall,L (16-35),19,37,51.4,179,1,53,209,3.9,0,90,388,4.3,10,15,1,26,3,45,0,0,0
3966,9,2014-11-01,florida-atlantic,,Alabama-Birmingham,L (28-31),18,31,58.1,177,3,29,145,5.0,1,60,322,5.4,8,7,1,16,3,30,1,1,2
3967,10,2014-11-08,florida-atlantic,@,North Texas,L (10-31),15,31,48.4,102,1,32,95,3.0,0,63,197,3.1,4,7,1,12,7,55,1,1,2
3968,11,2014-11-22,florida-atlantic,@,Middle Tennessee State,L (34-35),22,35,62.9,310,2,41,230,5.6,2,76,540,7.1,11,9,0,20,2,19,0,2,2
3969,12,2014-11-29,florida-atlantic,,Old Dominion,L (28-31),9,19,47.4,133,0,36,207,5.8,3,55,340,6.2,5,9,0,14,7,69,1,0,1
3970,,12 Games,florida-atlantic,,,,206,365,56.4,2394,18,443,1963,4.4,14,808,4357,5.4,108,100,12,220,51,474,13,5,18
3971,1,2015-09-05,florida-atlantic,@,Tulsa,L (44-47),23,35,65.7,263,2,61,300,4.9,3,96,563,5.9,11,19,0,30,13,130,0,0,0
3972,2,2015-09-11,florida-atlantic,,Miami (FL),L (20-44),19,34,55.9,166,1,33,223,6.8,1,67,389,5.8,8,12,2,22,8,71,3,2,5
3973,3,2015-09-19,florida-atlantic,,Buffalo,L (15-33),26,56,46.4,385,2,34,105,3.1,0,90,490,5.4,15,9,3,27,5,35,3,2,5
3974,4,2015-09-26,florida-atlantic,@,UNC Charlotte,W (17-7),14,25,56.0,144,0,48,40,0.8,1,73,184,2.5,8,3,2,13,6,44,3,2,5
3975,5,2015-10-10,florida-atlantic,,Rice,L (26-27),15,29,51.7,249,2,32,142,4.4,1,61,391,6.4,9,5,5,19,5,50,0,0,0
3976,6,2015-10-17,florida-atlantic,,Marshall,L (17-33),14,31,45.2,203,0,34,131,3.9,1,65,334,5.1,8,9,0,17,5,30,0,1,1
3977,7,2015-10-24,florida-atlantic,@,Texas-El Paso,L (17-27),14,23,60.9,219,0,30,146,4.9,2,53,365,6.9,10,2,3,15,5,60,2,1,3
3978,8,2015-10-31,florida-atlantic,,Florida International,W (31-17),16,25,64.0,168,0,49,229,4.7,3,74,397,5.4,9,17,1,27,6,60,0,0,0
3979,9,2015-11-07,florida-atlantic,@,Western Kentucky,L (19-35),14,33,42.4,185,2,43,174,4.0,0,76,359,4.7,9,11,3,23,3,24,0,0,0
3980,10,2015-11-14,florida-atlantic,,Middle Tennessee State,L (17-24),13,27,48.1,222,2,34,75,2.2,0,61,297,4.9,8,5,1,14,6,63,0,1,1
3981,11,2015-11-21,florida-atlantic,@,Florida,L (14-20),20,39,51.3,159,1,45,140,3.1,0,84,299,3.6,6,11,1,18,7,55,2,1,3
3982,12,2015-11-28,florida-atlantic,@,Old Dominion,W (33-31),17,35,48.6,188,0,54,248,4.6,3,89,436,4.9,11,11,1,23,6,64,0,2,2
3983,,12 Games,florida-atlantic,,,,205,392,52.3,2551,12,497,1953,3.9,15,889,4504,5.1,112,114,22,248,75,686,13,12,25
3984,1,2016-09-03,florida-atlantic,,Southern Illinois,W (38-30),23,31,74.2,282,2,45,170,3.8,3,76,452,5.9,9,8,2,19,5,45,0,0,0
3985,2,2016-09-10,florida-atlantic,@,Miami (FL),L (10-38),18,37,48.6,167,0,34,47,1.4,1,71,214,3.0,7,4,2,13,6,45,0,1,1
3986,3,2016-09-17,florida-atlantic,@,Kansas State,L (7-63),15,28,53.6,129,0,37,82,2.2,1,65,211,3.2,4,8,1,13,10,93,2,2,4
3987,4,2016-09-24,florida-atlantic,,Ball State,L (27-31),25,37,67.6,324,1,36,121,3.4,2,73,445,6.1,12,8,0,20,2,20,1,1,2
3988,5,2016-10-01,florida-atlantic,@,Florida International,L (31-33),9,21,42.9,92,1,36,236,6.6,2,57,328,5.8,5,12,0,17,4,35,1,0,1
3989,6,2016-10-09,florida-atlantic,,UNC Charlotte,L (23-28),22,42,52.4,212,0,41,174,4.2,3,83,386,4.7,13,11,2,26,3,25,0,1,1
3990,7,2016-10-15,florida-atlantic,@,Marshall,L (21-27),11,20,55.0,175,0,45,281,6.2,3,65,456,7.0,7,16,1,24,5,65,1,1,2
3991,8,2016-10-29,florida-atlantic,,Western Kentucky,L (3-52),15,34,44.1,77,0,33,125,3.8,0,67,202,3.0,4,6,2,12,1,10,1,1,2
3992,9,2016-11-05,florida-atlantic,@,Rice,W (42-25),16,26,61.5,321,2,40,340,8.5,4,66,661,10.0,10,15,1,26,13,122,0,0,0
3993,10,2016-11-12,florida-atlantic,,Texas-El Paso,W (35-31),20,27,74.1,233,1,36,243,6.8,3,63,476,7.6,11,13,2,26,5,45,1,2,3
3994,11,2016-11-19,florida-atlantic,,Old Dominion,L (24-42),15,28,53.6,219,0,34,144,4.2,3,62,363,5.9,10,6,0,16,8,62,0,0,0
3995,12,2016-11-26,florida-atlantic,@,Middle Tennessee State,L (56-77),26,35,74.3,290,2,53,299,5.6,6,88,589,6.7,17,17,1,35,1,10,0,4,4
3996,,12 Games,florida-atlantic,,,,215,366,58.7,2521,9,470,2262,4.8,31,836,4783,5.7,109,124,14,247,63,577,7,13,20
3997,1,2017-09-01,florida-atlantic,,Navy,L (19-42),21,33,63.6,286,2,24,40,1.7,0,57,326,5.7,8,7,1,16,4,20,0,2,2
3998,2,2017-09-09,florida-atlantic,@,Wisconsin,L (14-31),9,19,47.4,142,1,35,106,3.0,1,54,248,4.6,4,5,0,9,8,73,0,0,0
3999,3,2017-09-16,florida-atlantic,,Bethune-Cookman,W (45-0),19,32,59.4,180,1,58,439,7.6,4,90,619,6.9,6,22,4,32,8,83,1,1,2
4000,4,2017-09-23,florida-atlantic,@,Buffalo,L (31-34),17,29,58.6,150,0,37,262,7.1,4,66,412,6.2,7,15,0,22,8,65,0,1,1
4001,5,2017-09-30,florida-atlantic,,Middle Tennessee State,W (38-20),22,29,75.9,187,1,50,252,5.0,4,79,439,5.6,10,17,2,29,4,27,0,0,0
4002,6,2017-10-07,florida-atlantic,@,Old Dominion,W (58-28),13,22,59.1,97,0,69,453,6.6,8,91,550,6.0,5,23,1,29,5,65,1,1,2
4003,7,2017-10-21,florida-atlantic,,North Texas,W (69-31),24,35,68.6,357,2,48,447,9.3,7,83,804,9.7,16,18,3,37,5,39,0,0,0
4004,8,2017-10-28,florida-atlantic,@,Western Kentucky,W (42-28),10,24,41.7,93,1,55,368,6.7,4,79,461,5.8,3,17,1,21,9,75,0,1,1
4005,9,2017-11-03,florida-atlantic,,Marshall,W (30-25),12,18,66.7,164,1,45,189,4.2,3,63,353,5.6,6,11,0,17,5,60,0,0,0
4006,10,2017-11-11,florida-atlantic,@,Louisiana Tech,W (48-23),14,17,82.4,221,2,33,194,5.9,4,50,415,8.3,7,11,1,19,2,22,1,0,1
4007,11,2017-11-18,florida-atlantic,,Florida International,W (52-24),18,25,72.0,239,4,46,333,7.2,3,71,572,8.1,9,16,2,27,8,64,0,1,1
4008,12,2017-11-25,florida-atlantic,@,UNC Charlotte,W (31-12),18,22,81.8,245,2,63,316,5.0,2,85,561,6.6,11,19,1,31,1,15,2,0,2
4009,13,2017-12-02,florida-atlantic,,North Texas,W (41-17),18,30,60.0,352,2,42,281,6.7,3,72,633,8.8,11,9,2,22,9,73,1,0,1
4010,14,2017-12-19,florida-atlantic,,Akron*,W (50-3),19,26,73.1,270,2,60,312,5.2,5,86,582,6.8,8,19,2,29,6,52,0,0,0
4011,,14 Games,florida-atlantic,,,,234,361,64.8,2983,21,665,3992,6.0,52,1026,6975,6.8,111,209,20,340,82,733,6,7,13
4012,1,2018-09-01,florida-atlantic,@,Oklahoma,L (14-63),18,32,56.3,192,0,42,132,3.1,2,74,324,4.4,11,7,2,20,6,48,0,1,1
4013,2,2018-09-08,florida-atlantic,,Air Force,W (33-27),33,40,82.5,471,3,29,54,1.9,1,69,525,7.6,21,3,1,25,8,87,1,0,1
4014,3,2018-09-15,florida-atlantic,,Bethune-Cookman,W (49-28),19,30,63.3,183,1,61,376,6.2,6,91,559,6.1,7,20,0,27,6,69,0,2,2
4015,4,2018-09-21,florida-atlantic,@,Central Florida,L (36-56),14,27,51.9,127,1,50,320,6.4,4,77,447,5.8,5,18,2,25,7,73,0,3,3
4016,5,2018-09-29,florida-atlantic,@,Middle Tennessee State,L (24-25),17,28,60.7,154,0,55,272,4.9,3,83,426,5.1,8,12,2,22,8,54,1,1,2
4017,6,2018-10-06,florida-atlantic,,Old Dominion,W (52-33),21,32,65.6,339,2,40,266,6.7,5,72,605,8.4,15,13,0,28,8,84,0,0,0
4018,7,2018-10-20,florida-atlantic,@,Marshall,L (7-31),20,42,47.6,240,1,37,119,3.2,0,79,359,4.5,9,6,1,16,8,69,1,4,5
4019,8,2018-10-26,florida-atlantic,,Louisiana Tech,L (13-21),17,29,58.6,121,0,38,227,6.0,1,67,348,5.2,6,14,3,23,11,77,1,1,2
4020,9,2018-11-03,florida-atlantic,@,Florida International,W (49-14),10,16,62.5,157,2,60,439,7.3,5,76,596,7.8,5,23,3,30,5,55,0,0,0
4021,10,2018-11-10,florida-atlantic,,Western Kentucky,W (34-15),20,25,80.0,261,0,58,315,5.4,4,83,576,6.9,10,18,0,28,6,70,1,1,2
4022,11,2018-11-15,florida-atlantic,@,North Texas,L (38-41),21,35,60.0,294,2,47,195,4.1,3,82,489,6.0,9,10,1,20,5,58,0,2,2
4023,,11 Games,florida-atlantic,,,,210,336,62.5,2539,12,517,2715,5.3,34,853,5254,6.2,106,144,15,264,78,744,5,15,20
4024,1,2014-08-30,north-texas,@,Texas,L (7-38),3,17,17.6,15,0,43,79,1.8,0,60,94,1.6,0,6,2,8,6,56,0,4,4
4025,2,2014-09-06,north-texas,,Southern Methodist,W (43-6),12,17,70.6,108,0,55,245,4.5,3,72,353,4.9,6,11,0,17,15,166,0,0,0
4026,3,2014-09-11,north-texas,,Louisiana Tech,L (21-42),18,34,52.9,175,0,36,104,2.9,3,70,279,4.0,7,7,4,18,9,90,2,0,2
4027,4,2014-09-20,north-texas,,Nicholls State,W (77-3),13,17,76.5,202,3,38,324,8.5,5,55,526,9.6,7,13,0,20,5,40,1,0,1
4028,5,2014-10-04,north-texas,@,Indiana,L (24-49),18,34,52.9,205,3,35,143,4.1,0,69,348,5.0,9,12,1,22,2,10,0,2,2
4029,6,2014-10-11,north-texas,@,Alabama-Birmingham,L (21-56),20,36,55.6,291,2,43,160,3.7,1,79,451,5.7,12,12,0,24,3,30,3,2,5
4030,7,2014-10-18,north-texas,,Southern Mississippi,L (20-30),20,35,57.1,287,0,26,108,4.2,2,61,395,6.5,11,6,4,21,4,55,0,0,0
4031,8,2014-10-25,north-texas,@,Rice,L (21-41),16,34,47.1,190,1,33,26,0.8,1,67,216,3.2,7,6,3,16,4,40,1,1,2
4032,9,2014-11-08,north-texas,,Florida Atlantic,W (31-10),13,17,76.5,107,1,52,235,4.5,3,69,342,5.0,5,13,1,19,3,35,1,1,2
4033,10,2014-11-15,north-texas,@,Texas-El Paso,L (17-35),15,27,55.6,101,1,30,100,3.3,1,57,201,3.5,6,4,3,13,5,25,0,1,1
4034,11,2014-11-22,north-texas,,Florida International,W (17-14),9,20,45.0,105,1,44,161,3.7,1,64,266,4.2,5,8,3,16,2,30,0,2,2
4035,12,2014-11-29,north-texas,@,Texas-San Antonio,L (27-34),24,43,55.8,287,1,37,150,4.1,1,80,437,5.5,11,8,0,19,5,53,1,0,1
4036,,12 Games,north-texas,,,,181,331,54.7,2073,13,472,1835,3.9,21,803,3908,4.9,86,106,21,213,63,630,9,13,22
4037,1,2015-09-12,north-texas,@,Southern Methodist,L (13-31),16,34,47.1,128,0,33,112,3.4,1,67,240,3.6,7,7,3,17,7,73,2,2,4
4038,2,2015-09-19,north-texas,,Rice,L (24-38),19,35,54.3,303,2,27,175,6.5,1,62,478,7.7,13,6,1,20,4,45,2,1,3
4039,3,2015-09-26,north-texas,@,Iowa,L (16-62),17,43,39.5,173,1,45,183,4.1,0,88,356,4.0,8,14,0,22,8,62,1,2,3
4040,4,2015-10-03,north-texas,@,Southern Mississippi,L (14-49),14,32,43.8,201,1,49,185,3.8,1,81,386,4.8,7,14,5,26,5,40,0,1,1
4041,5,2015-10-10,north-texas,,Portland State,L (7-66),16,41,39.0,122,1,31,76,2.5,0,72,198,2.8,4,7,2,13,8,74,1,0,1
4042,6,2015-10-15,north-texas,,Western Kentucky,L (28-55),17,35,48.6,228,4,35,203,5.8,0,70,431,6.2,9,13,0,22,5,37,1,1,2
4043,7,2015-10-24,north-texas,@,Marshall,L (13-30),15,37,40.5,128,1,40,209,5.2,0,77,337,4.4,5,14,3,22,5,28,0,1,1
4044,8,2015-10-31,north-texas,,Texas-San Antonio,W (30-23),11,22,50.0,104,0,38,267,7.0,3,60,371,6.2,7,12,1,20,8,79,1,0,1
4045,9,2015-11-07,north-texas,@,Louisiana Tech,L (13-56),25,45,55.6,234,2,36,82,2.3,0,81,316,3.9,11,9,0,20,3,35,3,1,4
4046,10,2015-11-14,north-texas,@,Tennessee,L (0-24),13,26,50.0,107,0,32,92,2.9,0,58,199,3.4,8,6,0,14,5,35,0,0,0
4047,11,2015-11-21,north-texas,@,Middle Tennessee State,L (7-41),17,28,60.7,133,0,39,191,4.9,1,67,324,4.8,3,15,0,18,6,52,2,1,3
4048,12,2015-11-28,north-texas,,Texas-El Paso,L (17-20),10,29,34.5,76,0,31,129,4.2,0,60,205,3.4,1,8,1,10,10,120,1,1,2
4049,,12 Games,north-texas,,,,190,407,46.7,1937,12,436,1904,4.4,7,843,3841,4.6,83,125,16,224,74,680,14,11,25
4050,1,2016-09-03,north-texas,,Southern Methodist,L (21-34),32,50,64.0,311,2,29,83,2.9,1,79,394,5.0,20,5,1,26,6,68,0,3,3
4051,2,2016-09-10,north-texas,,Bethune-Cookman,W (41-20),15,33,45.5,121,0,51,329,6.5,4,84,450,5.4,7,18,3,28,4,48,0,1,1
4052,3,2016-09-17,north-texas,@,Florida,L (0-32),6,22,27.3,66,0,28,-13,-0.5,0,50,53,1.1,3,2,3,8,7,70,0,1,1
4053,4,2016-09-24,north-texas,@,Rice,W (42-35),17,29,58.6,224,1,42,215,5.1,5,71,439,6.2,9,8,2,19,10,70,1,0,1
4054,5,2016-10-01,north-texas,,Middle Tennessee State,L (13-30),33,54,61.1,303,1,22,5,0.2,1,76,308,4.1,11,3,2,16,9,90,0,0,0
4055,6,2016-10-08,north-texas,,Marshall,W (38-21),18,28,64.3,206,1,54,252,4.7,3,82,458,5.6,10,11,2,23,10,78,2,0,2
4056,7,2016-10-22,north-texas,@,Army,W (35-18),9,17,52.9,118,1,33,202,6.1,3,50,320,6.4,6,7,2,15,10,91,0,1,1
4057,8,2016-10-29,north-texas,@,Texas-San Antonio,L (17-31),27,38,71.1,257,1,34,152,4.5,1,72,409,5.7,12,8,2,22,2,25,2,2,4
4058,9,2016-11-05,north-texas,,Louisiana Tech,L (24-45),23,34,67.6,207,1,30,82,2.7,2,64,289,4.5,10,7,1,18,10,99,0,1,1
4059,10,2016-11-12,north-texas,@,Western Kentucky,L (7-45),17,33,51.5,117,0,20,115,5.8,1,53,232,4.4,4,3,0,7,8,66,1,1,2
4060,11,2016-11-19,north-texas,,Southern Mississippi,W (29-23),14,29,48.3,267,2,29,111,3.8,1,58,378,6.5,9,6,3,18,12,95,2,1,3
4061,12,2016-11-26,north-texas,@,Texas-El Paso,L (24-52),23,42,54.8,197,2,27,107,4.0,1,69,304,4.4,9,9,3,21,3,35,0,0,0
4062,13,2016-12-27,north-texas,N,Army*,L (31-38),27,40,67.5,314,3,27,96,3.6,1,67,410,6.1,11,7,1,19,6,55,0,2,2
4063,,13 Games,north-texas,,,,261,449,58.1,2708,15,426,1736,4.1,24,875,4444,5.1,121,94,25,240,97,890,8,13,21
4064,1,2017-09-02,north-texas,,Lamar,W (59-14),17,24,70.8,232,3,59,438,7.4,5,83,670,8.1,11,21,0,31,5,40,1,0,1
4065,2,2017-09-09,north-texas,@,Southern Methodist,L (32-54),32,47,68.1,424,3,27,69,2.6,1,74,493,6.7,17,4,1,22,7,58,1,2,3
4066,3,2017-09-16,north-texas,@,Iowa,L (14-31),18,29,62.1,193,1,17,112,6.6,1,46,305,6.6,10,5,2,17,13,119,1,1,2
4067,4,2017-09-23,north-texas,,Alabama-Birmingham,W (46-43),15,29,51.7,261,3,44,287,6.5,2,73,548,7.5,11,14,3,28,4,33,2,0,2
4068,5,2017-09-30,north-texas,@,Southern Mississippi,W (43-28),24,41,58.5,366,2,46,174,3.8,3,87,540,6.2,11,10,3,24,3,19,1,1,2
4069,6,2017-10-14,north-texas,,Texas-San Antonio,W (29-26),20,35,57.1,354,3,31,104,3.4,1,66,458,6.9,14,5,0,19,3,29,0,1,1
4070,7,2017-10-21,north-texas,@,Florida Atlantic,L (31-69),31,47,66.0,283,2,33,137,4.2,2,80,420,5.3,15,9,1,25,6,41,1,2,3
4071,8,2017-10-28,north-texas,,Old Dominion,W (45-38),25,36,69.4,309,1,41,151,3.7,4,77,460,6.0,15,8,1,24,3,45,1,1,2
4072,9,2017-11-04,north-texas,@,Louisiana Tech,W (24-23),23,37,62.2,211,1,41,204,5.0,2,78,415,5.3,10,15,1,26,4,45,0,1,1
4073,10,2017-11-11,north-texas,,Texas-El Paso,W (45-10),23,35,65.7,213,4,39,259,6.6,2,74,472,6.4,10,13,4,27,4,40,1,0,1
4074,11,2017-11-18,north-texas,,Army,W (52-49),24,36,66.7,386,4,33,103,3.1,3,69,489,7.1,13,9,3,25,1,1,0,1,1
4075,12,2017-11-25,north-texas,@,Rice,W (30-14),18,25,72.0,195,1,44,188,4.3,1,69,383,5.6,11,13,1,25,3,20,0,1,1
4076,13,2017-12-02,north-texas,@,Florida Atlantic,L (17-41),28,45,62.2,356,1,35,81,2.3,1,80,437,5.5,20,5,1,26,6,57,0,2,2
4077,14,2017-12-16,north-texas,N,Troy*,L (30-50),30,54,55.6,303,3,25,-8,-0.3,0,79,295,3.7,16,2,3,21,7,66,3,2,5
4078,,14 Games,north-texas,,,,328,520,63.1,4086,32,515,2299,4.5,28,1035,6385,6.2,184,133,24,340,69,613,12,15,27
4079,1,2018-09-01,north-texas,,Southern Methodist,W (46-23),41,51,80.4,461,3,43,68,1.6,0,94,529,5.6,27,5,2,34,5,40,0,0,0
4080,2,2018-09-08,north-texas,,Incarnate Word,W (58-16),32,49,65.3,454,4,42,153,3.6,3,91,607,6.7,19,9,4,32,5,61,0,1,1
4081,3,2018-09-15,north-texas,@,Arkansas,W (44-17),24,46,52.2,281,1,29,95,3.3,2,75,376,5.0,11,3,4,18,9,102,1,0,1
4082,4,2018-09-22,north-texas,@,Liberty,W (47-7),16,27,59.3,185,2,47,346,7.4,5,74,531,7.2,10,15,0,25,4,45,0,0,0
4083,5,2018-09-29,north-texas,,Louisiana Tech,L (27-29),22,35,62.9,296,3,37,131,3.5,1,72,427,5.9,13,9,1,23,4,55,2,0,2
4084,6,2018-10-06,north-texas,@,Texas-El Paso,W (27-24),23,34,67.6,294,2,35,134,3.8,1,69,428,6.2,12,8,1,21,3,40,0,0,0
4085,7,2018-10-13,north-texas,,Southern Mississippi,W (30-7),24,38,63.2,292,1,33,165,5.0,3,71,457,6.4,13,10,1,24,5,55,1,0,1
4086,8,2018-10-20,north-texas,@,Alabama-Birmingham,L (21-29),29,40,72.5,336,3,23,64,2.8,0,63,400,6.3,16,3,5,24,4,50,1,0,1
4087,9,2018-10-27,north-texas,,Rice,W (41-17),18,35,51.4,333,2,24,164,6.8,3,59,497,8.4,13,9,5,27,2,16,2,0,2
4088,10,2018-11-10,north-texas,@,Old Dominion,L (31-34),26,44,59.1,240,2,38,155,4.1,2,82,395,4.8,12,9,2,23,4,60,1,1,2
4089,11,2018-11-15,north-texas,,Florida Atlantic,W (41-38),23,35,65.7,303,2,37,208,5.6,3,72,511,7.1,14,8,3,25,4,40,0,2,2
4090,,11 Games,north-texas,,,,278,434,64.1,3475,25,388,1683,4.3,23,822,5158,6.3,160,88,28,276,49,564,8,4,12
4091,1,2014-09-06,old-dominion,@,North Carolina State,L (34-46),36,50,72.0,308,2,37,196,5.3,3,87,504,5.8,12,16,0,28,3,20,0,1,1
4092,2,2014-09-13,old-dominion,,Eastern Michigan,W (17-3),17,30,56.7,187,0,37,180,4.9,1,67,367,5.5,8,7,1,16,4,45,1,1,2
4093,3,2014-09-20,old-dominion,@,Rice,W (45-42),27,43,62.8,430,5,21,100,4.8,1,64,530,8.3,17,7,1,25,5,55,0,0,0
4094,4,2014-09-26,old-dominion,,Middle Tennessee State,L (28-41),29,44,65.9,362,4,19,41,2.2,0,63,403,6.4,16,5,3,24,2,25,1,3,4
4095,5,2014-10-04,old-dominion,,Marshall,L (14-56),10,25,40.0,85,1,42,201,4.8,1,67,286,4.3,4,10,1,15,1,9,0,1,1
4096,6,2014-10-11,old-dominion,@,Texas-El Paso,L (35-42),13,25,52.0,196,3,28,161,5.8,2,53,357,6.7,9,6,1,16,4,35,0,0,0
4097,7,2014-10-25,old-dominion,@,Western Kentucky,L (51-66),27,40,67.5,471,3,34,172,5.1,4,74,643,8.7,19,9,1,29,5,51,1,2,3
4098,8,2014-11-01,old-dominion,@,Vanderbilt,L (28-42),21,36,58.3,291,2,12,45,3.8,1,48,336,7.0,13,1,2,16,4,48,0,1,1
4099,9,2014-11-08,old-dominion,,Florida International,W (38-35),20,35,57.1,315,2,35,210,6.0,3,70,525,7.5,12,10,4,26,1,10,1,0,1
4100,10,2014-11-22,old-dominion,,Louisiana Tech,W (30-27),29,40,72.5,302,2,32,93,2.9,2,72,395,5.5,16,6,1,23,3,35,0,4,4
4101,11,2014-11-29,old-dominion,@,Florida Atlantic,W (31-28),32,50,64.0,282,3,32,206,6.4,1,82,488,6.0,16,5,5,26,8,77,0,1,1
4102,,11 Games,old-dominion,,,,261,418,62.4,3229,27,329,1605,4.9,19,747,4834,6.5,142,82,20,244,40,410,4,14,18
4103,1,2015-09-05,old-dominion,@,Eastern Michigan,W (38-34),18,32,56.3,184,1,41,229,5.6,4,73,413,5.7,10,11,4,25,6,75,0,0,0
4104,2,2015-09-12,old-dominion,,Norfolk State,W (24-10),12,22,54.5,122,0,59,338,5.7,3,81,460,5.7,7,17,0,24,6,51,0,1,1
4105,3,2015-09-19,old-dominion,,North Carolina State,L (14-38),11,23,47.8,151,2,21,-3,-0.1,0,44,148,3.4,4,2,2,8,0,0,0,0,0
4106,4,2015-09-26,old-dominion,,Appalachian State,L (0-49),16,28,57.1,133,0,21,42,2.0,0,49,175,3.6,5,3,0,8,7,59,2,2,4
4107,5,2015-10-03,old-dominion,@,Marshall,L (7-27),13,37,35.1,101,0,43,184,4.3,1,80,285,3.6,3,12,1,16,3,10,2,2,4
4108,6,2015-10-17,old-dominion,,UNC Charlotte,W (37-34),26,46,56.5,367,4,31,115,3.7,0,77,482,6.3,16,6,2,24,6,50,1,1,2
4109,7,2015-10-24,old-dominion,@,Florida International,L (12-41),18,34,52.9,201,0,33,297,9.0,2,67,498,7.4,9,11,0,20,6,41,2,1,3
4110,8,2015-10-31,old-dominion,,Western Kentucky,L (30-55),19,34,55.9,195,3,37,147,4.0,1,71,342,4.8,9,11,0,20,2,20,1,0,1
4111,9,2015-11-07,old-dominion,@,Texas-San Antonio,W (36-31),29,48,60.4,378,2,37,170,4.6,2,85,548,6.4,21,7,2,30,0,0,0,1,1
4112,10,2015-11-14,old-dominion,,Texas-El Paso,W (31-21),26,42,61.9,291,2,31,150,4.8,2,73,441,6.0,16,5,1,22,5,41,0,0,0
4113,11,2015-11-21,old-dominion,@,Southern Mississippi,L (31-56),23,45,51.1,224,3,23,114,5.0,0,68,338,5.0,12,5,1,18,4,50,1,1,2
4114,12,2015-11-28,old-dominion,,Florida Atlantic,L (31-33),24,42,57.1,287,3,24,38,1.6,1,66,325,4.9,12,1,2,15,4,40,1,0,1
4115,,12 Games,old-dominion,,,,235,433,54.3,2634,20,401,1821,4.5,16,834,4455,5.3,124,91,15,230,49,437,10,9,19
4116,1,2016-09-04,old-dominion,,Hampton,W (54-21),14,29,48.3,253,4,38,211,5.6,2,67,464,6.9,9,9,2,20,9,66,1,0,1
4117,2,2016-09-10,old-dominion,@,Appalachian State,L (7-31),17,36,47.2,169,0,31,157,5.1,1,67,326,4.9,9,5,4,18,5,45,0,1,1
4118,3,2016-09-17,old-dominion,@,North Carolina State,L (22-49),17,27,63.0,204,2,32,117,3.7,1,59,321,5.4,9,5,1,15,7,50,0,0,0
4119,4,2016-09-24,old-dominion,,Texas-San Antonio,W (33-19),21,35,60.0,207,2,45,238,5.3,3,80,445,5.6,12,9,6,27,3,30,0,0,0
4120,5,2016-10-01,old-dominion,@,UNC Charlotte,W (52-17),17,29,58.6,274,3,40,207,5.2,4,69,481,7.0,12,10,0,22,10,85,1,1,2
4121,6,2016-10-07,old-dominion,,Massachusetts,W (36-16),20,35,57.1,248,1,47,274,5.8,3,82,522,6.4,14,12,3,29,5,49,0,0,0
4122,7,2016-10-22,old-dominion,@,Western Kentucky,L (24-59),19,34,55.9,263,2,23,67,2.9,1,57,330,5.8,10,2,1,13,7,61,0,1,1
4123,8,2016-10-29,old-dominion,@,Texas-El Paso,W (31-21),14,22,63.6,262,2,30,131,4.4,2,52,393,7.6,9,6,0,15,5,52,0,1,1
4124,9,2016-11-05,old-dominion,,Marshall,W (38-14),16,27,59.3,199,3,50,262,5.2,2,77,461,6.0,10,13,3,26,2,10,0,0,0
4125,10,2016-11-12,old-dominion,,Southern Mississippi,W (51-35),13,19,68.4,150,2,31,170,5.5,4,50,320,6.4,5,3,2,10,2,20,0,0,0
4126,11,2016-11-19,old-dominion,@,Florida Atlantic,W (42-24),26,36,72.2,416,5,43,207,4.8,0,79,623,7.9,15,12,4,31,3,15,0,0,0
4127,12,2016-11-26,old-dominion,,Florida International,W (42-28),15,25,60.0,209,2,51,312,6.1,4,76,521,6.9,11,14,2,27,3,24,2,1,3
4128,13,2016-12-23,old-dominion,N,Eastern Michigan*,W (24-20),11,20,55.0,188,3,39,206,5.3,0,59,394,6.7,7,13,0,20,5,65,0,1,1
4129,,13 Games,old-dominion,,,,220,374,58.8,3042,31,500,2559,5.1,27,874,5601,6.4,132,113,28,273,66,572,4,6,10
4130,1,2017-09-02,old-dominion,,Albany,W (31-17),18,26,69.2,187,1,31,98,3.2,3,57,285,5.0,7,5,3,15,3,30,1,2,3
4131,2,2017-09-09,old-dominion,@,Massachusetts,W (17-7),13,29,44.8,169,1,48,197,4.1,1,77,366,4.8,8,9,2,19,5,32,0,0,0
4132,3,2017-09-16,old-dominion,,North Carolina,L (23-53),14,32,43.8,214,2,33,102,3.1,0,65,316,4.9,6,5,3,14,3,38,2,1,3
4133,4,2017-09-23,old-dominion,@,Virginia Tech,L (0-38),8,26,30.8,85,0,24,64,2.7,0,50,149,3.0,3,3,1,7,5,35,0,1,1
4134,5,2017-10-07,old-dominion,,Florida Atlantic,L (28-58),16,39,41.0,163,2,36,248,6.9,2,75,411,5.5,8,8,4,20,4,29,0,4,4
4135,6,2017-10-14,old-dominion,@,Marshall,L (3-35),14,27,51.9,116,0,36,81,2.3,0,63,197,3.1,6,6,1,13,6,55,1,1,2
4136,7,2017-10-20,old-dominion,,Western Kentucky,L (31-35),17,25,68.0,180,0,48,268,5.6,4,73,448,6.1,11,9,0,20,9,84,1,3,4
4137,8,2017-10-28,old-dominion,@,North Texas,L (38-45),21,35,60.0,181,0,48,205,4.3,2,83,386,4.7,9,12,0,21,2,25,1,2,3
4138,9,2017-11-04,old-dominion,,UNC Charlotte,W (6-0),20,30,66.7,178,0,49,148,3.0,0,79,326,4.1,13,6,1,20,2,12,0,0,0
4139,10,2017-11-11,old-dominion,@,Florida International,W (37-30),17,24,70.8,240,2,36,199,5.5,2,60,439,7.3,10,8,3,21,2,15,0,0,0
4140,11,2017-11-18,old-dominion,,Rice,W (24-21),20,29,69.0,188,0,39,172,4.4,3,68,360,5.3,10,10,1,21,2,20,0,0,0
4141,12,2017-11-25,old-dominion,@,Middle Tennessee State,L (10-41),15,27,55.6,120,1,33,185,5.6,0,60,305,5.1,7,6,1,14,5,55,0,0,0
4142,,12 Games,old-dominion,,,,193,349,55.3,2021,9,461,1967,4.3,17,810,3988,4.9,98,87,20,205,48,430,6,14,20
4143,1,2018-09-01,old-dominion,@,Liberty,L (10-52),18,34,52.9,172,0,39,129,3.3,1,73,301,4.1,9,6,3,18,8,75,2,0,2
4144,2,2018-09-08,old-dominion,,Florida International,L (20-28),19,37,51.4,303,2,27,93,3.4,0,64,396,6.2,11,4,1,16,3,35,0,0,0
4145,3,2018-09-13,old-dominion,@,UNC Charlotte,L (25-28),16,28,57.1,215,1,28,123,4.4,3,56,338,6.0,9,5,2,16,3,28,0,2,2
4146,4,2018-09-22,old-dominion,,Virginia Tech,W (49-35),30,50,60.0,495,4,34,137,4.0,3,84,632,7.5,19,7,4,30,2,10,0,0,0
4147,5,2018-09-29,old-dominion,@,East Carolina,L (35-37),21,36,58.3,250,2,35,21,0.6,2,71,271,3.8,10,3,5,18,5,50,0,1,1
4148,6,2018-10-06,old-dominion,@,Florida Atlantic,L (33-52),39,51,76.5,390,2,36,118,3.3,3,87,508,5.8,22,8,4,34,3,25,0,2,2
4149,7,2018-10-13,old-dominion,,Marshall,L (20-42),31,54,57.4,296,2,31,106,3.4,0,85,402,4.7,15,6,4,25,7,70,1,1,2
4150,8,2018-10-20,old-dominion,@,Western Kentucky,W (37-34),21,33,63.6,327,1,42,181,4.3,3,75,508,6.8,12,13,5,30,9,95,2,0,2
4151,9,2018-10-27,old-dominion,,Middle Tennessee State,L (17-51),26,35,74.3,333,2,35,187,5.3,0,70,520,7.4,11,9,1,21,9,101,2,3,5
4152,10,2018-11-10,old-dominion,,North Texas,W (34-31),21,43,48.8,301,2,34,58,1.7,2,77,359,4.7,12,4,3,19,5,45,0,1,1
4153,11,2018-11-17,old-dominion,,Virginia Military Institute,W (77-14),18,25,72.0,170,2,58,339,5.8,7,83,509,6.1,10,20,2,32,4,27,0,0,0
4154,,11 Games,old-dominion,,,,260,426,61.0,3252,20,399,1492,3.7,24,825,4744,5.8,140,85,34,259,58,561,7,10,17
4155,1,2014-08-30,rice,@,Notre Dame,L (17-48),15,26,57.7,226,2,40,141,3.5,0,66,367,5.6,9,7,0,16,5,30,1,1,2
4156,2,2014-09-13,rice,@,Texas A&M,L (10-38),24,36,66.7,241,1,55,240,4.4,0,91,481,5.3,15,11,2,28,8,66,0,0,0
4157,3,2014-09-20,rice,,Old Dominion,L (42-45),22,34,64.7,242,2,54,284,5.3,4,88,526,6.0,11,18,1,30,5,50,0,0,0
4158,4,2014-09-27,rice,@,Southern Mississippi,W (41-23),14,22,63.6,178,2,48,217,4.5,3,70,395,5.6,7,12,1,20,6,65,0,1,1
4159,5,2014-10-04,rice,,Hawaii,W (28-14),10,23,43.5,248,2,44,143,3.3,2,67,391,5.8,7,9,1,17,3,40,2,1,3
4160,6,2014-10-11,rice,@,Army,W (41-21),15,21,71.4,209,3,41,182,4.4,2,62,391,6.3,9,7,1,17,5,41,0,0,0
4161,7,2014-10-25,rice,,North Texas,W (41-21),13,26,50.0,233,1,46,188,4.1,3,72,421,5.8,9,9,2,20,4,50,0,0,0
4162,8,2014-11-01,rice,@,Florida International,W (31-17),11,25,44.0,230,2,38,169,4.4,2,63,399,6.3,8,8,1,17,2,15,0,0,0
4163,9,2014-11-08,rice,,Texas-San Antonio,W (17-7),18,28,64.3,213,1,56,200,3.6,1,84,413,4.9,9,11,2,22,8,69,0,1,1
4164,10,2014-11-15,rice,@,Marshall,L (14-41),11,23,47.8,99,0,35,81,2.3,2,58,180,3.1,7,5,3,15,2,19,0,0,0
4165,11,2014-11-21,rice,,Texas-El Paso,W (31-13),10,22,45.5,227,2,42,165,3.9,2,64,392,6.1,8,9,0,17,12,95,0,1,1
4166,12,2014-11-29,rice,@,Louisiana Tech,L (31-76),25,40,62.5,337,4,32,34,1.1,0,72,371,5.2,13,4,0,17,5,55,1,3,4
4167,13,2014-12-24,rice,N,Fresno State*,W (30-6),16,26,61.5,326,3,40,137,3.4,1,66,463,7.0,8,7,1,16,12,100,0,0,0
4168,,13 Games,rice,,,,204,352,58.0,3009,25,571,2181,3.8,22,923,5190,5.6,120,117,15,252,77,695,4,8,12
4169,1,2015-09-05,rice,,Wagner,W (56-16),12,21,57.1,142,1,54,401,7.4,7,75,543,7.2,6,21,1,28,4,49,1,1,2
4170,2,2015-09-12,rice,@,Texas,L (28-42),23,38,60.5,234,2,58,228,3.9,2,96,462,4.8,14,15,1,30,6,55,2,3,5
4171,3,2015-09-19,rice,@,North Texas,W (38-24),29,39,74.4,373,3,51,189,3.7,2,90,562,6.2,15,12,1,28,7,60,0,0,0
4172,4,2015-09-26,rice,@,Baylor,L (17-70),11,21,52.4,152,1,45,94,2.1,1,66,246,3.7,6,8,6,20,9,70,2,0,2
4173,5,2015-10-03,rice,,Western Kentucky,L (10-49),16,30,53.3,237,0,34,85,2.5,1,64,322,5.0,10,4,1,15,8,70,3,2,5
4174,6,2015-10-10,rice,@,Florida Atlantic,W (27-26),22,35,62.9,284,3,50,203,4.1,1,85,487,5.7,13,15,1,29,10,88,1,0,1
4175,7,2015-10-24,rice,,Army,W (38-31),20,30,66.7,267,2,35,165,4.7,3,65,432,6.6,14,6,1,21,8,64,2,0,2
4176,8,2015-10-30,rice,,Louisiana Tech,L (17-42),14,28,50.0,180,2,33,101,3.1,0,61,281,4.6,9,5,1,15,8,62,0,0,0
4177,9,2015-11-06,rice,@,Texas-El Paso,L (21-24),14,28,50.0,230,2,30,96,3.2,1,58,326,5.6,9,6,1,16,5,42,0,0,0
4178,10,2015-11-14,rice,,Southern Mississippi,L (10-65),13,36,36.1,107,1,35,107,3.1,0,71,214,3.0,7,6,2,15,7,67,1,0,1
4179,11,2015-11-21,rice,@,Texas-San Antonio,L (24-34),23,41,56.1,359,2,46,161,3.5,1,87,520,6.0,19,8,1,28,7,70,1,2,3
4180,12,2015-11-28,rice,,UNC Charlotte,W (27-7),15,26,57.7,126,1,61,307,5.0,2,87,433,5.0,7,17,4,28,5,55,0,1,1
4181,,12 Games,rice,,,,212,373,56.8,2691,20,532,2137,4.0,21,905,4828,5.3,129,123,21,273,84,752,13,9,22
4182,1,2016-09-01,rice,@,Western Kentucky,L (14-46),23,38,60.5,186,0,33,105,3.2,2,71,291,4.1,10,7,3,20,10,62,0,2,2
4183,2,2016-09-10,rice,@,Army,L (14-31),16,30,53.3,197,1,21,92,4.4,1,51,289,5.7,8,4,0,12,6,55,1,1,2
4184,3,2016-09-16,rice,,Baylor,L (10-38),9,27,33.3,31,0,42,234,5.6,1,69,265,3.8,3,8,3,14,3,21,1,0,1
4185,4,2016-09-24,rice,,North Texas,L (35-42),24,40,60.0,236,1,60,255,4.3,3,100,491,4.9,8,16,4,28,8,65,2,1,3
4186,5,2016-10-01,rice,@,Southern Mississippi,L (28-44),16,20,80.0,166,2,45,180,4.0,2,65,346,5.3,7,12,0,19,8,81,0,0,0
4187,6,2016-10-15,rice,,Texas-San Antonio,L (13-14),23,37,62.2,237,1,32,114,3.6,1,69,351,5.1,11,9,2,22,3,20,1,0,1
4188,7,2016-10-22,rice,,Prairie View A&M,W (65-44),23,32,71.9,434,6,36,203,5.6,3,68,637,9.4,14,9,5,28,10,86,0,0,0
4189,8,2016-10-29,rice,@,Louisiana Tech,L (16-61),15,27,55.6,152,0,43,153,3.6,2,70,305,4.4,7,10,1,18,1,6,1,1,2
4190,9,2016-11-05,rice,,Florida Atlantic,L (25-42),20,33,60.6,281,1,45,159,3.5,2,78,440,5.6,10,10,3,23,6,61,1,2,3
4191,10,2016-11-12,rice,@,UNC Charlotte,W (22-21),36,52,69.2,292,1,42,141,3.4,2,94,433,4.6,18,9,1,28,6,57,0,2,2
4192,11,2016-11-19,rice,,Texas-El Paso,W (44-24),21,28,75.0,246,3,44,236,5.4,2,72,482,6.7,10,15,2,27,3,17,1,1,2
4193,12,2016-11-26,rice,@,Stanford,L (17-41),15,48,31.3,124,0,39,167,4.3,2,87,291,3.3,6,14,1,21,5,35,0,0,0
4194,,12 Games,rice,,,,241,412,58.5,2582,16,482,2039,4.2,23,894,4621,5.2,112,123,25,260,69,566,8,10,18
4195,1,2017-08-26,rice,N,Stanford,L (7-62),10,24,41.7,95,0,38,146,3.8,1,62,241,3.9,5,8,1,14,6,45,1,1,2
4196,2,2017-09-09,rice,@,Texas-El Paso,W (31-14),10,18,55.6,131,1,49,306,6.2,3,67,437,6.5,6,16,0,22,4,31,1,0,1
4197,3,2017-09-16,rice,@,Houston,L (3-38),11,25,44.0,113,0,35,129,3.7,0,60,242,4.0,7,7,0,14,2,15,2,1,3
4198,4,2017-09-23,rice,,Florida International,L (7-13),16,27,59.3,148,0,41,100,2.4,1,68,248,3.6,11,6,2,19,4,30,0,1,1
4199,5,2017-09-30,rice,@,Pittsburgh,L (10-42),15,32,46.9,222,1,23,55,2.4,0,55,277,5.0,9,4,1,14,4,37,0,3,3
4200,6,2017-10-07,rice,,Army,L (12-49),9,21,42.9,146,1,37,200,5.4,1,58,346,6.0,5,12,0,17,3,33,5,1,6
4201,7,2017-10-21,rice,@,Texas-San Antonio,L (7-20),6,14,42.9,145,1,41,155,3.8,0,55,300,5.5,4,8,1,13,7,70,1,2,3
4202,8,2017-10-28,rice,,Louisiana Tech,L (28-42),7,17,41.2,187,1,46,247,5.4,3,63,434,6.9,5,14,0,19,5,49,1,3,4
4203,9,2017-11-04,rice,@,Alabama-Birmingham,L (21-52),14,24,58.3,227,1,35,236,6.7,2,59,463,7.8,9,8,0,17,6,50,1,2,3
4204,10,2017-11-11,rice,,Southern Mississippi,L (34-43),10,16,62.5,127,0,49,254,5.2,5,65,381,5.9,7,14,5,26,3,30,0,0,0
4205,11,2017-11-18,rice,@,Old Dominion,L (21-24),8,12,66.7,90,0,50,241,4.8,3,62,331,5.3,5,13,0,18,4,30,1,1,2
4206,12,2017-11-25,rice,,North Texas,L (14-30),6,16,37.5,107,0,42,175,4.2,1,58,282,4.9,3,10,0,13,5,40,0,1,1
4207,,12 Games,rice,,,,122,246,49.6,1738,6,486,2244,4.6,20,732,3982,5.4,76,120,10,206,53,460,13,16,29
4208,1,2018-08-25,rice,,Prairie View A&M,W (31-28),12,24,50.0,87,0,50,310,6.2,3,74,397,5.4,4,16,2,22,7,54,0,0,0
4209,2,2018-09-01,rice,,Houston,L (27-45),24,41,58.5,292,3,43,147,3.4,0,84,439,5.2,14,5,3,22,6,57,0,1,1
4210,3,2018-09-08,rice,@,Hawaii,L (29-43),20,33,60.6,299,2,39,147,3.8,1,72,446,6.2,11,8,2,21,5,54,1,1,2
4211,4,2018-09-22,rice,@,Southern Mississippi,L (22-40),13,26,50.0,125,2,29,137,4.7,1,55,262,4.8,7,5,0,12,3,30,0,2,2
4212,5,2018-09-29,rice,@,Wake Forest,L (24-56),17,32,53.1,103,2,44,267,6.1,1,76,370,4.9,9,9,1,19,6,55,1,2,3
4213,6,2018-10-06,rice,,Texas-San Antonio,L (3-20),16,30,53.3,175,0,37,47,1.3,0,67,222,3.3,8,2,1,11,4,20,2,2,4
4214,7,2018-10-13,rice,,Alabama-Birmingham,L (0-42),13,28,46.4,136,0,37,50,1.4,0,65,186,2.9,7,1,1,9,5,42,1,0,1
4215,8,2018-10-20,rice,@,Florida International,L (17-36),12,21,57.1,115,0,29,125,4.3,2,50,240,4.8,6,10,0,16,0,0,0,3,3
4216,9,2018-10-27,rice,@,North Texas,L (17-41),21,37,56.8,204,1,37,95,2.6,1,74,299,4.0,12,6,0,18,8,99,1,0,1
4217,10,2018-11-03,rice,,Texas-El Paso,L (26-34),17,32,53.1,313,2,28,70,2.5,1,60,383,6.4,10,4,2,16,7,45,1,2,3
4218,11,2018-11-10,rice,@,Louisiana Tech,L (13-28),19,35,54.3,226,1,29,100,3.4,0,64,326,5.1,8,7,0,15,1,3,0,3,3
4219,12,2018-11-17,rice,@,Louisiana State,L (10-42),7,15,46.7,101,0,43,97,2.3,1,58,198,3.4,6,8,1,15,3,22,0,0,0
4220,,12 Games,rice,,,,191,354,54.0,2176,13,445,1592,3.6,11,799,3768,4.7,102,81,13,196,55,481,7,16,23
4221,1,2014-08-30,florida-international,,Bethune-Cookman,L (12-14),16,33,48.5,143,1,32,43,1.3,0,65,186,2.9,5,4,3,12,8,47,0,0,0
4222,2,2014-09-06,florida-international,,Wagner,W (34-3),23,33,69.7,229,2,34,148,4.4,1,67,377,5.6,9,7,3,19,9,70,3,0,3
4223,3,2014-09-13,florida-international,,Pittsburgh,L (25-42),17,35,48.6,236,2,33,57,1.7,1,68,293,4.3,9,7,1,17,8,68,1,0,1
4224,4,2014-09-20,florida-international,,Louisville,L (3-34),13,26,50.0,117,0,40,88,2.2,0,66,205,3.1,4,7,1,12,6,60,1,2,3
4225,5,2014-09-27,florida-international,@,Alabama-Birmingham,W (34-20),9,24,37.5,204,2,37,93,2.5,0,61,297,4.9,5,4,0,9,10,65,0,0,0
4226,6,2014-10-02,florida-international,,Florida Atlantic,W (38-10),18,29,62.1,160,0,41,185,4.5,4,70,345,4.9,7,13,0,20,8,51,1,0,1
4227,7,2014-10-11,florida-international,@,Texas-San Antonio,L (13-16),11,26,42.3,141,1,47,118,2.5,0,73,259,3.5,8,9,3,20,6,30,3,2,5
4228,8,2014-10-18,florida-international,,Marshall,L (13-45),18,32,56.3,208,1,53,177,3.3,1,85,385,4.5,12,10,1,23,8,88,0,2,2
4229,9,2014-11-01,florida-international,,Rice,L (17-31),10,23,43.5,159,1,46,102,2.2,1,69,261,3.8,5,9,0,14,5,30,2,0,2
4230,10,2014-11-08,florida-international,@,Old Dominion,L (35-38),8,13,61.5,132,2,55,256,4.7,2,68,388,5.7,4,17,0,21,6,59,0,1,1
4231,11,2014-11-15,florida-international,,Middle Tennessee State,W (38-28),17,24,70.8,231,3,40,144,3.6,1,64,375,5.9,9,7,1,17,3,25,1,0,1
4232,12,2014-11-22,florida-international,@,North Texas,L (14-17),11,25,44.0,56,0,30,91,3.0,0,55,147,2.7,5,6,1,12,7,80,0,3,3
4233,,12 Games,florida-international,,,,171,323,52.9,2016,15,488,1502,3.1,11,811,3518,4.3,82,100,14,196,84,673,12,10,22
4234,1,2015-09-03,florida-international,@,Central Florida,W (15-14),29,38,76.3,260,1,31,131,4.2,1,69,391,5.7,11,6,0,17,7,45,1,0,1
4235,2,2015-09-12,florida-international,@,Indiana,L (22-36),24,47,51.1,283,3,33,123,3.7,0,80,406,5.1,12,7,5,24,8,54,2,1,3
4236,3,2015-09-19,florida-international,,North Carolina Central,W (39-14),22,36,61.1,242,3,46,248,5.4,2,82,490,6.0,8,13,0,21,6,60,1,1,2
4237,4,2015-09-26,florida-international,@,Louisiana Tech,L (17-27),29,44,65.9,263,1,23,45,2.0,0,67,308,4.6,14,4,0,18,7,55,0,0,0
4238,5,2015-10-03,florida-international,@,Massachusetts,L (14-24),22,34,64.7,115,1,29,73,2.5,1,63,188,3.0,6,5,2,13,10,111,0,0,0
4239,6,2015-10-10,florida-international,,Texas-El Paso,W (52-12),15,22,68.2,368,3,31,150,4.8,3,53,518,9.8,14,7,1,22,5,38,0,0,0
4240,7,2015-10-17,florida-international,@,Middle Tennessee State,L (34-42),29,51,56.9,260,2,30,86,2.9,2,81,346,4.3,16,5,4,25,3,20,0,1,1
4241,8,2015-10-24,florida-international,,Old Dominion,W (41-12),31,39,79.5,390,3,33,58,1.8,2,72,448,6.2,13,6,1,20,3,30,1,0,1
4242,9,2015-10-31,florida-international,@,Florida Atlantic,L (17-31),19,27,70.4,196,1,32,66,2.1,1,59,262,4.4,8,9,3,20,5,38,1,1,2
4243,10,2015-11-07,florida-international,,UNC Charlotte,W (48-31),27,42,64.3,284,3,32,155,4.8,2,74,439,5.9,13,9,2,24,6,55,0,1,1
4244,11,2015-11-14,florida-international,@,Marshall,L (0-52),11,27,40.7,98,0,36,111,3.1,0,63,209,3.3,3,9,1,13,5,55,0,1,1
4245,12,2015-11-21,florida-international,,Western Kentucky,L (7-63),17,33,51.5,95,0,29,73,2.5,1,62,168,2.7,2,5,3,10,4,33,1,2,3
4246,,12 Games,florida-international,,,,275,440,62.5,2854,21,385,1319,3.4,15,825,4173,5.1,120,85,22,227,69,594,7,8,15
4247,1,2016-09-01,florida-international,,Indiana,L (13-34),24,47,51.1,268,0,21,63,3.0,1,68,331,4.9,12,2,2,16,6,36,0,3,3
4248,2,2016-09-09,florida-international,,Maryland,L (14-41),14,28,50.0,170,1,40,202,5.1,1,68,372,5.5,7,7,2,16,9,90,0,1,1
4249,3,2016-09-17,florida-international,@,Massachusetts,L (13-21),20,34,58.8,178,0,34,137,4.0,1,68,315,4.6,8,7,4,19,10,95,2,0,2
4250,4,2016-09-24,florida-international,,Central Florida,L (14-53),11,24,45.8,109,1,34,80,2.4,1,58,189,3.3,5,5,1,11,5,55,0,1,1
4251,5,2016-10-01,florida-international,,Florida Atlantic,W (33-31),15,30,50.0,199,1,49,270,5.5,3,79,469,5.9,9,14,2,25,1,5,0,2,2
4252,6,2016-10-08,florida-international,@,Texas-El Paso,W (35-21),21,31,67.7,241,3,44,258,5.9,1,75,499,6.7,10,12,1,23,6,57,0,1,1
4253,7,2016-10-15,florida-international,@,UNC Charlotte,W (27-26),26,42,61.9,315,2,21,39,1.9,1,63,354,5.6,15,1,3,19,5,55,1,2,3
4254,8,2016-10-22,florida-international,,Louisiana Tech,L (24-44),29,49,59.2,331,3,29,67,2.3,0,78,398,5.1,18,5,1,24,7,49,0,1,1
4255,9,2016-10-29,florida-international,,Middle Tennessee State,L (35-42),27,40,67.5,307,3,44,210,4.8,2,84,517,6.2,15,11,0,26,3,25,2,1,3
4256,10,2016-11-05,florida-international,@,Western Kentucky,L (21-49),22,34,64.7,210,2,30,101,3.4,1,64,311,4.9,13,4,0,17,4,30,1,2,3
4257,11,2016-11-19,florida-international,,Marshall,W (31-14),18,25,72.0,257,1,41,259,6.3,3,66,516,7.8,12,13,1,26,5,45,0,2,2
4258,12,2016-11-26,florida-international,@,Old Dominion,L (28-42),11,23,47.8,135,2,36,97,2.7,1,59,232,3.9,5,10,1,16,3,42,0,1,1
4259,,12 Games,florida-international,,,,238,407,58.5,2720,19,423,1783,4.2,16,830,4503,5.4,129,91,18,238,64,584,6,17,23
4260,1,2017-08-31,florida-international,@,Central Florida,L (17-61),18,31,58.1,201,1,26,134,5.2,1,57,335,5.9,8,5,0,13,14,163,3,1,4
4261,2,2017-09-08,florida-international,N,Alcorn State,W (17-10),21,33,63.6,328,0,40,137,3.4,2,73,465,6.4,15,9,2,26,5,30,1,0,1
4262,3,2017-09-23,florida-international,@,Rice,W (13-7),17,28,60.7,172,1,33,99,3.0,0,61,271,4.4,10,7,1,18,5,57,0,1,1
4263,4,2017-09-30,florida-international,,UNC Charlotte,W (30-29),15,27,55.6,241,2,41,234,5.7,2,68,475,7.0,10,10,0,20,5,42,0,1,1
4264,5,2017-10-07,florida-international,@,Middle Tennessee State,L (17-37),22,34,64.7,221,1,36,85,2.4,1,70,306,4.4,10,8,3,21,4,45,1,1,2
4265,6,2017-10-14,florida-international,,Tulane,W (23-10),17,31,54.8,220,1,44,218,5.0,1,75,438,5.8,11,11,1,23,11,105,0,2,2
4266,7,2017-10-28,florida-international,@,Marshall,W (41-30),14,18,77.8,177,2,48,224,4.7,2,66,401,6.1,10,9,2,21,6,60,0,0,0
4267,8,2017-11-04,florida-international,,Texas-San Antonio,W (14-7),18,25,72.0,215,2,37,100,2.7,0,62,315,5.1,11,6,1,18,6,75,2,1,3
4268,9,2017-11-11,florida-international,,Old Dominion,L (30-37),35,50,70.0,323,2,35,164,4.7,2,85,487,5.7,20,6,1,27,9,84,2,0,2
4269,10,2017-11-18,florida-international,@,Florida Atlantic,L (24-52),20,33,60.6,218,2,31,85,2.7,1,64,303,4.7,10,7,1,18,6,55,0,0,0
4270,11,2017-11-24,florida-international,,Western Kentucky,W (41-17),18,27,66.7,251,2,34,122,3.6,2,61,373,6.1,13,5,0,18,2,19,0,0,0
4271,12,2017-12-02,florida-international,,Massachusetts,W (63-45),20,25,80.0,295,3,49,379,7.7,6,74,674,9.1,12,11,3,26,5,50,1,1,2
4272,13,2017-12-21,florida-international,N,Temple*,L (3-28),17,34,50.0,169,0,40,88,2.2,0,74,257,3.5,11,5,4,20,6,59,1,2,3
4273,,13 Games,florida-international,,,,252,396,63.6,3031,19,494,2069,4.2,20,890,5100,5.7,151,99,19,269,84,844,11,10,21
4274,1,2018-09-01,florida-international,,Indiana,L (28-38),17,28,60.7,157,1,39,170,4.4,3,67,327,4.9,8,9,5,22,7,70,2,1,3
4275,2,2018-09-08,florida-international,@,Old Dominion,W (28-20),19,31,61.3,300,3,51,189,3.7,1,82,489,6.0,14,10,1,25,5,35,0,1,1
4276,3,2018-09-15,florida-international,,Massachusetts,W (63-24),16,23,69.6,207,2,53,329,6.2,5,76,536,7.1,8,22,2,32,2,30,1,1,2
4277,4,2018-09-22,florida-international,@,Miami (FL),L (17-31),13,28,46.4,170,2,24,17,0.7,0,52,187,3.6,5,1,1,7,3,23,0,1,1
4278,5,2018-09-29,florida-international,,Arkansas-Pine Bluff,W (55-9),13,19,68.4,393,4,28,222,7.9,3,47,615,13.1,11,7,0,18,5,52,0,0,0
4279,6,2018-10-13,florida-international,,Middle Tennessee State,W (24-21),27,36,75.0,311,2,34,70,2.1,0,70,381,5.4,11,6,4,21,7,49,0,0,0
4280,7,2018-10-20,florida-international,,Rice,W (36-17),20,29,69.0,229,2,38,217,5.7,2,67,446,6.7,15,8,0,23,3,15,0,0,0
4281,8,2018-10-27,florida-international,@,Western Kentucky,W (38-17),19,28,67.9,171,3,38,197,5.2,2,66,368,5.6,6,8,3,17,6,65,0,0,0
4282,9,2018-11-03,florida-international,,Florida Atlantic,L (14-49),19,34,55.9,234,2,33,96,2.9,0,67,330,4.9,13,5,1,19,2,21,1,2,3
4283,10,2018-11-10,florida-international,@,Texas-San Antonio,W (45-7),20,30,66.7,304,3,40,151,3.8,2,70,455,6.5,12,9,0,21,8,95,0,0,0
4284,11,2018-11-17,florida-international,@,UNC Charlotte,W (42-35),25,32,78.1,294,2,23,196,8.5,2,55,490,8.9,15,5,1,21,6,47,0,0,0
4285,,11 Games,florida-international,,,,208,318,65.4,2770,26,401,1854,4.6,20,719,4624,6.4,118,90,18,226,54,502,4,6,10
4286,1,2015-09-04,charlotte,@,Georgia State,W (23-20),19,32,59.4,244,1,54,164,3.0,0,86,408,4.7,12,11,1,24,4,31,2,2,4
4287,2,2015-09-12,charlotte,,Presbyterian,W (34-10),20,29,69.0,276,3,47,192,4.1,1,76,468,6.2,11,12,0,23,6,57,1,0,1
4288,3,2015-09-19,charlotte,@,Middle Tennessee State,L (14-73),13,33,39.4,102,0,38,117,3.1,1,71,219,3.1,5,5,1,11,8,75,3,4,7
4289,4,2015-09-26,charlotte,,Florida Atlantic,L (7-17),11,34,32.4,89,0,49,117,2.4,0,83,206,2.5,3,11,2,16,5,56,1,6,7
4290,5,2015-10-02,charlotte,,Temple,L (3-37),13,27,48.1,131,0,44,223,5.1,0,71,354,5.0,6,10,0,16,4,47,0,1,1
4291,6,2015-10-17,charlotte,@,Old Dominion,L (34-37),24,36,66.7,227,0,70,309,4.4,4,106,536,5.1,12,18,1,31,5,50,2,1,3
4292,7,2015-10-24,charlotte,,Southern Mississippi,L (10-44),12,30,40.0,120,0,36,137,3.8,1,66,257,3.9,6,7,0,13,5,60,0,3,3
4293,8,2015-10-31,charlotte,,Marshall,L (10-34),19,36,52.8,141,0,43,166,3.9,1,79,307,3.9,6,13,3,22,4,39,1,1,2
4294,9,2015-11-07,charlotte,@,Florida International,L (31-48),25,38,65.8,264,3,48,131,2.7,1,86,395,4.6,11,14,2,27,7,77,0,1,1
4295,10,2015-11-14,charlotte,,Texas-San Antonio,L (27-30),15,29,51.7,243,3,54,134,2.5,0,83,377,4.5,12,9,1,22,9,110,0,2,2
4296,11,2015-11-21,charlotte,@,Kentucky,L (10-58),11,25,44.0,87,1,48,146,3.0,0,73,233,3.2,5,7,2,14,2,15,1,2,3
4297,12,2015-11-28,charlotte,@,Rice,L (7-27),14,26,53.8,158,1,32,127,4.0,0,58,285,4.9,7,6,2,15,5,42,0,0,0
4298,,12 Games,charlotte,,,,196,375,52.3,2082,12,563,1963,3.5,9,938,4045,4.3,96,123,15,234,64,659,11,23,34
4299,1,2016-09-01,charlotte,@,Louisville,L (14-70),18,32,56.3,160,1,31,48,1.5,0,63,208,3.3,6,4,2,12,13,118,1,0,1
4300,2,2016-09-10,charlotte,,Elon,W (47-14),24,34,70.6,274,4,35,232,6.6,2,69,506,7.3,7,9,2,18,8,95,0,0,0
4301,3,2016-09-17,charlotte,,Eastern Michigan,L (19-37),23,44,52.3,199,2,39,157,4.0,0,83,356,4.3,9,9,5,23,7,81,1,2,3
4302,4,2016-09-24,charlotte,@,Temple,L (20-48),17,42,40.5,198,1,42,231,5.5,2,84,429,5.1,11,11,3,25,5,40,1,0,1
4303,5,2016-10-01,charlotte,,Old Dominion,L (17-52),18,36,50.0,176,1,49,178,3.6,1,85,354,4.2,9,10,3,22,5,25,2,1,3
4304,6,2016-10-09,charlotte,@,Florida Atlantic,W (28-23),14,17,82.4,223,3,48,219,4.6,1,65,442,6.8,8,13,1,22,5,37,1,1,2
4305,7,2016-10-15,charlotte,,Florida International,L (26-27),21,31,67.7,171,1,47,232,4.9,2,78,403,5.2,9,13,2,24,8,71,2,1,3
4306,8,2016-10-22,charlotte,@,Marshall,W (27-24),17,31,54.8,203,0,47,191,4.1,3,78,394,5.1,12,8,4,24,8,77,0,1,1
4307,9,2016-11-05,charlotte,@,Southern Mississippi,W (38-27),12,25,48.0,136,1,46,303,6.6,3,71,439,6.2,7,10,1,18,3,28,0,0,0
4308,10,2016-11-12,charlotte,,Rice,L (21-22),13,27,48.1,105,1,36,158,4.4,1,63,263,4.2,6,9,2,17,5,45,1,0,1
4309,11,2016-11-19,charlotte,,Middle Tennessee State,L (31-38),22,50,44.0,239,1,45,164,3.6,3,95,403,4.2,11,9,2,22,8,85,0,0,0
4310,12,2016-11-26,charlotte,@,Texas-San Antonio,L (14-33),15,44,34.1,229,1,19,8,0.4,0,63,237,3.8,7,1,2,10,13,116,0,0,0
4311,,12 Games,charlotte,,,,214,413,51.8,2313,17,484,2121,4.4,18,897,4434,4.9,102,106,29,237,88,818,9,6,15
4312,1,2017-09-01,charlotte,@,Eastern Michigan,L (7-24),12,29,41.4,114,1,35,166,4.7,0,64,280,4.4,6,6,1,13,11,112,0,3,3
4313,2,2017-09-09,charlotte,@,Kansas State,L (7-55),10,25,40.0,58,0,28,110,3.9,1,53,168,3.2,3,6,1,10,7,50,1,2,3
4314,3,2017-09-16,charlotte,,North Carolina A&T,L (31-35),13,29,44.8,170,3,46,266,5.8,1,75,436,5.8,8,17,2,27,7,60,1,2,3
4315,4,2017-09-23,charlotte,,Georgia State,L (0-28),16,29,55.2,179,0,34,94,2.8,0,63,273,4.3,8,6,0,14,6,51,1,2,3
4316,5,2017-09-30,charlotte,@,Florida International,L (29-30),16,28,57.1,155,1,49,349,7.1,3,77,504,6.5,8,13,2,23,5,40,0,0,0
4317,6,2017-10-07,charlotte,,Marshall,L (3-14),10,26,38.5,132,0,26,80,3.1,0,52,212,4.1,5,4,0,9,6,65,0,1,1
4318,7,2017-10-14,charlotte,@,Western Kentucky,L (14-45),9,19,47.4,61,0,34,248,7.3,2,53,309,5.8,2,6,1,9,6,80,0,1,1
4319,8,2017-10-21,charlotte,,Alabama-Birmingham,W (25-24),14,28,50.0,154,1,49,222,4.5,2,77,376,4.9,5,7,2,14,12,135,0,2,2
4320,9,2017-11-04,charlotte,@,Old Dominion,L (0-6),9,22,40.9,95,0,27,136,5.0,0,49,231,4.7,4,4,0,8,4,39,1,0,1
4321,10,2017-11-11,charlotte,,Middle Tennessee State,L (21-35),18,30,60.0,258,2,32,98,3.1,1,62,356,5.7,9,5,2,16,7,78,0,1,1
4322,11,2017-11-18,charlotte,@,Southern Mississippi,L (21-66),9,25,36.0,96,1,38,142,3.7,2,63,238,3.8,6,7,1,14,5,55,0,2,2
4323,12,2017-11-25,charlotte,,Florida Atlantic,L (12-31),10,22,45.5,171,1,30,84,2.8,1,52,255,4.9,6,4,0,10,2,15,0,0,0
4324,,12 Games,charlotte,,,,146,312,46.8,1643,10,428,1995,4.7,13,740,3638,4.9,70,85,12,167,78,780,4,16,20
4325,1,2018-09-01,charlotte,,Fordham,W (34-10),13,20,65.0,267,1,47,221,4.7,2,67,488,7.3,8,11,1,20,4,45,1,0,1
4326,2,2018-09-08,charlotte,,Appalachian State,L (9-45),12,25,48.0,108,0,43,95,2.2,0,68,203,3.0,4,8,3,15,9,80,1,1,2
4327,3,2018-09-13,charlotte,,Old Dominion,W (28-25),23,34,67.6,202,2,46,171,3.7,1,80,373,4.7,11,14,2,27,3,22,1,0,1
4328,4,2018-09-22,charlotte,@,Massachusetts,L (31-49),23,36,63.9,283,3,41,81,2.0,1,77,364,4.7,12,7,3,22,4,32,1,0,1
4329,5,2018-09-29,charlotte,@,Alabama-Birmingham,L (7-28),17,25,68.0,194,0,34,69,2.0,1,59,263,4.5,9,4,3,16,7,76,1,1,2
4330,6,2018-10-13,charlotte,,Western Kentucky,W (40-14),17,26,65.4,237,1,50,211,4.2,4,76,448,5.9,12,13,3,28,4,30,1,0,1
4331,7,2018-10-20,charlotte,@,Middle Tennessee State,L (13-21),20,40,50.0,209,1,39,150,3.8,1,79,359,4.5,8,10,1,19,5,40,0,2,2
4332,8,2018-10-27,charlotte,,Southern Mississippi,W (20-17),8,14,57.1,78,0,41,146,3.6,1,55,224,4.1,5,7,1,13,5,50,0,1,1
4333,9,2018-11-03,charlotte,@,Tennessee,L (3-14),13,25,52.0,152,0,37,92,2.5,0,62,244,3.9,7,4,2,13,8,55,0,1,1
4334,10,2018-11-10,charlotte,@,Marshall,L (13-30),10,20,50.0,72,0,41,113,2.8,1,61,185,3.0,3,10,0,13,3,15,0,0,0
4335,11,2018-11-17,charlotte,,Florida International,L (35-42),16,22,72.7,253,1,57,281,4.9,4,79,534,6.8,9,16,3,28,7,65,1,1,2
4336,,11 Games,charlotte,,,,172,287,59.9,2055,9,476,1630,3.4,16,763,3685,4.8,88,104,22,214,59,510,7,7,14
4337,1,2014-08-28,tulsa,,Tulane,W (38-31),31,53,58.5,438,4,36,154,4.3,0,89,592,6.7,20,7,3,30,9,90,0,2,2
4338,2,2014-09-06,tulsa,,Oklahoma,L (7-52),27,50,54.0,234,1,34,94,2.8,0,84,328,3.9,14,8,1,23,6,62,1,3,4
4339,3,2014-09-13,tulsa,@,Florida Atlantic,L (21-50),24,52,46.2,269,1,27,94,3.5,2,79,363,4.6,12,9,3,24,5,25,1,2,3
4340,4,2014-09-27,tulsa,,Texas State,L (34-37),23,40,57.5,234,2,56,200,3.6,2,96,434,4.5,10,13,2,25,4,34,0,1,1
4341,5,2014-10-04,tulsa,@,Colorado State,L (17-42),18,35,51.4,263,1,45,127,2.8,1,80,390,4.9,9,8,2,19,4,30,1,2,3
4342,6,2014-10-11,tulsa,@,Temple,L (24-35),21,36,58.3,260,2,50,178,3.6,1,86,438,5.1,12,11,1,24,8,108,0,0,0
4343,7,2014-10-18,tulsa,,South Florida,L (30-38),22,34,64.7,314,1,41,174,4.2,1,75,488,6.5,11,7,2,20,11,114,1,0,1
4344,8,2014-10-31,tulsa,@,Memphis,L (20-40),28,54,51.9,349,2,34,62,1.8,0,88,411,4.7,19,2,1,22,11,111,0,0,0
4345,9,2014-11-08,tulsa,,Southern Methodist,W (38-28),16,25,64.0,286,5,47,215,4.6,0,72,501,7.0,10,13,3,26,5,40,1,0,1
4346,10,2014-11-14,tulsa,@,Central Florida,L (7-31),10,29,34.5,72,1,27,129,4.8,0,56,201,3.6,4,7,0,11,6,64,0,3,3
4347,11,2014-11-22,tulsa,@,Houston,L (28-38),28,41,68.3,258,2,35,158,4.5,2,76,416,5.5,12,12,1,25,4,35,0,3,3
4348,12,2014-11-28,tulsa,,East Carolina,L (32-49),15,32,46.9,199,1,45,189,4.2,2,77,388,5.0,7,10,4,21,5,55,0,2,2
4349,,12 Games,tulsa,,,,263,481,54.7,3176,23,477,1774,3.7,11,958,4950,5.2,140,107,23,270,78,768,5,18,23
4350,1,2015-09-05,tulsa,,Florida Atlantic,W (47-44),21,35,60.0,424,2,51,194,3.8,4,86,618,7.2,14,13,4,31,4,26,2,2,4
4351,2,2015-09-12,tulsa,@,New Mexico,W (40-21),16,30,53.3,321,2,59,279,4.7,2,89,600,6.7,0,0,0,31,7,56,1,0,1
4352,3,2015-09-19,tulsa,@,Oklahoma,L (38-52),34,51,66.7,427,4,40,176,4.4,1,91,603,6.6,21,7,3,31,8,60,0,0,0
4353,4,2015-10-03,tulsa,,Houston,L (24-38),26,45,57.8,326,0,43,130,3.0,3,88,456,5.2,14,6,3,23,10,71,1,1,2
4354,5,2015-10-10,tulsa,,Louisiana-Monroe,W (34-24),28,45,62.2,341,2,62,222,3.6,2,107,563,5.3,16,13,2,31,10,82,0,0,0
4355,6,2015-10-17,tulsa,@,East Carolina,L (17-30),19,41,46.3,288,1,45,175,3.9,1,86,463,5.4,11,8,3,22,7,53,1,1,2
4356,7,2015-10-23,tulsa,,Memphis,L (42-66),24,36,66.7,421,4,45,113,2.5,2,81,534,6.6,13,8,6,27,11,76,2,1,3
4357,8,2015-10-31,tulsa,@,Southern Methodist,W (40-31),19,27,70.4,240,0,57,179,3.1,4,84,419,5.0,10,12,0,22,7,70,0,0,0
4358,9,2015-11-07,tulsa,,Central Florida,W (45-30),10,18,55.6,150,2,46,275,6.0,3,64,425,6.6,5,13,3,21,3,38,2,2,4
4359,10,2015-11-14,tulsa,@,Cincinnati,L (38-49),30,50,60.0,375,2,39,213,5.5,3,89,588,6.6,14,10,2,26,7,53,1,0,1
4360,11,2015-11-21,tulsa,,Navy,L (21-44),32,37,86.5,278,0,34,78,2.3,3,71,356,5.0,13,5,2,20,5,50,2,0,2
4361,12,2015-11-27,tulsa,@,Tulane,W (45-34),19,33,57.6,367,3,31,41,1.3,1,64,408,6.4,17,2,1,20,6,51,0,1,1
4362,13,2015-12-26,tulsa,N,Virginia Tech*,L (52-55),27,44,61.4,374,3,39,189,4.8,4,83,563,6.8,15,11,1,27,6,44,0,0,0
4363,,13 Games,tulsa,,,,305,492,62.0,4332,25,591,2264,3.8,33,1083,6596,6.1,163,108,30,332,91,730,12,8,20
4364,1,2016-09-03,tulsa,,San Jose State,W (45-10),13,25,52.0,207,1,58,305,5.3,3,83,512,6.2,9,19,0,28,2,25,0,0,0
4365,2,2016-09-10,tulsa,@,Ohio State,L (3-48),15,32,46.9,127,0,37,61,1.6,0,69,188,2.7,9,4,1,14,5,46,2,4,6
4366,3,2016-09-17,tulsa,,North Carolina A&T,W (58-21),25,39,64.1,358,4,38,136,3.6,2,77,494,6.4,16,8,4,28,6,60,1,1,2
4367,4,2016-09-24,tulsa,@,Fresno State,W (48-41),24,34,70.6,281,4,68,344,5.1,2,102,625,6.1,10,22,2,34,8,71,1,1,2
4368,5,2016-10-07,tulsa,,Southern Methodist,W (43-40),25,44,56.8,247,1,59,315,5.3,4,103,562,5.5,17,15,2,34,17,149,0,1,1
4369,6,2016-10-15,tulsa,@,Houston,L (31-38),27,51,52.9,365,1,35,94,2.7,3,86,459,5.3,18,6,3,27,5,25,1,1,2
4370,7,2016-10-22,tulsa,,Tulane,W (50-27),14,23,60.9,236,3,58,330,5.7,3,81,566,7.0,9,17,3,29,6,36,2,0,2
4371,8,2016-10-29,tulsa,@,Memphis,W (59-30),20,33,60.6,234,2,54,362,6.7,6,87,596,6.9,13,14,2,29,7,63,1,0,1
4372,9,2016-11-05,tulsa,,East Carolina,W (45-24),22,38,57.9,274,3,54,342,6.3,3,92,616,6.7,14,18,5,37,10,86,0,0,0
4373,10,2016-11-12,tulsa,@,Navy,L (40-42),16,27,59.3,369,4,38,207,5.4,1,65,576,8.9,13,10,0,23,3,35,0,1,1
4374,11,2016-11-19,tulsa,@,Central Florida,W (35-20),12,25,48.0,126,2,56,348,6.2,3,81,474,5.9,5,15,1,21,3,26,0,1,1
4375,12,2016-11-25,tulsa,,Cincinnati,W (40-37),25,39,64.1,305,3,65,306,4.7,2,104,611,5.9,18,14,3,35,3,37,1,2,3
4376,13,2016-12-19,tulsa,N,Central Michigan*,W (55-10),29,39,74.4,320,5,46,261,5.7,1,85,581,6.8,14,20,0,34,3,25,0,0,0
4377,,13 Games,tulsa,,,,267,449,59.5,3449,33,666,3411,5.1,33,1115,6860,6.2,165,182,26,373,78,684,9,12,21
4378,1,2017-08-31,tulsa,@,Oklahoma State,L (24-59),20,38,52.6,188,0,60,244,4.1,2,98,432,4.4,10,14,2,26,6,48,2,0,2
4379,2,2017-09-09,tulsa,,Louisiana,W (66-42),14,20,70.0,243,1,72,424,5.9,8,92,667,7.3,9,21,3,33,5,46,1,0,1
4380,3,2017-09-16,tulsa,@,Toledo,L (51-54),12,20,60.0,125,0,68,423,6.2,6,88,548,6.2,4,21,4,29,9,97,0,0,0
4381,4,2017-09-23,tulsa,,New Mexico,L (13-16),13,27,48.1,131,0,31,155,5.0,1,58,286,4.9,8,6,1,15,6,59,0,1,1
4382,5,2017-09-30,tulsa,,Navy,L (21-31),12,18,66.7,115,1,39,229,5.9,2,57,344,6.0,4,6,2,12,5,40,0,0,0
4383,6,2017-10-07,tulsa,@,Tulane,L (28-62),12,20,60.0,273,1,28,139,5.0,3,48,412,8.6,6,9,1,16,4,36,1,1,2
4384,7,2017-10-14,tulsa,,Houston,W (45-17),9,18,50.0,128,1,53,288,5.4,4,71,416,5.9,3,16,1,20,9,70,0,1,1
4385,8,2017-10-21,tulsa,@,Connecticut,L (14-20),17,28,60.7,259,0,44,194,4.4,2,72,453,6.3,11,9,3,23,5,47,0,1,1
4386,9,2017-10-27,tulsa,@,Southern Methodist,L (34-38),9,25,36.0,212,1,53,246,4.6,3,78,458,5.9,6,12,4,22,8,73,0,1,1
4387,10,2017-11-03,tulsa,,Memphis,L (14-41),18,31,58.1,157,0,35,145,4.1,2,66,302,4.6,7,8,2,17,14,103,0,1,1
4388,11,2017-11-16,tulsa,@,South Florida,L (20-27),14,28,50.0,191,0,55,166,3.0,2,83,357,4.3,7,13,2,22,7,46,0,0,0
4389,12,2017-11-25,tulsa,,Temple,L (22-43),6,19,31.6,55,1,54,314,5.8,1,73,369,5.1,2,18,5,25,6,55,1,2,3
4390,,12 Games,tulsa,,,,156,292,53.4,2077,6,592,2967,5.0,36,884,5044,5.7,77,153,30,260,84,720,5,8,13
4391,1,2018-09-01,tulsa,,Central Arkansas,W (38-27),15,24,62.5,196,2,63,274,4.3,3,87,470,5.4,6,18,1,25,9,92,1,0,1
4392,2,2018-09-08,tulsa,@,Texas,L (21-28),13,26,50.0,164,1,38,189,5.0,2,64,353,5.5,7,9,1,17,6,45,0,2,2
4393,3,2018-09-15,tulsa,,Arkansas State,L (20-29),19,27,70.4,172,1,42,167,4.0,1,69,339,4.9,7,10,2,19,8,64,2,1,3
4394,4,2018-09-20,tulsa,@,Temple,L (17-31),22,41,53.7,195,0,66,208,3.2,2,107,403,3.8,12,18,2,32,8,73,2,3,5
4395,5,2018-10-04,tulsa,@,Houston,L (26-41),13,31,41.9,227,1,57,199,3.5,1,88,426,4.8,8,11,0,19,9,85,2,1,3
4396,6,2018-10-12,tulsa,,South Florida,L (24-25),6,21,28.6,79,1,49,220,4.5,2,70,299,4.3,5,10,1,16,10,81,0,0,0
4397,7,2018-10-20,tulsa,@,Arkansas,L (0-23),8,25,32.0,127,0,40,133,3.3,0,65,260,4.0,5,9,1,15,4,43,1,1,2
4398,8,2018-10-27,tulsa,,Tulane,L (17-24),12,26,46.2,180,1,35,135,3.9,1,61,315,5.2,8,8,1,17,8,57,1,0,1
4399,9,2018-11-03,tulsa,,Connecticut,W (49-19),9,14,64.3,168,4,57,470,8.2,3,71,638,9.0,7,18,0,25,6,60,1,0,1
4400,10,2018-11-10,tulsa,@,Memphis,L (21-47),14,26,53.8,140,1,41,112,2.7,2,67,252,3.8,9,5,2,16,6,46,1,0,1
4401,11,2018-11-17,tulsa,@,Navy,L (29-37),19,28,67.9,206,0,44,164,3.7,4,72,370,5.1,11,10,1,22,7,75,1,1,2
4402,,11 Games,tulsa,,,,150,289,51.9,1854,12,532,2271,4.3,21,821,4125,5.0,85,126,12,223,81,721,12,9,21
4403,1,2014-08-30,east-carolina,,North Carolina Central,W (52-7),33,46,71.7,374,4,28,208,7.4,3,74,582,7.9,19,9,4,32,8,72,1,1,2
4404,2,2014-09-06,east-carolina,@,South Carolina,L (23-33),32,46,69.6,321,1,21,132,6.3,1,67,453,6.8,20,4,3,27,4,40,0,2,2
4405,3,2014-09-13,east-carolina,@,Virginia Tech,W (28-21),23,47,48.9,427,3,25,75,3.0,1,72,502,7.0,16,2,2,20,13,114,1,0,1
4406,4,2014-09-20,east-carolina,,North Carolina,W (70-41),32,51,62.7,446,4,46,343,7.5,5,97,789,8.1,21,14,4,39,9,74,0,1,1
4407,5,2014-10-04,east-carolina,,Southern Methodist,W (45-24),31,41,75.6,410,4,33,171,5.2,2,74,581,7.9,20,10,0,30,5,53,1,0,1
4408,6,2014-10-11,east-carolina,@,South Florida,W (28-17),24,34,70.6,250,1,37,231,6.2,3,71,481,6.8,16,9,0,25,12,148,0,1,1
4409,7,2014-10-23,east-carolina,,Connecticut,W (31-21),39,65,60.0,445,2,35,135,3.9,2,100,580,5.8,18,8,5,31,11,105,0,1,1
4410,8,2014-11-01,east-carolina,@,Temple,L (10-20),24,42,57.1,217,0,46,211,4.6,1,88,428,4.9,12,15,3,30,12,116,5,0,5
4411,9,2014-11-13,east-carolina,N,Cincinnati,L (46-54),35,62,56.5,425,2,32,154,4.8,4,94,579,6.2,19,6,5,30,5,38,2,0,2
4412,10,2014-11-22,east-carolina,,Tulane,W (34-6),31,44,70.5,358,1,33,139,4.2,3,77,497,6.5,17,12,1,30,5,40,0,0,0
4413,11,2014-11-28,east-carolina,@,Tulsa,W (49-32),28,42,66.7,338,4,37,172,4.6,2,79,510,6.5,17,7,2,26,8,42,0,1,1
4414,12,2014-12-04,east-carolina,,Central Florida,L (30-32),36,49,73.5,397,3,27,14,0.5,1,76,411,5.4,20,5,1,26,12,127,1,2,3
4415,13,2015-01-03,east-carolina,N,Florida*,L (20-28),34,68,50.0,427,2,33,109,3.3,0,101,536,5.3,23,6,3,32,5,35,1,2,3
4416,,13 Games,east-carolina,,,,402,637,63.1,4835,31,433,2094,4.8,28,1070,6929,6.5,238,107,33,378,109,1004,12,11,23
4417,1,2015-09-05,east-carolina,,Towson,W (28-20),29,37,78.4,230,0,34,210,6.2,4,71,440,6.2,11,11,1,23,8,102,0,0,0
4418,2,2015-09-12,east-carolina,@,Florida,L (24-31),37,58,63.8,346,3,22,-13,-0.6,0,80,333,4.2,16,1,3,20,9,65,2,1,3
4419,3,2015-09-19,east-carolina,@,Navy,L (21-45),36,49,73.5,325,3,21,80,3.8,0,70,405,5.8,17,7,1,25,6,47,1,1,2
4420,4,2015-09-26,east-carolina,,Virginia Tech,W (35-28),14,20,70.0,228,2,43,182,4.2,3,63,410,6.5,10,6,3,19,7,97,1,1,2
4421,5,2015-10-03,east-carolina,@,Southern Methodist,W (49-23),19,26,73.1,249,3,54,306,5.7,4,80,555,6.9,11,14,1,26,5,45,0,2,2
4422,6,2015-10-10,east-carolina,@,Brigham Young,L (38-45),30,42,71.4,385,2,32,133,4.2,2,74,518,7.0,17,8,2,27,7,64,2,1,3
4423,7,2015-10-17,east-carolina,,Tulsa,W (30-17),20,29,69.0,239,1,43,143,3.3,1,72,382,5.3,11,7,0,18,9,78,0,1,1
4424,8,2015-10-22,east-carolina,,Temple,L (14-24),33,53,62.3,283,1,35,95,2.7,1,88,378,4.3,16,6,2,24,9,99,1,1,2
4425,9,2015-10-30,east-carolina,@,Connecticut,L (13-31),19,33,57.6,137,0,36,203,5.6,1,69,340,4.9,7,9,0,16,7,64,0,4,4
4426,10,2015-11-07,east-carolina,,South Florida,L (17-22),14,23,60.9,158,0,34,62,1.8,2,57,220,3.9,5,2,1,8,5,40,0,0,0
4427,11,2015-11-19,east-carolina,@,Central Florida,W (44-7),36,52,69.2,473,4,33,149,4.5,1,85,622,7.3,17,12,2,31,11,93,0,0,0
4428,12,2015-11-28,east-carolina,,Cincinnati,L (16-19),34,51,66.7,317,2,18,68,3.8,0,69,385,5.6,20,3,0,23,6,64,0,0,0
4429,,12 Games,east-carolina,,,,321,473,67.9,3370,21,405,1618,4.0,19,878,4988,5.7,158,86,16,260,89,858,7,12,19
4430,1,2016-09-03,east-carolina,,Western Carolina,W (52-7),29,33,87.9,413,5,38,275,7.2,2,71,688,9.7,17,11,0,28,3,25,1,0,1
4431,2,2016-09-10,east-carolina,,North Carolina State,W (33-30),33,43,76.7,297,1,33,148,4.5,3,76,445,5.9,12,9,2,23,4,36,1,1,2
4432,3,2016-09-17,east-carolina,@,South Carolina,L (15-20),44,58,75.9,400,1,33,119,3.6,0,91,519,5.7,24,6,4,34,8,75,2,2,4
4433,4,2016-09-24,east-carolina,@,Virginia Tech,L (17-54),17,34,50.0,362,2,35,81,2.3,0,69,443,6.4,10,6,0,16,5,43,1,0,1
4434,5,2016-10-01,east-carolina,,Central Florida,L (29-47),38,70,54.3,488,3,32,33,1.0,1,102,521,5.1,22,3,5,30,2,15,2,3,5
4435,6,2016-10-08,east-carolina,@,South Florida,L (22-38),33,56,58.9,308,1,35,168,4.8,1,91,476,5.2,15,8,1,24,2,19,0,1,1
4436,7,2016-10-22,east-carolina,@,Cincinnati,L (19-31),28,43,65.1,283,2,44,221,5.0,0,87,504,5.8,13,13,2,28,4,34,1,2,3
4437,8,2016-10-29,east-carolina,,Connecticut,W (41-3),33,47,70.2,294,4,40,136,3.4,1,87,430,4.9,16,8,1,25,5,35,0,0,0
4438,9,2016-11-05,east-carolina,@,Tulsa,L (24-45),38,62,61.3,436,2,30,38,1.3,1,92,474,5.2,20,6,1,27,13,117,0,0,0
4439,10,2016-11-12,east-carolina,,Southern Methodist,L (31-55),29,49,59.2,314,1,32,152,4.8,3,81,466,5.8,13,12,2,27,9,84,2,3,5
4440,11,2016-11-19,east-carolina,,Navy,L (31-66),16,25,64.0,238,3,25,176,7.0,1,50,414,8.3,6,6,0,12,1,5,1,0,1
4441,12,2016-11-26,east-carolina,@,Temple,L (10-37),21,34,61.8,183,1,27,42,1.6,0,61,225,3.7,9,4,0,13,4,33,1,0,1
4442,,12 Games,east-carolina,,,,359,554,64.8,4016,26,404,1589,3.9,13,958,5605,5.9,177,92,18,287,60,521,12,12,24
4443,1,2017-09-02,east-carolina,,James Madison,L (14-34),28,53,52.8,292,0,28,75,2.7,2,81,367,4.5,17,3,8,28,8,61,1,3,4
4444,2,2017-09-09,east-carolina,@,West Virginia,L (20-56),23,47,48.9,328,2,32,142,4.4,0,79,470,5.9,13,6,2,21,8,103,0,2,2
4445,3,2017-09-16,east-carolina,,Virginia Tech,L (17-64),11,30,36.7,241,2,31,40,1.3,0,61,281,4.6,6,3,3,12,6,40,2,1,3
4446,4,2017-09-24,east-carolina,@,Connecticut,W (41-38),30,39,76.9,426,3,47,170,3.6,2,86,596,6.9,19,10,1,30,8,78,0,0,0
4447,5,2017-09-30,east-carolina,,South Florida,L (31-61),21,46,45.7,306,2,36,108,3.0,2,82,414,5.0,13,7,3,23,6,58,0,2,2
4448,6,2017-10-07,east-carolina,,Temple,L (10-34),20,38,52.6,253,1,22,34,1.5,0,60,287,4.8,11,3,1,15,8,96,0,1,1
4449,7,2017-10-14,east-carolina,@,Central Florida,L (21-63),15,33,45.5,160,3,37,187,5.1,0,70,347,5.0,8,5,3,16,10,50,0,1,1
4450,8,2017-10-21,east-carolina,,Brigham Young,W (33-17),20,30,66.7,298,2,35,115,3.3,1,65,413,6.4,12,8,2,22,2,15,1,0,1
4451,9,2017-11-04,east-carolina,@,Houston,L (27-52),54,74,73.0,468,3,24,36,1.5,0,98,504,5.1,27,4,2,33,7,51,1,2,3
4452,10,2017-11-11,east-carolina,,Tulane,L (24-31),25,53,47.2,228,1,32,161,5.0,2,85,389,4.6,12,9,3,24,2,20,0,1,1
4453,11,2017-11-18,east-carolina,,Cincinnati,W (48-20),32,46,69.6,464,5,33,114,3.5,1,79,578,7.3,19,6,3,28,7,54,0,0,0
4454,12,2017-11-25,east-carolina,@,Memphis,L (13-70),28,54,51.9,351,2,37,115,3.1,0,91,466,5.1,15,8,4,27,8,74,0,3,3
4455,,12 Games,east-carolina,,,,307,543,56.5,3815,26,394,1297,3.3,10,937,5112,5.5,172,72,35,279,80,700,5,16,21
4456,1,2018-09-02,east-carolina,,North Carolina A&T,L (23-28),38,66,57.6,314,2,29,68,2.3,0,95,382,4.0,16,6,6,28,5,45,1,2,3
4457,2,2018-09-08,east-carolina,,North Carolina,W (41-19),19,33,57.6,290,1,49,220,4.5,4,82,510,6.2,15,9,2,26,4,40,0,0,0
4458,3,2018-09-22,east-carolina,@,South Florida,L (13-20),22,50,44.0,256,0,46,156,3.4,1,96,412,4.3,11,10,3,24,2,10,0,1,1
4459,4,2018-09-29,east-carolina,,Old Dominion,W (37-35),25,45,55.6,313,3,38,179,4.7,2,83,492,5.9,17,6,2,25,8,86,0,2,2
4460,5,2018-10-06,east-carolina,@,Temple,L (6-49),18,39,46.2,120,0,28,76,2.7,0,67,196,2.9,4,5,3,12,2,25,0,0,0
4461,6,2018-10-13,east-carolina,,Houston,L (20-42),38,63,60.3,374,1,31,41,1.3,1,94,415,4.4,20,4,3,27,8,69,1,3,4
4462,7,2018-10-20,east-carolina,,Central Florida,L (10-37),29,56,51.8,406,1,38,90,2.4,0,94,496,5.3,18,9,2,29,8,60,4,1,5
4463,8,2018-11-03,east-carolina,,Memphis,L (41-59),34,62,54.8,449,3,29,107,3.7,2,91,556,6.1,18,8,3,29,4,45,1,0,1
4464,9,2018-11-10,east-carolina,@,Tulane,L (18-24),21,68,30.9,360,2,26,90,3.5,0,94,450,4.8,13,6,4,23,7,69,0,1,1
4465,10,2018-11-17,east-carolina,,Connecticut,W (55-21),22,33,66.7,242,4,54,415,7.7,3,87,657,7.6,9,23,2,34,5,48,0,0,0
4466,,10 Games,east-carolina,,,,266,515,51.7,3124,17,368,1442,3.9,13,883,4566,5.2,141,86,30,257,53,497,7,10,17
4467,1,2014-08-28,tulane,@,Tulsa,L (31-38),22,44,50.0,262,3,30,254,8.5,1,74,516,7.0,13,6,3,22,9,96,1,1,2
4468,2,2014-09-06,tulane,,Georgia Tech,L (21-38),17,35,48.6,231,2,25,96,3.8,1,60,327,5.5,10,6,1,17,10,69,0,3,3
4469,3,2014-09-13,tulane,,Southeastern Louisiana,W (35-20),14,30,46.7,238,3,40,122,3.1,2,70,360,5.1,10,5,6,21,12,115,1,2,3
4470,4,2014-09-20,tulane,@,Duke,L (13-47),14,36,38.9,160,0,58,231,4.0,2,94,391,4.2,7,17,4,28,13,92,1,4,5
4471,5,2014-09-27,tulane,@,Rutgers,L (6-31),18,29,62.1,152,0,31,152,4.9,1,60,304,5.1,4,7,2,13,7,62,0,0,0
4472,6,2014-10-11,tulane,,Connecticut,W (12-3),19,26,73.1,135,1,33,167,5.1,0,59,302,5.1,6,8,0,14,7,64,0,0,0
4473,7,2014-10-18,tulane,@,Central Florida,L (13-20),18,42,42.9,147,0,36,131,3.6,1,78,278,3.6,6,9,3,18,9,84,0,2,2
4474,8,2014-10-31,tulane,,Cincinnati,L (14-38),24,35,68.6,205,1,33,175,5.3,1,68,380,5.6,12,9,0,21,4,51,1,0,1
4475,9,2014-11-08,tulane,@,Houston,W (31-24),24,35,68.6,237,3,36,124,3.4,1,71,361,5.1,11,9,2,22,5,64,1,1,2
4476,10,2014-11-15,tulane,,Memphis,L (7-38),26,48,54.2,196,0,39,155,4.0,1,87,351,4.0,10,9,2,21,3,30,2,3,5
4477,11,2014-11-22,tulane,@,East Carolina,L (6-34),25,43,58.1,301,0,27,24,0.9,0,70,325,4.6,11,2,2,15,7,79,0,1,1
4478,12,2014-12-06,tulane,,Temple,L (3-10),19,40,47.5,151,0,31,115,3.7,0,71,266,3.7,5,6,3,14,4,35,0,1,1
4479,,12 Games,tulane,,,,240,443,54.2,2415,13,419,1746,4.2,11,862,4161,4.8,105,93,28,226,90,841,7,18,25
4480,1,2015-09-03,tulane,,Duke,L (7-37),24,42,57.1,246,1,23,25,1.1,0,65,271,4.2,8,3,3,14,5,25,0,1,1
4481,2,2015-09-12,tulane,@,Georgia Tech,L (10-65),15,33,45.5,177,1,33,71,2.2,0,66,248,3.8,9,8,1,18,4,34,1,1,2
4482,3,2015-09-19,tulane,,Maine,W (38-7),18,31,58.1,292,1,42,205,4.9,4,73,497,6.8,14,6,0,20,7,65,1,1,2
4483,4,2015-10-03,tulane,,Central Florida,W (45-31),17,29,58.6,225,5,44,170,3.9,1,73,395,5.4,7,8,2,17,7,67,1,0,1
4484,5,2015-10-10,tulane,@,Temple,L (10-49),17,30,56.7,102,1,27,8,0.3,0,57,110,1.9,5,2,1,8,9,102,0,2,2
4485,6,2015-10-16,tulane,,Houston,L (7-42),14,33,42.4,150,0,32,112,3.5,1,65,262,4.0,6,4,1,11,12,133,0,0,0
4486,7,2015-10-24,tulane,@,Navy,L (14-31),27,38,71.1,263,1,27,123,4.6,1,65,386,5.9,18,2,1,21,9,80,2,1,3
4487,8,2015-10-31,tulane,@,Memphis,L (13-41),10,24,41.7,131,0,42,139,3.3,2,66,270,4.1,6,8,3,17,6,50,0,0,0
4488,9,2015-11-07,tulane,,Connecticut,L (3-7),13,40,32.5,106,0,25,34,1.4,0,65,140,2.2,6,3,0,9,2,10,0,1,1
4489,10,2015-11-14,tulane,@,Army,W (34-31),14,29,48.3,252,2,28,115,4.1,1,57,367,6.4,11,7,0,18,2,10,0,1,1
4490,11,2015-11-21,tulane,@,Southern Methodist,L (21-49),13,33,39.4,128,2,33,200,6.1,1,66,328,5.0,7,8,2,17,4,40,0,0,0
4491,12,2015-11-27,tulane,,Tulsa,L (34-45),23,41,56.1,343,4,41,187,4.6,0,82,530,6.5,15,9,1,25,3,25,0,2,2
4492,,12 Games,tulane,,,,205,403,50.9,2415,18,397,1389,3.5,11,800,3804,4.8,112,68,15,195,70,641,5,10,15
4493,1,2016-09-01,tulane,@,Wake Forest,L (3-7),12,23,52.2,134,0,47,146,3.1,0,70,280,4.0,6,7,1,14,4,30,1,0,1
4494,2,2016-09-10,tulane,,Southern,W (66-21),2,6,33.3,12,0,57,437,7.7,7,63,449,7.1,0,20,2,22,4,35,0,1,1
4495,3,2016-09-17,tulane,,Navy,L (14-21),3,12,25.0,21,0,47,240,5.1,2,59,261,4.4,0,14,0,14,9,71,0,0,0
4496,4,2016-09-24,tulane,,Louisiana,W (41-39),13,26,50.0,181,4,48,130,2.7,0,74,311,4.2,7,7,0,14,6,40,0,1,1
4497,5,2016-10-01,tulane,@,Massachusetts,W (31-24),11,21,52.4,168,1,64,280,4.4,3,85,448,5.3,8,16,3,27,6,50,1,0,1
4498,6,2016-10-14,tulane,,Memphis,L (14-24),11,30,36.7,144,1,44,169,3.8,1,74,313,4.2,7,9,4,20,7,62,2,1,3
4499,7,2016-10-22,tulane,@,Tulsa,L (27-50),3,19,15.8,37,0,49,355,7.2,4,68,392,5.8,2,12,1,15,9,85,1,0,1
4500,8,2016-10-29,tulane,,Southern Methodist,L (31-35),13,26,50.0,164,2,46,227,4.9,2,72,391,5.4,7,9,2,18,10,100,0,1,1
4501,9,2016-11-05,tulane,@,Central Florida,L (6-37),5,21,23.8,68,0,64,280,4.4,1,85,348,4.1,3,16,3,22,6,65,2,3,5
4502,10,2016-11-12,tulane,@,Houston,L (18-30),21,42,50.0,241,2,36,100,2.8,0,78,341,4.4,11,5,1,17,5,33,1,0,1
4503,11,2016-11-19,tulane,,Temple,L (0-31),4,13,30.8,24,0,33,118,3.6,0,46,142,3.1,0,8,0,8,6,50,2,0,2
4504,12,2016-11-26,tulane,@,Connecticut,W (38-13),11,19,57.9,166,0,55,257,4.7,5,74,423,5.7,8,8,1,17,5,40,0,1,1
4505,,12 Games,tulane,,,,109,258,42.2,1360,10,590,2739,4.6,25,848,4099,4.8,59,131,18,208,77,661,10,8,18
4506,1,2017-09-02,tulane,,Grambling State,W (43-14),10,15,66.7,185,3,51,296,5.8,3,66,481,7.3,9,15,2,26,8,75,0,0,0
4507,2,2017-09-09,tulane,@,Navy,L (21-23),8,13,61.5,71,0,46,191,4.2,2,59,262,4.4,1,10,0,11,7,41,0,0,0
4508,3,2017-09-16,tulane,@,Oklahoma,L (14-56),6,12,50.0,54,0,62,237,3.8,2,74,291,3.9,3,16,1,20,2,20,1,1,2
4509,4,2017-09-23,tulane,,Army,W (21-17),10,22,45.5,103,0,30,253,8.4,3,52,356,6.8,5,8,2,15,6,59,0,0,0
4510,5,2017-10-07,tulane,,Tulsa,W (62-28),9,13,69.2,165,1,70,488,7.0,8,83,653,7.9,7,22,2,31,6,60,0,0,0
4511,6,2017-10-14,tulane,@,Florida International,L (10-23),5,16,31.3,36,0,40,203,5.1,1,56,239,4.3,1,14,3,18,1,15,1,1,2
4512,7,2017-10-21,tulane,,South Florida,L (28-34),9,19,47.4,221,2,47,194,4.1,2,66,415,6.3,8,12,3,23,12,137,0,1,1
4513,8,2017-10-27,tulane,@,Memphis,L (26-56),15,31,48.4,203,3,52,122,2.3,1,83,325,3.9,6,11,1,18,4,27,1,0,1
4514,9,2017-11-04,tulane,,Cincinnati,L (16-17),17,24,70.8,196,0,35,132,3.8,1,59,328,5.6,8,5,3,16,6,39,0,0,0
4515,10,2017-11-11,tulane,@,East Carolina,W (31-24),12,20,60.0,121,0,52,325,6.3,4,72,446,6.2,5,17,0,22,8,70,1,2,3
4516,11,2017-11-18,tulane,,Houston,W (20-17),17,25,68.0,251,1,47,166,3.5,1,72,417,5.8,12,11,0,23,5,42,0,1,1
4517,12,2017-11-25,tulane,@,Southern Methodist,L (38-41),18,31,58.1,314,2,43,171,4.0,3,74,485,6.6,13,12,2,27,5,40,1,0,1
4518,,12 Games,tulane,,,,136,241,56.4,1920,12,575,2778,4.8,31,816,4698,5.8,78,153,19,250,70,625,5,6,11
4519,1,2018-08-30,tulane,,Wake Forest,L (17-23),19,38,50.0,283,2,41,153,3.7,0,79,436,5.5,8,9,3,20,9,83,1,0,1
4520,2,2018-09-08,tulane,,Nicholls State,W (42-17),12,16,75.0,190,1,41,268,6.5,5,57,458,8.0,9,12,1,22,9,78,1,0,1
4521,3,2018-09-15,tulane,@,Alabama-Birmingham,L (24-31),7,26,26.9,180,2,40,175,4.4,1,66,355,5.4,6,8,3,17,2,25,2,1,3
4522,4,2018-09-22,tulane,@,Ohio State,L (6-49),10,16,62.5,156,0,41,107,2.6,1,57,263,4.6,8,5,1,14,6,55,0,0,0
4523,5,2018-09-28,tulane,,Memphis,W (40-24),13,22,59.1,178,1,56,318,5.7,4,78,496,6.4,9,13,0,22,9,95,0,0,0
4524,6,2018-10-06,tulane,@,Cincinnati,L (21-37),12,31,38.7,132,2,38,134,3.5,1,69,266,3.9,5,7,2,14,12,90,1,0,1
4525,7,2018-10-20,tulane,,Southern Methodist,L (23-27),14,22,63.6,153,0,46,168,3.7,2,68,321,4.7,7,10,1,18,10,96,2,1,3
4526,8,2018-10-27,tulane,@,Tulsa,W (24-17),10,19,52.6,92,0,55,312,5.7,3,74,404,5.5,5,9,3,17,8,70,1,0,1
4527,9,2018-11-03,tulane,@,South Florida,W (41-15),4,11,36.4,61,0,52,365,7.0,5,63,426,6.8,1,15,1,17,7,52,1,0,1
4528,10,2018-11-10,tulane,,East Carolina,W (24-18),12,28,42.9,372,3,49,163,3.3,0,77,535,6.9,10,7,0,17,8,93,1,0,1
4529,11,2018-11-15,tulane,@,Houston,L (17-48),10,24,41.7,147,0,43,212,4.9,2,67,359,5.4,6,12,0,18,5,43,1,3,4
4530,,11 Games,tulane,,,,123,253,48.6,1944,11,502,2375,4.7,24,755,4319,5.7,74,107,15,196,85,780,11,5,16
4531,1,2014-08-29,houston,,Texas-San Antonio,L (7-27),25,50,50.0,234,0,23,-26,-1.1,1,73,208,2.8,10,4,4,18,9,47,2,4,6
4532,2,2014-09-06,houston,,Grambling State,W (47-0),15,26,57.7,202,1,40,275,6.9,3,66,477,7.2,8,8,4,20,5,30,2,0,2
4533,3,2014-09-11,houston,@,Brigham Young,L (25-33),31,53,58.5,315,3,13,10,0.8,0,66,325,4.9,14,1,3,18,8,83,0,0,0
4534,4,2014-09-20,houston,,Nevada-Las Vegas,W (47-14),12,29,41.4,135,2,52,399,7.7,4,81,534,6.6,6,19,5,30,9,110,0,2,2
4535,5,2014-10-02,houston,,Central Florida,L (12-17),22,43,51.2,214,0,33,117,3.5,0,76,331,4.4,7,9,4,20,11,99,1,2,3
4536,6,2014-10-11,houston,@,Memphis,W (28-24),17,28,60.7,188,1,40,166,4.2,3,68,354,5.2,8,6,1,15,3,32,2,1,3
4537,7,2014-10-17,houston,,Temple,W (31-10),29,33,87.9,268,2,49,171,3.5,1,82,439,5.4,10,11,2,23,10,102,0,0,0
4538,8,2014-11-01,houston,@,South Florida,W (27-3),15,19,78.9,89,1,47,217,4.6,3,66,306,4.6,5,14,2,21,1,5,0,0,0
4539,9,2014-11-08,houston,,Tulane,L (24-31),30,49,61.2,336,2,32,90,2.8,0,81,426,5.3,13,8,4,25,6,51,0,4,4
4540,10,2014-11-22,houston,,Tulsa,W (38-28),16,21,76.2,227,1,43,244,5.7,4,64,471,7.4,9,12,0,21,5,47,0,0,0
4541,11,2014-11-28,houston,@,Southern Methodist,W (35-9),18,29,62.1,151,0,48,282,5.9,5,77,433,5.6,11,12,2,25,4,28,0,1,1
4542,12,2014-12-06,houston,N,Cincinnati,L (31-38),27,45,60.0,360,2,35,234,6.7,2,80,594,7.4,12,14,1,27,4,37,0,1,1
4543,13,2015-01-02,houston,N,Pittsburgh*,W (35-34),15,25,60.0,274,3,40,212,5.3,2,65,486,7.5,10,12,1,23,9,100,0,0,0
4544,,13 Games,houston,,,,272,450,60.4,2993,18,495,2391,4.8,28,945,5384,5.7,123,130,33,286,84,771,7,15,22
4545,1,2015-09-05,houston,,Tennessee Tech,W (52-24),27,38,71.1,355,1,44,272,6.2,6,82,627,7.6,13,14,0,27,9,59,1,0,1
4546,2,2015-09-12,houston,@,Louisville,W (34-31),23,35,65.7,236,3,57,226,4.0,0,92,462,5.0,11,12,2,25,7,78,0,1,1
4547,3,2015-09-26,houston,,Texas State,W (59-14),18,24,75.0,323,4,54,366,6.8,3,78,689,8.8,10,19,0,29,10,69,0,0,0
4548,4,2015-10-03,houston,@,Tulsa,W (38-24),22,38,57.9,273,0,56,365,6.5,5,94,638,6.8,12,13,3,28,3,44,1,0,1
4549,5,2015-10-08,houston,,Southern Methodist,W (49-28),16,18,88.9,243,0,48,214,4.5,7,66,457,6.9,9,13,1,23,6,55,1,0,1
4550,6,2015-10-16,houston,@,Tulane,W (42-7),17,25,68.0,222,1,47,239,5.1,4,72,461,6.4,8,12,4,24,10,99,0,1,1
4551,7,2015-10-24,houston,@,Central Florida,W (59-10),20,28,71.4,234,2,48,366,7.6,5,76,600,7.9,10,17,3,30,7,87,0,0,0
4552,8,2015-10-31,houston,,Vanderbilt,W (34-0),15,23,65.2,221,1,51,150,2.9,2,74,371,5.0,11,6,2,19,6,55,2,0,2
4553,9,2015-11-07,houston,,Cincinnati,W (33-30),16,24,66.7,161,2,63,266,4.2,1,87,427,4.9,10,8,6,24,4,40,0,2,2
4554,10,2015-11-14,houston,,Memphis,W (35-34),26,44,59.1,296,1,31,96,3.1,4,75,392,5.2,14,5,1,20,4,40,0,0,0
4555,11,2015-11-21,houston,@,Connecticut,L (17-20),17,31,54.8,208,1,33,110,3.3,0,64,318,5.0,8,4,1,13,7,69,2,2,4
4556,12,2015-11-27,houston,,Navy,W (52-31),27,36,75.0,337,4,44,218,5.0,3,80,555,6.9,14,13,0,27,3,29,0,0,0
4557,13,2015-12-05,houston,,Temple,W (24-13),12,22,54.5,106,0,40,233,5.8,3,62,339,5.5,5,11,0,16,5,40,0,0,0
4558,14,2015-12-31,houston,N,Florida State*,W (38-24),28,46,60.9,261,2,53,187,3.5,3,99,448,4.5,14,10,3,27,4,30,0,1,1
4559,,14 Games,houston,,,,284,432,65.7,3476,22,669,3308,4.9,46,1101,6784,6.2,149,157,26,332,85,794,7,7,14
4560,1,2016-09-03,houston,N,Oklahoma,W (33-23),23,40,57.5,321,2,40,89,2.2,0,80,410,5.1,16,5,4,25,7,75,1,0,1
4561,2,2016-09-10,houston,,Lamar,W (42-0),15,26,57.7,130,0,71,381,5.4,6,97,511,5.3,7,17,1,25,2,15,0,1,1
4562,3,2016-09-15,houston,@,Cincinnati,W (40-16),24,36,66.7,326,1,57,180,3.2,2,93,506,5.4,14,14,0,28,4,45,1,2,3
4563,4,2016-09-24,houston,@,Texas State,W (64-3),25,32,78.1,320,3,50,243,4.9,5,82,563,6.9,14,14,4,32,0,0,0,0,0
4564,5,2016-09-29,houston,,Connecticut,W (42-14),40,49,81.6,426,3,30,114,3.8,3,79,540,6.8,20,6,1,27,2,20,0,0,0
4565,6,2016-10-08,houston,@,Navy,L (40-46),32,50,64.0,359,3,33,125,3.8,2,83,484,5.8,20,8,0,28,4,30,1,2,3
4566,7,2016-10-15,houston,,Tulsa,W (38-31),26,34,76.5,254,0,55,268,4.9,4,89,522,5.9,15,15,0,30,10,104,2,1,3
4567,8,2016-10-22,houston,@,Southern Methodist,L (16-38),21,33,63.6,241,2,35,62,1.8,0,68,303,4.5,8,5,0,13,4,55,2,0,2
4568,9,2016-10-29,houston,,Central Florida,W (31-24),26,37,70.3,240,1,49,158,3.2,3,86,398,4.6,12,10,0,22,6,71,1,3,4
4569,10,2016-11-12,houston,,Tulane,W (30-18),21,37,56.8,221,2,35,66,1.9,1,72,287,4.0,8,5,1,14,7,55,1,1,2
4570,11,2016-11-17,houston,,Louisville,W (36-10),27,46,58.7,298,3,33,64,1.9,1,79,362,4.6,15,5,1,21,1,5,0,0,0
4571,12,2016-11-25,houston,@,Memphis,L (44-48),47,69,68.1,487,4,32,137,4.3,1,101,624,6.2,20,10,3,33,9,69,1,1,2
4572,13,2016-12-17,houston,N,San Diego State*,L (10-34),25,34,73.5,229,0,41,25,0.6,1,75,254,3.4,9,7,0,16,2,10,0,4,4
4573,,13 Games,houston,,,,352,523,67.3,3852,24,561,1912,3.4,29,1084,5764,5.3,178,121,15,314,58,554,10,15,25
4574,1,2017-09-09,houston,@,Arizona,W (19-16),25,32,78.1,225,1,37,158,4.3,1,69,383,5.6,11,6,1,18,10,110,0,2,2
4575,2,2017-09-16,houston,,Rice,W (38-3),34,38,89.5,354,2,37,130,3.5,3,75,484,6.5,16,6,0,22,2,10,0,0,0
4576,3,2017-09-23,houston,,Texas Tech,L (24-27),32,52,61.5,317,2,31,110,3.5,1,83,427,5.1,14,8,3,25,6,50,3,2,5
4577,4,2017-09-30,houston,@,Temple,W (20-13),25,36,69.4,226,1,31,162,5.2,1,67,388,5.8,10,9,4,23,12,108,0,1,1
4578,5,2017-10-07,houston,,Southern Methodist,W (35-22),20,28,71.4,198,3,40,265,6.6,2,68,463,6.8,10,14,3,27,4,48,0,2,2
4579,6,2017-10-14,houston,@,Tulsa,L (17-45),25,41,61.0,258,0,47,146,3.1,2,88,404,4.6,13,11,1,25,6,36,1,2,3
4580,7,2017-10-19,houston,,Memphis,L (38-42),29,41,70.7,315,1,54,239,4.4,4,95,554,5.8,16,9,0,25,8,72,2,1,3
4581,8,2017-10-28,houston,@,South Florida,W (28-24),14,25,56.0,142,1,48,255,5.3,3,73,397,5.4,5,11,0,16,5,45,1,0,1
4582,9,2017-11-04,houston,,East Carolina,W (52-27),15,22,68.2,330,3,26,142,5.5,3,48,472,9.8,8,7,1,16,4,34,0,0,0
4583,10,2017-11-18,houston,@,Tulane,L (17-20),18,26,69.2,225,0,33,220,6.7,2,59,445,7.5,13,8,1,22,5,46,1,1,2
4584,11,2017-11-24,houston,,Navy,W (24-14),21,27,77.8,277,1,32,103,3.2,2,59,380,6.4,10,5,1,16,4,43,2,0,2
4585,12,2017-12-24,houston,N,Fresno State*,L (27-33),23,43,53.5,269,1,30,72,2.4,1,73,341,4.7,13,3,1,17,6,44,1,1,2
4586,,12 Games,houston,,,,281,411,68.4,3136,16,446,2002,4.5,25,857,5138,6.0,139,97,16,252,72,646,11,12,23
4587,1,2018-09-01,houston,@,Rice,W (45-27),18,25,72.0,320,3,37,251,6.8,3,62,571,9.2,11,10,2,23,5,38,2,0,2
4588,2,2018-09-08,houston,,Arizona,W (45-18),19,40,47.5,254,4,40,297,7.4,2,80,551,6.9,11,14,3,28,7,56,0,0,0
4589,3,2018-09-15,houston,@,Texas Tech,L (49-63),31,52,59.6,462,5,40,173,4.3,2,92,635,6.9,18,8,2,28,9,68,0,0,0
4590,4,2018-09-22,houston,,Texas Southern,W (70-14),33,49,67.3,386,5,41,285,7.0,5,90,671,7.5,18,17,1,36,2,10,0,1,1
4591,5,2018-10-04,houston,,Tulsa,W (41-26),19,27,70.4,165,3,39,314,8.1,2,66,479,7.3,8,11,2,21,8,55,1,2,3
4592,6,2018-10-13,houston,@,East Carolina,W (42-20),16,28,57.1,249,3,43,157,3.7,2,71,406,5.7,8,8,2,18,12,115,0,0,0
4593,7,2018-10-20,houston,@,Navy,W (49-36),25,39,64.1,413,3,25,157,6.3,3,64,570,8.9,18,11,0,29,3,20,1,1,2
4594,8,2018-10-27,houston,,South Florida,W (57-36),28,40,70.0,419,5,49,263,5.4,3,89,682,7.7,16,16,3,35,5,50,0,2,2
4595,9,2018-11-03,houston,@,Southern Methodist,L (31-45),11,22,50.0,175,2,47,190,4.0,1,69,365,5.3,6,9,0,15,6,50,2,0,2
4596,10,2018-11-10,houston,,Temple,L (49-59),28,47,59.6,322,5,44,205,4.7,2,91,527,5.8,14,11,6,31,12,90,2,1,3
4597,11,2018-11-15,houston,,Tulane,W (48-17),17,30,56.7,190,3,48,298,6.2,3,78,488,6.3,9,13,2,24,6,54,0,1,1
4598,,11 Games,houston,,,,245,399,61.4,3355,41,453,2590,5.7,28,852,5945,7.0,137,128,23,288,75,606,8,8,16
4599,1,2014-08-30,memphis,,Austin Peay,W (63-0),20,27,74.1,242,2,55,303,5.5,7,82,545,6.6,10,14,4,28,6,55,1,1,2
4600,2,2014-09-06,memphis,@,UCLA,L (35-42),27,42,64.3,305,1,39,164,4.2,3,81,469,5.8,17,5,2,24,10,110,0,0,0
4601,3,2014-09-20,memphis,,Middle Tennessee State,W (36-17),21,35,60.0,219,2,51,261,5.1,1,86,480,5.6,14,11,1,26,6,35,0,1,1
4602,4,2014-09-27,memphis,@,Mississippi,L (3-24),13,31,41.9,81,0,31,23,0.7,0,62,104,1.7,4,4,5,13,9,105,1,1,2
4603,5,2014-10-04,memphis,N,Cincinnati,W (41-14),18,25,72.0,311,2,69,299,4.3,3,94,610,6.5,14,16,0,30,8,72,0,0,0
4604,6,2014-10-11,memphis,,Houston,L (24-28),26,37,70.3,243,2,41,125,3.0,1,78,368,4.7,12,7,1,20,4,41,2,3,5
4605,7,2014-10-25,memphis,@,Southern Methodist,W (48-10),20,27,74.1,352,2,53,230,4.3,4,80,582,7.3,17,10,2,29,8,69,1,0,1
4606,8,2014-10-31,memphis,,Tulsa,W (40-20),18,31,58.1,183,0,41,243,5.9,4,72,426,5.9,7,13,3,23,4,40,1,0,1
4607,9,2014-11-07,memphis,@,Temple,W (16-13),21,28,75.0,230,1,40,82,2.1,0,68,312,4.6,13,3,1,17,6,46,1,0,1
4608,10,2014-11-15,memphis,@,Tulane,W (38-7),14,25,56.0,178,1,40,156,3.9,2,65,334,5.1,8,5,0,13,4,51,2,0,2
4609,11,2014-11-22,memphis,,South Florida,W (31-20),18,23,78.3,232,2,39,238,6.1,2,62,470,7.6,8,10,1,19,6,58,0,0,0
4610,12,2014-11-29,memphis,,Connecticut,W (41-10),22,41,53.7,194,4,44,178,4.0,1,85,372,4.4,10,12,6,28,4,40,0,0,0
4611,13,2014-12-22,memphis,N,Brigham Young*,W (55-48),24,46,52.2,306,4,51,174,3.4,3,97,480,4.9,15,8,1,24,6,43,2,3,5
4612,,13 Games,memphis,,,,262,418,62.7,3076,23,594,2476,4.2,31,1012,5552,5.5,149,118,27,294,81,765,11,9,20
4613,1,2015-09-05,memphis,,Missouri State,W (63-7),16,21,76.2,202,3,60,317,5.3,5,81,519,6.4,9,16,2,27,9,92,0,0,0
4614,2,2015-09-12,memphis,@,Kansas,W (55-23),24,27,88.9,370,2,52,281,5.4,5,79,651,8.2,0,0,0,34,7,58,3,0,3
4615,3,2015-09-19,memphis,@,Bowling Green State,W (44-41),29,40,72.5,386,3,50,155,3.1,2,90,541,6.0,14,11,3,28,7,78,0,0,0
4616,4,2015-09-24,memphis,,Cincinnati,W (53-46),24,36,66.7,412,2,37,158,4.3,4,73,570,7.8,16,6,0,22,9,100,1,0,1
4617,5,2015-10-02,memphis,@,South Florida,W (24-17),20,33,60.6,305,2,39,120,3.1,1,72,425,5.9,12,7,1,20,7,75,0,0,0
4618,6,2015-10-17,memphis,,Mississippi,W (37-24),39,53,73.6,384,3,41,107,2.6,1,94,491,5.2,21,7,3,31,10,80,0,1,1
4619,7,2015-10-23,memphis,@,Tulsa,W (66-42),32,44,72.7,447,4,52,257,4.9,5,96,704,7.3,18,11,6,35,12,120,1,0,1
4620,8,2015-10-31,memphis,,Tulane,W (41-13),27,44,61.4,358,1,39,223,5.7,3,83,581,7.0,16,16,0,32,8,106,0,0,0
4621,9,2015-11-07,memphis,,Navy,L (20-45),26,42,61.9,305,1,31,133,4.3,1,73,438,6.0,13,7,1,21,4,43,2,1,3
4622,10,2015-11-14,memphis,@,Houston,L (34-35),20,32,62.5,278,2,54,212,3.9,2,86,490,5.7,11,14,1,26,7,45,1,1,2
4623,11,2015-11-21,memphis,@,Temple,L (12-31),25,34,73.5,156,0,35,76,2.2,0,69,232,3.4,10,3,0,13,8,79,0,0,0
4624,12,2015-11-28,memphis,,Southern Methodist,W (63-0),13,22,59.1,288,7,42,195,4.6,0,64,483,7.5,10,8,2,20,5,60,1,1,2
4625,13,2015-12-30,memphis,N,Auburn*,L (10-31),16,37,43.2,106,0,31,99,3.2,0,68,205,3.0,6,5,2,13,6,40,0,1,1
4626,,13 Games,memphis,,,,311,465,66.9,3997,30,563,2333,4.1,29,1028,6330,6.2,156,111,21,322,99,976,9,5,14
4627,1,2016-09-03,memphis,,Southeast Missouri State,W (35-17),26,40,65.0,295,3,32,117,3.7,1,72,412,5.7,18,5,4,27,4,40,1,2,3
4628,2,2016-09-17,memphis,,Kansas,W (43-7),15,25,60.0,189,2,47,205,4.4,2,72,394,5.5,6,12,1,19,8,89,0,0,0
4629,3,2016-09-24,memphis,,Bowling Green State,W (77-3),23,32,71.9,395,6,45,240,5.3,4,77,635,8.2,13,9,3,25,9,85,0,0,0
4630,4,2016-10-01,memphis,@,Mississippi,L (28-48),31,47,66.0,355,0,31,119,3.8,4,78,474,6.1,16,7,4,27,7,52,1,3,4
4631,5,2016-10-06,memphis,,Temple,W (34-27),17,26,65.4,174,0,31,151,4.9,2,57,325,5.7,10,4,1,15,3,25,1,0,1
4632,6,2016-10-14,memphis,@,Tulane,W (24-14),21,34,61.8,236,1,33,163,4.9,1,67,399,6.0,7,8,1,16,7,79,2,1,3
4633,7,2016-10-22,memphis,@,Navy,L (28-42),25,40,62.5,333,2,31,98,3.2,1,71,431,6.1,18,6,0,24,3,25,1,0,1
4634,8,2016-10-29,memphis,,Tulsa,L (30-59),19,40,47.5,349,3,42,159,3.8,1,82,508,6.2,11,9,2,22,12,98,2,2,4
4635,9,2016-11-05,memphis,@,Southern Methodist,W (51-7),24,33,72.7,314,4,39,160,4.1,1,72,474,6.6,13,10,1,24,3,26,0,0,0
4636,10,2016-11-12,memphis,,South Florida,L (42-49),29,46,63.0,331,3,35,277,7.9,2,81,608,7.5,15,12,2,29,6,60,0,1,1
4637,11,2016-11-18,memphis,@,Cincinnati,W (34-7),16,20,80.0,159,2,53,172,3.2,2,73,331,4.5,10,9,1,20,5,45,1,0,1
4638,12,2016-11-25,memphis,,Houston,W (48-44),30,45,66.7,409,4,34,146,4.3,2,79,555,7.0,19,6,3,28,10,94,0,0,0
4639,13,2016-12-20,memphis,N,Western Kentucky*,L (31-51),27,49,55.1,418,4,32,73,2.3,0,81,491,6.1,18,5,4,27,5,53,2,1,3
4640,,13 Games,memphis,,,,303,477,63.5,3957,34,485,2080,4.3,23,962,6037,6.3,174,102,27,303,82,771,11,10,21
4641,1,2017-08-31,memphis,,Louisiana-Monroe,W (37-29),10,25,40.0,97,0,39,319,8.2,4,64,416,6.5,4,10,2,16,10,96,1,1,2
4642,2,2017-09-16,memphis,,UCLA,W (48-45),23,39,59.0,398,6,37,162,4.4,0,76,560,7.4,15,5,6,26,11,109,1,2,3
4643,3,2017-09-23,memphis,,Southern Illinois,W (44-31),22,36,61.1,288,2,36,176,4.9,2,72,464,6.4,15,8,1,24,8,90,0,0,0
4644,4,2017-09-30,memphis,@,Central Florida,L (13-40),27,49,55.1,321,1,24,75,3.1,1,73,396,5.4,14,6,5,25,3,20,1,3,4
4645,5,2017-10-06,memphis,@,Connecticut,W (70-31),39,55,70.9,480,8,45,231,5.1,2,100,711,7.1,21,12,1,34,12,104,0,0,0
4646,6,2017-10-14,memphis,,Navy,W (30-27),24,40,60.0,279,3,29,118,4.1,0,69,397,5.8,14,6,4,24,9,39,1,0,1
4647,7,2017-10-19,memphis,@,Houston,W (42-38),33,53,62.3,471,1,23,30,1.3,4,76,501,6.6,20,4,4,28,2,10,1,1,2
4648,8,2017-10-27,memphis,,Tulane,W (56-26),18,31,58.1,298,3,32,259,8.1,4,63,557,8.8,12,6,0,18,8,80,0,1,1
4649,9,2017-11-03,memphis,@,Tulsa,W (41-14),28,40,70.0,333,4,37,191,5.2,1,77,524,6.8,17,6,5,28,10,77,0,0,0
4650,10,2017-11-18,memphis,,Southern Methodist,W (66-45),22,28,78.6,331,2,46,333,7.2,7,74,664,9.0,16,15,1,32,11,132,0,1,1
4651,11,2017-11-25,memphis,,East Carolina,W (70-13),10,15,66.7,302,3,34,333,9.8,5,49,635,13.0,8,14,1,23,8,88,0,0,0
4652,12,2017-12-02,memphis,@,Central Florida,L (55-62),30,44,68.2,471,4,45,282,6.3,3,89,753,8.5,18,12,2,32,14,127,1,1,2
4653,13,2017-12-30,memphis,,Iowa State*,L (20-21),21,33,63.6,286,2,26,53,2.0,0,59,339,5.7,14,2,1,17,5,34,0,0,0
4654,,13 Games,memphis,,,,307,488,62.9,4355,39,453,2562,5.7,33,941,6917,7.4,188,106,33,327,111,1006,6,10,16
4655,1,2018-09-01,memphis,,Mercer,W (66-14),28,39,71.8,428,5,47,324,6.9,3,86,752,8.7,19,11,2,32,7,57,1,0,1
4656,2,2018-09-08,memphis,@,Navy,L (21-22),15,25,60.0,145,0,24,233,9.7,3,49,378,7.7,8,6,0,14,4,20,3,1,4
4657,3,2018-09-14,memphis,,Georgia State,W (59-22),19,27,70.4,269,5,35,410,11.7,3,62,679,11.0,14,13,0,27,10,79,0,1,1
4658,4,2018-09-22,memphis,,South Alabama,W (52-35),22,30,73.3,292,2,46,271,5.9,5,76,563,7.4,14,14,3,31,5,50,0,0,0
4659,5,2018-09-28,memphis,@,Tulane,L (24-40),14,30,46.7,246,2,21,31,1.5,1,51,277,5.4,8,2,3,13,4,20,0,0,0
4660,6,2018-10-06,memphis,,Connecticut,W (55-14),17,19,89.5,256,2,40,378,9.5,6,59,634,10.7,9,16,1,26,9,90,0,0,0
4661,7,2018-10-13,memphis,,Central Florida,L (30-31),17,29,58.6,209,0,52,281,5.4,3,81,490,6.0,10,14,3,27,7,43,2,0,2
4662,8,2018-10-20,memphis,@,Missouri,L (33-65),15,38,39.5,208,2,43,200,4.7,2,81,408,5.0,12,9,4,25,8,65,0,2,2
4663,9,2018-11-03,memphis,@,East Carolina,W (59-41),21,30,70.0,362,3,52,277,5.3,5,82,639,7.8,11,14,1,26,9,56,0,0,0
4664,10,2018-11-10,memphis,,Tulsa,W (47-21),16,23,69.6,202,2,55,297,5.4,3,78,499,6.4,10,14,2,26,8,79,1,0,1
4665,11,2018-11-16,memphis,@,Southern Methodist,W (28-18),18,31,58.1,226,2,43,208,4.8,2,74,434,5.9,12,7,2,21,12,143,0,2,2
4666,,11 Games,memphis,,,,202,321,62.9,2843,25,458,2910,6.4,36,779,5753,7.4,127,120,21,268,83,702,7,6,13
4667,1,2014-09-01,louisville,,Miami (FL),W (31-13),20,28,71.4,206,2,43,130,3.0,1,71,336,4.7,10,11,0,21,7,57,2,0,2
4668,2,2014-09-06,louisville,,Murray State,W (66-21),25,39,64.1,278,3,49,325,6.6,6,88,603,6.9,13,15,3,31,3,19,0,0,0
4669,3,2014-09-13,louisville,@,Virginia,L (21-23),20,43,46.5,203,2,27,79,2.9,1,70,282,4.0,9,6,2,17,7,50,2,2,4
4670,4,2014-09-20,louisville,@,Florida International,W (34-3),20,36,55.6,324,2,35,12,0.3,1,71,336,4.7,9,6,1,16,7,36,2,0,2
4671,5,2014-09-27,louisville,,Wake Forest,W (20-10),16,32,50.0,206,0,49,215,4.4,2,81,421,5.2,9,11,1,21,11,89,3,0,3
4672,6,2014-10-03,louisville,@,Syracuse,W (28-6),12,22,54.5,174,1,48,178,3.7,2,70,352,5.0,6,11,1,18,9,75,1,1,2
4673,7,2014-10-11,louisville,@,Clemson,L (17-23),15,30,50.0,212,1,38,52,1.4,1,68,264,3.9,6,3,1,10,11,65,2,0,2
4674,8,2014-10-18,louisville,,North Carolina State,W (30-18),21,36,58.3,203,2,33,166,5.0,1,69,369,5.3,10,11,0,21,4,33,0,0,0
4675,9,2014-10-30,louisville,,Florida State,L (31-42),20,38,52.6,330,1,33,158,4.8,3,71,488,6.9,14,9,1,24,3,14,1,1,2
4676,10,2014-11-08,louisville,@,Boston College,W (38-19),17,24,70.8,257,2,40,166,4.2,3,64,423,6.6,10,9,2,21,10,87,1,0,1
4677,11,2014-11-22,louisville,@,Notre Dame,W (31-28),8,21,38.1,180,1,50,229,4.6,3,71,409,5.8,7,14,2,23,8,57,0,1,1
4678,12,2014-11-29,louisville,,Kentucky,W (44-40),22,35,62.9,389,3,39,83,2.1,3,74,472,6.4,16,4,2,22,3,15,2,2,4
4679,13,2014-12-30,louisville,N,Georgia*,L (14-37),21,44,47.7,314,1,27,62,2.3,1,71,376,5.3,14,6,0,20,7,44,0,3,3
4680,,13 Games,louisville,,,,237,428,55.4,3276,21,511,1855,3.6,28,939,5131,5.5,133,116,16,265,90,641,16,10,26
4681,1,2015-09-05,louisville,N,Auburn,L (24-31),17,33,51.5,167,0,48,238,5.0,3,81,405,5.0,9,17,1,27,5,35,1,1,2
4682,2,2015-09-12,louisville,,Houston,L (31-34),27,45,60.0,325,2,26,70,2.7,2,71,395,5.6,15,7,3,25,9,80,2,2,4
4683,3,2015-09-17,louisville,,Clemson,L (17-20),20,35,57.1,253,0,28,19,0.7,1,63,272,4.3,10,3,3,16,2,15,0,2,2
4684,4,2015-09-26,louisville,,Samford,W (45-3),18,28,64.3,274,2,46,288,6.3,4,74,562,7.6,13,12,0,25,9,89,0,2,2
4685,5,2015-10-03,louisville,@,North Carolina State,W (20-13),10,27,37.0,103,1,45,203,4.5,1,72,306,4.3,7,10,3,20,6,50,0,0,0
4686,6,2015-10-17,louisville,@,Florida State,L (21-41),20,35,57.1,307,3,30,99,3.3,0,65,406,6.2,13,6,1,20,9,84,1,1,2
4687,7,2015-10-24,louisville,,Boston College,W (17-14),15,26,57.7,230,0,48,135,2.8,1,74,365,4.9,10,8,0,18,8,49,2,2,4
4688,8,2015-10-30,louisville,@,Wake Forest,W (20-19),23,32,71.9,249,2,42,68,1.6,0,74,317,4.3,12,3,2,17,10,89,1,0,1
4689,9,2015-11-07,louisville,,Syracuse,W (41-17),24,36,66.7,362,3,31,217,7.0,1,67,579,8.6,12,11,0,23,9,84,3,1,4
4690,10,2015-11-14,louisville,,Virginia,W (38-31),11,22,50.0,159,2,37,266,7.2,3,59,425,7.2,9,11,3,23,5,53,2,0,2
4691,11,2015-11-21,louisville,@,Pittsburgh,L (34-45),20,38,52.6,355,3,24,-1,0.0,1,62,354,5.7,13,2,2,17,8,50,0,1,1
4692,12,2015-11-28,louisville,@,Kentucky,W (38-24),10,26,38.5,175,1,40,314,7.9,4,66,489,7.4,6,13,1,20,7,46,0,3,3
4693,13,2015-12-30,louisville,N,Texas A&M*,W (27-21),12,26,46.2,227,2,46,307,6.7,2,72,534,7.4,7,12,2,21,10,90,0,0,0
4694,,13 Games,louisville,,,,227,409,55.5,3186,21,491,2223,4.5,23,900,5409,6.0,136,115,21,272,97,814,12,15,27
4695,1,2016-09-01,louisville,,UNC Charlotte,W (70-14),26,35,74.3,391,8,35,272,7.8,2,70,663,9.5,20,14,4,38,10,49,2,1,3
4696,2,2016-09-09,louisville,@,Syracuse,W (62-28),21,40,52.5,431,1,41,414,10.1,7,81,845,10.4,16,13,1,30,9,100,2,1,3
4697,3,2016-09-17,louisville,,Florida State,W (63-20),13,20,65.0,216,1,46,314,6.8,7,66,530,8.0,8,13,3,24,5,56,0,1,1
4698,4,2016-09-24,louisville,@,Marshall,W (59-28),24,44,54.5,417,5,41,273,6.7,3,85,690,8.1,14,15,4,33,12,143,2,1,3
4699,5,2016-10-01,louisville,@,Clemson,L (36-42),27,44,61.4,295,1,55,273,5.0,3,99,568,5.7,12,16,3,31,11,104,2,1,3
4700,6,2016-10-14,louisville,,Duke,W (24-14),13,26,50.0,181,1,35,288,8.2,2,61,469,7.7,6,14,1,21,4,32,1,0,1
4701,7,2016-10-22,louisville,,North Carolina State,W (54-13),21,36,58.3,390,3,44,163,3.7,3,80,553,6.9,12,10,2,24,12,94,2,0,2
4702,8,2016-10-29,louisville,@,Virginia,W (32-25),24,41,58.5,361,4,34,147,4.3,0,75,508,6.8,16,10,1,27,7,68,1,1,2
4703,9,2016-11-05,louisville,@,Boston College,W (52-7),19,29,65.5,305,4,36,210,5.8,3,65,515,7.9,13,6,3,22,0,0,2,1,3
4704,10,2016-11-12,louisville,,Wake Forest,W (44-12),14,26,53.8,145,1,37,346,9.4,4,63,491,7.8,7,13,0,20,4,55,3,0,3
4705,11,2016-11-17,louisville,@,Houston,L (10-36),20,43,46.5,211,1,40,101,2.5,0,83,312,3.8,8,10,0,18,15,114,3,0,3
4706,12,2016-11-26,louisville,,Kentucky,L (38-41),16,25,64.0,281,2,46,280,6.1,3,71,561,7.9,12,14,0,26,4,48,1,3,4
4707,13,2016-12-31,louisville,N,Louisiana State*,L (9-29),10,27,37.0,153,0,35,67,1.9,0,62,220,3.5,6,4,1,11,8,56,1,0,1
4708,,13 Games,louisville,,,,248,436,56.9,3777,32,525,3148,6.0,37,961,6925,7.2,150,152,23,325,101,919,22,10,32
4709,1,2017-09-02,louisville,N,Purdue,W (35-28),30,46,65.2,378,2,33,146,4.4,1,79,524,6.6,16,8,3,27,16,110,3,0,3
4710,2,2017-09-09,louisville,@,North Carolina,W (47-35),25,39,64.1,393,3,44,312,7.1,3,83,705,8.5,18,15,2,35,6,61,0,0,0
4711,3,2017-09-16,louisville,,Clemson,L (21-47),21,42,50.0,317,3,27,116,4.3,0,69,433,6.3,13,7,1,21,4,35,0,1,1
4712,4,2017-09-23,louisville,,Kent State,W (42-3),23,30,76.7,374,2,27,165,6.1,3,57,539,9.5,12,9,2,23,4,30,2,2,4
4713,5,2017-09-30,louisville,,Murray State,W (55-10),32,45,71.1,364,4,46,312,6.8,3,91,676,7.4,18,16,4,38,7,69,2,0,2
4714,6,2017-10-05,louisville,@,North Carolina State,L (25-39),26,48,54.2,354,1,29,116,4.0,2,77,470,6.1,12,12,1,25,10,69,0,1,1
4715,7,2017-10-14,louisville,,Boston College,L (42-45),19,39,48.7,332,2,36,293,8.1,4,75,625,8.3,12,13,0,25,4,30,1,1,2
4716,8,2017-10-21,louisville,@,Florida State,W (31-28),13,21,61.9,156,1,44,293,6.7,3,65,449,6.9,7,14,1,22,2,13,1,0,1
4717,9,2017-10-28,louisville,@,Wake Forest,L (32-42),28,46,60.9,332,1,42,191,4.5,3,88,523,5.9,19,10,1,30,0,0,0,1,1
4718,10,2017-11-11,louisville,,Virginia,W (38-21),15,26,57.7,195,3,43,298,6.9,2,69,493,7.1,9,15,3,27,6,65,2,0,2
4719,11,2017-11-18,louisville,,Syracuse,W (56-10),17,30,56.7,316,3,42,411,9.8,5,72,727,10.1,12,15,0,27,11,85,0,0,0
4720,12,2017-11-25,louisville,@,Kentucky,W (44-17),15,21,71.4,216,2,43,346,8.0,3,64,562,8.8,11,16,5,32,6,55,0,0,0
4721,13,2017-12-30,louisville,N,Mississippi State*,L (27-31),13,31,41.9,171,2,39,187,4.8,1,70,358,5.1,9,7,4,20,6,42,0,4,4
4722,,13 Games,louisville,,,,277,464,59.7,3898,29,495,3186,6.4,33,959,7084,7.4,168,157,27,352,82,664,11,10,21
4723,1,2018-09-01,louisville,N,Alabama,L (14-51),20,39,51.3,252,2,25,27,1.1,0,64,279,4.4,13,1,5,19,11,93,0,2,2
4724,2,2018-09-08,louisville,,Indiana State,W (31-7),14,22,63.6,164,1,38,199,5.2,2,60,363,6.1,6,12,1,19,7,75,1,1,2
4725,3,2018-09-15,louisville,,Western Kentucky,W (20-17),10,21,47.6,88,0,38,204,5.4,2,59,292,4.9,4,11,2,17,5,40,0,1,1
4726,4,2018-09-22,louisville,@,Virginia,L (3-27),16,28,57.1,148,0,29,66,2.3,0,57,214,3.8,11,3,0,14,6,52,1,2,3
4727,5,2018-09-29,louisville,,Florida State,L (24-28),24,45,53.3,306,2,38,115,3.0,1,83,421,5.1,11,11,2,24,8,75,1,2,3
4728,6,2018-10-05,louisville,,Georgia Tech,L (31-66),27,44,61.4,370,3,23,113,4.9,1,67,483,7.2,14,7,2,23,4,35,2,1,3
4729,7,2018-10-13,louisville,@,Boston College,L (20-38),17,35,48.6,170,0,32,47,1.5,3,67,217,3.2,10,4,1,15,4,33,0,1,1
4730,8,2018-10-27,louisville,,Wake Forest,L (35-56),30,54,55.6,358,1,36,174,4.8,4,90,532,5.9,19,11,1,31,5,31,1,0,1
4731,9,2018-11-03,louisville,@,Clemson,L (16-77),17,34,50.0,231,0,36,81,2.3,1,70,312,4.5,8,8,0,16,10,100,1,2,3
4732,10,2018-11-09,louisville,@,Syracuse,L (23-54),14,31,45.2,210,1,39,203,5.2,2,70,413,5.9,7,9,2,18,17,125,2,2,4
4733,11,2018-11-17,louisville,,North Carolina State,L (10-52),13,25,52.0,157,0,38,254,6.7,1,63,411,6.5,8,11,0,19,12,68,1,1,2
4734,,11 Games,louisville,,,,202,378,53.4,2454,10,372,1483,4.0,17,750,3937,5.2,111,88,16,215,89,727,10,15,25
4735,1,2014-08-30,texas-christian,,Samford,W (48-14),33,50,66.0,355,3,46,200,4.3,3,96,555,5.8,17,15,1,33,4,60,1,1,2
4736,2,2014-09-13,texas-christian,,Minnesota,W (30-7),27,46,58.7,258,2,27,169,6.3,1,73,427,5.8,13,8,1,22,8,72,1,1,2
4737,3,2014-09-27,texas-christian,@,Southern Methodist,W (56-0),28,43,65.1,349,5,38,265,7.0,3,81,614,7.6,18,12,1,31,5,48,0,0,0
4738,4,2014-10-04,texas-christian,,Oklahoma,W (37-33),20,39,51.3,318,2,39,151,3.9,2,78,469,6.0,12,8,3,23,12,90,2,1,3
4739,5,2014-10-11,texas-christian,@,Baylor,L (58-61),22,48,45.8,346,1,41,139,3.4,4,89,485,5.4,12,7,4,23,8,110,1,0,1
4740,6,2014-10-18,texas-christian,,Oklahoma State,W (42-9),27,42,64.3,415,3,40,261,6.5,3,82,676,8.2,12,13,1,26,5,45,0,1,1
4741,7,2014-10-25,texas-christian,,Texas Tech,W (82-27),27,45,60.0,480,7,41,305,7.4,3,86,785,9.1,16,13,3,32,10,77,0,0,0
4742,8,2014-11-01,texas-christian,@,West Virginia,W (31-30),12,30,40.0,166,1,42,223,5.3,3,72,389,5.4,5,11,0,16,5,40,1,1,2
4743,9,2014-11-08,texas-christian,,Kansas State,W (41-20),23,34,67.6,219,1,48,334,7.0,4,82,553,6.7,12,14,2,28,4,35,0,0,0
4744,10,2014-11-15,texas-christian,@,Kansas,W (34-30),26,36,72.2,330,1,36,133,3.7,2,72,463,6.4,13,10,1,24,5,40,2,1,3
4745,11,2014-11-27,texas-christian,@,Texas,W (48-10),20,34,58.8,233,2,31,135,4.4,2,65,368,5.7,10,5,1,16,6,45,1,1,2
4746,12,2014-12-06,texas-christian,,Iowa State,W (55-3),33,45,73.3,525,5,38,197,5.2,1,83,722,8.7,20,12,1,33,5,50,1,1,2
4747,13,2014-12-31,texas-christian,N,Mississippi*,W (42-3),27,37,73.0,246,4,42,177,4.2,1,79,423,5.4,13,11,0,24,5,55,1,3,4
4748,,13 Games,texas-christian,,,,325,529,61.4,4240,37,509,2689,5.3,32,1038,6929,6.7,173,139,19,331,82,767,11,11,22
4749,1,2015-09-03,texas-christian,@,Minnesota,W (23-17),26,42,61.9,246,1,44,203,4.6,1,86,449,5.2,13,10,2,25,9,50,1,1,2
4750,2,2015-09-12,texas-christian,,Stephen F. Austin,W (70-7),26,37,70.3,403,5,45,224,5.0,4,82,627,7.6,14,16,0,30,3,43,0,1,1
4751,3,2015-09-19,texas-christian,,Southern Methodist,W (56-37),21,30,70.0,454,5,41,266,6.5,3,71,720,10.1,16,12,0,28,9,115,0,1,1
4752,4,2015-09-26,texas-christian,@,Texas Tech,W (55-52),35,56,62.5,503,4,47,247,5.3,3,103,750,7.3,24,13,1,38,10,110,0,0,0
4753,5,2015-10-03,texas-christian,,Texas,W (50-7),22,38,57.9,376,6,42,228,5.4,0,80,604,7.6,18,12,1,31,8,84,0,0,0
4754,6,2015-10-10,texas-christian,@,Kansas State,W (52-45),20,30,66.7,301,2,23,242,10.5,4,53,543,10.2,13,7,2,22,11,81,0,2,2
4755,7,2015-10-17,texas-christian,@,Iowa State,W (45-21),28,34,82.4,444,4,41,177,4.3,2,75,621,8.3,20,7,3,30,7,75,1,0,1
4756,8,2015-10-29,texas-christian,,West Virginia,W (40-10),32,48,66.7,388,3,40,228,5.7,1,88,616,7.0,18,12,5,35,9,100,0,0,0
4757,9,2015-11-07,texas-christian,@,Oklahoma State,L (29-49),35,58,60.3,445,1,52,218,4.2,3,110,663,6.0,21,12,3,36,7,70,0,4,4
4758,10,2015-11-14,texas-christian,,Kansas,W (23-17),19,34,55.9,208,1,58,279,4.8,0,92,487,5.3,9,15,1,25,3,27,0,1,1
4759,11,2015-11-21,texas-christian,@,Oklahoma,L (29-30),13,29,44.8,229,3,36,161,4.5,1,65,390,6.0,5,9,2,16,2,19,1,3,4
4760,12,2015-11-27,texas-christian,,Baylor,W (28-21),18,33,54.5,148,2,46,154,3.3,1,79,302,3.8,5,8,2,15,8,65,1,1,2
4761,13,2016-01-02,texas-christian,N,Oregon*,W (47-41),30,47,63.8,371,2,47,174,3.7,3,94,545,5.8,14,12,1,27,8,83,0,1,1
4762,,13 Games,texas-christian,,,,325,516,63.0,4516,39,562,2801,5.0,26,1078,7317,6.8,190,145,23,358,94,922,4,15,19
4763,1,2016-09-03,texas-christian,,South Dakota State,W (59-41),33,50,66.0,439,2,37,223,6.0,5,87,662,7.6,22,11,2,35,12,125,0,2,2
4764,2,2016-09-10,texas-christian,,Arkansas,L (38-41),36,58,62.1,377,1,32,195,6.1,4,90,572,6.4,19,6,0,25,9,95,1,1,2
4765,3,2016-09-17,texas-christian,,Iowa State,W (41-20),22,35,62.9,252,1,37,229,6.2,4,72,481,6.7,12,8,2,22,5,50,0,0,0
4766,4,2016-09-23,texas-christian,@,Southern Methodist,W (33-3),32,47,68.1,452,2,31,137,4.4,1,78,589,7.6,16,8,1,25,8,65,0,1,1
4767,5,2016-10-01,texas-christian,,Oklahoma,L (46-52),26,45,57.8,449,5,29,65,2.2,1,74,514,6.9,14,4,1,19,9,64,0,1,1
4768,6,2016-10-08,texas-christian,@,Kansas,W (24-23),17,32,53.1,206,1,34,160,4.7,2,66,366,5.5,7,9,2,18,7,79,1,3,4
4769,7,2016-10-22,texas-christian,@,West Virginia,L (10-34),18,31,58.1,148,1,29,152,5.2,0,60,300,5.0,6,11,1,18,10,67,2,1,3
4770,8,2016-10-29,texas-christian,,Texas Tech,L (24-27),22,47,46.8,246,1,39,172,4.4,2,86,418,4.9,14,11,0,25,4,25,0,1,1
4771,9,2016-11-05,texas-christian,@,Baylor,W (62-22),18,31,58.1,257,1,59,431,7.3,6,90,688,7.6,9,21,4,34,7,55,0,0,0
4772,10,2016-11-19,texas-christian,,Oklahoma State,L (6-31),20,33,60.6,198,1,39,145,3.7,0,72,343,4.8,9,7,2,18,4,49,0,2,2
4773,11,2016-11-25,texas-christian,@,Texas,W (31-9),16,30,53.3,178,0,46,309,6.7,4,76,487,6.4,10,13,2,25,7,68,0,1,1
4774,12,2016-12-03,texas-christian,,Kansas State,L (6-30),17,36,47.2,138,0,37,142,3.8,0,73,280,3.8,5,8,2,15,4,45,0,1,1
4775,13,2016-12-30,texas-christian,N,Georgia*,L (23-31),18,28,64.3,146,2,39,175,4.5,1,67,321,4.8,7,8,2,17,2,10,2,0,2
4776,,13 Games,texas-christian,,,,295,503,58.6,3486,18,488,2535,5.2,30,991,6021,6.1,150,125,21,296,88,797,6,14,20
4777,1,2017-09-02,texas-christian,,Jackson State,W (63-0),23,30,76.7,300,6,36,242,6.7,1,66,542,8.2,11,13,0,24,5,51,0,1,1
4778,2,2017-09-09,texas-christian,@,Arkansas,W (28-7),21,31,67.7,166,0,42,195,4.6,4,73,361,4.9,8,15,1,24,6,60,1,1,2
4779,3,2017-09-16,texas-christian,,Southern Methodist,W (56-36),24,30,80.0,365,4,49,254,5.2,3,79,619,7.8,16,13,1,30,11,94,3,0,3
4780,4,2017-09-23,texas-christian,@,Oklahoma State,W (44-31),22,33,66.7,228,1,52,238,4.6,4,85,466,5.5,12,14,6,32,4,23,0,1,1
4781,5,2017-10-07,texas-christian,,West Virginia,W (31-24),16,29,55.2,236,2,36,170,4.7,2,65,406,6.2,9,7,0,16,5,51,0,0,0
4782,6,2017-10-14,texas-christian,@,Kansas State,W (26-6),27,37,73.0,297,0,36,98,2.7,3,73,395,5.4,11,5,1,17,7,51,1,0,1
4783,7,2017-10-21,texas-christian,,Kansas,W (43-0),20,28,71.4,284,5,42,191,4.5,0,70,475,6.8,11,10,1,22,7,55,0,0,0
4784,8,2017-10-28,texas-christian,@,Iowa State,L (7-14),12,25,48.0,135,0,34,172,5.1,0,59,307,5.2,7,6,1,14,11,104,1,2,3
4785,9,2017-11-04,texas-christian,,Texas,W (24-7),19,27,70.4,166,0,46,177,3.8,3,73,343,4.7,7,8,2,17,9,49,0,0,0
4786,10,2017-11-11,texas-christian,@,Oklahoma,L (20-38),14,29,48.3,269,1,32,155,4.8,2,61,424,7.0,7,10,2,19,7,60,0,0,0
4787,11,2017-11-18,texas-christian,@,Texas Tech,W (27-3),6,17,35.3,85,1,42,204,4.9,1,59,289,4.9,4,10,3,17,6,55,1,0,1
4788,12,2017-11-24,texas-christian,,Baylor,W (45-22),26,36,72.2,325,3,36,112,3.1,3,72,437,6.1,13,9,3,25,3,23,0,0,0
4789,13,2017-12-02,texas-christian,N,Oklahoma,L (17-41),27,37,73.0,234,2,24,83,3.5,0,61,317,5.2,14,5,1,20,7,70,1,1,2
4790,14,2017-12-28,texas-christian,N,Stanford*,W (39-37),28,41,68.3,341,3,26,147,5.7,1,67,488,7.3,13,8,0,21,1,4,1,2,3
4791,,14 Games,texas-christian,,,,285,430,66.3,3431,28,533,2438,4.6,27,963,5869,6.1,143,133,22,298,89,750,9,8,17
4792,1,2018-09-01,texas-christian,,Southern,W (55-7),21,32,65.6,264,4,42,235,5.6,2,74,499,6.7,16,12,2,30,5,48,0,0,0
4793,2,2018-09-07,texas-christian,@,Southern Methodist,W (42-12),15,28,53.6,146,1,42,247,5.9,3,70,393,5.6,5,17,1,23,4,35,1,1,2
4794,3,2018-09-15,texas-christian,N,Ohio State,L (28-40),24,40,60.0,308,1,36,203,5.6,3,76,511,6.7,13,8,1,22,5,40,1,2,3
4795,4,2018-09-22,texas-christian,@,Texas,L (16-31),20,39,51.3,231,1,32,141,4.4,0,71,372,5.2,9,7,0,16,3,30,1,3,4
4796,5,2018-09-29,texas-christian,,Iowa State,W (17-14),21,29,72.4,182,1,46,117,2.5,0,75,299,4.0,10,9,0,19,5,55,2,1,3
4797,6,2018-10-11,texas-christian,,Texas Tech,L (14-17),26,45,57.8,290,2,32,121,3.8,0,77,411,5.3,12,6,2,20,8,63,1,2,3
4798,7,2018-10-20,texas-christian,,Oklahoma,L (27-52),10,25,40.0,163,2,30,112,3.7,0,55,275,5.0,6,5,1,12,2,10,0,1,1
4799,8,2018-10-27,texas-christian,@,Kansas,L (26-27),23,33,69.7,351,1,39,153,3.9,2,72,504,7.0,17,7,3,27,5,57,1,1,2
4800,9,2018-11-03,texas-christian,,Kansas State,W (14-13),17,33,51.5,218,1,26,57,2.2,1,59,275,4.7,8,5,0,13,2,15,1,0,1
4801,10,2018-11-10,texas-christian,@,West Virginia,L (10-47),22,37,59.5,229,1,24,-7,-0.3,0,61,222,3.6,9,3,0,12,2,15,2,0,2
4802,11,2018-11-17,texas-christian,@,Baylor,W (16-9),15,21,71.4,151,1,42,160,3.8,1,63,311,4.9,4,10,0,14,8,80,0,0,0
4803,,11 Games,texas-christian,,,,214,362,59.1,2533,16,391,1539,3.9,12,753,4072,5.4,109,89,10,208,49,448,10,11,21
4804,1,2014-09-12,cincinnati,,Toledo,W (58-34),29,42,69.0,436,6,30,148,4.9,2,72,584,8.1,21,6,1,28,2,30,0,0,0
4805,2,2014-09-20,cincinnati,N,Miami (OH),W (31-24),25,39,64.1,271,4,30,99,3.3,0,69,370,5.4,13,7,2,22,4,30,0,2,2
4806,3,2014-09-27,cincinnati,@,Ohio State,L (28-50),21,33,63.6,352,4,19,70,3.7,0,52,422,8.1,10,5,0,15,6,40,0,0,0
4807,4,2014-10-04,cincinnati,N,Memphis,L (14-41),16,40,40.0,255,1,25,97,3.9,1,65,352,5.4,13,4,2,19,6,55,1,1,2
4808,5,2014-10-11,cincinnati,@,Miami (FL),L (34-55),31,60,51.7,355,3,29,67,2.3,0,89,422,4.7,17,5,4,26,5,54,0,3,3
4809,6,2014-10-18,cincinnati,@,Southern Methodist,W (41-3),17,27,63.0,268,1,46,240,5.2,3,73,508,7.0,12,14,3,29,6,69,0,0,0
4810,7,2014-10-24,cincinnati,N,South Florida,W (34-17),27,37,73.0,317,1,50,273,5.5,3,87,590,6.8,16,12,3,31,4,37,3,0,3
4811,8,2014-10-31,cincinnati,@,Tulane,W (38-14),17,26,65.4,214,3,35,265,7.6,1,61,479,7.9,11,8,2,21,5,35,1,2,3
4812,9,2014-11-13,cincinnati,N,East Carolina,W (54-46),29,45,64.4,436,4,33,150,4.5,2,78,586,7.5,19,9,1,29,8,64,1,3,4
4813,10,2014-11-22,cincinnati,@,Connecticut,W (41-0),20,36,55.6,176,3,48,249,5.2,2,84,425,5.1,10,13,1,24,2,25,0,1,1
4814,11,2014-11-29,cincinnati,@,Temple,W (14-6),19,31,61.3,174,1,33,81,2.5,1,64,255,4.0,9,4,1,14,3,20,1,0,1
4815,12,2014-12-06,cincinnati,N,Houston,W (38-31),25,38,65.8,348,2,43,152,3.5,3,81,500,6.2,20,11,2,33,1,10,0,0,0
4816,13,2014-12-27,cincinnati,N,Virginia Tech*,L (17-33),18,37,48.6,345,2,33,144,4.4,0,70,489,7.0,14,5,0,19,7,73,1,2,3
4817,,13 Games,cincinnati,,,,294,491,59.9,3947,35,454,2035,4.5,18,945,5982,6.3,185,103,22,310,59,542,8,14,22
4818,1,2015-09-05,cincinnati,,Alabama A&M,W (52-10),26,38,68.4,340,3,51,296,5.8,4,89,636,7.1,17,14,3,34,8,79,2,0,2
4819,2,2015-09-12,cincinnati,,Temple,L (26-34),30,52,57.7,427,2,31,130,4.2,1,83,557,6.7,21,8,5,34,5,51,1,4,5
4820,3,2015-09-19,cincinnati,@,Miami (OH),W (37-33),22,40,55.0,263,1,54,282,5.2,3,94,545,5.8,15,15,3,33,7,55,2,2,4
4821,4,2015-09-24,cincinnati,@,Memphis,L (46-53),38,64,59.4,620,4,36,132,3.7,1,100,752,7.5,27,8,3,38,11,101,0,3,3
4822,5,2015-10-01,cincinnati,,Miami (FL),W (34-23),22,33,66.7,279,2,34,167,4.9,2,67,446,6.7,13,9,0,22,7,75,0,1,1
4823,6,2015-10-16,cincinnati,@,Brigham Young,L (24-38),16,31,51.6,220,1,46,121,2.6,2,77,341,4.4,13,6,2,21,9,65,0,0,0
4824,7,2015-10-24,cincinnati,,Connecticut,W (37-13),26,35,74.3,327,2,49,285,5.8,2,84,612,7.3,14,14,0,28,10,105,1,0,1
4825,8,2015-10-31,cincinnati,,Central Florida,W (52-7),27,32,84.4,489,6,42,237,5.6,1,74,726,9.8,17,11,5,33,7,62,0,1,1
4826,9,2015-11-07,cincinnati,@,Houston,L (30-33),28,51,54.9,523,4,18,66,3.7,0,69,589,8.5,20,3,1,24,11,85,1,2,3
4827,10,2015-11-14,cincinnati,,Tulsa,W (49-38),29,42,69.0,386,2,41,266,6.5,5,83,652,7.9,21,11,1,33,10,68,2,1,3
4828,11,2015-11-20,cincinnati,@,South Florida,L (27-65),28,51,54.9,333,1,35,97,2.8,2,86,430,5.0,14,10,1,25,4,42,2,4,6
4829,12,2015-11-28,cincinnati,@,East Carolina,W (19-16),30,47,63.8,270,1,43,157,3.7,1,90,427,4.7,16,12,2,30,5,50,0,1,1
4830,13,2015-12-24,cincinnati,N,San Diego State*,L (7-42),19,31,61.3,202,0,32,77,2.4,1,63,279,4.4,9,5,1,15,10,110,0,3,3
4831,,13 Games,cincinnati,,,,341,547,62.3,4679,29,512,2313,4.5,25,1059,6992,6.6,217,126,27,370,104,948,11,22,33
4832,1,2016-09-01,cincinnati,,Tennessee-Martin,W (28-7),21,34,61.8,260,2,34,140,4.1,1,68,400,5.9,13,8,1,22,5,60,2,1,3
4833,2,2016-09-10,cincinnati,@,Purdue,W (38-20),19,32,59.4,250,3,46,262,5.7,2,78,512,6.6,12,9,1,22,5,45,0,0,0
4834,3,2016-09-15,cincinnati,,Houston,L (16-40),22,39,56.4,277,2,25,30,1.2,0,64,307,4.8,11,1,1,13,2,15,0,3,3
4835,4,2016-09-24,cincinnati,,Miami (OH),W (27-20),25,38,65.8,276,0,48,187,3.9,3,86,463,5.4,15,12,1,28,5,60,1,2,3
4836,5,2016-10-01,cincinnati,,South Florida,L (20-45),23,41,56.1,263,1,35,130,3.7,2,76,393,5.2,11,8,2,21,4,40,1,3,4
4837,6,2016-10-08,cincinnati,@,Connecticut,L (9-20),29,56,51.8,315,0,22,2,0.1,0,78,317,4.1,18,2,2,22,5,57,0,1,1
4838,7,2016-10-22,cincinnati,,East Carolina,W (31-19),23,40,57.5,348,4,35,165,4.7,0,75,513,6.8,11,12,2,25,9,82,0,0,0
4839,8,2016-10-29,cincinnati,@,Temple,L (13-34),15,27,55.6,119,2,22,67,3.0,0,49,186,3.8,8,2,0,10,4,35,2,0,2
4840,9,2016-11-05,cincinnati,,Brigham Young,L (3-20),19,32,59.4,199,0,25,96,3.8,0,57,295,5.2,12,4,0,16,4,40,0,1,1
4841,10,2016-11-12,cincinnati,@,Central Florida,L (3-24),19,42,45.2,220,0,36,107,3.0,0,78,327,4.2,11,6,1,18,2,15,1,2,3
4842,11,2016-11-18,cincinnati,,Memphis,L (7-34),23,34,67.6,144,1,35,100,2.9,0,69,244,3.5,9,7,1,17,5,52,1,2,3
4843,12,2016-11-25,cincinnati,@,Tulsa,L (37-40),21,38,55.3,400,4,33,134,4.1,0,71,534,7.5,12,5,1,18,5,43,0,0,0
4844,,12 Games,cincinnati,,,,259,453,57.2,3071,19,396,1420,3.6,8,849,4491,5.3,143,76,13,232,55,544,8,15,23
4845,1,2017-08-31,cincinnati,,Austin Peay,W (26-14),17,28,60.7,151,3,29,97,3.3,1,57,248,4.4,7,6,2,15,7,70,0,0,0
4846,2,2017-09-09,cincinnati,@,Michigan,L (14-36),15,40,37.5,132,1,30,68,2.3,1,70,200,2.9,6,4,3,13,4,30,0,2,2
4847,3,2017-09-16,cincinnati,@,Miami (OH),W (21-17),24,43,55.8,222,1,35,139,4.0,0,78,361,4.6,10,8,3,21,6,56,0,2,2
4848,4,2017-09-23,cincinnati,@,Navy,L (32-42),28,46,60.9,381,3,23,58,2.5,1,69,439,6.4,19,3,0,22,6,60,1,0,1
4849,5,2017-09-30,cincinnati,,Marshall,L (21-38),22,45,48.9,211,1,26,138,5.3,2,71,349,4.9,9,7,5,21,7,78,3,0,3
4850,6,2017-10-07,cincinnati,,Central Florida,L (23-51),23,40,57.5,278,1,26,113,4.3,2,66,391,5.9,13,6,2,21,9,74,0,1,1
4851,7,2017-10-14,cincinnati,@,South Florida,L (3-33),21,37,56.8,178,0,33,95,2.9,0,70,273,3.9,9,7,5,21,11,98,1,1,2
4852,8,2017-10-21,cincinnati,,Southern Methodist,L (28-31),22,35,62.9,189,2,42,249,5.9,1,77,438,5.7,11,14,1,26,6,46,1,1,2
4853,9,2017-11-04,cincinnati,@,Tulane,W (17-16),18,27,66.7,248,1,35,208,5.9,1,62,456,7.4,11,8,0,19,12,123,0,0,0
4854,10,2017-11-10,cincinnati,,Temple,L (24-35),21,37,56.8,221,2,35,184,5.3,1,72,405,5.6,8,10,3,21,11,107,1,0,1
4855,11,2017-11-18,cincinnati,@,East Carolina,L (20-48),15,28,53.6,187,3,31,139,4.5,0,59,326,5.5,6,11,0,17,10,90,0,1,1
4856,12,2017-11-25,cincinnati,,Connecticut,W (22-21),19,28,67.9,199,2,26,136,5.2,1,54,335,6.2,11,8,0,19,5,44,0,1,1
4857,,12 Games,cincinnati,,,,245,434,56.5,2597,20,371,1624,4.4,11,805,4221,5.2,120,92,24,236,94,876,7,9,16
4858,1,2018-09-01,cincinnati,@,UCLA,W (26-17),14,26,53.8,110,0,51,194,3.8,3,77,304,3.9,7,11,0,18,7,45,1,0,1
4859,2,2018-09-08,cincinnati,@,Miami (OH),W (21-0),6,11,54.5,45,1,51,188,3.7,2,62,233,3.8,3,9,1,13,8,86,0,0,0
4860,3,2018-09-15,cincinnati,,Alabama A&M,W (63-7),21,26,80.8,332,3,55,409,7.4,5,81,741,9.1,12,26,0,38,7,75,0,1,1
4861,4,2018-09-22,cincinnati,,Ohio,W (34-30),19,31,61.3,274,2,34,150,4.4,3,65,424,6.5,12,10,2,24,14,150,0,1,1
4862,5,2018-09-29,cincinnati,@,Connecticut,W (49-7),23,29,79.3,339,2,53,320,6.0,5,82,659,8.0,18,13,0,31,11,113,1,0,1
4863,6,2018-10-06,cincinnati,,Tulane,W (37-21),15,25,60.0,174,2,48,272,5.7,3,73,446,6.1,8,10,4,22,7,65,2,1,3
4864,7,2018-10-20,cincinnati,@,Temple,L (17-24),14,34,41.2,111,0,47,200,4.3,2,81,311,3.8,8,11,1,20,7,65,2,1,3
4865,8,2018-10-27,cincinnati,@,Southern Methodist,W (26-20),33,50,66.0,352,2,39,125,3.2,0,89,477,5.4,15,9,1,25,6,51,1,2,3
4866,9,2018-11-03,cincinnati,,Navy,W (42-0),14,20,70.0,189,2,41,262,6.4,4,61,451,7.4,8,14,0,22,4,30,0,0,0
4867,10,2018-11-10,cincinnati,,South Florida,W (35-23),17,24,70.8,194,2,52,238,4.6,3,76,432,5.7,8,14,2,24,5,22,2,0,2
4868,11,2018-11-17,cincinnati,@,Central Florida,L (13-38),11,26,42.3,127,0,55,252,4.6,1,81,379,4.7,6,13,1,20,9,70,3,0,3
4869,,11 Games,cincinnati,,,,187,302,61.9,2247,16,526,2610,5.0,31,828,4857,5.9,105,140,12,257,85,772,12,6,18
4870,1,2014-08-30,south-florida,,Western Carolina,W (36-31),10,27,37.0,191,0,33,294,8.9,4,60,485,8.1,6,6,1,13,6,38,1,1,2
4871,2,2014-09-06,south-florida,,Maryland,L (17-24),15,37,40.5,174,0,37,83,2.2,1,74,257,3.5,9,6,1,16,6,39,0,1,1
4872,3,2014-09-13,south-florida,,North Carolina State,L (17-49),5,20,25.0,89,1,27,70,2.6,0,47,159,3.4,3,4,1,8,5,40,1,2,3
4873,4,2014-09-19,south-florida,,Connecticut,W (17-14),10,18,55.6,113,1,53,158,3.0,1,71,271,3.8,6,10,1,17,5,45,0,1,1
4874,5,2014-09-27,south-florida,@,Wisconsin,L (10-27),8,19,42.1,173,0,19,72,3.8,1,38,245,6.4,5,3,0,8,11,90,1,1,2
4875,6,2014-10-11,south-florida,,East Carolina,L (17-28),21,42,50.0,257,1,27,93,3.4,1,69,350,5.1,12,6,5,23,8,59,0,1,1
4876,7,2014-10-18,south-florida,@,Tulsa,W (38-30),17,26,65.4,272,3,32,140,4.4,2,58,412,7.1,12,5,2,19,7,77,1,1,2
4877,8,2014-10-24,south-florida,N,Cincinnati,L (17-34),20,33,60.6,239,2,22,42,1.9,0,55,281,5.1,9,3,0,12,7,95,2,2,4
4878,9,2014-11-01,south-florida,,Houston,L (3-27),13,26,50.0,146,0,29,76,2.6,0,55,222,4.0,8,5,0,13,5,45,0,1,1
4879,10,2014-11-15,south-florida,@,Southern Methodist,W (14-13),15,31,48.4,211,2,40,167,4.2,0,71,378,5.3,10,8,0,18,8,96,2,0,2
4880,11,2014-11-22,south-florida,@,Memphis,L (20-31),27,46,58.7,301,1,35,95,2.7,1,81,396,4.9,15,3,2,20,2,29,1,0,1
4881,12,2014-11-28,south-florida,,Central Florida,L (0-16),18,39,46.2,195,0,22,5,0.2,0,61,200,3.3,9,3,3,15,5,75,0,0,0
4882,,12 Games,south-florida,,,,179,364,49.2,2361,11,376,1295,3.4,11,740,3656,4.9,104,62,16,182,75,728,9,11,20
4883,1,2015-09-05,south-florida,,Florida A&M,W (51-3),20,26,76.9,281,3,46,275,6.0,4,72,556,7.7,9,15,3,27,11,97,0,1,1
4884,2,2015-09-12,south-florida,@,Florida State,L (14-34),12,24,50.0,125,2,36,149,4.1,0,60,274,4.6,5,6,0,11,2,21,0,1,1
4885,3,2015-09-19,south-florida,@,Maryland,L (17-35),10,22,45.5,60,1,50,240,4.8,1,72,300,4.2,3,12,3,18,10,105,0,2,2
4886,4,2015-10-02,south-florida,,Memphis,L (17-24),17,26,65.4,199,1,43,178,4.1,1,69,377,5.5,8,7,4,19,6,40,0,1,1
4887,5,2015-10-10,south-florida,,Syracuse,W (45-24),15,22,68.2,259,2,47,281,6.0,4,69,540,7.8,10,15,1,26,9,85,1,0,1
4888,6,2015-10-17,south-florida,@,Connecticut,W (28-20),12,16,75.0,186,3,44,275,6.3,1,60,461,7.7,6,11,0,17,3,30,0,2,2
4889,7,2015-10-24,south-florida,,Southern Methodist,W (38-14),9,21,42.9,97,0,44,255,5.8,5,65,352,5.4,3,10,2,15,4,40,1,0,1
4890,8,2015-10-31,south-florida,@,Navy,L (17-29),12,20,60.0,208,0,24,62,2.6,1,44,270,6.1,7,1,1,9,6,54,1,0,1
4891,9,2015-11-07,south-florida,@,East Carolina,W (22-17),12,23,52.2,200,2,60,242,4.0,0,83,442,5.3,10,10,2,22,6,58,1,0,1
4892,10,2015-11-14,south-florida,,Temple,W (44-23),15,22,68.2,230,2,48,326,6.8,3,70,556,7.9,8,13,1,22,8,86,1,0,1
4893,11,2015-11-20,south-florida,,Cincinnati,W (65-27),13,20,65.0,200,5,53,361,6.8,3,73,561,7.7,7,18,0,25,1,11,1,2,3
4894,12,2015-11-26,south-florida,@,Central Florida,W (44-3),15,23,65.2,174,3,54,281,5.2,2,77,455,5.9,8,16,1,25,4,20,0,0,0
4895,13,2015-12-21,south-florida,N,Western Kentucky*,L (35-45),15,34,44.1,307,2,45,290,6.4,3,79,597,7.6,11,16,1,28,9,67,0,0,0
4896,,13 Games,south-florida,,,,177,299,59.2,2526,26,594,3215,5.4,28,893,5741,6.4,95,150,19,264,79,714,6,9,15
4897,1,2016-09-03,south-florida,,Towson,W (56-20),13,25,52.0,230,4,41,214,5.2,4,66,444,6.7,9,10,3,22,4,42,1,1,2
4898,2,2016-09-10,south-florida,,Northern Illinois,W (48-17),25,39,64.1,365,4,50,293,5.9,2,89,658,7.4,15,15,4,34,8,77,1,0,1
4899,3,2016-09-17,south-florida,@,Syracuse,W (45-20),14,29,48.3,220,1,32,240,7.5,4,61,460,7.5,9,10,1,20,4,50,0,0,0
4900,4,2016-09-24,south-florida,,Florida State,L (35-55),5,14,35.7,160,1,41,290,7.1,4,55,450,8.2,3,12,2,17,8,68,0,2,2
4901,5,2016-10-01,south-florida,@,Cincinnati,W (45-20),22,33,66.7,228,0,48,226,4.7,5,81,454,5.6,12,13,0,25,2,21,0,0,0
4902,6,2016-10-08,south-florida,,East Carolina,W (38-22),21,29,72.4,250,3,42,306,7.3,2,71,556,7.8,8,14,1,23,9,101,1,0,1
4903,7,2016-10-15,south-florida,,Connecticut,W (42-27),23,37,62.2,213,2,47,316,6.7,4,84,529,6.3,11,15,0,26,4,36,2,2,4
4904,8,2016-10-21,south-florida,@,Temple,L (30-46),11,20,55.0,187,2,33,165,5.0,2,53,352,6.6,9,8,1,18,11,88,0,1,1
4905,9,2016-10-28,south-florida,,Navy,W (52-45),20,30,66.7,217,2,44,412,9.4,5,74,629,8.5,11,14,0,25,8,50,1,0,1
4906,10,2016-11-12,south-florida,@,Memphis,W (49-42),24,29,82.8,263,2,50,416,8.3,5,79,679,8.6,11,17,2,30,7,75,0,0,0
4907,11,2016-11-19,south-florida,@,Southern Methodist,W (35-27),7,15,46.7,195,3,43,278,6.5,2,58,473,8.2,4,12,0,16,7,55,1,1,2
4908,12,2016-11-26,south-florida,,Central Florida,W (48-31),17,26,65.4,152,0,48,351,7.3,5,74,503,6.8,6,14,0,20,6,50,1,0,1
4909,13,2016-12-29,south-florida,N,South Carolina*,W (46-39),23,32,71.9,261,2,48,208,4.3,3,80,469,5.9,13,10,1,24,5,50,1,1,2
4910,,13 Games,south-florida,,,,225,358,62.8,2941,26,567,3715,6.6,47,925,6656,7.2,121,164,15,300,83,763,9,8,17
4911,1,2017-08-26,south-florida,@,San Jose State,W (42-22),13,26,50.0,233,2,74,315,4.3,4,100,548,5.5,10,17,2,29,10,57,0,0,0
4912,2,2017-09-02,south-florida,,Stony Brook,W (31-17),19,32,59.4,186,2,49,153,3.1,2,81,339,4.2,6,13,2,21,5,40,0,1,1
4913,3,2017-09-15,south-florida,,Illinois,W (47-23),17,32,53.1,304,4,66,376,5.7,2,98,680,6.9,14,21,3,38,16,140,0,1,1
4914,4,2017-09-21,south-florida,,Temple,W (43-7),8,20,40.0,96,0,63,312,5.0,4,83,408,4.9,4,15,3,22,9,70,2,0,2
4915,5,2017-09-30,south-florida,@,East Carolina,W (61-31),13,21,61.9,185,2,50,390,7.8,5,71,575,8.1,8,15,2,25,8,102,1,0,1
4916,6,2017-10-14,south-florida,,Cincinnati,W (33-3),17,30,56.7,190,0,53,212,4.0,2,83,402,4.8,9,14,2,25,14,137,0,0,0
4917,7,2017-10-21,south-florida,@,Tulane,W (34-28),10,24,41.7,127,2,52,378,7.3,3,76,505,6.6,6,18,1,25,7,89,0,1,1
4918,8,2017-10-28,south-florida,,Houston,L (24-28),23,38,60.5,325,0,55,137,2.5,3,93,462,5.0,14,6,1,21,5,35,0,0,0
4919,9,2017-11-04,south-florida,@,Connecticut,W (37-20),24,37,64.9,385,3,40,217,5.4,1,77,602,7.8,15,12,1,28,11,100,1,1,2
4920,10,2017-11-16,south-florida,,Tulsa,W (27-20),11,28,39.3,142,2,45,279,6.2,1,73,421,5.8,6,14,1,21,6,60,1,1,2
4921,11,2017-11-24,south-florida,@,Central Florida,L (42-49),24,45,53.3,503,4,39,150,3.8,2,84,653,7.8,16,10,1,27,10,102,1,1,2
4922,12,2017-12-23,south-florida,N,Texas Tech*,W (38-34),17,34,50.0,311,4,48,250,5.2,1,82,561,6.8,12,11,4,27,10,100,2,0,2
4923,,12 Games,south-florida,,,,196,367,53.4,2987,25,634,3169,5.0,30,1001,6156,6.1,120,166,23,309,111,1032,8,6,14
4924,1,2018-09-01,south-florida,,Elon,W (34-14),29,46,63.0,367,3,38,148,3.9,1,84,515,6.1,17,10,0,27,7,55,0,0,0
4925,2,2018-09-08,south-florida,,Georgia Tech,W (49-38),21,31,67.7,202,2,44,224,5.1,3,75,426,5.7,13,13,3,29,5,36,0,1,1
4926,3,2018-09-15,south-florida,N,Illinois,W (25-19),23,40,57.5,411,2,44,215,4.9,1,84,626,7.5,19,11,1,31,14,124,0,2,2
4927,4,2018-09-22,south-florida,,East Carolina,W (20-13),12,20,60.0,181,1,32,115,3.6,2,52,296,5.7,5,4,0,9,3,33,1,0,1
4928,5,2018-10-06,south-florida,@,Massachusetts,W (58-42),17,24,70.8,209,1,41,365,8.9,5,65,574,8.8,8,9,1,18,11,100,1,1,2
4929,6,2018-10-12,south-florida,@,Tulsa,W (25-24),17,40,42.5,237,0,47,250,5.3,3,87,487,5.6,11,12,3,26,8,70,0,1,1
4930,7,2018-10-20,south-florida,,Connecticut,W (38-30),20,28,71.4,265,1,37,346,9.4,4,65,611,9.4,8,16,0,24,9,90,1,2,3
4931,8,2018-10-27,south-florida,@,Houston,L (36-57),26,39,66.7,263,1,42,204,4.9,3,81,467,5.8,14,13,2,29,8,85,1,1,2
4932,9,2018-11-03,south-florida,,Tulane,L (15-41),29,49,59.2,322,0,33,102,3.1,2,82,424,5.2,17,8,2,27,10,91,2,1,3
4933,10,2018-11-10,south-florida,@,Cincinnati,L (23-35),14,32,43.8,232,3,29,81,2.8,0,61,313,5.1,8,4,0,12,8,80,0,0,0
4934,11,2018-11-17,south-florida,@,Temple,L (17-27),14,23,60.9,82,0,48,184,3.8,2,71,266,3.7,3,10,2,15,7,55,3,2,5
4935,,11 Games,south-florida,,,,222,372,59.7,2771,14,435,2234,5.1,26,807,5005,6.2,123,110,14,247,90,819,9,11,20
4936,1,2014-09-06,army,,Buffalo,W (47-39),7,7,100.0,125,0,54,341,6.3,7,61,466,7.6,4,13,0,17,12,105,2,0,2
4937,2,2014-09-13,army,@,Stanford,L (0-35),3,5,60.0,9,0,56,198,3.5,0,61,207,3.4,1,10,1,12,2,20,1,1,2
4938,3,2014-09-20,army,@,Wake Forest,L (21-24),3,5,60.0,18,1,59,341,5.8,2,64,359,5.6,0,16,1,17,7,57,2,0,2
4939,4,2014-09-27,army,@,Yale,L (43-49),12,21,57.1,211,1,53,386,7.3,4,74,597,8.1,8,15,0,23,8,70,0,0,0
4940,5,2014-10-04,army,,Ball State,W (33-24),2,5,40.0,48,0,69,425,6.2,4,74,473,6.4,1,21,2,24,1,15,1,0,1
4941,6,2014-10-11,army,,Rice,L (21-41),6,14,42.9,91,1,54,250,4.6,2,68,341,5.0,2,15,2,19,2,24,2,0,2
4942,7,2014-10-18,army,@,Kent State,L (17-39),5,15,33.3,35,0,56,295,5.3,2,71,330,4.6,1,17,1,19,5,38,0,1,1
4943,8,2014-11-01,army,,Air Force,L (6-23),3,13,23.1,47,0,38,122,3.2,0,51,169,3.3,1,7,0,8,3,41,1,0,1
4944,9,2014-11-08,army,N,Connecticut,W (35-21),2,3,66.7,38,0,59,325,5.5,4,62,363,5.9,2,20,1,23,3,13,1,0,1
4945,10,2014-11-15,army,@,Western Kentucky,L (24-52),3,6,50.0,40,0,57,293,5.1,3,63,333,5.3,2,13,3,18,3,20,0,0,0
4946,11,2014-11-22,army,,Fordham,W (42-31),2,4,50.0,48,0,64,382,6.0,5,68,430,6.3,1,21,0,22,1,5,0,0,0
4947,12,2014-12-13,army,N,Navy,L (10-17),2,7,28.6,37,0,45,198,4.4,0,52,235,4.5,2,13,0,15,2,10,1,0,1
4948,,12 Games,army,,,,50,105,47.6,747,3,664,3556,5.4,33,769,4303,5.6,25,181,11,217,49,418,11,2,13
4949,1,2015-09-04,army,,Fordham,L (35-37),7,16,43.8,133,2,42,256,6.1,3,58,389,6.7,4,17,1,22,3,26,1,1,2
4950,2,2015-09-12,army,@,Connecticut,L (17-22),3,8,37.5,85,1,33,180,5.5,1,41,265,6.5,1,6,2,9,6,60,0,1,1
4951,3,2015-09-19,army,,Wake Forest,L (14-17),2,3,66.7,54,0,54,186,3.4,2,57,240,4.2,2,9,0,11,4,57,0,0,0
4952,4,2015-09-26,army,@,Eastern Michigan,W (58-36),5,9,55.6,98,1,71,556,7.8,7,80,654,8.2,3,24,2,29,6,70,2,1,3
4953,5,2015-10-03,army,@,Penn State,L (14-20),1,1,100.0,32,0,55,261,4.7,2,56,293,5.2,1,16,0,17,4,45,3,0,3
4954,6,2015-10-10,army,,Duke,L (3-44),2,6,33.3,55,0,49,113,2.3,0,55,168,3.1,2,9,1,12,5,32,2,1,3
4955,7,2015-10-17,army,,Bucknell,W (21-14),5,10,50.0,114,1,61,263,4.3,2,71,377,5.3,3,14,1,18,4,35,1,2,3
4956,8,2015-10-24,army,@,Rice,L (31-38),2,10,20.0,18,1,56,378,6.8,3,66,396,6.0,1,14,3,18,2,24,1,0,1
4957,9,2015-11-07,army,@,Air Force,L (3-20),2,8,25.0,45,0,44,124,2.8,0,52,169,3.3,2,6,1,9,4,27,0,0,0
4958,10,2015-11-14,army,,Tulane,L (31-34),7,13,53.8,146,2,55,216,3.9,1,68,362,5.3,6,10,0,16,5,35,1,0,1
4959,11,2015-11-21,army,,Rutgers,L (21-31),4,6,66.7,140,1,52,261,5.0,2,58,401,6.9,4,13,1,18,3,35,1,1,2
4960,12,2015-12-12,army,N,Navy,L (17-21),9,18,50.0,208,1,44,137,3.1,1,62,345,5.6,7,8,1,16,2,28,1,2,3
4961,,12 Games,army,,,,49,108,45.4,1128,10,616,2931,4.8,24,724,4059,5.6,36,146,13,195,48,474,13,9,22
4962,1,2016-09-02,army,@,Temple,W (28-13),2,5,40.0,15,0,67,329,4.9,4,72,344,4.8,1,23,1,25,5,34,0,0,0
4963,2,2016-09-10,army,,Rice,W (31-14),4,6,66.7,66,0,69,348,5.0,4,75,414,5.5,4,18,1,23,5,50,0,0,0
4964,3,2016-09-17,army,@,Texas-El Paso,W (66-14),7,8,87.5,174,1,71,426,6.0,7,79,600,7.6,7,24,2,33,2,10,0,0,0
4965,4,2016-09-24,army,@,Buffalo,L (20-23),4,10,40.0,48,0,67,396,5.9,2,77,444,5.8,2,19,0,21,8,83,1,1,2
4966,5,2016-10-08,army,@,Duke,L (6-13),3,11,27.3,49,0,43,165,3.8,1,54,214,4.0,2,5,1,8,5,40,2,1,3
4967,6,2016-10-15,army,,Lafayette,W (62-7),7,13,53.8,134,3,54,537,9.9,6,67,671,10.0,4,26,1,31,6,64,1,0,1
4968,7,2016-10-22,army,,North Texas,L (18-35),7,21,33.3,94,0,67,302,4.5,2,88,396,4.5,3,19,2,24,9,79,3,4,7
4969,8,2016-10-29,army,@,Wake Forest,W (21-13),6,9,66.7,145,1,64,238,3.7,2,73,383,5.2,4,17,0,21,2,20,1,1,2
4970,9,2016-11-05,army,,Air Force,L (12-31),5,16,31.3,84,1,40,144,3.6,1,56,228,4.1,4,7,4,15,5,35,0,2,2
4971,10,2016-11-12,army,N,Notre Dame,L (6-44),2,8,25.0,13,0,42,229,5.5,1,50,242,4.8,1,9,0,10,7,68,0,1,1
4972,11,2016-11-19,army,,Morgan State,W (60-3),3,8,37.5,57,1,60,504,8.4,7,68,561,8.3,3,23,2,28,4,25,2,0,2
4973,12,2016-12-10,army,N,Navy,W (21-17),2,4,50.0,35,0,70,316,4.5,3,74,351,4.7,1,22,0,23,0,0,3,1,4
4974,13,2016-12-27,army,N,North Texas*,W (38-31),2,4,50.0,53,0,73,481,6.6,6,77,534,6.9,2,20,0,22,4,40,1,0,1
4975,,13 Games,army,,,,54,123,43.9,967,7,787,4415,5.6,46,910,5382,5.9,38,232,14,284,62,548,14,11,25
4976,1,2017-09-01,army,,Fordham,W (64-6),0,2,0.0,0,0,47,513,10.9,8,49,513,10.5,0,22,0,22,3,30,1,0,1
4977,2,2017-09-09,army,,Buffalo,W (21-17),2,8,25.0,17,0,66,322,4.9,3,74,339,4.6,1,16,2,19,5,44,0,0,0
4978,3,2017-09-16,army,@,Ohio State,L (7-38),2,8,25.0,19,0,58,259,4.5,1,66,278,4.2,1,14,1,16,2,22,1,0,1
4979,4,2017-09-23,army,@,Tulane,L (17-21),0,5,0.0,0,0,69,371,5.4,2,74,371,5.0,0,20,2,22,5,35,1,2,3
4980,5,2017-09-30,army,,Texas-El Paso,W (35-21),3,7,42.9,80,1,50,353,7.1,4,57,433,7.6,3,18,1,22,6,47,0,1,1
4981,6,2017-10-07,army,@,Rice,W (49-12),1,3,33.3,9,0,65,418,6.4,6,68,427,6.3,0,20,1,21,5,35,0,1,1
4982,7,2017-10-14,army,,Eastern Michigan,W (28-27),0,5,0.0,0,0,61,413,6.8,4,66,413,6.3,0,21,0,21,4,32,0,0,0
4983,8,2017-10-21,army,,Temple,W (31-28),8,18,44.4,141,1,50,248,5.0,3,68,389,5.7,7,11,1,19,5,46,0,1,1
4984,9,2017-11-04,army,@,Air Force,W (21-0),0,0,,0,0,59,392,6.6,3,59,392,6.6,0,20,0,20,2,10,0,0,0
4985,10,2017-11-11,army,,Duke,W (21-16),1,1,100.0,42,0,57,226,4.0,2,58,268,4.6,1,14,2,17,6,49,1,0,1
4986,11,2017-11-18,army,@,North Texas,L (49-52),1,3,33.3,27,0,67,534,8.0,7,70,561,8.0,1,24,0,25,6,65,1,0,1
4987,12,2017-12-09,army,N,Navy,W (14-13),1,1,100.0,20,0,49,221,4.5,2,50,241,4.8,1,13,1,15,2,10,0,0,0
4988,13,2017-12-23,army,N,San Diego State*,W (42-35),1,4,25.0,6,0,87,440,5.1,5,91,446,4.9,1,28,2,31,4,47,0,1,1
4989,,13 Games,army,,,,20,65,30.8,361,2,785,4710,6.0,50,850,5071,6.0,16,241,13,270,55,472,5,6,11
4990,1,2018-08-31,army,@,Duke,L (14-34),10,21,47.6,197,1,47,168,3.6,1,68,365,5.4,7,11,0,18,7,69,2,0,2
4991,2,2018-09-08,army,,Liberty,W (38-14),2,8,25.0,61,1,74,449,6.1,4,82,510,6.2,2,24,2,28,7,100,0,0,0
4992,3,2018-09-15,army,,Hawaii,W (28-21),6,10,60.0,162,0,66,303,4.6,4,76,465,6.1,6,12,0,18,5,70,0,0,0
4993,4,2018-09-22,army,@,Oklahoma,L (21-28),3,9,33.3,40,0,78,339,4.3,3,87,379,4.4,3,22,1,26,6,50,0,2,2
4994,5,2018-09-29,army,@,Buffalo,W (42-13),4,5,80.0,91,1,64,281,4.4,4,69,372,5.4,3,19,3,25,7,73,0,1,1
4995,6,2018-10-13,army,N,San Jose State,W (52-3),2,5,40.0,54,1,65,341,5.2,5,70,395,5.6,2,19,2,23,3,15,0,0,0
4996,7,2018-10-20,army,,Miami (OH),W (31-30),0,2,0.0,0,0,74,347,4.7,4,76,347,4.6,0,19,1,20,1,5,0,0,0
4997,8,2018-10-27,army,@,Eastern Michigan,W (37-22),7,8,87.5,126,2,73,289,4.0,2,81,415,5.1,4,18,5,27,3,25,0,0,0
4998,9,2018-11-03,army,,Air Force,W (17-14),3,5,60.0,44,0,59,242,4.1,2,64,286,4.5,0,15,1,16,5,69,0,0,0
4999,10,2018-11-10,army,,Lafayette,W (31-13),5,6,83.3,95,0,57,313,5.5,4,63,408,6.5,3,20,0,23,6,40,1,0,1
5000,11,2018-11-17,army,,Colgate,W (28-14),2,6,33.3,25,0,59,261,4.4,4,65,286,4.4,2,18,1,21,3,25,1,0,1
5001,,11 Games,army,,,,44,85,51.8,895,6,716,3333,4.7,37,801,4228,5.3,32,197,16,245,53,541,4,3,7
5002,1,2014-08-30,notre-dame,,Rice,W (48-17),14,22,63.6,295,2,42,281,6.7,4,64,576,9.0,9,14,0,23,2,10,0,0,0
5003,2,2014-09-06,notre-dame,,Michigan,W (31-0),23,34,67.6,226,3,31,54,1.7,1,65,280,4.3,14,3,3,20,3,20,0,0,0
5004,3,2014-09-13,notre-dame,N,Purdue,W (30-14),25,40,62.5,259,2,38,139,3.7,1,78,398,5.1,17,8,2,27,7,43,1,0,1
5005,4,2014-09-27,notre-dame,N,Syracuse,W (31-15),32,39,82.1,362,4,41,161,3.9,0,80,523,6.5,17,10,2,29,8,80,3,2,5
5006,5,2014-10-04,notre-dame,,Stanford,W (17-14),20,43,46.5,241,2,32,129,4.0,0,75,370,4.9,13,5,3,21,1,10,1,1,2
5007,6,2014-10-11,notre-dame,,North Carolina,W (50-43),21,38,55.3,300,3,43,216,5.0,4,81,516,6.4,12,11,4,27,10,76,2,1,3
5008,7,2014-10-18,notre-dame,@,Florida State,L (27-31),31,52,59.6,313,3,35,157,4.5,0,87,470,5.4,11,12,3,26,9,67,0,2,2
5009,8,2014-11-01,notre-dame,N,Navy,W (49-39),18,25,72.0,315,3,39,218,5.6,4,64,533,8.3,11,13,1,25,1,5,0,1,1
5010,9,2014-11-08,notre-dame,@,Arizona State,L (31-55),22,41,53.7,446,2,38,41,1.1,2,79,487,6.2,19,5,0,24,5,43,1,4,5
5011,10,2014-11-15,notre-dame,,Northwestern,L (40-43),21,40,52.5,287,3,40,211,5.3,2,80,498,6.2,15,10,3,28,4,47,3,1,4
5012,11,2014-11-22,notre-dame,,Louisville,L (28-31),16,24,66.7,236,2,29,99,3.4,1,53,335,6.3,9,6,1,16,3,36,0,1,1
5013,12,2014-11-29,notre-dame,@,Southern California,L (14-49),16,39,41.0,245,0,25,104,4.2,2,64,349,5.5,12,6,2,20,3,35,1,1,2
5014,13,2014-12-30,notre-dame,N,Louisiana State*,W (31-28),18,26,69.2,186,1,51,263,5.2,3,77,449,5.8,9,14,0,23,2,15,0,0,0
5015,,13 Games,notre-dame,,,,277,463,59.8,3711,30,484,2073,4.3,24,947,5784,6.1,168,117,24,309,58,487,12,14,26
5016,1,2015-09-05,notre-dame,,Texas,W (38-3),19,23,82.6,313,3,52,214,4.1,2,75,527,7.0,14,14,2,30,6,39,0,0,0
5017,2,2015-09-12,notre-dame,@,Virginia,W (34-27),15,30,50.0,207,3,34,253,7.4,1,64,460,7.2,7,12,1,20,4,40,0,0,0
5018,3,2015-09-19,notre-dame,,Georgia Tech,W (30-22),21,30,70.0,242,1,32,215,6.7,3,62,457,7.4,9,8,0,17,8,55,1,1,2
5019,4,2015-09-26,notre-dame,,Massachusetts,W (62-27),18,28,64.3,224,2,51,457,9.0,6,79,681,8.6,13,17,0,30,8,75,0,1,1
5020,5,2015-10-03,notre-dame,@,Clemson,L (22-24),19,35,54.3,321,2,33,116,3.5,1,68,437,6.4,12,6,2,20,6,45,3,1,4
5021,6,2015-10-10,notre-dame,,Navy,W (41-24),22,31,71.0,281,1,40,178,4.5,4,71,459,6.5,13,12,2,27,4,35,0,1,1
5022,7,2015-10-17,notre-dame,,Southern California,W (41-31),16,25,64.0,262,2,35,214,6.1,2,60,476,7.9,7,12,2,21,4,40,1,0,1
5023,8,2015-10-31,notre-dame,@,Temple,W (24-20),23,36,63.9,299,1,31,168,5.4,2,67,467,7.0,9,7,4,20,8,81,0,2,2
5024,9,2015-11-07,notre-dame,@,Pittsburgh,W (42-30),19,26,73.1,262,5,42,175,4.2,1,68,437,6.4,11,11,0,22,2,20,1,0,1
5025,10,2015-11-14,notre-dame,,Wake Forest,W (28-7),13,19,68.4,111,0,30,171,5.7,3,49,282,5.8,8,5,2,15,4,45,0,0,0
5026,11,2015-11-21,notre-dame,N,Boston College,W (19-16),20,38,52.6,320,2,34,127,3.7,0,72,447,6.2,15,4,3,22,4,31,2,3,5
5027,12,2015-11-28,notre-dame,@,Stanford,L (36-38),13,25,52.0,234,1,35,299,8.5,2,60,533,8.9,10,14,0,24,6,65,1,0,1
5028,13,2016-01-01,notre-dame,N,Ohio State*,L (28-44),22,38,57.9,284,2,32,121,3.8,2,70,405,5.8,15,7,2,24,3,20,1,1,2
5029,,13 Games,notre-dame,,,,240,384,62.5,3360,25,481,2708,5.6,29,865,6068,7.0,143,129,20,292,67,591,10,10,20
5030,1,2016-09-04,notre-dame,@,Texas,L (47-50),17,30,56.7,238,5,46,206,4.5,1,76,444,5.8,11,10,1,22,8,64,0,0,0
5031,2,2016-09-10,notre-dame,,Nevada,W (39-10),19,27,70.4,205,2,46,239,5.2,3,73,444,6.1,9,10,2,21,9,94,0,1,1
5032,3,2016-09-17,notre-dame,,Michigan State,L (28-36),20,37,54.1,344,2,25,57,2.3,2,62,401,6.5,14,3,2,19,4,51,2,1,3
5033,4,2016-09-24,notre-dame,,Duke,L (35-38),22,37,59.5,381,2,37,153,4.1,3,74,534,7.2,15,9,0,24,2,20,2,1,3
5034,5,2016-10-01,notre-dame,N,Syracuse,W (50-33),23,35,65.7,471,3,37,183,4.9,2,72,654,9.1,17,6,2,25,6,55,0,1,1
5035,6,2016-10-08,notre-dame,@,North Carolina State,L (3-10),9,26,34.6,54,0,38,59,1.6,0,64,113,1.8,4,5,1,10,5,40,2,1,3
5036,7,2016-10-15,notre-dame,,Stanford,L (10-17),14,29,48.3,154,0,35,153,4.4,1,64,307,4.8,7,9,0,16,7,47,0,2,2
5037,8,2016-10-29,notre-dame,,Miami (FL),W (30-27),25,38,65.8,263,2,29,148,5.1,1,67,411,6.1,12,7,1,20,7,53,2,0,2
5038,9,2016-11-05,notre-dame,N,Navy,L (27-28),19,27,70.4,223,3,29,147,5.1,0,56,370,6.6,11,10,0,21,7,47,0,0,0
5039,10,2016-11-12,notre-dame,N,Army,W (44-6),18,29,62.1,215,3,43,261,6.1,2,72,476,6.6,9,19,3,31,7,35,0,1,1
5040,11,2016-11-19,notre-dame,,Virginia Tech,L (31-34),17,34,50.0,249,2,36,200,5.6,2,70,449,6.4,10,12,0,22,10,78,0,0,0
5041,12,2016-11-26,notre-dame,@,Southern California,L (27-45),21,39,53.8,254,3,37,154,4.2,1,76,408,5.4,13,7,3,23,6,54,1,1,2
5042,,12 Games,notre-dame,,,,224,388,57.7,3051,27,438,1960,4.5,18,826,5011,6.1,132,107,15,254,78,638,9,9,18
5043,1,2017-09-02,notre-dame,,Temple,W (49-16),17,30,56.7,184,2,44,422,9.6,5,74,606,8.2,7,16,3,26,4,20,0,1,1
5044,2,2017-09-09,notre-dame,,Georgia,L (19-20),20,40,50.0,210,0,37,55,1.5,1,77,265,3.4,8,3,7,18,8,63,2,0,2
5045,3,2017-09-16,notre-dame,@,Boston College,W (49-20),11,27,40.7,96,0,51,515,10.1,7,78,611,7.8,5,14,0,19,5,45,1,1,2
5046,4,2017-09-23,notre-dame,@,Michigan State,W (38-18),14,20,70.0,173,1,40,182,4.6,3,60,355,5.9,10,7,4,21,6,65,0,0,0
5047,5,2017-09-30,notre-dame,,Miami (OH),W (52-17),10,23,43.5,170,3,39,333,8.5,4,62,503,8.1,7,10,4,21,5,60,0,0,0
5048,6,2017-10-07,notre-dame,@,North Carolina,W (33-10),17,31,54.8,146,1,57,341,6.0,3,88,487,5.5,9,16,2,27,10,80,0,2,2
5049,7,2017-10-21,notre-dame,,Southern California,W (49-14),9,22,40.9,120,2,47,377,8.0,5,69,497,7.2,6,17,0,23,7,51,0,0,0
5050,8,2017-10-28,notre-dame,,North Carolina State,W (35-14),10,19,52.6,104,2,54,318,5.9,2,73,422,5.8,6,15,4,25,4,29,0,0,0
5051,9,2017-11-04,notre-dame,,Wake Forest,W (48-37),23,38,60.5,330,2,46,380,8.3,4,84,710,8.5,14,16,0,30,5,40,0,0,0
5052,10,2017-11-11,notre-dame,@,Miami (FL),L (8-41),13,27,48.1,152,1,36,109,3.0,0,63,261,4.1,9,4,0,13,6,49,1,3,4
5053,11,2017-11-18,notre-dame,,Navy,W (24-17),9,18,50.0,164,2,31,163,5.3,1,49,327,6.7,7,8,1,16,3,35,1,0,1
5054,12,2017-11-25,notre-dame,@,Stanford,L (20-38),12,29,41.4,261,2,44,154,3.5,0,73,415,5.7,8,9,0,17,8,81,1,2,3
5055,13,2018-01-01,notre-dame,N,Louisiana State*,W (21-17),17,28,60.7,216,2,33,154,4.7,0,61,370,6.1,8,10,0,18,4,15,1,1,2
5056,,13 Games,notre-dame,,,,182,352,51.7,2326,20,559,3503,6.3,35,911,5829,6.4,104,145,25,274,75,633,7,10,17
5057,1,2018-09-01,notre-dame,,Michigan,W (24-17),12,22,54.5,170,1,47,132,2.8,2,69,302,4.4,7,10,4,21,4,40,0,1,1
5058,2,2018-09-08,notre-dame,,Ball State,W (24-16),17,31,54.8,297,0,39,121,3.1,3,70,418,6.0,13,7,0,20,2,20,0,3,3
5059,3,2018-09-15,notre-dame,,Vanderbilt,W (22-17),16,26,61.5,135,1,48,245,5.1,1,74,380,5.1,7,14,3,24,6,63,0,0,0
5060,4,2018-09-22,notre-dame,@,Wake Forest,W (56-27),25,36,69.4,325,2,40,241,6.0,6,76,566,7.4,11,15,2,28,4,37,1,0,1
5061,5,2018-09-29,notre-dame,,Stanford,W (38-17),24,33,72.7,278,4,55,272,4.9,1,88,550,6.3,16,12,1,29,6,67,0,0,0
5062,6,2018-10-06,notre-dame,@,Virginia Tech,W (45-23),25,35,71.4,271,2,32,167,5.2,3,67,438,6.5,12,6,1,19,5,19,0,1,1
5063,7,2018-10-13,notre-dame,,Pittsburgh,W (19-14),26,32,81.3,264,2,38,80,2.1,0,70,344,4.9,12,8,3,23,4,35,0,2,2
5064,8,2018-10-27,notre-dame,N,Navy,W (44-22),27,33,81.8,330,2,43,254,5.9,4,76,584,7.7,14,13,1,28,3,40,1,1,2
5065,9,2018-11-03,notre-dame,@,Northwestern,W (31-21),22,34,64.7,343,2,40,121,3.0,2,74,464,6.3,18,7,0,25,8,58,1,0,1
5066,10,2018-11-10,notre-dame,,Florida State,W (42-13),12,25,48.0,130,3,50,365,7.3,2,75,495,6.6,8,15,1,24,8,74,0,2,2
5067,11,2018-11-17,notre-dame,N,Syracuse,W (36-3),23,38,60.5,292,2,36,171,4.8,2,74,463,6.3,14,7,2,23,7,55,0,1,1
5068,,11 Games,notre-dame,,,,229,345,66.4,2835,21,468,2169,4.6,26,813,5004,6.2,132,114,18,264,57,508,3,11,14
5069,1,2014-08-29,brigham-young,@,Connecticut,W (35-10),28,36,77.8,308,3,37,205,5.5,2,73,513,7.0,13,11,3,27,15,150,2,0,2
5070,2,2014-09-06,brigham-young,@,Texas,W (41-7),18,28,64.3,181,0,60,248,4.1,5,88,429,4.9,12,15,1,28,6,40,1,1,2
5071,3,2014-09-11,brigham-young,,Houston,W (33-25),21,34,61.8,200,1,62,323,5.2,3,96,523,5.4,9,19,4,32,11,98,1,2,3
5072,4,2014-09-20,brigham-young,,Virginia,W (41-33),13,23,56.5,187,2,37,145,3.9,2,60,332,5.5,7,7,2,16,12,133,0,0,0
5073,5,2014-10-03,brigham-young,,Utah State,L (20-35),18,40,45.0,271,1,34,154,4.5,1,74,425,5.7,8,12,3,23,9,60,1,3,4
5074,6,2014-10-09,brigham-young,@,Central Florida,L (24-31),22,37,59.5,153,3,49,189,3.9,0,86,342,4.0,7,14,0,21,9,71,1,1,2
5075,7,2014-10-18,brigham-young,,Nevada,L (35-42),39,63,61.9,408,4,39,193,4.9,1,102,601,5.9,25,13,0,38,6,75,3,0,3
5076,8,2014-10-24,brigham-young,@,Boise State,L (30-55),23,38,60.5,259,1,26,63,2.4,2,64,322,5.0,12,4,1,17,7,70,1,1,2
5077,9,2014-11-01,brigham-young,@,Middle Tennessee State,W (27-7),28,45,62.2,316,2,39,128,3.3,2,84,444,5.3,15,9,1,25,7,70,0,0,0
5078,10,2014-11-15,brigham-young,,Nevada-Las Vegas,W (42-23),18,32,56.3,325,3,41,267,6.5,3,73,592,8.1,12,10,1,23,5,50,2,0,2
5079,11,2014-11-22,brigham-young,,Savannah State,W (64-0),15,20,75.0,234,4,62,264,4.3,4,82,498,6.1,9,17,1,27,7,75,1,0,1
5080,12,2014-11-29,brigham-young,@,California,W (42-35),23,38,60.5,433,5,39,107,2.7,1,77,540,7.0,16,6,4,26,9,90,1,1,2
5081,13,2014-12-22,brigham-young,N,Memphis*,L (48-55),23,49,46.9,348,3,42,77,1.8,2,91,425,4.7,15,6,1,22,7,70,1,3,4
5082,,13 Games,brigham-young,,,,289,483,59.8,3623,32,567,2363,4.2,28,1050,5986,5.7,160,143,22,325,110,1052,15,12,27
5083,1,2015-09-05,brigham-young,@,Nebraska,W (33-28),28,46,60.9,379,2,26,132,5.1,2,72,511,7.1,13,7,1,21,4,30,0,1,1
5084,2,2015-09-12,brigham-young,,Boise State,W (35-24),17,29,58.6,309,2,39,72,1.8,2,68,381,5.6,0,0,0,16,5,54,0,2,2
5085,3,2015-09-19,brigham-young,@,UCLA,L (23-24),30,47,63.8,244,1,41,161,3.9,1,88,405,4.6,13,11,2,26,5,35,0,1,1
5086,4,2015-09-26,brigham-young,@,Michigan,L (0-31),12,28,42.9,55,0,22,50,2.3,0,50,105,2.1,2,4,2,8,5,45,0,0,0
5087,5,2015-10-02,brigham-young,,Connecticut,W (30-13),35,54,64.8,365,2,41,174,4.2,1,95,539,5.7,20,9,2,31,7,70,1,2,3
5088,6,2015-10-10,brigham-young,,East Carolina,W (45-38),25,38,65.8,341,3,43,167,3.9,3,81,508,6.3,13,11,2,26,7,61,1,1,2
5089,7,2015-10-16,brigham-young,,Cincinnati,W (38-24),19,32,59.4,252,2,29,197,6.8,3,61,449,7.4,10,7,5,22,10,74,0,1,1
5090,8,2015-10-24,brigham-young,,Wagner,W (70-6),23,27,85.2,411,4,42,330,7.9,6,69,741,10.7,16,15,0,31,7,55,0,0,0
5091,9,2015-11-06,brigham-young,@,San Jose State,W (17-16),23,37,62.2,293,1,25,36,1.4,1,62,329,5.3,14,3,0,17,7,84,0,1,1
5092,10,2015-11-14,brigham-young,N,Missouri,L (16-20),23,41,56.1,244,1,15,46,3.1,1,56,290,5.2,11,3,4,18,6,42,2,0,2
5093,11,2015-11-21,brigham-young,,Fresno State,W (52-10),26,39,66.7,362,2,34,158,4.6,4,73,520,7.1,18,4,0,22,7,70,2,0,2
5094,12,2015-11-28,brigham-young,@,Utah State,W (51-28),16,30,53.3,284,4,31,74,2.4,2,61,358,5.9,9,4,2,15,9,76,0,0,0
5095,13,2015-12-19,brigham-young,N,Utah*,L (28-35),25,56,44.6,315,2,25,71,2.8,2,81,386,4.8,12,5,4,22,6,54,2,3,5
5096,,13 Games,brigham-young,,,,302,504,59.9,3854,26,413,1668,4.0,28,917,5522,6.0,151,83,24,275,85,750,8,12,20
5097,1,2016-09-03,brigham-young,N,Arizona,W (18-16),21,29,72.4,202,1,47,213,4.5,1,76,415,5.5,10,14,0,24,8,65,0,0,0
5098,2,2016-09-10,brigham-young,@,Utah,L (19-20),22,39,56.4,185,0,28,146,5.2,2,67,331,4.9,11,6,1,18,10,112,0,2,2
5099,3,2016-09-17,brigham-young,,UCLA,L (14-17),26,49,53.1,250,1,25,23,0.9,1,74,273,3.7,12,4,3,19,2,15,0,1,1
5100,4,2016-09-24,brigham-young,N,West Virginia,L (32-35),23,36,63.9,241,2,40,280,7.0,2,76,521,6.9,14,12,1,27,8,51,1,3,4
5101,5,2016-09-30,brigham-young,,Toledo,W (55-53),11,21,52.4,248,1,45,338,7.5,6,66,586,8.9,10,14,2,26,7,82,0,0,0
5102,6,2016-10-08,brigham-young,@,Michigan State,W (31-14),18,29,62.1,138,1,49,260,5.3,3,78,398,5.1,7,15,2,24,3,24,0,0,0
5103,7,2016-10-14,brigham-young,,Mississippi State,W (28-21),16,28,57.1,165,3,46,147,3.2,1,74,312,4.2,8,8,4,20,9,84,1,1,2
5104,8,2016-10-20,brigham-young,@,Boise State,L (27-28),21,41,51.2,187,0,38,135,3.6,1,79,322,4.1,9,9,1,19,7,61,0,0,0
5105,9,2016-11-05,brigham-young,@,Cincinnati,W (20-3),15,25,60.0,130,0,47,207,4.4,2,72,337,4.7,9,12,2,23,5,28,0,1,1
5106,10,2016-11-12,brigham-young,,Southern Utah,W (37-7),33,42,78.6,441,2,40,155,3.9,2,82,596,7.3,19,14,0,33,6,65,2,1,3
5107,11,2016-11-19,brigham-young,,Massachusetts,W (51-9),20,34,58.8,184,1,49,247,5.0,4,83,431,5.2,11,12,4,27,5,64,1,0,1
5108,12,2016-11-26,brigham-young,,Utah State,W (28-10),11,22,50.0,106,2,54,249,4.6,1,76,355,4.7,5,14,7,26,8,68,0,2,2
5109,13,2016-12-21,brigham-young,N,Wyoming*,W (24-21),8,15,53.3,96,1,35,216,6.2,2,50,312,6.2,5,7,1,13,5,63,1,1,2
5110,,13 Games,brigham-young,,,,245,410,59.8,2573,15,543,2616,4.8,28,953,5189,5.4,130,141,28,299,83,782,6,12,18
5111,1,2017-08-26,brigham-young,,Portland State,W (20-6),16,27,59.3,194,1,33,173,5.2,1,60,367,6.1,10,3,0,13,7,70,0,0,0
5112,2,2017-09-02,brigham-young,N,Louisiana State,L (0-27),12,24,50.0,102,0,14,-5,-0.4,0,38,97,2.6,4,1,1,6,5,39,0,1,1
5113,3,2017-09-09,brigham-young,,Utah,L (13-19),21,39,53.8,170,1,24,63,2.6,1,63,233,3.7,8,3,2,13,4,35,0,3,3
5114,4,2017-09-16,brigham-young,,Wisconsin,L (6-40),11,20,55.0,111,0,26,81,3.1,0,46,192,4.2,5,5,1,11,5,33,0,2,2
5115,5,2017-09-29,brigham-young,@,Utah State,L (24-40),12,29,41.4,186,2,46,210,4.6,0,75,396,5.3,9,11,0,20,8,55,3,4,7
5116,6,2017-10-06,brigham-young,,Boise State,L (7-24),20,37,54.1,172,0,23,66,2.9,1,60,238,4.0,8,4,0,12,3,35,0,2,2
5117,7,2017-10-14,brigham-young,@,Mississippi State,L (10-35),17,29,58.6,147,1,17,29,1.7,0,46,176,3.8,4,2,2,8,2,22,1,1,2
5118,8,2017-10-21,brigham-young,@,East Carolina,L (17-33),26,41,63.4,319,2,31,102,3.3,0,72,421,5.8,14,7,1,22,8,69,0,1,1
5119,9,2017-10-28,brigham-young,,San Jose State,W (41-20),21,38,55.3,332,3,39,266,6.8,2,77,598,7.8,15,7,0,22,6,65,1,1,2
5120,10,2017-11-04,brigham-young,@,Fresno State,L (13-20),23,43,53.5,214,0,27,122,4.5,1,70,336,4.8,10,10,1,21,3,25,1,0,1
5121,11,2017-11-10,brigham-young,@,Nevada-Las Vegas,W (31-21),14,22,63.6,160,1,42,265,6.3,3,64,425,6.6,9,13,2,24,2,20,0,0,0
5122,12,2017-11-18,brigham-young,,Massachusetts,L (10-16),21,45,46.7,257,1,26,42,1.6,0,71,299,4.2,10,7,0,17,5,35,0,4,4
5123,13,2017-11-25,brigham-young,@,Hawaii,W (30-20),14,24,58.3,166,1,54,285,5.3,3,78,451,5.8,10,14,2,26,1,6,2,0,2
5124,,13 Games,brigham-young,,,,228,418,54.5,2530,13,402,1699,4.2,12,820,4229,5.2,116,87,12,215,59,509,8,19,27
5125,1,2018-09-01,brigham-young,@,Arizona,W (28-23),18,28,64.3,209,1,43,183,4.3,3,71,392,5.5,12,11,0,23,10,94,0,0,0
5126,2,2018-09-08,brigham-young,,California,L (18-21),22,41,53.7,196,1,33,91,2.8,0,74,287,3.9,9,8,0,17,7,65,0,2,2
5127,3,2018-09-15,brigham-young,@,Wisconsin,W (24-21),13,23,56.5,120,1,28,191,6.8,2,51,311,6.1,5,8,1,14,4,36,0,0,0
5128,4,2018-09-22,brigham-young,,McNeese State,W (30-3),16,27,59.3,130,1,42,161,3.8,2,69,291,4.2,7,9,2,18,5,56,1,0,1
5129,5,2018-09-29,brigham-young,@,Washington,L (7-35),18,21,85.7,160,0,28,34,1.2,1,49,194,4.0,6,1,0,7,8,50,1,0,1
5130,6,2018-10-05,brigham-young,,Utah State,L (20-45),30,49,61.2,322,3,16,39,2.4,0,65,361,5.6,14,2,7,23,6,50,2,1,3
5131,7,2018-10-13,brigham-young,,Hawaii,W (49-23),16,24,66.7,194,3,47,280,6.0,4,71,474,6.7,11,14,1,26,6,55,0,1,1
5132,8,2018-10-27,brigham-young,,Northern Illinois,L (6-7),18,30,60.0,208,0,37,93,2.5,0,67,301,4.5,9,5,3,17,7,52,0,1,1
5133,9,2018-11-03,brigham-young,@,Boise State,L (16-21),19,29,65.5,292,0,38,96,2.5,1,67,388,5.8,12,7,2,21,8,58,3,0,3
5134,10,2018-11-10,brigham-young,@,Massachusetts,W (35-16),14,23,60.9,167,2,38,225,5.9,3,61,392,6.4,7,12,0,19,2,20,1,0,1
5135,11,2018-11-17,brigham-young,,New Mexico State,W (45-10),13,29,44.8,193,0,51,317,6.2,6,80,510,6.4,9,15,1,25,2,20,1,1,2
5136,,11 Games,brigham-young,,,,197,324,60.8,2191,12,401,1710,4.3,22,725,3901,5.4,101,92,17,210,65,556,9,6,15
5137,1,2014-09-06,army,,Buffalo,W (47-39),7,7,100.0,125,0,54,341,6.3,7,61,466,7.6,4,13,0,17,12,105,2,0,2
5138,2,2014-09-13,army,@,Stanford,L (0-35),3,5,60.0,9,0,56,198,3.5,0,61,207,3.4,1,10,1,12,2,20,1,1,2
5139,3,2014-09-20,army,@,Wake Forest,L (21-24),3,5,60.0,18,1,59,341,5.8,2,64,359,5.6,0,16,1,17,7,57,2,0,2
5140,4,2014-09-27,army,@,Yale,L (43-49),12,21,57.1,211,1,53,386,7.3,4,74,597,8.1,8,15,0,23,8,70,0,0,0
5141,5,2014-10-04,army,,Ball State,W (33-24),2,5,40.0,48,0,69,425,6.2,4,74,473,6.4,1,21,2,24,1,15,1,0,1
5142,6,2014-10-11,army,,Rice,L (21-41),6,14,42.9,91,1,54,250,4.6,2,68,341,5.0,2,15,2,19,2,24,2,0,2
5143,7,2014-10-18,army,@,Kent State,L (17-39),5,15,33.3,35,0,56,295,5.3,2,71,330,4.6,1,17,1,19,5,38,0,1,1
5144,8,2014-11-01,army,,Air Force,L (6-23),3,13,23.1,47,0,38,122,3.2,0,51,169,3.3,1,7,0,8,3,41,1,0,1
5145,9,2014-11-08,army,N,Connecticut,W (35-21),2,3,66.7,38,0,59,325,5.5,4,62,363,5.9,2,20,1,23,3,13,1,0,1
5146,10,2014-11-15,army,@,Western Kentucky,L (24-52),3,6,50.0,40,0,57,293,5.1,3,63,333,5.3,2,13,3,18,3,20,0,0,0
5147,11,2014-11-22,army,,Fordham,W (42-31),2,4,50.0,48,0,64,382,6.0,5,68,430,6.3,1,21,0,22,1,5,0,0,0
5148,12,2014-12-13,army,N,Navy,L (10-17),2,7,28.6,37,0,45,198,4.4,0,52,235,4.5,2,13,0,15,2,10,1,0,1
5149,,12 Games,army,,,,50,105,47.6,747,3,664,3556,5.4,33,769,4303,5.6,25,181,11,217,49,418,11,2,13
5150,1,2015-09-04,army,,Fordham,L (35-37),7,16,43.8,133,2,42,256,6.1,3,58,389,6.7,4,17,1,22,3,26,1,1,2
5151,2,2015-09-12,army,@,Connecticut,L (17-22),3,8,37.5,85,1,33,180,5.5,1,41,265,6.5,1,6,2,9,6,60,0,1,1
5152,3,2015-09-19,army,,Wake Forest,L (14-17),2,3,66.7,54,0,54,186,3.4,2,57,240,4.2,2,9,0,11,4,57,0,0,0
5153,4,2015-09-26,army,@,Eastern Michigan,W (58-36),5,9,55.6,98,1,71,556,7.8,7,80,654,8.2,3,24,2,29,6,70,2,1,3
5154,5,2015-10-03,army,@,Penn State,L (14-20),1,1,100.0,32,0,55,261,4.7,2,56,293,5.2,1,16,0,17,4,45,3,0,3
5155,6,2015-10-10,army,,Duke,L (3-44),2,6,33.3,55,0,49,113,2.3,0,55,168,3.1,2,9,1,12,5,32,2,1,3
5156,7,2015-10-17,army,,Bucknell,W (21-14),5,10,50.0,114,1,61,263,4.3,2,71,377,5.3,3,14,1,18,4,35,1,2,3
5157,8,2015-10-24,army,@,Rice,L (31-38),2,10,20.0,18,1,56,378,6.8,3,66,396,6.0,1,14,3,18,2,24,1,0,1
5158,9,2015-11-07,army,@,Air Force,L (3-20),2,8,25.0,45,0,44,124,2.8,0,52,169,3.3,2,6,1,9,4,27,0,0,0
5159,10,2015-11-14,army,,Tulane,L (31-34),7,13,53.8,146,2,55,216,3.9,1,68,362,5.3,6,10,0,16,5,35,1,0,1
5160,11,2015-11-21,army,,Rutgers,L (21-31),4,6,66.7,140,1,52,261,5.0,2,58,401,6.9,4,13,1,18,3,35,1,1,2
5161,12,2015-12-12,army,N,Navy,L (17-21),9,18,50.0,208,1,44,137,3.1,1,62,345,5.6,7,8,1,16,2,28,1,2,3
5162,,12 Games,army,,,,49,108,45.4,1128,10,616,2931,4.8,24,724,4059,5.6,36,146,13,195,48,474,13,9,22
5163,1,2016-09-02,army,@,Temple,W (28-13),2,5,40.0,15,0,67,329,4.9,4,72,344,4.8,1,23,1,25,5,34,0,0,0
5164,2,2016-09-10,army,,Rice,W (31-14),4,6,66.7,66,0,69,348,5.0,4,75,414,5.5,4,18,1,23,5,50,0,0,0
5165,3,2016-09-17,army,@,Texas-El Paso,W (66-14),7,8,87.5,174,1,71,426,6.0,7,79,600,7.6,7,24,2,33,2,10,0,0,0
5166,4,2016-09-24,army,@,Buffalo,L (20-23),4,10,40.0,48,0,67,396,5.9,2,77,444,5.8,2,19,0,21,8,83,1,1,2
5167,5,2016-10-08,army,@,Duke,L (6-13),3,11,27.3,49,0,43,165,3.8,1,54,214,4.0,2,5,1,8,5,40,2,1,3
5168,6,2016-10-15,army,,Lafayette,W (62-7),7,13,53.8,134,3,54,537,9.9,6,67,671,10.0,4,26,1,31,6,64,1,0,1
5169,7,2016-10-22,army,,North Texas,L (18-35),7,21,33.3,94,0,67,302,4.5,2,88,396,4.5,3,19,2,24,9,79,3,4,7
5170,8,2016-10-29,army,@,Wake Forest,W (21-13),6,9,66.7,145,1,64,238,3.7,2,73,383,5.2,4,17,0,21,2,20,1,1,2
5171,9,2016-11-05,army,,Air Force,L (12-31),5,16,31.3,84,1,40,144,3.6,1,56,228,4.1,4,7,4,15,5,35,0,2,2
5172,10,2016-11-12,army,N,Notre Dame,L (6-44),2,8,25.0,13,0,42,229,5.5,1,50,242,4.8,1,9,0,10,7,68,0,1,1
5173,11,2016-11-19,army,,Morgan State,W (60-3),3,8,37.5,57,1,60,504,8.4,7,68,561,8.3,3,23,2,28,4,25,2,0,2
5174,12,2016-12-10,army,N,Navy,W (21-17),2,4,50.0,35,0,70,316,4.5,3,74,351,4.7,1,22,0,23,0,0,3,1,4
5175,13,2016-12-27,army,N,North Texas*,W (38-31),2,4,50.0,53,0,73,481,6.6,6,77,534,6.9,2,20,0,22,4,40,1,0,1
5176,,13 Games,army,,,,54,123,43.9,967,7,787,4415,5.6,46,910,5382,5.9,38,232,14,284,62,548,14,11,25
5177,1,2017-09-01,army,,Fordham,W (64-6),0,2,0.0,0,0,47,513,10.9,8,49,513,10.5,0,22,0,22,3,30,1,0,1
5178,2,2017-09-09,army,,Buffalo,W (21-17),2,8,25.0,17,0,66,322,4.9,3,74,339,4.6,1,16,2,19,5,44,0,0,0
5179,3,2017-09-16,army,@,Ohio State,L (7-38),2,8,25.0,19,0,58,259,4.5,1,66,278,4.2,1,14,1,16,2,22,1,0,1
5180,4,2017-09-23,army,@,Tulane,L (17-21),0,5,0.0,0,0,69,371,5.4,2,74,371,5.0,0,20,2,22,5,35,1,2,3
5181,5,2017-09-30,army,,Texas-El Paso,W (35-21),3,7,42.9,80,1,50,353,7.1,4,57,433,7.6,3,18,1,22,6,47,0,1,1
5182,6,2017-10-07,army,@,Rice,W (49-12),1,3,33.3,9,0,65,418,6.4,6,68,427,6.3,0,20,1,21,5,35,0,1,1
5183,7,2017-10-14,army,,Eastern Michigan,W (28-27),0,5,0.0,0,0,61,413,6.8,4,66,413,6.3,0,21,0,21,4,32,0,0,0
5184,8,2017-10-21,army,,Temple,W (31-28),8,18,44.4,141,1,50,248,5.0,3,68,389,5.7,7,11,1,19,5,46,0,1,1
5185,9,2017-11-04,army,@,Air Force,W (21-0),0,0,,0,0,59,392,6.6,3,59,392,6.6,0,20,0,20,2,10,0,0,0
5186,10,2017-11-11,army,,Duke,W (21-16),1,1,100.0,42,0,57,226,4.0,2,58,268,4.6,1,14,2,17,6,49,1,0,1
5187,11,2017-11-18,army,@,North Texas,L (49-52),1,3,33.3,27,0,67,534,8.0,7,70,561,8.0,1,24,0,25,6,65,1,0,1
5188,12,2017-12-09,army,N,Navy,W (14-13),1,1,100.0,20,0,49,221,4.5,2,50,241,4.8,1,13,1,15,2,10,0,0,0
5189,13,2017-12-23,army,N,San Diego State*,W (42-35),1,4,25.0,6,0,87,440,5.1,5,91,446,4.9,1,28,2,31,4,47,0,1,1
5190,,13 Games,army,,,,20,65,30.8,361,2,785,4710,6.0,50,850,5071,6.0,16,241,13,270,55,472,5,6,11
5191,1,2018-08-31,army,@,Duke,L (14-34),10,21,47.6,197,1,47,168,3.6,1,68,365,5.4,7,11,0,18,7,69,2,0,2
5192,2,2018-09-08,army,,Liberty,W (38-14),2,8,25.0,61,1,74,449,6.1,4,82,510,6.2,2,24,2,28,7,100,0,0,0
5193,3,2018-09-15,army,,Hawaii,W (28-21),6,10,60.0,162,0,66,303,4.6,4,76,465,6.1,6,12,0,18,5,70,0,0,0
5194,4,2018-09-22,army,@,Oklahoma,L (21-28),3,9,33.3,40,0,78,339,4.3,3,87,379,4.4,3,22,1,26,6,50,0,2,2
5195,5,2018-09-29,army,@,Buffalo,W (42-13),4,5,80.0,91,1,64,281,4.4,4,69,372,5.4,3,19,3,25,7,73,0,1,1
5196,6,2018-10-13,army,N,San Jose State,W (52-3),2,5,40.0,54,1,65,341,5.2,5,70,395,5.6,2,19,2,23,3,15,0,0,0
5197,7,2018-10-20,army,,Miami (OH),W (31-30),0,2,0.0,0,0,74,347,4.7,4,76,347,4.6,0,19,1,20,1,5,0,0,0
5198,8,2018-10-27,army,@,Eastern Michigan,W (37-22),7,8,87.5,126,2,73,289,4.0,2,81,415,5.1,4,18,5,27,3,25,0,0,0
5199,9,2018-11-03,army,,Air Force,W (17-14),3,5,60.0,44,0,59,242,4.1,2,64,286,4.5,0,15,1,16,5,69,0,0,0
5200,10,2018-11-10,army,,Lafayette,W (31-13),5,6,83.3,95,0,57,313,5.5,4,63,408,6.5,3,20,0,23,6,40,1,0,1
5201,11,2018-11-17,army,,Colgate,W (28-14),2,6,33.3,25,0,59,261,4.4,4,65,286,4.4,2,18,1,21,3,25,1,0,1
5202,,11 Games,army,,,,44,85,51.8,895,6,716,3333,4.7,37,801,4228,5.3,32,197,16,245,53,541,4,3,7
5203,1,2014-08-28,new-mexico-state,,Cal Poly,W (28-10),18,27,66.7,118,2,47,197,4.2,2,74,315,4.3,8,12,1,21,3,50,0,1,1
5204,2,2014-09-06,new-mexico-state,@,Georgia State,W (34-31),25,44,56.8,241,3,41,194,4.7,0,85,435,5.1,13,11,2,26,5,38,2,1,3
5205,3,2014-09-13,new-mexico-state,@,Texas-El Paso,L (24-42),23,41,56.1,335,2,21,90,4.3,1,62,425,6.9,13,6,1,20,4,17,0,2,2
5206,4,2014-09-20,new-mexico-state,,New Mexico,L (35-38),32,47,68.1,333,2,45,174,3.9,3,92,507,5.5,15,12,2,29,5,44,0,2,2
5207,5,2014-09-27,new-mexico-state,@,Louisiana State,L (7-63),16,33,48.5,102,0,37,172,4.6,1,70,274,3.9,5,7,1,13,5,35,2,2,4
5208,6,2014-10-04,new-mexico-state,,Georgia Southern,L (28-36),35,50,70.0,334,0,42,183,4.4,4,92,517,5.6,16,13,1,30,2,10,1,3,4
5209,7,2014-10-11,new-mexico-state,@,Troy,L (24-41),22,33,66.7,272,2,38,123,3.2,1,71,395,5.6,14,6,0,20,1,12,2,2,4
5210,8,2014-10-18,new-mexico-state,@,Idaho,L (17-29),9,16,56.3,100,0,34,214,6.3,2,50,314,6.3,5,4,2,11,7,39,1,3,4
5211,9,2014-11-01,new-mexico-state,,Texas State,L (29-37),36,52,69.2,404,3,48,235,4.9,1,100,639,6.4,17,15,0,32,11,76,0,2,2
5212,10,2014-11-08,new-mexico-state,,Louisiana,L (16-44),19,34,55.9,204,1,33,103,3.1,1,67,307,4.6,8,6,0,14,1,5,1,3,4
5213,11,2014-11-22,new-mexico-state,,Louisiana-Monroe,L (17-30),15,32,46.9,102,0,51,276,5.4,2,83,378,4.6,6,11,2,19,3,21,1,1,2
5214,12,2014-11-29,new-mexico-state,@,Arkansas State,L (35-68),28,43,65.1,314,4,34,178,5.2,1,77,492,6.4,14,5,3,22,10,80,0,2,2
5215,,12 Games,new-mexico-state,,,,278,452,61.5,2859,19,471,2139,4.5,19,923,4998,5.4,134,108,15,257,57,427,10,24,34
5216,1,2015-09-05,new-mexico-state,@,Florida,L (13-61),14,28,50.0,128,1,23,72,3.1,1,51,200,3.9,4,4,0,8,1,9,0,1,1
5217,2,2015-09-12,new-mexico-state,,Georgia State,L (32-34),31,55,56.4,445,3,23,84,3.7,1,78,529,6.8,17,6,3,26,7,129,0,1,1
5218,3,2015-09-19,new-mexico-state,,Texas-El Paso,L (47-50),14,28,50.0,285,3,35,266,7.6,2,63,551,8.7,8,11,2,21,13,149,0,1,1
5219,4,2015-10-03,new-mexico-state,@,New Mexico,L (29-38),12,28,42.9,108,0,39,308,7.9,3,67,416,6.2,2,11,1,14,7,39,1,2,3
5220,5,2015-10-10,new-mexico-state,@,Mississippi,L (3-52),22,37,59.5,141,0,37,98,2.6,0,74,239,3.2,7,10,1,18,3,35,0,2,2
5221,6,2015-10-17,new-mexico-state,@,Georgia Southern,L (26-56),20,37,54.1,253,3,29,133,4.6,0,66,386,5.8,9,7,3,19,4,40,0,1,1
5222,7,2015-10-24,new-mexico-state,,Troy,L (7-52),13,34,38.2,161,1,47,231,4.9,0,81,392,4.8,6,14,0,20,8,82,2,0,2
5223,8,2015-10-31,new-mexico-state,,Idaho,W (55-48),24,40,60.0,326,3,41,315,7.7,5,81,641,7.9,10,14,0,24,6,47,1,1,2
5224,9,2015-11-07,new-mexico-state,@,Texas State,W (31-21),24,45,53.3,297,2,48,230,4.8,2,93,527,5.7,11,12,3,26,5,37,0,0,0
5225,10,2015-11-21,new-mexico-state,@,Louisiana,W (37-34),16,42,38.1,261,4,46,237,5.2,0,88,498,5.7,12,12,3,27,3,30,0,0,0
5226,11,2015-11-28,new-mexico-state,,Arkansas State,L (28-52),26,41,63.4,315,4,25,119,4.8,0,66,434,6.6,13,4,3,20,9,86,1,3,4
5227,12,2015-12-05,new-mexico-state,@,Louisiana-Monroe,L (35-42),23,36,63.9,308,2,52,89,1.7,2,88,397,4.5,10,7,1,18,10,100,2,2,4
5228,,12 Games,new-mexico-state,,,,239,451,53.0,3028,26,445,2182,4.9,16,896,5210,5.8,109,112,20,241,76,783,7,14,21
5229,1,2016-09-03,new-mexico-state,@,Texas-El Paso,L (22-38),17,41,41.5,206,0,30,139,4.6,2,71,345,4.9,8,9,2,19,7,40,0,0,0
5230,2,2016-09-10,new-mexico-state,,New Mexico,W (32-31),21,35,60.0,205,2,35,102,2.9,1,70,307,4.4,10,8,4,22,7,75,0,0,0
5231,3,2016-09-17,new-mexico-state,@,Kentucky,L (42-62),17,34,50.0,277,3,45,223,5.0,3,79,500,6.3,12,12,2,26,5,33,0,2,2
5232,4,2016-09-24,new-mexico-state,@,Troy,L (6-52),29,54,53.7,445,1,33,94,2.8,0,87,539,6.2,18,6,1,25,5,45,0,5,5
5233,5,2016-10-01,new-mexico-state,,Louisiana,W (37-31),31,49,63.3,354,2,42,145,3.5,1,91,499,5.5,16,12,3,31,9,43,0,2,2
5234,6,2016-10-15,new-mexico-state,@,Idaho,L (23-55),23,36,63.9,366,3,29,62,2.1,0,65,428,6.6,10,7,0,17,6,64,2,0,2
5235,7,2016-10-22,new-mexico-state,,Georgia Southern,L (19-22),22,39,56.4,250,2,40,168,4.2,0,79,418,5.3,11,11,4,26,6,57,2,1,3
5236,8,2016-10-29,new-mexico-state,@,Texas A&M,L (10-52),21,38,55.3,147,1,39,169,4.3,0,77,316,4.1,6,8,4,18,5,30,0,0,0
5237,9,2016-11-12,new-mexico-state,@,Arkansas State,L (22-41),26,45,57.8,256,1,40,182,4.6,1,85,438,5.2,11,13,1,25,9,86,1,1,2
5238,10,2016-11-19,new-mexico-state,,Texas State,W (50-10),23,38,60.5,231,5,44,252,5.7,1,82,483,5.9,8,15,3,26,10,121,1,0,1
5239,11,2016-11-26,new-mexico-state,,Appalachian State,L (7-37),12,27,44.4,92,1,27,143,5.3,0,54,235,4.4,3,6,1,10,2,15,0,2,2
5240,12,2016-12-03,new-mexico-state,@,South Alabama,L (28-35),11,25,44.0,110,1,48,353,7.4,3,73,463,6.3,7,12,2,21,5,57,1,2,3
5241,,12 Games,new-mexico-state,,,,253,461,54.9,2939,22,452,2032,4.5,12,913,4971,5.4,120,119,27,266,76,666,7,15,22
5242,1,2017-08-31,new-mexico-state,@,Arizona State,L (31-37),40,58,69.0,398,3,30,151,5.0,2,88,549,6.2,18,9,0,27,6,59,0,2,2
5243,2,2017-09-09,new-mexico-state,@,New Mexico,W (30-28),34,57,59.6,401,4,25,104,4.2,0,82,505,6.2,17,5,1,23,10,82,1,1,2
5244,3,2017-09-16,new-mexico-state,,Troy,L (24-27),32,45,71.1,331,3,16,75,4.7,0,61,406,6.7,14,4,0,18,6,66,0,0,0
5245,4,2017-09-23,new-mexico-state,,Texas-El Paso,W (41-14),26,43,60.5,283,2,27,183,6.8,3,70,466,6.7,12,7,2,21,11,103,1,1,2
5246,5,2017-09-30,new-mexico-state,@,Arkansas,L (24-42),23,38,60.5,344,2,14,11,0.8,1,52,355,6.8,15,2,1,18,6,29,1,1,2
5247,6,2017-10-07,new-mexico-state,@,Appalachian State,L (31-45),27,50,54.0,356,2,42,176,4.2,2,92,532,5.8,13,13,2,28,10,57,0,6,6
5248,7,2017-10-14,new-mexico-state,@,Georgia Southern,W (35-27),32,52,61.5,399,4,26,92,3.5,1,78,491,6.3,16,5,4,25,2,15,0,2,2
5249,8,2017-10-28,new-mexico-state,,Arkansas State,L (21-37),20,40,50.0,221,1,32,35,1.1,2,72,256,3.6,7,4,2,13,4,39,0,2,2
5250,9,2017-11-04,new-mexico-state,@,Texas State,W (45-35),31,49,63.3,503,4,33,119,3.6,2,82,622,7.6,19,6,1,26,8,55,2,0,2
5251,10,2017-11-18,new-mexico-state,@,Louisiana,L (34-47),32,44,72.7,313,1,19,89,4.7,2,63,402,6.4,17,6,3,26,6,49,0,3,3
5252,11,2017-11-25,new-mexico-state,,Idaho,W (17-10),31,49,63.3,231,0,37,172,4.6,2,86,403,4.7,11,12,0,23,6,60,1,1,2
5253,12,2017-12-02,new-mexico-state,,South Alabama,W (22-17),40,61,65.6,451,2,23,40,1.7,0,84,491,5.8,23,3,0,26,9,55,0,1,1
5254,13,2017-12-29,new-mexico-state,N,Utah State*,W (26-20),29,54,53.7,191,1,29,184,6.3,1,83,375,4.5,9,6,1,16,4,45,1,2,3
5255,,13 Games,new-mexico-state,,,,397,640,62.0,4422,29,353,1431,4.1,18,993,5853,5.9,191,82,17,290,88,714,7,22,29
5256,1,2018-08-25,new-mexico-state,,Wyoming,L (7-29),18,33,54.5,144,1,16,-9,-0.6,0,49,135,2.8,5,2,0,7,12,57,0,0,0
5257,2,2018-08-30,new-mexico-state,@,Minnesota,L (10-48),29,58,50.0,233,1,20,38,1.9,0,78,271,3.5,10,4,5,19,5,50,0,1,1
5258,3,2018-09-08,new-mexico-state,@,Utah State,L (13-60),20,37,54.1,171,1,45,109,2.4,0,82,280,3.4,8,11,1,20,6,66,2,3,5
5259,4,2018-09-15,new-mexico-state,,New Mexico,L (25-42),22,40,55.0,249,1,36,119,3.3,1,76,368,4.8,10,6,6,22,15,114,0,5,5
5260,5,2018-09-22,new-mexico-state,@,Texas-El Paso,W (27-20),9,18,50.0,156,1,34,155,4.6,0,52,311,6.0,5,6,4,15,8,65,1,0,1
5261,6,2018-10-06,new-mexico-state,,Liberty,W (49-41),34,51,66.7,402,4,28,173,6.2,3,79,575,7.3,18,6,1,25,8,77,0,0,0
5262,7,2018-10-13,new-mexico-state,@,Louisiana,L (38-66),25,44,56.8,284,1,25,122,4.9,3,69,406,5.9,15,7,4,26,2,30,1,1,2
5263,8,2018-10-20,new-mexico-state,,Georgia Southern,L (31-48),25,38,65.8,295,0,35,148,4.2,4,73,443,6.1,12,10,4,26,5,38,2,1,3
5264,9,2018-10-27,new-mexico-state,@,Texas State,L (20-27),29,59,49.2,275,0,33,153,4.6,1,92,428,4.7,14,5,3,22,6,63,0,2,2
5265,10,2018-11-03,new-mexico-state,,Alcorn State,W (52-42),32,44,72.7,396,4,29,133,4.6,2,73,529,7.2,14,10,0,24,2,15,1,0,1
5266,11,2018-11-17,new-mexico-state,@,Brigham Young,L (10-45),25,61,41.0,264,1,26,48,1.8,0,87,312,3.6,12,7,1,20,5,39,1,2,3
5267,,11 Games,new-mexico-state,,,,268,483,55.5,2869,15,327,1189,3.6,14,810,4058,5.0,123,74,29,226,74,614,8,15,23
5268,1,2014-08-30,massachusetts,N,Boston College,L (7-30),9,22,40.9,147,1,22,55,2.5,0,44,202,4.6,4,4,1,9,4,23,0,1,1
5269,2,2014-09-06,massachusetts,N,Colorado,L (38-41),20,38,52.6,267,3,30,104,3.5,2,68,371,5.5,11,7,5,23,7,85,0,1,1
5270,3,2014-09-13,massachusetts,@,Vanderbilt,L (31-34),18,35,51.4,258,2,39,88,2.3,2,74,346,4.7,13,4,3,20,2,10,1,0,1
5271,4,2014-09-20,massachusetts,@,Penn State,L (7-48),17,33,51.5,263,1,28,3,0.1,0,61,266,4.4,7,5,1,13,4,30,1,0,1
5272,5,2014-09-27,massachusetts,,Bowling Green State,L (42-47),36,61,59.0,589,5,31,49,1.6,1,92,638,6.9,23,3,3,29,4,30,3,1,4
5273,6,2014-10-04,massachusetts,@,Miami (OH),L (41-42),35,62,56.5,389,4,34,165,4.9,1,96,554,5.8,17,9,6,32,7,60,2,2,4
5274,7,2014-10-11,massachusetts,@,Kent State,W (40-17),23,38,60.5,286,3,35,196,5.6,1,73,482,6.6,12,9,3,24,10,105,0,0,0
5275,8,2014-10-18,massachusetts,N,Eastern Michigan,W (36-14),28,51,54.9,337,0,43,225,5.2,5,94,562,6.0,19,11,4,34,9,55,2,1,3
5276,9,2014-10-25,massachusetts,@,Toledo,L (35-42),29,58,50.0,445,5,20,52,2.6,0,78,497,6.4,18,6,2,26,9,75,0,2,2
5277,10,2014-11-12,massachusetts,,Ball State,W (24-10),28,44,63.6,424,0,40,145,3.6,3,84,569,6.8,16,8,3,27,7,49,0,2,2
5278,11,2014-11-18,massachusetts,@,Akron,L (6-30),13,21,61.9,168,1,30,67,2.2,0,51,235,4.6,6,5,0,11,5,45,1,3,4
5279,12,2014-11-28,massachusetts,,Buffalo,L (21-41),13,29,44.8,168,2,35,162,4.6,1,64,330,5.2,9,8,1,18,5,50,0,0,0
5280,,12 Games,massachusetts,,,,269,492,54.7,3741,27,387,1311,3.4,16,879,5052,5.7,155,79,32,266,73,617,10,13,23
5281,1,2015-09-12,massachusetts,@,Colorado,L (14-48),24,42,57.1,250,1,29,147,5.1,1,71,397,5.6,11,6,3,20,4,50,1,1,2
5282,2,2015-09-19,massachusetts,,Temple,L (23-25),29,55,52.7,393,3,25,45,1.8,0,80,438,5.5,14,2,4,20,12,106,1,1,2
5283,3,2015-09-26,massachusetts,@,Notre Dame,L (27-62),28,48,58.3,302,1,29,148,5.1,3,77,450,5.8,13,4,5,22,4,35,0,1,1
5284,4,2015-10-03,massachusetts,,Florida International,W (24-14),32,43,74.4,363,3,39,132,3.4,0,82,495,6.0,16,9,4,29,10,72,2,0,2
5285,5,2015-10-10,massachusetts,@,Bowling Green State,L (38-62),37,61,60.7,486,4,15,30,2.0,0,76,516,6.8,25,1,4,30,7,78,1,1,2
5286,6,2015-10-17,massachusetts,,Kent State,L (10-15),17,33,51.5,171,0,27,86,3.2,1,60,257,4.3,6,6,4,16,9,76,0,1,1
5287,7,2015-10-24,massachusetts,,Toledo,L (35-51),27,49,55.1,240,4,24,148,6.2,1,73,388,5.3,12,6,1,19,15,134,0,1,1
5288,8,2015-10-31,massachusetts,@,Ball State,L (10-20),32,44,72.7,259,1,36,189,5.3,0,80,448,5.6,14,11,1,26,12,87,0,1,1
5289,9,2015-11-07,massachusetts,,Akron,L (13-17),19,44,43.2,173,0,32,88,2.8,1,76,261,3.4,9,8,2,19,2,27,0,2,2
5290,10,2015-11-14,massachusetts,@,Eastern Michigan,W (28-17),10,20,50.0,109,1,57,330,5.8,3,77,439,5.7,6,16,2,24,6,56,0,1,1
5291,11,2015-11-21,massachusetts,,Miami (OH),L (13-20),17,34,50.0,181,0,30,69,2.3,1,64,250,3.9,9,3,1,13,4,25,0,1,1
5292,12,2015-11-27,massachusetts,@,Buffalo,W (31-26),9,22,40.9,163,0,49,295,6.0,4,71,458,6.5,6,11,1,18,4,21,1,2,3
5293,,12 Games,massachusetts,,,,281,495,56.8,3090,18,392,1707,4.4,15,887,4797,5.4,141,83,32,256,89,767,6,13,19
5294,1,2016-09-03,massachusetts,@,Florida,L (7-24),9,17,52.9,141,0,35,46,1.3,1,52,187,3.6,5,3,4,12,7,25,0,0,0
5295,2,2016-09-10,massachusetts,,Boston College,L (7-26),11,28,39.3,145,1,33,-23,-0.7,0,61,122,2.0,6,1,1,8,5,37,2,1,3
5296,3,2016-09-17,massachusetts,,Florida International,W (21-13),28,42,66.7,278,3,36,116,3.2,0,78,394,5.1,16,4,1,21,9,72,0,1,1
5297,4,2016-09-24,massachusetts,,Mississippi State,L (35-47),24,41,58.5,273,4,28,138,4.9,1,69,411,6.0,16,5,1,22,7,35,0,3,3
5298,5,2016-10-01,massachusetts,,Tulane,L (24-31),16,30,53.3,181,2,24,131,5.5,1,54,312,5.8,7,8,1,16,7,65,1,1,2
5299,6,2016-10-07,massachusetts,@,Old Dominion,L (16-36),16,33,48.5,237,1,32,169,5.3,1,65,406,6.2,11,10,1,22,10,85,0,2,2
5300,7,2016-10-15,massachusetts,,Louisiana Tech,L (28-56),29,40,72.5,268,3,33,131,4.0,1,73,399,5.5,14,11,0,25,7,73,1,1,2
5301,8,2016-10-22,massachusetts,@,South Carolina,L (28-34),20,42,47.6,247,3,37,142,3.8,1,79,389,4.9,13,8,2,23,8,77,2,2,4
5302,9,2016-10-29,massachusetts,,Wagner,W (34-10),26,41,63.4,364,3,24,143,6.0,1,65,507,7.8,15,7,2,24,7,60,0,1,1
5303,10,2016-11-05,massachusetts,@,Troy,L (31-52),23,44,52.3,316,3,28,44,1.6,1,72,360,5.0,13,5,0,18,8,76,1,1,2
5304,11,2016-11-19,massachusetts,@,Brigham Young,L (9-51),27,40,67.5,288,1,20,40,2.0,0,60,328,5.5,10,3,1,14,9,94,2,2,4
5305,12,2016-11-26,massachusetts,@,Hawaii,L (40-46),24,38,63.2,342,3,34,117,3.4,2,72,459,6.4,12,10,3,25,9,85,1,0,1
5306,,12 Games,massachusetts,,,,253,436,58.0,3080,27,364,1194,3.3,10,800,4274,5.3,138,75,17,230,93,784,10,15,25
5307,1,2017-08-26,massachusetts,,Hawaii,L (35-38),22,34,64.7,298,2,41,115,2.8,3,75,413,5.5,13,6,1,20,5,55,1,1,2
5308,2,2017-09-02,massachusetts,@,Coastal Carolina,L (28-38),27,45,60.0,362,1,26,79,3.0,3,71,441,6.2,17,5,1,23,7,64,2,0,2
5309,3,2017-09-09,massachusetts,,Old Dominion,L (7-17),22,37,59.5,253,1,36,79,2.2,0,73,332,4.5,10,9,1,20,3,40,0,0,0
5310,4,2017-09-15,massachusetts,@,Temple,L (21-29),23,39,59.0,377,2,33,81,2.5,1,72,458,6.4,18,5,2,25,6,48,1,0,1
5311,5,2017-09-23,massachusetts,@,Tennessee,L (13-17),13,22,59.1,137,1,37,144,3.9,1,59,281,4.8,7,6,1,14,7,43,0,0,0
5312,6,2017-09-30,massachusetts,,Ohio,L (50-58),33,58,56.9,403,5,37,147,4.0,1,95,550,5.8,17,9,4,30,5,39,1,1,2
5313,7,2017-10-21,massachusetts,,Georgia Southern,W (55-20),21,28,75.0,350,4,44,320,7.3,4,72,670,9.3,15,13,5,33,8,70,2,0,2
5314,8,2017-10-28,massachusetts,,Appalachian State,W (30-27),20,33,60.6,190,0,39,209,5.4,3,72,399,5.5,9,6,1,16,11,82,2,2,4
5315,9,2017-11-04,massachusetts,@,Mississippi State,L (23-34),15,28,53.6,223,1,32,127,4.0,0,60,350,5.8,3,6,3,12,5,55,0,1,1
5316,10,2017-11-11,massachusetts,N,Maine,W (44-31),21,39,53.8,355,4,36,100,2.8,1,75,455,6.1,14,5,4,23,13,96,0,0,0
5317,11,2017-11-18,massachusetts,@,Brigham Young,W (16-10),21,35,60.0,230,1,33,69,2.1,0,68,299,4.4,14,4,0,18,3,30,0,0,0
5318,12,2017-12-02,massachusetts,@,Florida International,L (45-63),34,49,69.4,392,4,24,156,6.5,2,73,548,7.5,17,8,1,26,6,57,2,1,3
5319,,12 Games,massachusetts,,,,272,447,60.9,3570,26,418,1626,3.9,19,865,5196,6.0,154,82,24,260,79,679,11,6,17
5320,1,2018-08-25,massachusetts,,Duquesne,W (63-15),19,28,67.9,290,4,38,284,7.5,4,66,574,8.7,12,11,1,24,4,30,1,0,1
5321,2,2018-09-01,massachusetts,@,Boston College,L (21-55),21,34,61.8,249,1,34,66,1.9,2,68,315,4.6,12,5,1,18,2,8,1,2,3
5322,3,2018-09-08,massachusetts,@,Georgia Southern,L (13-34),23,36,63.9,216,0,24,108,4.5,1,60,324,5.4,12,6,1,19,8,55,1,1,2
5323,4,2018-09-15,massachusetts,@,Florida International,L (24-63),15,32,46.9,224,1,34,199,5.9,2,66,423,6.4,11,11,2,24,5,40,1,2,3
5324,5,2018-09-22,massachusetts,,UNC Charlotte,W (49-31),12,19,63.2,189,2,35,142,4.1,4,54,331,6.1,9,5,2,16,6,59,1,0,1
5325,6,2018-09-29,massachusetts,@,Ohio,L (42-58),30,43,69.8,410,5,22,41,1.9,0,65,451,6.9,19,3,1,23,8,77,0,1,1
5326,7,2018-10-06,massachusetts,,South Florida,L (42-58),33,52,63.5,401,5,34,85,2.5,1,86,486,5.7,19,6,4,29,8,80,4,1,5
5327,8,2018-10-20,massachusetts,,Coastal Carolina,L (13-24),25,43,58.1,390,1,22,63,2.9,0,65,453,7.0,18,4,0,22,8,70,2,0,2
5328,9,2018-10-27,massachusetts,@,Connecticut,W (22-17),8,15,53.3,197,2,53,247,4.7,1,68,444,6.5,7,12,1,20,2,15,1,1,2
5329,10,2018-11-03,massachusetts,,Liberty,W (62-59),29,44,65.9,540,4,54,237,4.4,4,98,777,7.9,17,15,2,34,9,79,2,1,3
5330,11,2018-11-10,massachusetts,,Brigham Young,L (16-35),23,33,69.7,183,0,36,102,2.8,2,69,285,4.1,9,5,1,15,1,10,0,0,0
5331,12,2018-11-17,massachusetts,@,Georgia,L (27-66),24,32,75.0,287,2,22,103,4.7,1,54,390,7.2,10,5,1,16,7,59,0,1,1
5332,,12 Games,massachusetts,,,,262,411,63.7,3576,27,408,1677,4.1,22,819,5253,6.4,155,88,17,260,68,582,14,10,24
5333,1,2016-09-03,liberty,@,Virginia Tech,L (13-36),9,27,33.3,70,0,35,90,2.6,1,62,160,2.6,4,4,3,11,13,75,1,3,4
5334,2,2016-09-17,liberty,@,Southern Methodist,L (14-29),18,36,50.0,183,1,36,97,2.7,1,72,280,3.9,8,6,2,16,7,88,0,4,4
5335,,2 Games,liberty,,,,27,63,42.9,253,1,71,187,2.6,2,134,440,3.3,12,10,5,27,20,163,1,7,8
5336,1,2017-09-02,liberty,@,Baylor,W (48-45),44,60,73.3,447,3,43,138,3.2,1,103,585,5.7,21,9,1,31,8,95,0,0,0
5337,1,2018-09-01,liberty,,Old Dominion,W (52-10),26,37,70.3,353,4,38,238,6.3,3,75,591,7.9,14,9,6,29,6,58,1,0,1
5338,2,2018-09-08,liberty,@,Army,L (14-38),19,37,51.4,307,2,23,110,4.8,0,60,417,7.0,14,5,2,21,6,27,2,1,3
5339,3,2018-09-22,liberty,,North Texas,L (7-47),16,40,40.0,222,1,42,122,2.9,0,82,344,4.2,11,9,3,23,5,45,0,1,1
5340,4,2018-09-29,liberty,@,New Mexico,W (52-43),27,47,57.4,472,3,43,96,2.2,4,90,568,6.3,15,5,3,23,3,30,0,1,1
5341,5,2018-10-06,liberty,@,New Mexico State,L (41-49),31,54,57.4,365,2,42,153,3.6,4,96,518,5.4,19,9,2,30,4,40,1,1,2
5342,6,2018-10-13,liberty,,Troy,W (22-16),17,32,53.1,238,2,45,103,2.3,1,77,341,4.4,13,4,0,17,3,45,0,1,1
5343,7,2018-10-20,liberty,,Idaho State,W (48-41),32,48,66.7,362,2,41,190,4.6,5,89,552,6.2,18,9,2,29,6,55,0,2,2
5344,8,2018-11-03,liberty,@,Massachusetts,L (59-62),16,35,45.7,272,2,51,216,4.2,5,86,488,5.7,13,16,2,31,7,45,0,4,4
5345,9,2018-11-10,liberty,@,Virginia,L (24-45),15,27,55.6,149,0,44,205,4.7,3,71,354,5.0,10,10,0,20,3,30,0,3,3
5346,10,2018-11-17,liberty,@,Auburn,L (0-53),9,28,32.1,79,0,28,55,2.0,0,56,134,2.4,6,1,1,7,1,5,2,2,4
5347,,10 Games,liberty,,,,208,385,54.0,2819,18,397,1488,3.7,25,782,4307,5.5,133,77,21,230,44,380,6,16,22
5348,1,2014-08-30,navy,N,Ohio State,L (17-34),2,4,50.0,20,0,63,370,5.9,2,67,390,5.8,1,21,0,22,3,20,1,0,1
5349,2,2014-09-06,navy,@,Temple,W (31-24),4,8,50.0,30,0,63,487,7.7,4,71,517,7.3,1,24,2,27,1,15,3,0,3
5350,3,2014-09-13,navy,@,Texas State,W (35-21),5,7,71.4,117,2,57,352,6.2,3,64,469,7.3,3,13,1,17,4,50,0,1,1
5351,4,2014-09-20,navy,,Rutgers,L (24-31),12,22,54.5,231,1,43,171,4.0,2,65,402,6.2,8,11,1,20,3,34,1,0,1
5352,5,2014-09-27,navy,,Western Kentucky,L (27-36),3,15,20.0,55,0,52,412,7.9,4,67,467,7.0,3,19,0,22,3,25,1,1,2
5353,6,2014-10-04,navy,@,Air Force,L (21-30),8,16,50.0,142,1,55,251,4.6,2,71,393,5.5,5,12,3,20,5,55,1,1,2
5354,7,2014-10-11,navy,,Virginia Military Institute,W (51-14),3,6,50.0,82,1,49,352,7.2,5,55,434,7.9,3,17,0,20,3,18,1,1,2
5355,8,2014-10-25,navy,,San Jose State,W (41-31),4,8,50.0,56,0,68,423,6.2,5,76,479,6.3,2,25,1,28,0,0,1,0,1
5356,9,2014-11-01,navy,N,Notre Dame,L (39-49),6,17,35.3,118,2,60,336,5.6,3,77,454,5.9,5,18,0,23,3,56,0,1,1
5357,10,2014-11-15,navy,,Georgia Southern,W (52-19),5,8,62.5,71,1,50,394,7.9,6,58,465,8.0,3,20,0,23,0,0,0,0,0
5358,11,2014-11-28,navy,@,South Alabama,W (42-40),1,4,25.0,42,0,54,388,7.2,6,58,430,7.4,1,15,2,18,1,15,3,0,3
5359,12,2014-12-13,navy,N,Army,W (17-10),6,8,75.0,77,1,55,205,3.7,1,63,282,4.5,2,14,0,16,3,20,1,0,1
5360,13,2014-12-23,navy,N,San Diego State*,W (17-16),3,7,42.9,17,0,58,254,4.4,2,65,271,4.2,0,13,0,13,5,45,4,0,4
5361,,13 Games,navy,,,,62,130,47.7,1058,9,727,4395,6.0,45,857,5453,6.4,37,222,10,269,34,353,17,5,22
5362,1,2015-09-05,navy,,Colgate,W (48-10),3,6,50.0,67,0,47,371,7.9,5,53,438,8.3,2,16,1,19,3,34,1,0,1
5363,2,2015-09-19,navy,,East Carolina,W (45-21),4,7,57.1,41,0,75,415,5.5,6,82,456,5.6,2,23,3,28,6,55,0,0,0
5364,3,2015-09-26,navy,@,Connecticut,W (28-18),3,5,60.0,40,1,61,303,5.0,3,66,343,5.2,3,17,1,21,3,37,0,0,0
5365,4,2015-10-03,navy,,Air Force,W (33-11),4,10,40.0,117,1,51,270,5.3,3,61,387,6.3,4,9,1,14,7,35,0,0,0
5366,5,2015-10-10,navy,@,Notre Dame,L (24-41),3,6,50.0,22,0,49,318,6.5,3,55,340,6.2,0,16,0,16,3,41,2,1,3
5367,6,2015-10-24,navy,,Tulane,W (31-14),8,12,66.7,158,1,54,133,2.5,3,66,291,4.4,5,11,2,18,3,30,0,0,0
5368,7,2015-10-31,navy,,South Florida,W (29-17),3,9,33.3,16,0,69,428,6.2,3,78,444,5.7,0,21,1,22,2,20,1,0,1
5369,8,2015-11-07,navy,@,Memphis,W (45-20),3,5,60.0,85,1,66,374,5.7,5,71,459,6.5,1,20,2,23,2,5,0,0,0
5370,9,2015-11-14,navy,,Southern Methodist,W (55-14),2,9,22.2,81,1,65,403,6.2,7,74,484,6.5,2,24,2,28,0,0,0,0,0
5371,10,2015-11-21,navy,@,Tulsa,W (44-21),2,3,66.7,55,1,61,469,7.7,5,64,524,8.2,2,22,0,24,4,27,1,0,1
5372,11,2015-11-27,navy,@,Houston,L (31-52),13,18,72.2,312,1,38,147,3.9,3,56,459,8.2,8,8,1,17,2,15,0,1,1
5373,12,2015-12-12,navy,N,Army,W (21-17),6,14,42.9,113,1,41,199,4.9,2,55,312,5.7,3,8,0,11,3,25,0,0,0
5374,13,2015-12-28,navy,N,Pittsburgh*,W (44-28),10,18,55.6,173,1,71,417,5.9,5,89,590,6.6,8,22,1,31,2,15,1,0,1
5375,,13 Games,navy,,,,64,122,52.5,1280,9,748,4247,5.7,53,870,5527,6.4,40,217,15,272,40,339,6,2,8
5376,1,2016-09-03,navy,,Fordham,W (52-16),4,4,100.0,123,1,53,427,8.1,6,57,550,9.6,3,15,0,18,2,16,0,0,0
5377,2,2016-09-10,navy,,Connecticut,W (28-24),6,8,75.0,130,0,50,235,4.7,3,58,365,6.3,4,14,0,18,2,30,1,0,1
5378,3,2016-09-17,navy,@,Tulane,W (21-14),5,12,41.7,59,0,52,300,5.8,3,64,359,5.6,3,16,2,21,3,30,2,0,2
5379,4,2016-10-01,navy,@,Air Force,L (14-28),17,31,54.8,260,0,38,57,1.5,2,69,317,4.6,11,5,2,18,3,15,1,2,3
5380,5,2016-10-08,navy,,Houston,W (46-40),3,5,60.0,76,2,63,306,4.9,2,68,382,5.6,3,16,1,20,1,5,0,0,0
5381,6,2016-10-22,navy,,Memphis,W (42-28),3,4,75.0,85,2,74,447,6.0,4,78,532,6.8,3,23,1,27,3,20,1,0,1
5382,7,2016-10-28,navy,@,South Florida,L (45-52),15,27,55.6,299,1,54,317,5.9,6,81,616,7.6,10,19,0,29,2,10,0,1,1
5383,8,2016-11-05,navy,N,Notre Dame,W (28-27),5,8,62.5,48,0,56,320,5.7,4,64,368,5.8,2,17,2,21,1,5,0,0,0
5384,9,2016-11-12,navy,,Tulsa,W (42-40),6,8,75.0,111,1,64,390,6.1,5,72,501,7.0,4,19,1,24,5,35,0,0,0
5385,10,2016-11-19,navy,@,East Carolina,W (66-31),3,5,60.0,113,0,68,480,7.1,9,73,593,8.1,3,24,1,28,4,40,0,0,0
5386,11,2016-11-26,navy,@,Southern Methodist,W (75-31),5,9,55.6,104,1,48,496,10.3,9,57,600,10.5,4,17,2,23,4,50,1,0,1
5387,12,2016-12-03,navy,,Temple,L (10-34),8,15,53.3,138,0,44,168,3.8,1,59,306,5.2,6,6,1,13,0,0,1,2,3
5388,13,2016-12-10,navy,N,Army,L (17-21),6,10,60.0,89,0,26,112,4.3,2,36,201,5.6,4,4,0,8,3,15,1,2,3
5389,14,2016-12-23,navy,N,Louisiana Tech*,L (45-48),7,12,58.3,159,1,49,300,6.1,5,61,459,7.5,5,17,3,25,6,70,1,0,1
5390,,14 Games,navy,,,,93,158,58.9,1794,9,739,4355,5.9,61,897,6149,6.9,65,212,16,293,39,341,9,7,16
5391,1,2017-09-01,navy,@,Florida Atlantic,W (42-19),3,10,30.0,110,1,68,416,6.1,5,78,526,6.7,3,20,0,23,2,20,1,1,2
5392,2,2017-09-09,navy,,Tulane,W (23-21),4,12,33.3,132,1,52,194,3.7,1,64,326,5.1,2,12,1,15,0,0,1,1,2
5393,3,2017-09-23,navy,,Cincinnati,W (42-32),2,3,66.7,53,1,72,569,7.9,5,75,622,8.3,2,26,3,31,4,50,1,0,1
5394,4,2017-09-30,navy,@,Tulsa,W (31-21),3,4,75.0,90,0,68,421,6.2,4,72,511,7.1,2,22,0,24,9,83,1,0,1
5395,5,2017-10-07,navy,,Air Force,W (48-45),4,12,33.3,86,2,57,471,8.3,4,69,557,8.1,3,19,0,22,4,35,0,0,0
5396,6,2017-10-14,navy,@,Memphis,L (27-30),1,8,12.5,20,0,68,314,4.6,3,76,334,4.4,1,17,1,19,5,65,3,2,5
5397,7,2017-10-21,navy,,Central Florida,L (21-31),5,13,38.5,171,1,59,248,4.2,2,72,419,5.8,4,15,0,19,4,40,1,2,3
5398,8,2017-11-02,navy,@,Temple,L (26-34),13,19,68.4,226,3,52,136,2.6,0,71,362,5.1,8,11,1,20,7,69,0,1,1
5399,9,2017-11-11,navy,,Southern Methodist,W (43-40),0,1,0.0,0,0,72,559,7.8,6,73,559,7.7,0,21,3,24,5,68,1,1,2
5400,10,2017-11-18,navy,@,Notre Dame,L (17-24),3,8,37.5,41,1,72,277,3.8,1,80,318,4.0,2,19,2,23,2,16,0,1,1
5401,11,2017-11-24,navy,@,Houston,L (14-24),3,8,37.5,74,0,60,217,3.6,2,68,291,4.3,2,16,1,19,4,32,0,1,1
5402,12,2017-12-09,navy,N,Army,L (13-14),1,2,50.0,2,0,46,294,6.4,1,48,296,6.2,0,11,1,12,4,25,0,0,0
5403,13,2017-12-28,navy,,Virginia*,W (49-7),0,1,0.0,0,0,76,452,5.9,7,77,452,5.9,0,23,1,24,3,25,0,0,0
5404,,13 Games,navy,,,,42,101,41.6,1005,10,822,4568,5.6,41,923,5573,6.0,29,232,14,275,53,528,9,10,19
5405,1,2018-09-01,navy,@,Hawaii,L (41-59),6,13,46.2,85,1,49,326,6.7,5,62,411,6.6,6,13,0,19,2,18,0,0,0
5406,2,2018-09-08,navy,,Memphis,W (22-21),4,6,66.7,52,0,73,264,3.6,3,79,316,4.0,3,16,1,20,1,10,1,0,1
5407,3,2018-09-15,navy,,Lehigh,W (51-21),6,14,42.9,145,0,62,484,7.8,6,76,629,8.3,4,21,1,26,8,63,1,1,2
5408,4,2018-09-22,navy,@,Southern Methodist,L (30-31),1,4,25.0,25,1,78,349,4.5,3,82,374,4.6,1,22,0,23,2,25,3,0,3
5409,5,2018-10-06,navy,@,Air Force,L (7-35),3,12,25.0,49,0,41,129,3.1,1,53,178,3.4,2,7,0,9,4,40,0,0,0
5410,6,2018-10-13,navy,,Temple,L (17-24),3,11,27.3,14,0,53,270,5.1,2,64,284,4.4,1,14,3,18,6,40,1,0,1
5411,7,2018-10-20,navy,,Houston,L (36-49),10,16,62.5,178,1,68,344,5.1,4,84,522,6.2,6,19,1,26,3,32,0,1,1
5412,8,2018-10-27,navy,N,Notre Dame,L (22-44),4,12,33.3,52,0,48,292,6.1,3,60,344,5.7,2,11,1,14,4,16,1,1,2
5413,9,2018-11-03,navy,@,Cincinnati,L (0-42),3,4,75.0,47,0,52,124,2.4,0,56,171,3.1,2,9,2,13,3,31,1,0,1
5414,10,2018-11-10,navy,@,Central Florida,L (24-35),0,2,0.0,0,0,62,375,6.0,3,64,375,5.9,0,19,1,20,4,30,1,0,1
5415,11,2018-11-17,navy,,Tulsa,W (37-29),1,2,50.0,15,0,61,395,6.5,5,63,410,6.5,1,18,2,21,4,45,1,0,1
5416,,11 Games,navy,,,,41,96,42.7,662,3,647,3352,5.2,35,743,4014,5.4,28,169,12,209,41,350,10,3,13
5417,1,2014-09-06,idaho,@,Louisiana-Monroe,L (31-38),26,47,55.3,324,3,36,118,3.3,1,83,442,5.3,15,8,2,25,12,119,1,2,3
5418,2,2014-09-13,idaho,,Western Michigan,L (33-45),27,41,65.9,362,3,31,45,1.5,1,72,407,5.7,14,4,5,23,8,79,0,1,1
5419,3,2014-09-20,idaho,@,Ohio,L (24-36),33,56,58.9,353,2,28,64,2.3,1,84,417,5.0,15,7,1,23,4,32,0,3,3
5420,4,2014-09-27,idaho,,South Alabama,L (10-34),25,40,62.5,239,1,33,30,0.9,0,73,269,3.7,10,4,4,18,7,59,0,2,2
5421,5,2014-10-04,idaho,@,Texas State,L (30-35),33,52,63.5,347,0,53,176,3.3,4,105,523,5.0,18,13,2,33,4,35,0,2,2
5422,6,2014-10-11,idaho,@,Georgia Southern,L (24-47),20,32,62.5,271,0,40,94,2.4,3,72,365,5.1,11,6,0,17,3,23,0,1,1
5423,7,2014-10-18,idaho,,New Mexico State,W (29-17),23,37,62.2,226,1,52,310,6.0,2,89,536,6.0,11,17,2,30,6,57,1,1,2
5424,8,2014-11-01,idaho,,Arkansas State,L (28-44),17,31,54.8,206,0,46,243,5.3,4,77,449,5.8,11,12,2,25,9,93,4,4,8
5425,9,2014-11-08,idaho,@,San Diego State,L (21-35),17,33,51.5,186,1,49,193,3.9,2,82,379,4.6,9,13,4,26,4,30,1,0,1
5426,10,2014-11-15,idaho,,Troy,L (17-34),14,36,38.9,269,1,27,117,4.3,1,63,386,6.1,8,8,3,19,5,40,0,3,3
5427,11,2014-11-29,idaho,@,Appalachian State,L (28-45),21,37,56.8,208,1,42,157,3.7,3,79,365,4.6,11,6,1,18,12,145,0,1,1
5428,,11 Games,idaho,,,,256,442,57.9,2991,13,437,1547,3.5,22,879,4538,5.2,133,98,26,257,74,712,7,20,27
5429,1,2015-09-03,idaho,,Ohio,L (28-45),36,48,75.0,297,1,28,100,3.6,2,76,397,5.2,18,4,3,25,3,31,1,2,3
5430,2,2015-09-12,idaho,@,Southern California,L (9-59),28,45,62.2,240,1,32,71,2.2,0,77,311,4.0,12,6,1,19,2,23,0,0,0
5431,3,2015-09-19,idaho,,Wofford,W (41-38),25,34,73.5,334,1,43,198,4.6,3,77,532,6.9,11,11,0,22,6,75,0,2,2
5432,4,2015-09-26,idaho,,Georgia Southern,L (20-44),20,36,55.6,284,2,34,111,3.3,0,70,395,5.6,10,8,2,20,2,15,0,2,2
5433,5,2015-10-03,idaho,@,Arkansas State,L (35-49),24,42,57.1,166,0,29,172,5.9,4,71,338,4.8,6,6,7,19,11,105,0,3,3
5434,6,2015-10-17,idaho,@,Troy,W (19-16),20,37,54.1,207,0,37,123,3.3,1,74,330,4.5,11,6,3,20,6,59,0,0,0
5435,7,2015-10-24,idaho,,Louisiana-Monroe,W (27-13),23,39,59.0,315,3,52,174,3.3,0,91,489,5.4,15,12,1,28,5,65,2,1,3
5436,8,2015-10-31,idaho,@,New Mexico State,L (48-55),25,42,59.5,307,2,50,262,5.2,3,92,569,6.2,14,14,2,30,4,30,0,2,2
5437,9,2015-11-07,idaho,@,South Alabama,L (45-52),26,39,66.7,317,2,45,177,3.9,4,84,494,5.9,15,9,3,27,3,24,2,1,3
5438,10,2015-11-14,idaho,,Appalachian State,L (20-47),20,32,62.5,243,2,28,56,2.0,0,60,299,5.0,11,5,1,17,5,44,0,0,0
5439,11,2015-11-21,idaho,@,Auburn,L (34-56),29,48,60.4,356,1,37,123,3.3,3,85,479,5.6,11,10,5,26,4,38,1,2,3
5440,12,2015-11-28,idaho,,Texas State,W (38-31),21,31,67.7,309,2,43,199,4.6,3,74,508,6.9,12,10,1,23,3,15,2,0,2
5441,,12 Games,idaho,,,,297,473,62.8,3375,17,458,1766,3.9,23,931,5141,5.5,146,101,29,276,54,524,8,15,23
5442,1,2016-09-01,idaho,,Montana State,W (20-17),8,22,36.4,128,0,35,225,6.4,2,57,353,6.2,6,9,0,15,5,85,1,1,2
5443,2,2016-09-10,idaho,@,Washington,L (14-59),23,38,60.5,218,1,38,104,2.7,1,76,322,4.2,9,8,0,17,4,35,2,1,3
5444,3,2016-09-17,idaho,@,Washington State,L (6-56),20,37,54.1,179,0,31,78,2.5,0,68,257,3.8,10,2,3,15,6,80,2,0,2
5445,4,2016-09-24,idaho,@,Nevada-Las Vegas,W (33-30),17,35,48.6,249,1,36,129,3.6,2,71,378,5.3,11,7,3,21,5,40,1,0,1
5446,5,2016-10-01,idaho,,Troy,L (13-34),19,34,55.9,166,1,36,89,2.5,0,70,255,3.6,10,7,2,19,4,40,0,2,2
5447,6,2016-10-08,idaho,@,Louisiana-Monroe,W (34-31),21,38,55.3,211,1,33,203,6.2,1,71,414,5.8,10,7,1,18,7,61,0,0,0
5448,7,2016-10-15,idaho,,New Mexico State,W (55-23),31,39,79.5,482,4,42,169,4.0,3,81,651,8.0,24,7,3,34,5,40,0,1,1
5449,8,2016-10-22,idaho,@,Appalachian State,L (19-37),26,41,63.4,294,1,26,63,2.4,0,67,357,5.3,16,5,3,24,3,37,0,3,3
5450,9,2016-11-05,idaho,@,Louisiana,W (23-13),20,30,66.7,227,0,40,157,3.9,2,70,384,5.5,14,7,1,22,4,45,0,0,0
5451,10,2016-11-12,idaho,@,Texas State,W (47-14),26,33,78.8,336,1,40,154,3.9,5,73,490,6.7,14,7,2,23,14,103,0,0,0
5452,11,2016-11-26,idaho,,South Alabama,W (38-31),17,34,50.0,231,2,35,176,5.0,3,69,407,5.9,11,11,5,27,4,45,0,3,3
5453,12,2016-12-03,idaho,,Georgia State,W (37-12),16,20,80.0,138,3,45,149,3.3,0,65,287,4.4,7,8,1,16,5,45,0,0,0
5454,13,2016-12-22,idaho,N,Colorado State*,W (61-50),21,31,67.7,381,4,51,225,4.4,5,82,606,7.4,16,13,1,30,7,69,0,0,0
5455,,13 Games,idaho,,,,265,432,61.3,3240,19,488,1921,3.9,24,920,5161,5.6,158,98,25,281,73,725,6,11,17
5456,1,2017-08-31,idaho,,Sacramento State,W (28-6),14,19,73.7,163,2,44,197,4.5,2,63,360,5.7,4,11,0,15,3,20,1,2,3
5457,2,2017-09-09,idaho,,Nevada-Las Vegas,L (16-44),22,34,64.7,261,1,36,123,3.4,1,70,384,5.5,11,6,1,18,4,40,0,1,1
5458,3,2017-09-16,idaho,@,Western Michigan,L (28-37),16,26,61.5,229,3,34,170,5.0,1,60,399,6.7,5,8,2,15,6,44,2,1,3
5459,4,2017-09-23,idaho,@,South Alabama,W (29-23),23,39,59.0,273,1,37,146,3.9,2,76,419,5.5,13,5,6,24,5,51,2,0,2
5460,5,2017-10-07,idaho,,Louisiana,L (16-21),13,28,46.4,149,0,39,130,3.3,1,67,279,4.2,7,6,0,13,6,60,0,0,0
5461,6,2017-10-14,idaho,,Appalachian State,L (20-23),15,28,53.6,200,2,36,112,3.1,0,64,312,4.9,6,8,0,14,7,60,2,0,2
5462,7,2017-10-21,idaho,@,Missouri,L (21-68),22,36,61.1,197,3,38,81,2.1,0,74,278,3.8,8,6,1,15,6,50,1,0,1
5463,8,2017-10-28,idaho,,Louisiana-Monroe,W (31-23),28,42,66.7,360,3,39,158,4.1,1,81,518,6.4,17,9,1,27,5,56,0,0,0
5464,9,2017-11-02,idaho,@,Troy,L (21-24),24,35,68.6,288,3,32,90,2.8,0,67,378,5.6,13,6,3,22,5,45,0,0,0
5465,10,2017-11-18,idaho,,Coastal Carolina,L (7-13),18,26,69.2,177,1,33,100,3.0,0,59,277,4.7,9,5,0,14,8,84,0,1,1
5466,11,2017-11-25,idaho,@,New Mexico State,L (10-17),19,35,54.3,174,1,38,41,1.1,0,73,215,2.9,8,6,2,16,4,20,1,2,3
5467,12,2017-12-02,idaho,@,Georgia State,W (24-10),16,30,53.3,228,1,40,147,3.7,2,70,375,5.4,11,6,1,18,5,37,0,0,0
5468,,12 Games,idaho,,,,230,378,60.8,2699,21,446,1495,3.4,10,824,4194,5.1,112,82,17,211,64,567,9,7,16
5469,1,2018-09-01,idaho,@,Fresno State,L (13-79),14,33,42.4,205,1,32,102,3.2,1,65,307,4.7,9,6,0,15,4,20,2,5,7
5470,2,2018-11-17,idaho,@,Florida,L (10-63),13,35,37.1,73,1,33,154,4.7,0,68,227,3.3,4,11,2,17,6,48,0,2,2
5471,,2 Games,idaho,,,,27,68,39.7,278,2,65,256,3.9,1,133,534,4.0,13,17,2,32,10,68,2,7,9
5472,1,2014-08-29,western-kentucky,,Bowling Green State,W (59-31),46,56,82.1,569,6,40,139,3.5,2,96,708,7.4,29,9,2,40,7,66,0,0,0
5473,2,2014-09-06,western-kentucky,@,Illinois,L (34-42),28,48,58.3,297,2,30,103,3.4,1,78,400,5.1,17,5,1,23,5,24,2,1,3
5474,3,2014-09-13,western-kentucky,@,Middle Tennessee State,L (47-50),43,66,65.2,593,4,36,125,3.5,1,102,718,7.0,22,9,2,33,10,92,0,1,1
5475,4,2014-09-27,western-kentucky,@,Navy,W (36-27),38,54,70.4,387,2,34,164,4.8,1,88,551,6.3,19,11,0,30,7,66,0,1,1
5476,5,2014-10-04,western-kentucky,,Alabama-Birmingham,L (39-42),25,37,67.6,319,2,28,184,6.6,3,65,503,7.7,14,9,2,25,6,50,0,0,0
5477,6,2014-10-18,western-kentucky,@,Florida Atlantic,L (38-45),28,44,63.6,335,3,26,67,2.6,2,70,402,5.7,16,4,3,23,3,25,1,1,2
5478,7,2014-10-25,western-kentucky,,Old Dominion,W (66-51),23,26,88.5,371,5,45,230,5.1,2,71,601,8.5,17,13,2,32,3,40,2,0,2
5479,8,2014-11-01,western-kentucky,@,Louisiana Tech,L (10-59),16,39,41.0,145,1,33,152,4.6,0,72,297,4.1,6,9,0,15,8,93,1,4,5
5480,9,2014-11-08,western-kentucky,,Texas-El Paso,W (35-27),23,34,67.6,324,3,21,34,1.6,1,55,358,6.5,13,2,1,16,3,24,0,0,0
5481,10,2014-11-15,western-kentucky,,Army,W (52-24),16,25,64.0,178,3,41,383,9.3,4,66,561,8.5,6,16,0,22,7,80,0,0,0
5482,11,2014-11-22,western-kentucky,,Texas-San Antonio,W (45-7),26,35,74.3,346,5,28,120,4.3,1,63,466,7.4,13,6,6,25,4,40,0,0,0
5483,12,2014-11-28,western-kentucky,@,Marshall,W (67-66),35,51,68.6,516,8,35,222,6.3,1,86,738,8.6,22,13,2,37,4,38,0,2,2
5484,13,2014-12-24,western-kentucky,N,Central Michigan*,W (49-48),31,42,73.8,486,5,32,161,5.0,2,74,647,8.7,22,6,2,30,9,105,2,0,2
5485,,13 Games,western-kentucky,,,,378,557,67.9,4866,49,429,2084,4.9,21,986,6950,7.0,216,112,23,351,76,743,8,10,18
5486,1,2015-09-03,western-kentucky,@,Vanderbilt,W (14-12),19,30,63.3,209,1,23,37,1.6,1,53,246,4.6,7,4,0,11,9,70,0,0,0
5487,2,2015-09-10,western-kentucky,,Louisiana Tech,W (41-38),28,38,73.7,441,1,33,149,4.5,2,71,590,8.3,18,6,0,24,10,109,1,0,1
5488,3,2015-09-19,western-kentucky,@,Indiana,L (35-38),35,46,76.1,484,3,26,84,3.2,2,72,568,7.9,21,5,2,28,6,65,0,2,2
5489,4,2015-09-26,western-kentucky,,Miami (OH),W (56-14),34,42,81.0,464,6,32,105,3.3,2,74,569,7.7,20,6,1,27,6,50,0,0,0
5490,5,2015-10-03,western-kentucky,@,Rice,W (49-10),29,39,74.4,424,4,32,80,2.5,3,71,504,7.1,16,4,4,24,3,20,0,0,0
5491,6,2015-10-10,western-kentucky,,Middle Tennessee State,W (58-28),29,37,78.4,428,6,40,165,4.1,1,77,593,7.7,14,8,2,24,3,35,1,1,2
5492,7,2015-10-15,western-kentucky,@,North Texas,W (55-28),31,43,72.1,400,4,40,283,7.1,3,83,683,8.2,17,17,1,35,7,55,0,1,1
5493,8,2015-10-24,western-kentucky,@,Louisiana State,L (20-48),37,61,60.7,325,3,23,103,4.5,0,84,428,5.1,16,7,1,24,7,62,1,1,2
5494,9,2015-10-31,western-kentucky,@,Old Dominion,W (55-30),22,29,75.9,284,3,31,239,7.7,4,60,523,8.7,12,9,1,22,1,5,0,0,0
5495,10,2015-11-07,western-kentucky,,Florida Atlantic,W (35-19),25,30,83.3,287,5,34,229,6.7,0,64,516,8.1,10,14,1,25,7,85,0,1,1
5496,11,2015-11-21,western-kentucky,@,Florida International,W (63-7),16,21,76.2,224,3,37,253,6.8,5,58,477,8.2,8,14,1,23,5,70,3,0,3
5497,12,2015-11-27,western-kentucky,,Marshall,W (49-28),27,40,67.5,370,5,43,176,4.1,1,83,546,6.6,18,10,3,31,8,102,2,0,2
5498,13,2015-12-05,western-kentucky,,Southern Mississippi,W (45-28),34,52,65.4,410,3,36,111,3.1,3,88,521,5.9,16,7,1,24,2,15,0,1,1
5499,14,2015-12-21,western-kentucky,N,South Florida*,W (45-35),32,46,69.6,461,3,33,151,4.6,3,79,612,7.7,17,9,1,27,9,66,0,2,2
5500,,14 Games,western-kentucky,,,,398,554,71.8,5211,50,463,2165,4.7,30,1017,7376,7.3,210,120,19,349,83,809,8,9,17
5501,1,2016-09-01,western-kentucky,,Rice,W (46-14),26,35,74.3,552,3,30,97,3.2,2,65,649,10.0,17,4,2,23,8,77,0,0,0
5502,2,2016-09-10,western-kentucky,@,Alabama,L (10-38),19,38,50.0,216,1,22,23,1.0,0,60,239,4.0,9,2,1,12,2,16,0,2,2
5503,3,2016-09-17,western-kentucky,@,Miami (OH),W (31-24),19,31,61.3,268,2,35,136,3.9,1,66,404,6.1,10,7,2,19,9,126,2,1,3
5504,4,2016-09-24,western-kentucky,,Vanderbilt,L (30-31),24,40,60.0,291,2,33,205,6.2,2,73,496,6.8,12,12,3,27,11,88,2,1,3
5505,5,2016-10-01,western-kentucky,,,W (50-3),16,22,72.7,283,3,30,252,8.4,3,52,535,10.3,12,11,0,23,3,35,0,0,0
5506,6,2016-10-06,western-kentucky,@,Louisiana Tech,L (52-55),36,50,72.0,340,5,23,87,3.8,1,73,427,5.8,18,7,1,26,5,58,2,0,2
5507,7,2016-10-15,western-kentucky,@,Middle Tennessee State,W (44-43),29,40,72.5,391,2,37,130,3.5,3,77,521,6.8,15,12,1,28,7,64,0,1,1
5508,8,2016-10-22,western-kentucky,,Old Dominion,W (59-24),28,33,84.8,378,4,35,246,7.0,4,68,624,9.2,17,11,1,29,7,81,0,1,1
5509,9,2016-10-29,western-kentucky,@,Florida Atlantic,W (52-3),16,25,64.0,393,5,45,268,6.0,2,70,661,9.4,11,11,0,22,8,80,1,0,1
5510,10,2016-11-05,western-kentucky,,Florida International,W (49-21),18,32,56.3,284,1,37,225,6.1,5,69,509,7.4,14,10,0,24,3,15,2,0,2
5511,11,2016-11-12,western-kentucky,,North Texas,W (45-7),17,33,51.5,329,5,41,214,5.2,1,74,543,7.3,12,11,2,25,9,55,0,0,0
5512,12,2016-11-26,western-kentucky,@,Marshall,W (60-6),16,31,51.6,233,3,30,229,7.6,3,61,462,7.6,11,14,2,27,6,80,0,0,0
5513,13,2016-12-03,western-kentucky,,Louisiana Tech,W (58-44),21,31,67.7,421,3,41,235,5.7,4,72,656,9.1,15,13,3,31,7,75,2,1,3
5514,14,2016-12-20,western-kentucky,N,Memphis*,W (51-31),20,30,66.7,336,3,48,262,5.5,4,78,598,7.7,11,14,3,28,8,84,0,1,1
5515,,14 Games,western-kentucky,,,,305,471,64.8,4715,42,487,2609,5.4,35,958,7324,7.6,184,139,21,344,93,934,11,8,19
5516,1,2017-09-02,western-kentucky,,Eastern Kentucky,W (31-17),20,31,64.5,264,1,40,100,2.5,3,71,364,5.1,10,8,2,20,3,25,1,0,1
5517,2,2017-09-09,western-kentucky,@,Illinois,L (7-20),28,43,65.1,238,0,16,6,0.4,1,59,244,4.1,8,2,4,14,11,100,1,1,2
5518,3,2017-09-16,western-kentucky,,Louisiana Tech,L (22-23),25,35,71.4,226,0,41,141,3.4,3,76,367,4.8,13,9,1,23,3,22,0,0,0
5519,4,2017-09-23,western-kentucky,,Ball State,W (33-21),28,44,63.6,319,1,30,52,1.7,2,74,371,5.0,16,5,1,22,4,35,0,2,2
5520,5,2017-10-07,western-kentucky,@,Texas-El Paso,W (15-14),24,37,64.9,208,0,33,74,2.2,2,70,282,4.0,12,4,2,18,6,49,0,0,0
5521,6,2017-10-14,western-kentucky,,UNC Charlotte,W (45-14),43,58,74.1,506,5,34,121,3.6,1,92,627,6.8,22,10,2,34,7,58,1,0,1
5522,7,2017-10-20,western-kentucky,@,Old Dominion,W (35-31),25,35,71.4,343,5,33,73,2.2,0,68,416,6.1,15,7,1,23,5,25,1,1,2
5523,8,2017-10-28,western-kentucky,,Florida Atlantic,L (28-42),32,56,57.1,371,2,33,99,3.0,2,89,470,5.3,21,8,3,32,3,35,2,2,4
5524,9,2017-11-04,western-kentucky,@,Vanderbilt,L (17-31),33,53,62.3,355,1,30,-6,-0.2,1,83,349,4.2,15,4,3,22,5,31,0,1,1
5525,10,2017-11-11,western-kentucky,@,Marshall,L (23-30),28,42,66.7,334,3,19,34,1.8,0,61,368,6.0,14,6,1,21,6,63,1,1,2
5526,11,2017-11-17,western-kentucky,,Middle Tennessee State,W (41-38),39,54,72.2,485,5,33,53,1.6,0,87,538,6.2,16,6,3,25,7,69,2,0,2
5527,12,2017-11-24,western-kentucky,@,Florida International,L (17-41),30,49,61.2,355,2,28,46,1.6,0,77,401,5.2,17,5,1,23,4,32,3,0,3
5528,13,2017-12-16,western-kentucky,N,Georgia State*,L (17-27),26,40,65.0,351,2,21,-2,-0.1,0,61,349,5.7,14,3,0,17,10,89,1,2,3
5529,,13 Games,western-kentucky,,,,381,577,66.0,4355,27,391,791,2.0,15,968,5146,5.3,193,77,24,294,74,633,13,10,23
5530,1,2018-08-31,western-kentucky,@,Wisconsin,L (3-34),17,30,56.7,181,0,34,124,3.6,0,64,305,4.8,8,6,1,15,6,65,1,1,2
5531,2,2018-09-08,western-kentucky,,Maine,L (28-31),23,41,56.1,347,3,31,42,1.4,0,72,389,5.4,6,11,0,17,4,38,2,0,2
5532,3,2018-09-15,western-kentucky,@,Louisville,L (17-20),25,38,65.8,260,1,43,168,3.9,1,81,428,5.3,14,11,1,26,8,69,0,1,1
5533,4,2018-09-22,western-kentucky,@,Ball State,W (28-20),25,35,71.4,252,2,40,192,4.8,2,75,444,5.9,12,14,3,29,11,102,0,0,0
5534,5,2018-09-29,western-kentucky,,Marshall,L (17-20),24,39,61.5,263,1,32,61,1.9,1,71,324,4.6,10,4,3,17,6,43,2,1,3
5535,6,2018-10-13,western-kentucky,@,UNC Charlotte,L (14-40),27,39,69.2,214,1,17,42,2.5,1,56,256,4.6,11,4,2,17,7,55,1,2,3
5536,7,2018-10-20,western-kentucky,,Old Dominion,L (34-37),24,32,75.0,257,2,45,207,4.6,2,77,464,6.0,14,11,4,29,10,83,0,0,0
5537,8,2018-10-27,western-kentucky,,Florida International,L (17-38),18,34,52.9,144,0,38,168,4.4,2,72,312,4.3,7,12,4,23,4,34,0,1,1
5538,9,2018-11-02,western-kentucky,@,Middle Tennessee State,L (10-29),16,47,34.0,270,1,25,109,4.4,0,72,379,5.3,10,6,1,17,7,80,1,1,2
5539,10,2018-11-10,western-kentucky,@,Florida Atlantic,L (15-34),25,42,59.5,228,1,34,123,3.6,1,76,351,4.6,15,4,2,21,2,10,0,1,1
5540,11,2018-11-17,western-kentucky,,Texas-El Paso,W (40-16),19,31,61.3,214,2,50,208,4.2,2,81,422,5.2,9,12,1,22,7,62,0,1,1
5541,,11 Games,western-kentucky,,,,243,408,59.6,2630,14,389,1444,3.7,12,797,4074,5.1,116,95,22,233,72,641,7,9,16
5542,1,2014-08-28,temple,@,Vanderbilt,W (37-7),23,36,63.9,207,2,45,144,3.2,1,81,351,4.3,9,9,0,17,3,23,2,0,2
5543,2,2014-09-06,temple,,Navy,L (24-31),29,50,58.0,240,2,34,156,4.6,0,84,396,4.7,10,14,1,25,6,56,1,1,2
5544,3,2014-09-20,temple,,Delaware State,W (59-0),16,21,76.2,179,2,40,172,4.3,3,61,351,5.8,8,11,0,19,8,69,0,2,2
5545,4,2014-09-27,temple,@,Connecticut,W (36-10),20,31,64.5,231,1,24,41,1.7,1,55,272,4.9,13,2,0,15,5,57,1,0,1
5546,5,2014-10-11,temple,,Tulsa,W (35-24),15,31,48.4,294,2,35,203,5.8,3,66,497,7.5,10,6,5,21,5,30,1,1,2
5547,6,2014-10-17,temple,@,Houston,L (10-31),12,29,41.4,259,1,20,98,4.9,0,49,357,7.3,6,4,1,11,11,93,1,3,4
5548,7,2014-10-25,temple,@,Central Florida,L (14-34),20,38,52.6,150,1,20,32,1.6,0,58,182,3.1,5,4,2,11,8,68,1,3,4
5549,8,2014-11-01,temple,,East Carolina,W (20-10),7,19,36.8,70,0,37,65,1.8,2,56,135,2.4,4,2,4,10,7,65,0,0,0
5550,9,2014-11-07,temple,,Memphis,L (13-16),16,37,43.2,140,0,32,158,4.9,1,69,298,4.3,6,8,2,16,4,36,1,1,2
5551,10,2014-11-15,temple,@,Penn State,L (13-30),17,38,44.7,187,1,20,61,3.1,0,58,248,4.3,4,4,0,8,10,69,1,4,5
5552,11,2014-11-29,temple,,Cincinnati,L (6-14),19,35,54.3,196,0,32,71,2.2,0,67,267,4.0,8,6,0,14,3,26,2,0,2
5553,12,2014-12-06,temple,@,Tulane,W (10-3),20,38,52.6,255,1,30,92,3.1,0,68,347,5.1,10,6,0,16,8,67,0,1,1
5554,,12 Games,temple,,,,214,403,53.1,2408,13,369,1293,3.5,11,772,3701,4.8,93,76,15,183,78,659,11,16,27
5555,1,2015-09-05,temple,,Penn State,W (27-10),16,21,76.2,168,0,43,149,3.5,3,64,317,5.0,7,6,2,15,5,35,1,0,1
5556,2,2015-09-12,temple,@,Cincinnati,W (34-26),13,20,65.0,81,2,36,215,6.0,1,56,296,5.3,5,8,0,13,12,112,1,0,1
5557,3,2015-09-19,temple,@,Massachusetts,W (25-23),28,49,57.1,391,1,37,67,1.8,1,86,458,5.3,19,4,1,24,7,70,1,2,3
5558,4,2015-10-02,temple,@,UNC Charlotte,W (37-3),11,23,47.8,116,2,45,206,4.6,2,68,322,4.7,6,11,2,19,2,25,1,0,1
5559,5,2015-10-10,temple,,Tulane,W (49-10),14,18,77.8,223,3,46,122,2.7,3,64,345,5.4,12,7,4,23,7,55,2,0,2
5560,6,2015-10-17,temple,,Central Florida,W (30-16),15,27,55.6,149,1,41,212,5.2,3,68,361,5.3,8,10,2,20,8,84,3,1,4
5561,7,2015-10-22,temple,@,East Carolina,W (24-14),19,36,52.8,250,1,25,72,2.9,2,61,322,5.3,9,5,3,17,12,114,0,0,0
5562,8,2015-10-31,temple,,Notre Dame,L (20-24),13,30,43.3,188,1,32,107,3.3,1,62,295,4.8,7,7,2,16,6,79,0,1,1
5563,9,2015-11-06,temple,@,Southern Methodist,W (60-40),18,25,72.0,268,4,37,268,7.2,3,62,536,8.6,9,9,2,20,7,81,0,0,0
5564,10,2015-11-14,temple,@,South Florida,L (23-44),20,48,41.7,259,1,31,121,3.9,1,79,380,4.8,12,7,3,22,5,48,0,1,1
5565,11,2015-11-21,temple,,Memphis,W (31-12),14,26,53.8,261,2,46,200,4.3,2,72,461,6.4,11,10,4,25,1,10,1,1,2
5566,12,2015-11-28,temple,,Connecticut,W (27-3),19,29,65.5,160,1,39,161,4.1,2,68,321,4.7,9,6,3,18,3,15,0,0,0
5567,13,2015-12-05,temple,@,Houston,L (13-24),26,44,59.1,287,1,27,98,3.6,0,71,385,5.4,13,5,1,19,2,15,1,1,2
5568,14,2015-12-22,temple,N,Toledo*,L (17-32),23,42,54.8,236,0,33,99,3.0,1,75,335,4.5,9,9,3,21,4,30,0,1,1
5569,,14 Games,temple,,,,249,438,56.8,3037,20,518,2097,4.0,25,956,5134,5.4,136,104,32,272,81,773,11,8,19
5570,1,2016-09-02,temple,,Army,L (13-28),12,26,46.2,168,0,28,83,3.0,1,54,251,4.6,10,5,1,16,5,35,0,3,3
5571,2,2016-09-10,temple,,Stony Brook,W (38-0),11,25,44.0,124,3,39,177,4.5,2,64,301,4.7,6,8,0,14,2,20,0,1,1
5572,3,2016-09-17,temple,@,Penn State,L (27-34),25,34,73.5,286,0,28,38,1.4,3,62,324,5.2,9,2,2,13,13,118,0,1,1
5573,4,2016-09-24,temple,,UNC Charlotte,W (48-20),17,32,53.1,297,2,34,210,6.2,4,66,507,7.7,11,12,3,26,5,31,0,0,0
5574,5,2016-10-01,temple,,Southern Methodist,W (45-20),7,18,38.9,124,1,45,244,5.4,4,63,368,5.8,5,11,1,17,3,25,1,2,3
5575,6,2016-10-06,temple,@,Memphis,L (27-34),36,59,61.0,445,2,29,86,3.0,1,88,531,6.0,19,6,2,27,7,61,1,2,3
5576,7,2016-10-15,temple,@,Central Florida,W (26-25),12,24,50.0,167,2,51,197,3.9,1,75,364,4.9,9,11,4,24,10,69,1,1,2
5577,8,2016-10-21,temple,,South Florida,W (46-30),14,21,66.7,209,1,48,322,6.7,4,69,531,7.7,8,16,2,26,8,75,0,0,0
5578,9,2016-10-29,temple,,Cincinnati,W (34-13),12,19,63.2,199,2,60,275,4.6,2,79,474,6.0,7,16,2,25,3,25,1,0,1
5579,10,2016-11-04,temple,@,Connecticut,W (21-0),12,18,66.7,215,3,46,216,4.7,0,64,431,6.7,9,13,0,22,4,25,1,2,3
5580,11,2016-11-19,temple,@,Tulane,W (31-0),18,33,54.5,337,2,48,196,4.1,2,81,533,6.6,12,12,2,26,7,55,0,0,0
5581,12,2016-11-26,temple,,East Carolina,W (37-10),12,20,60.0,158,0,46,256,5.6,5,66,414,6.3,9,12,2,23,0,0,0,0,0
5582,13,2016-12-03,temple,@,Navy,W (34-10),16,25,64.0,199,2,36,189,5.3,2,61,388,6.4,8,10,0,18,4,30,0,0,0
5583,14,2016-12-27,temple,N,Wake Forest*,L (26-34),28,49,57.1,396,2,23,-20,-0.9,0,72,376,5.2,14,5,2,21,4,35,1,1,2
5584,,14 Games,temple,,,,232,403,57.6,3324,22,561,2469,4.4,31,964,5793,6.0,136,139,23,298,75,604,6,13,19
5585,1,2017-09-02,temple,@,Notre Dame,L (16-49),19,35,54.3,245,2,37,85,2.3,0,72,330,4.6,13,4,1,18,6,42,1,0,1
5586,2,2017-09-09,temple,,Villanova,W (16-13),20,34,58.8,274,0,27,79,2.9,1,61,353,5.8,10,5,2,17,8,59,0,0,0
5587,3,2017-09-15,temple,,Massachusetts,W (29-21),24,39,61.5,268,3,34,119,3.5,0,73,387,5.3,14,5,1,20,7,74,0,0,0
5588,4,2017-09-21,temple,@,South Florida,L (7-43),7,25,28.0,89,0,33,-4,-0.1,0,58,85,1.5,4,2,1,7,6,51,2,4,6
5589,5,2017-09-30,temple,,Houston,L (13-20),20,42,47.6,182,1,37,142,3.8,0,79,324,4.1,9,11,2,22,10,83,0,3,3
5590,6,2017-10-07,temple,@,East Carolina,W (34-10),21,33,63.6,344,2,46,179,3.9,2,79,523,6.6,14,6,4,24,8,65,0,1,1
5591,7,2017-10-14,temple,,Connecticut,L (24-28),33,55,60.0,356,1,29,117,4.0,2,84,473,5.6,18,7,3,28,12,117,1,1,2
5592,8,2017-10-21,temple,@,Army,L (28-31),21,31,67.7,289,1,37,217,5.9,3,68,506,7.4,13,10,1,24,8,45,0,0,0
5593,9,2017-11-02,temple,,Navy,W (34-26),22,30,73.3,289,4,28,104,3.7,0,58,393,6.8,14,4,2,20,6,50,0,1,1
5594,10,2017-11-10,temple,@,Cincinnati,W (35-24),19,30,63.3,224,1,43,205,4.8,2,73,429,5.9,11,12,2,25,4,50,1,1,2
5595,11,2017-11-18,temple,,Central Florida,L (19-45),17,42,40.5,201,2,35,196,5.6,0,77,397,5.2,8,10,1,19,6,57,1,4,5
5596,12,2017-11-25,temple,@,Tulsa,W (43-22),21,29,72.4,258,3,34,193,5.7,2,63,451,7.2,13,6,1,20,10,123,0,0,0
5597,13,2017-12-21,temple,N,Florida International*,W (28-3),18,28,64.3,254,1,41,141,3.4,3,69,395,5.7,11,7,2,20,10,86,1,0,1
5598,,13 Games,temple,,,,262,453,57.8,3273,21,461,1773,3.8,15,914,5046,5.5,152,89,23,264,101,902,7,15,22
5599,1,2018-09-01,temple,,Villanova,L (17-19),19,33,57.6,205,1,22,46,2.1,0,55,251,4.6,10,5,1,16,6,56,0,2,2
5600,2,2018-09-08,temple,,Buffalo,L (29-36),17,38,44.7,240,3,29,115,4.0,0,67,355,5.3,10,6,0,16,6,65,1,2,3
5601,3,2018-09-15,temple,@,Maryland,W (35-14),16,28,57.1,264,2,52,165,3.2,2,80,429,5.4,11,9,1,21,4,50,0,1,1
5602,4,2018-09-20,temple,,Tulsa,W (31-17),8,21,38.1,109,0,36,191,5.3,2,57,300,5.3,4,11,1,16,6,47,0,2,2
5603,5,2018-09-29,temple,@,Boston College,L (35-45),21,47,44.7,261,0,34,191,5.6,4,81,452,5.6,15,7,2,24,11,95,1,2,3
5604,6,2018-10-06,temple,,East Carolina,W (49-6),25,30,83.3,297,4,48,173,3.6,2,78,470,6.0,14,11,1,26,6,66,0,1,1
5605,7,2018-10-13,temple,@,Navy,W (24-17),23,32,71.9,300,1,34,109,3.2,2,66,409,6.2,11,8,2,21,7,63,1,1,2
5606,8,2018-10-20,temple,,Cincinnati,W (24-17),20,42,47.6,237,3,30,80,2.7,0,72,317,4.4,11,3,2,16,6,60,0,3,3
5607,9,2018-11-01,temple,@,Central Florida,L (40-52),31,52,59.6,444,4,46,226,4.9,1,98,670,6.8,21,12,2,35,14,149,0,2,2
5608,10,2018-11-10,temple,@,Houston,W (59-49),15,23,65.2,225,0,55,317,5.8,8,78,542,6.9,11,15,2,28,15,114,1,0,1
5609,11,2018-11-17,temple,,South Florida,W (27-17),20,35,57.1,264,0,39,74,1.9,1,74,338,4.6,15,2,1,18,7,61,1,1,2
5610,,11 Games,temple,,,,215,381,56.4,2846,18,425,1687,4.0,22,806,4533,5.6,133,89,15,237,88,826,5,17,22
5611,1,2014-08-30,troy,@,Alabama-Birmingham,L (10-48),21,31,67.7,201,0,37,71,1.9,1,68,272,4.0,8,6,1,15,5,57,1,0,1
5612,2,2014-09-06,troy,,Duke,L (17-34),22,34,64.7,238,0,43,158,3.7,2,77,396,5.1,11,8,1,20,7,55,0,0,0
5613,3,2014-09-13,troy,,Abilene Christian,L (35-38),21,38,55.3,286,1,29,131,4.5,4,67,417,6.2,8,9,0,17,10,108,0,0,0
5614,4,2014-09-20,troy,@,Georgia,L (0-66),18,33,54.5,169,0,28,47,1.7,0,61,216,3.5,5,5,1,11,4,35,1,1,2
5615,5,2014-09-27,troy,@,Louisiana-Monroe,L (20-22),23,34,67.6,270,3,32,81,2.5,0,66,351,5.3,10,7,0,17,3,45,1,0,1
5616,6,2014-10-11,troy,,New Mexico State,W (41-24),23,30,76.7,211,1,53,360,6.8,3,83,571,6.9,10,17,0,27,5,49,1,1,2
5617,7,2014-10-18,troy,,Appalachian State,L (14-53),27,40,67.5,229,0,32,79,2.5,1,72,308,4.3,8,7,2,17,11,89,2,2,4
5618,8,2014-10-24,troy,@,South Alabama,L (13-27),13,24,54.2,145,1,40,164,4.1,0,64,309,4.8,5,10,4,19,10,100,0,0,0
5619,9,2014-10-30,troy,@,Georgia Southern,L (10-42),4,11,36.4,13,0,33,141,4.3,1,44,154,3.5,0,9,0,9,4,45,1,0,1
5620,10,2014-11-08,troy,,Georgia State,W (45-21),18,22,81.8,116,1,45,324,7.2,5,67,440,6.6,4,16,1,21,3,23,0,0,0
5621,11,2014-11-15,troy,@,Idaho,W (34-17),19,26,73.1,231,2,57,293,5.1,1,83,524,6.3,7,15,1,23,8,92,1,0,1
5622,12,2014-11-29,troy,,Louisiana,L (23-42),29,34,85.3,272,3,32,122,3.8,0,66,394,6.0,14,7,3,24,4,40,2,0,2
5623,,12 Games,troy,,,,238,357,66.7,2381,12,461,1971,4.3,18,818,4352,5.3,90,116,14,220,74,738,10,4,14
5624,1,2015-09-05,troy,@,North Carolina State,L (21-49),14,21,66.7,184,1,25,121,4.8,2,46,305,6.6,7,5,1,13,5,54,1,1,2
5625,2,2015-09-12,troy,,Charleston Southern,W (44-16),19,28,67.9,249,2,28,125,4.5,3,56,374,6.7,10,7,1,18,7,62,0,0,0
5626,3,2015-09-19,troy,@,Wisconsin,L (3-28),23,35,65.7,174,0,33,81,2.5,0,68,255,3.8,10,6,3,19,7,59,1,0,1
5627,4,2015-10-03,troy,,South Alabama,L (18-24),16,35,45.7,146,1,33,119,3.6,1,68,265,3.9,9,7,2,18,7,66,0,3,3
5628,5,2015-10-10,troy,@,Mississippi State,L (17-45),20,36,55.6,142,0,46,112,2.4,2,82,254,3.1,8,9,2,19,3,20,1,1,2
5629,6,2015-10-17,troy,,Idaho,L (16-19),20,38,52.6,238,1,37,143,3.9,0,75,381,5.1,13,6,3,22,7,47,2,2,4
5630,7,2015-10-24,troy,@,New Mexico State,W (52-7),26,42,61.9,316,5,24,166,6.9,1,66,482,7.3,16,4,3,23,5,27,0,0,0
5631,8,2015-10-31,troy,@,Appalachian State,L (41-44),29,43,67.4,310,1,45,140,3.1,4,88,450,5.1,16,8,1,25,8,73,0,2,2
5632,9,2015-11-07,troy,,Louisiana-Monroe,W (51-14),24,36,66.7,345,4,35,148,4.2,0,71,493,6.9,13,7,0,20,5,30,0,0,0
5633,10,2015-11-14,troy,,Georgia Southern,L (10-45),15,29,51.7,170,0,18,68,3.8,0,47,238,5.1,8,3,0,11,4,41,2,1,3
5634,11,2015-11-27,troy,@,Georgia State,L (21-31),21,46,45.7,293,2,25,81,3.2,1,71,374,5.3,11,7,2,20,12,117,1,1,2
5635,12,2015-12-05,troy,@,Louisiana,W (41-17),22,28,78.6,320,4,33,128,3.9,0,61,448,7.3,12,6,0,18,10,95,0,0,0
5636,,12 Games,troy,,,,249,417,59.7,2887,21,382,1432,3.7,14,799,4319,5.4,133,75,18,226,80,691,8,11,19
5637,1,2016-09-03,troy,,Austin Peay,W (57-17),29,36,80.6,323,3,43,383,8.9,5,79,706,8.9,11,18,0,29,14,153,1,0,1
5638,2,2016-09-10,troy,@,Clemson,L (24-30),26,45,57.8,245,2,33,141,4.3,1,78,386,4.9,11,6,4,21,11,95,0,3,3
5639,3,2016-09-17,troy,@,Southern Mississippi,W (37-31),10,28,35.7,123,3,49,186,3.8,1,77,309,4.0,5,11,3,19,10,70,0,1,1
5640,4,2016-09-24,troy,,New Mexico State,W (52-6),27,37,73.0,285,2,41,207,5.0,3,78,492,6.3,16,9,2,27,2,26,0,0,0
5641,5,2016-10-01,troy,@,Idaho,W (34-13),31,42,73.8,373,3,33,157,4.8,1,75,530,7.1,15,11,1,27,7,58,1,2,3
5642,6,2016-10-15,troy,,Georgia State,W (31-21),20,36,55.6,235,2,43,128,3.0,1,79,363,4.6,10,7,3,20,10,95,0,1,1
5643,7,2016-10-20,troy,@,South Alabama,W (28-21),28,42,66.7,395,1,38,190,5.0,2,80,585,7.3,15,11,2,28,7,55,2,0,2
5644,8,2016-11-05,troy,,Massachusetts,W (52-31),29,39,74.4,287,4,38,198,5.2,3,77,485,6.3,16,11,1,28,5,35,0,1,1
5645,9,2016-11-12,troy,,Appalachian State,W (28-24),20,36,55.6,223,1,38,187,4.9,3,74,410,5.5,8,11,3,22,8,70,1,1,2
5646,10,2016-11-17,troy,,Arkansas State,L (3-35),20,39,51.3,207,0,24,55,2.3,0,63,262,4.2,10,4,3,17,3,16,3,2,5
5647,11,2016-11-26,troy,@,Texas State,W (40-7),24,37,64.9,237,2,42,154,3.7,3,79,391,4.9,10,11,4,25,2,15,0,0,0
5648,12,2016-12-03,troy,@,Georgia Southern,L (24-28),27,34,79.4,218,1,32,126,3.9,2,66,344,5.2,14,6,0,20,3,25,0,0,0
5649,13,2016-12-23,troy,N,Ohio*,W (28-23),24,41,58.5,235,1,31,87,2.8,3,72,322,4.5,13,3,1,17,6,90,0,2,2
5650,,13 Games,troy,,,,315,492,64.0,3386,25,485,2199,4.5,28,977,5585,5.7,154,119,27,300,88,803,8,13,21
5651,1,2017-09-02,troy,@,Boise State,L (13-24),17,34,50.0,139,0,29,76,2.6,0,63,215,3.4,4,5,2,11,8,60,2,1,3
5652,2,2017-09-09,troy,,Alabama State,W (34-7),33,42,78.6,354,0,35,251,7.2,5,77,605,7.9,18,12,2,32,10,110,0,1,1
5653,3,2017-09-16,troy,@,New Mexico State,W (27-24),25,40,62.5,286,1,37,192,5.2,3,77,478,6.2,13,9,4,26,9,61,0,0,0
5654,4,2017-09-23,troy,,Akron,W (22-17),28,42,66.7,314,1,28,181,6.5,2,70,495,7.1,15,6,3,24,16,159,1,0,1
5655,5,2017-09-30,troy,@,Louisiana State,W (24-21),16,28,57.1,157,0,42,206,4.9,3,70,363,5.2,8,8,0,16,5,35,2,0,2
5656,6,2017-10-11,troy,,South Alabama,L (8-19),25,47,53.2,269,0,20,30,1.5,1,67,299,4.5,11,4,3,18,6,33,3,1,4
5657,7,2017-10-21,troy,@,Georgia State,W (34-10),25,36,69.4,335,2,22,122,5.5,2,58,457,7.9,14,5,1,20,1,5,1,1,2
5658,8,2017-10-28,troy,,Georgia Southern,W (38-16),10,20,50.0,142,2,30,241,8.0,3,50,383,7.7,6,8,2,16,4,18,0,0,0
5659,9,2017-11-02,troy,,Idaho,W (24-21),20,31,64.5,212,1,36,183,5.1,2,67,395,5.9,8,11,1,20,10,91,1,1,2
5660,10,2017-11-11,troy,@,Coastal Carolina,W (42-17),21,33,63.6,259,1,36,122,3.4,3,69,381,5.5,12,11,1,24,4,29,0,1,1
5661,11,2017-11-24,troy,,Texas State,W (62-9),26,35,74.3,487,5,31,154,5.0,3,66,641,9.7,17,5,0,22,3,15,0,0,0
5662,12,2017-12-02,troy,@,Arkansas State,W (32-25),23,41,56.1,246,2,25,47,1.9,0,66,293,4.4,12,0,2,14,7,46,1,0,1
5663,13,2017-12-16,troy,N,North Texas*,W (50-30),24,31,77.4,305,4,38,130,3.4,3,69,435,6.3,13,5,3,21,8,80,1,1,2
5664,,13 Games,troy,,,,293,460,63.7,3505,19,409,1935,4.7,30,869,5440,6.3,151,89,24,264,91,742,12,7,19
5665,1,2018-09-01,troy,,Boise State,L (20-56),24,34,70.6,255,1,44,124,2.8,2,78,379,4.9,13,7,1,21,3,25,3,1,4
5666,2,2018-09-08,troy,,Florida A&M,W (59-7),22,38,57.9,185,5,41,292,7.1,2,79,477,6.0,10,15,1,26,5,51,0,0,0
5667,3,2018-09-15,troy,@,Nebraska,W (24-19),14,21,66.7,110,0,34,143,4.2,2,55,253,4.6,4,5,3,12,10,95,1,1,2
5668,4,2018-09-22,troy,@,Louisiana-Monroe,W (35-27),27,32,84.4,329,3,35,140,4.0,2,67,469,7.0,15,10,2,27,5,32,0,0,0
5669,5,2018-09-29,troy,,Coastal Carolina,W (45-21),14,19,73.7,185,2,31,282,9.1,3,50,467,9.3,7,9,2,18,6,45,1,1,2
5670,6,2018-10-04,troy,,Georgia State,W (37-20),19,25,76.0,217,3,37,337,9.1,2,62,554,8.9,9,9,0,18,13,95,0,1,1
5671,7,2018-10-13,troy,@,Liberty,L (16-22),16,30,53.3,160,1,39,133,3.4,0,69,293,4.2,5,10,2,17,10,65,2,1,3
5672,8,2018-10-23,troy,@,South Alabama,W (38-17),9,16,56.3,158,3,35,252,7.2,2,51,410,8.0,5,7,4,16,7,67,1,1,2
5673,9,2018-11-03,troy,,Louisiana,W (26-16),18,22,81.8,317,1,40,110,2.8,1,62,427,6.9,12,8,1,21,9,73,1,0,1
5674,10,2018-11-10,troy,@,Georgia Southern,W (35-21),23,30,76.7,314,1,42,140,3.3,3,72,454,6.3,13,9,2,24,4,45,1,0,1
5675,11,2018-11-17,troy,,Texas State,W (12-7),13,27,48.1,79,0,47,141,3.0,0,74,220,3.0,4,9,0,13,4,25,0,0,0
5676,,11 Games,troy,,,,199,294,67.7,2309,20,425,2094,4.9,19,719,4403,6.1,97,98,18,213,76,618,10,6,16
5677,1,2014-08-29,connecticut,,Brigham Young,L (10-35),25,48,52.1,284,0,31,71,2.3,1,79,355,4.5,14,3,6,23,8,90,1,1,2
5678,2,2014-09-06,connecticut,,Stony Brook,W (19-16),12,27,44.4,142,1,37,81,2.2,0,64,223,3.5,7,5,3,15,3,25,2,0,2
5679,3,2014-09-13,connecticut,,Boise State,L (21-38),22,38,57.9,242,2,36,48,1.3,0,74,290,3.9,11,6,1,183,3,30,1,2,3
5680,4,2014-09-19,connecticut,@,South Florida,L (14-17),6,10,60.0,88,1,26,57,2.2,0,36,145,4.0,3,2,1,6,9,61,1,0,1
5681,5,2014-09-27,connecticut,,Temple,L (10-36),14,28,50.0,174,1,43,133,3.1,0,71,307,4.3,6,10,2,18,7,70,1,2,3
5682,6,2014-10-11,connecticut,@,Tulane,L (3-12),17,26,65.4,141,0,28,76,2.7,0,54,217,4.0,6,6,1,13,1,15,2,1,3
5683,7,2014-10-23,connecticut,@,East Carolina,L (21-31),20,32,62.5,313,2,26,84,3.2,1,58,397,6.8,10,3,3,16,12,118,0,1,1
5684,8,2014-11-01,connecticut,,Central Florida,W (37-29),14,28,50.0,148,2,40,179,4.5,3,68,327,4.8,6,7,3,16,10,102,1,0,1
5685,9,2014-11-08,connecticut,N,Army,L (21-35),23,37,62.2,190,2,24,169,7.0,1,61,359,5.9,9,8,1,18,5,37,0,2,2
5686,10,2014-11-22,connecticut,,Cincinnati,L (0-41),14,27,51.9,81,0,27,48,1.8,0,54,129,2.4,5,5,0,10,2,20,2,1,3
5687,11,2014-11-29,connecticut,@,Memphis,L (10-41),13,27,48.1,162,1,36,107,3.0,0,63,269,4.3,7,6,1,14,10,115,1,1,2
5688,12,2014-12-06,connecticut,,Southern Methodist,L (20-27),5,14,35.7,67,0,41,249,6.1,2,55,316,5.7,3,8,0,11,4,44,4,1,5
5689,,12 Games,connecticut,,,,185,342,54.1,2032,12,395,1302,3.3,8,737,3334,4.5,87,69,22,343,74,727,16,12,28
5690,1,2015-09-03,connecticut,,Villanova,W (20-15),12,20,60.0,202,2,39,105,2.7,1,59,307,5.2,9,8,2,19,4,30,0,1,1
5691,2,2015-09-12,connecticut,,Army,W (22-17),19,25,76.0,270,0,46,145,3.2,2,71,415,5.8,10,11,2,23,7,50,1,0,1
5692,3,2015-09-19,connecticut,@,Missouri,L (6-9),17,28,60.7,156,0,33,77,2.3,1,61,233,3.8,7,4,0,11,8,85,1,1,2
5693,4,2015-09-26,connecticut,,Navy,L (18-28),19,32,59.4,219,2,31,106,3.4,0,63,325,5.2,10,8,2,20,3,22,1,0,1
5694,5,2015-10-02,connecticut,@,Brigham Young,L (13-30),14,28,50.0,168,1,27,62,2.3,0,55,230,4.2,9,3,2,14,5,43,0,2,2
5695,6,2015-10-10,connecticut,@,Central Florida,W (40-13),18,24,75.0,263,1,45,170,3.8,4,69,433,6.3,10,10,0,20,11,69,0,0,0
5696,7,2015-10-17,connecticut,,South Florida,L (20-28),28,42,66.7,365,1,38,163,4.3,1,80,528,6.6,16,9,1,26,4,39,0,1,1
5697,8,2015-10-24,connecticut,@,Cincinnati,L (13-37),17,41,41.5,130,0,30,136,4.5,1,71,266,3.7,6,8,5,19,3,25,1,1,2
5698,9,2015-10-30,connecticut,,East Carolina,W (31-13),12,21,57.1,184,1,44,220,5.0,3,65,404,6.2,7,7,3,17,5,34,1,1,2
5699,10,2015-11-07,connecticut,@,Tulane,W (7-3),8,19,42.1,81,0,42,146,3.5,0,61,227,3.7,2,7,0,9,4,45,0,1,1
5700,11,2015-11-21,connecticut,,Houston,W (20-17),14,24,58.3,159,2,43,156,3.6,0,67,315,4.7,6,6,1,13,10,63,0,0,0
5701,12,2015-11-28,connecticut,@,Temple,L (3-27),13,21,61.9,129,0,26,9,0.3,0,47,138,2.9,7,2,0,9,7,65,1,1,2
5702,13,2015-12-26,connecticut,N,Marshall*,L (10-16),10,17,58.8,86,0,33,127,3.8,1,50,213,4.3,6,7,2,15,3,25,0,1,1
5703,,13 Games,connecticut,,,,201,342,58.8,2412,10,477,1622,3.4,14,819,4034,4.9,105,90,20,215,74,595,6,10,16
5704,1,2016-09-01,connecticut,,Maine,W (24-21),16,23,69.6,162,0,50,200,4.0,3,73,362,5.0,11,11,1,23,3,30,1,0,1
5705,2,2016-09-10,connecticut,@,Navy,L (24-28),24,27,88.9,264,1,34,90,2.6,1,61,354,5.8,12,6,1,19,2,6,2,0,2
5706,3,2016-09-17,connecticut,,Virginia,W (13-10),13,24,54.2,154,0,40,123,3.1,1,64,277,4.3,9,4,5,18,3,35,1,1,2
5707,4,2016-09-24,connecticut,,Syracuse,L (24-31),28,46,60.9,281,1,45,144,3.2,2,91,425,4.7,13,10,0,23,1,5,0,1,1
5708,5,2016-09-29,connecticut,@,Houston,L (14-42),16,36,44.4,273,1,27,62,2.3,1,63,335,5.3,12,2,0,14,4,38,0,0,0
5709,6,2016-10-08,connecticut,,Cincinnati,W (20-9),18,33,54.5,224,2,41,188,4.6,0,74,412,5.6,10,8,3,21,8,69,0,2,2
5710,7,2016-10-15,connecticut,@,South Florida,L (27-42),22,39,56.4,306,2,36,72,2.0,1,75,378,5.0,11,7,2,20,3,20,0,0,0
5711,8,2016-10-22,connecticut,,Central Florida,L (16-24),18,35,51.4,242,0,45,171,3.8,1,80,413,5.2,11,13,0,24,4,30,0,0,0
5712,9,2016-10-29,connecticut,@,East Carolina,L (3-41),18,35,51.4,206,0,31,89,2.9,0,66,295,4.5,9,4,1,14,4,34,1,2,3
5713,10,2016-11-04,connecticut,,Temple,L (0-21),12,21,57.1,69,0,28,91,3.3,0,49,160,3.3,5,3,0,8,4,23,0,0,0
5714,11,2016-11-19,connecticut,@,Boston College,L (0-30),13,30,43.3,127,0,17,-6,-0.4,0,47,121,2.6,6,1,1,8,6,46,1,3,4
5715,12,2016-11-26,connecticut,,Tulane,L (13-38),15,31,48.4,124,1,24,184,7.7,1,55,308,5.6,8,4,1,13,1,3,2,2,4
5716,,12 Games,connecticut,,,,213,380,56.1,2432,8,418,1408,3.4,11,798,3840,4.8,117,73,15,205,43,339,8,11,19
5717,1,2017-08-31,connecticut,,Holy Cross,W (27-20),28,41,68.3,278,1,37,160,4.3,3,78,438,5.6,10,7,1,18,4,40,2,0,2
5718,2,2017-09-16,connecticut,@,Virginia,L (18-38),18,26,69.2,227,2,41,207,5.0,1,67,434,6.5,10,9,4,23,1,5,1,1,2
5719,3,2017-09-24,connecticut,,East Carolina,L (38-41),24,39,61.5,406,3,38,190,5.0,2,77,596,7.7,15,9,3,27,4,40,0,1,1
5720,4,2017-09-30,connecticut,@,Southern Methodist,L (28-49),22,28,78.6,408,2,36,-8,-0.2,1,64,400,6.3,13,2,3,18,5,42,1,0,1
5721,5,2017-10-06,connecticut,,Memphis,L (31-70),21,35,60.0,310,1,34,167,4.9,3,69,477,6.9,14,7,3,24,6,55,2,1,3
5722,6,2017-10-14,connecticut,@,Temple,W (28-24),18,28,64.3,105,3,36,143,4.0,0,64,248,3.9,6,6,3,15,6,51,1,1,2
5723,7,2017-10-21,connecticut,,Tulsa,W (20-14),23,29,79.3,372,1,42,69,1.6,1,71,441,6.2,11,6,2,19,11,105,0,0,0
5724,8,2017-10-28,connecticut,,Missouri,L (12-52),22,52,42.3,233,0,41,121,3.0,1,93,354,3.8,9,11,3,23,5,65,0,1,1
5725,9,2017-11-04,connecticut,,South Florida,L (20-37),21,28,75.0,176,1,41,148,3.6,2,69,324,4.7,12,7,3,22,2,20,0,1,1
5726,10,2017-11-11,connecticut,@,Central Florida,L (24-49),18,31,58.1,201,2,45,212,4.7,1,76,413,5.4,9,11,3,23,8,79,1,1,2
5727,11,2017-11-18,connecticut,N,Boston College,L (16-39),14,33,42.4,241,1,41,171,4.2,1,74,412,5.6,8,7,0,15,7,47,0,3,3
5728,12,2017-11-25,connecticut,@,Cincinnati,L (21-22),27,51,52.9,273,1,52,176,3.4,1,103,449,4.4,13,13,3,29,4,37,0,1,1
5729,,12 Games,connecticut,,,,256,421,60.8,3230,18,484,1756,3.6,17,905,4986,5.5,130,95,31,256,63,586,8,11,19
5730,1,2018-08-30,connecticut,,Central Florida,L (17-56),27,41,65.9,266,1,46,220,4.8,1,87,486,5.6,9,16,2,27,7,93,2,1,3
5731,2,2018-09-08,connecticut,@,Boise State,L (7-62),11,21,52.4,71,1,25,122,4.9,0,46,193,4.2,3,6,0,9,7,44,0,1,1
5732,3,2018-09-15,connecticut,,Rhode Island,W (56-49),20,27,74.1,308,4,54,265,4.9,4,81,573,7.1,16,11,5,32,4,35,2,1,3
5733,4,2018-09-22,connecticut,@,Syracuse,L (21-51),19,29,65.5,217,2,39,178,4.6,1,68,395,5.8,7,7,2,16,5,42,2,1,3
5734,5,2018-09-29,connecticut,,Cincinnati,L (7-49),14,35,40.0,181,1,29,77,2.7,0,64,258,4.0,7,5,7,19,2,15,0,1,1
5735,6,2018-10-06,connecticut,@,Memphis,L (14-55),24,43,55.8,215,1,30,112,3.7,1,73,327,4.5,14,4,1,19,3,25,1,3,4
5736,7,2018-10-20,connecticut,@,South Florida,L (30-38),10,21,47.6,133,0,51,322,6.3,4,72,455,6.3,5,17,2,24,4,25,0,1,1
5737,8,2018-10-27,connecticut,,Massachusetts,L (17-22),4,6,66.7,15,0,44,250,5.7,2,50,265,5.3,0,11,0,11,2,25,0,1,1
5738,9,2018-11-03,connecticut,@,Tulsa,L (19-49),14,28,50.0,232,2,50,255,5.1,0,78,487,6.2,8,13,2,23,5,45,2,1,3
5739,10,2018-11-10,connecticut,,Southern Methodist,L (50-62),25,40,62.5,215,4,49,365,7.4,3,89,580,6.5,12,17,5,34,9,77,0,1,1
5740,11,2018-11-17,connecticut,@,East Carolina,L (21-55),17,33,51.5,183,3,29,91,3.1,0,62,274,4.4,11,4,1,16,5,30,1,2,3
5741,,11 Games,connecticut,,,,185,324,57.1,2036,19,446,2257,5.1,16,770,4293,5.6,92,111,27,230,53,456,10,14,24
5742,1,2014-08-30,south-florida,,Western Carolina,W (36-31),10,27,37.0,191,0,33,294,8.9,4,60,485,8.1,6,6,1,13,6,38,1,1,2
5743,2,2014-09-06,south-florida,,Maryland,L (17-24),15,37,40.5,174,0,37,83,2.2,1,74,257,3.5,9,6,1,16,6,39,0,1,1
5744,3,2014-09-13,south-florida,,North Carolina State,L (17-49),5,20,25.0,89,1,27,70,2.6,0,47,159,3.4,3,4,1,8,5,40,1,2,3
5745,4,2014-09-19,south-florida,,Connecticut,W (17-14),10,18,55.6,113,1,53,158,3.0,1,71,271,3.8,6,10,1,17,5,45,0,1,1
5746,5,2014-09-27,south-florida,@,Wisconsin,L (10-27),8,19,42.1,173,0,19,72,3.8,1,38,245,6.4,5,3,0,8,11,90,1,1,2
5747,6,2014-10-11,south-florida,,East Carolina,L (17-28),21,42,50.0,257,1,27,93,3.4,1,69,350,5.1,12,6,5,23,8,59,0,1,1
5748,7,2014-10-18,south-florida,@,Tulsa,W (38-30),17,26,65.4,272,3,32,140,4.4,2,58,412,7.1,12,5,2,19,7,77,1,1,2
5749,8,2014-10-24,south-florida,N,Cincinnati,L (17-34),20,33,60.6,239,2,22,42,1.9,0,55,281,5.1,9,3,0,12,7,95,2,2,4
5750,9,2014-11-01,south-florida,,Houston,L (3-27),13,26,50.0,146,0,29,76,2.6,0,55,222,4.0,8,5,0,13,5,45,0,1,1
5751,10,2014-11-15,south-florida,@,Southern Methodist,W (14-13),15,31,48.4,211,2,40,167,4.2,0,71,378,5.3,10,8,0,18,8,96,2,0,2
5752,11,2014-11-22,south-florida,@,Memphis,L (20-31),27,46,58.7,301,1,35,95,2.7,1,81,396,4.9,15,3,2,20,2,29,1,0,1
5753,12,2014-11-28,south-florida,,Central Florida,L (0-16),18,39,46.2,195,0,22,5,0.2,0,61,200,3.3,9,3,3,15,5,75,0,0,0
5754,,12 Games,south-florida,,,,179,364,49.2,2361,11,376,1295,3.4,11,740,3656,4.9,104,62,16,182,75,728,9,11,20
5755,1,2015-09-05,south-florida,,Florida A&M,W (51-3),20,26,76.9,281,3,46,275,6.0,4,72,556,7.7,9,15,3,27,11,97,0,1,1
5756,2,2015-09-12,south-florida,@,Florida State,L (14-34),12,24,50.0,125,2,36,149,4.1,0,60,274,4.6,5,6,0,11,2,21,0,1,1
5757,3,2015-09-19,south-florida,@,Maryland,L (17-35),10,22,45.5,60,1,50,240,4.8,1,72,300,4.2,3,12,3,18,10,105,0,2,2
5758,4,2015-10-02,south-florida,,Memphis,L (17-24),17,26,65.4,199,1,43,178,4.1,1,69,377,5.5,8,7,4,19,6,40,0,1,1
5759,5,2015-10-10,south-florida,,Syracuse,W (45-24),15,22,68.2,259,2,47,281,6.0,4,69,540,7.8,10,15,1,26,9,85,1,0,1
5760,6,2015-10-17,south-florida,@,Connecticut,W (28-20),12,16,75.0,186,3,44,275,6.3,1,60,461,7.7,6,11,0,17,3,30,0,2,2
5761,7,2015-10-24,south-florida,,Southern Methodist,W (38-14),9,21,42.9,97,0,44,255,5.8,5,65,352,5.4,3,10,2,15,4,40,1,0,1
5762,8,2015-10-31,south-florida,@,Navy,L (17-29),12,20,60.0,208,0,24,62,2.6,1,44,270,6.1,7,1,1,9,6,54,1,0,1
5763,9,2015-11-07,south-florida,@,East Carolina,W (22-17),12,23,52.2,200,2,60,242,4.0,0,83,442,5.3,10,10,2,22,6,58,1,0,1
5764,10,2015-11-14,south-florida,,Temple,W (44-23),15,22,68.2,230,2,48,326,6.8,3,70,556,7.9,8,13,1,22,8,86,1,0,1
5765,11,2015-11-20,south-florida,,Cincinnati,W (65-27),13,20,65.0,200,5,53,361,6.8,3,73,561,7.7,7,18,0,25,1,11,1,2,3
5766,12,2015-11-26,south-florida,@,Central Florida,W (44-3),15,23,65.2,174,3,54,281,5.2,2,77,455,5.9,8,16,1,25,4,20,0,0,0
5767,13,2015-12-21,south-florida,N,Western Kentucky*,L (35-45),15,34,44.1,307,2,45,290,6.4,3,79,597,7.6,11,16,1,28,9,67,0,0,0
5768,,13 Games,south-florida,,,,177,299,59.2,2526,26,594,3215,5.4,28,893,5741,6.4,95,150,19,264,79,714,6,9,15
5769,1,2016-09-03,south-florida,,Towson,W (56-20),13,25,52.0,230,4,41,214,5.2,4,66,444,6.7,9,10,3,22,4,42,1,1,2
5770,2,2016-09-10,south-florida,,Northern Illinois,W (48-17),25,39,64.1,365,4,50,293,5.9,2,89,658,7.4,15,15,4,34,8,77,1,0,1
5771,3,2016-09-17,south-florida,@,Syracuse,W (45-20),14,29,48.3,220,1,32,240,7.5,4,61,460,7.5,9,10,1,20,4,50,0,0,0
5772,4,2016-09-24,south-florida,,Florida State,L (35-55),5,14,35.7,160,1,41,290,7.1,4,55,450,8.2,3,12,2,17,8,68,0,2,2
5773,5,2016-10-01,south-florida,@,Cincinnati,W (45-20),22,33,66.7,228,0,48,226,4.7,5,81,454,5.6,12,13,0,25,2,21,0,0,0
5774,6,2016-10-08,south-florida,,East Carolina,W (38-22),21,29,72.4,250,3,42,306,7.3,2,71,556,7.8,8,14,1,23,9,101,1,0,1
5775,7,2016-10-15,south-florida,,Connecticut,W (42-27),23,37,62.2,213,2,47,316,6.7,4,84,529,6.3,11,15,0,26,4,36,2,2,4
5776,8,2016-10-21,south-florida,@,Temple,L (30-46),11,20,55.0,187,2,33,165,5.0,2,53,352,6.6,9,8,1,18,11,88,0,1,1
5777,9,2016-10-28,south-florida,,Navy,W (52-45),20,30,66.7,217,2,44,412,9.4,5,74,629,8.5,11,14,0,25,8,50,1,0,1
5778,10,2016-11-12,south-florida,@,Memphis,W (49-42),24,29,82.8,263,2,50,416,8.3,5,79,679,8.6,11,17,2,30,7,75,0,0,0
5779,11,2016-11-19,south-florida,@,Southern Methodist,W (35-27),7,15,46.7,195,3,43,278,6.5,2,58,473,8.2,4,12,0,16,7,55,1,1,2
5780,12,2016-11-26,south-florida,,Central Florida,W (48-31),17,26,65.4,152,0,48,351,7.3,5,74,503,6.8,6,14,0,20,6,50,1,0,1
5781,13,2016-12-29,south-florida,N,South Carolina*,W (46-39),23,32,71.9,261,2,48,208,4.3,3,80,469,5.9,13,10,1,24,5,50,1,1,2
5782,,13 Games,south-florida,,,,225,358,62.8,2941,26,567,3715,6.6,47,925,6656,7.2,121,164,15,300,83,763,9,8,17
5783,1,2017-08-26,south-florida,@,San Jose State,W (42-22),13,26,50.0,233,2,74,315,4.3,4,100,548,5.5,10,17,2,29,10,57,0,0,0
5784,2,2017-09-02,south-florida,,Stony Brook,W (31-17),19,32,59.4,186,2,49,153,3.1,2,81,339,4.2,6,13,2,21,5,40,0,1,1
5785,3,2017-09-15,south-florida,,Illinois,W (47-23),17,32,53.1,304,4,66,376,5.7,2,98,680,6.9,14,21,3,38,16,140,0,1,1
5786,4,2017-09-21,south-florida,,Temple,W (43-7),8,20,40.0,96,0,63,312,5.0,4,83,408,4.9,4,15,3,22,9,70,2,0,2
5787,5,2017-09-30,south-florida,@,East Carolina,W (61-31),13,21,61.9,185,2,50,390,7.8,5,71,575,8.1,8,15,2,25,8,102,1,0,1
5788,6,2017-10-14,south-florida,,Cincinnati,W (33-3),17,30,56.7,190,0,53,212,4.0,2,83,402,4.8,9,14,2,25,14,137,0,0,0
5789,7,2017-10-21,south-florida,@,Tulane,W (34-28),10,24,41.7,127,2,52,378,7.3,3,76,505,6.6,6,18,1,25,7,89,0,1,1
5790,8,2017-10-28,south-florida,,Houston,L (24-28),23,38,60.5,325,0,55,137,2.5,3,93,462,5.0,14,6,1,21,5,35,0,0,0
5791,9,2017-11-04,south-florida,@,Connecticut,W (37-20),24,37,64.9,385,3,40,217,5.4,1,77,602,7.8,15,12,1,28,11,100,1,1,2
5792,10,2017-11-16,south-florida,,Tulsa,W (27-20),11,28,39.3,142,2,45,279,6.2,1,73,421,5.8,6,14,1,21,6,60,1,1,2
5793,11,2017-11-24,south-florida,@,Central Florida,L (42-49),24,45,53.3,503,4,39,150,3.8,2,84,653,7.8,16,10,1,27,10,102,1,1,2
5794,12,2017-12-23,south-florida,N,Texas Tech*,W (38-34),17,34,50.0,311,4,48,250,5.2,1,82,561,6.8,12,11,4,27,10,100,2,0,2
5795,,12 Games,south-florida,,,,196,367,53.4,2987,25,634,3169,5.0,30,1001,6156,6.1,120,166,23,309,111,1032,8,6,14
5796,1,2018-09-01,south-florida,,Elon,W (34-14),29,46,63.0,367,3,38,148,3.9,1,84,515,6.1,17,10,0,27,7,55,0,0,0
5797,2,2018-09-08,south-florida,,Georgia Tech,W (49-38),21,31,67.7,202,2,44,224,5.1,3,75,426,5.7,13,13,3,29,5,36,0,1,1
5798,3,2018-09-15,south-florida,N,Illinois,W (25-19),23,40,57.5,411,2,44,215,4.9,1,84,626,7.5,19,11,1,31,14,124,0,2,2
5799,4,2018-09-22,south-florida,,East Carolina,W (20-13),12,20,60.0,181,1,32,115,3.6,2,52,296,5.7,5,4,0,9,3,33,1,0,1
5800,5,2018-10-06,south-florida,@,Massachusetts,W (58-42),17,24,70.8,209,1,41,365,8.9,5,65,574,8.8,8,9,1,18,11,100,1,1,2
5801,6,2018-10-12,south-florida,@,Tulsa,W (25-24),17,40,42.5,237,0,47,250,5.3,3,87,487,5.6,11,12,3,26,8,70,0,1,1
5802,7,2018-10-20,south-florida,,Connecticut,W (38-30),20,28,71.4,265,1,37,346,9.4,4,65,611,9.4,8,16,0,24,9,90,1,2,3
5803,8,2018-10-27,south-florida,@,Houston,L (36-57),26,39,66.7,263,1,42,204,4.9,3,81,467,5.8,14,13,2,29,8,85,1,1,2
5804,9,2018-11-03,south-florida,,Tulane,L (15-41),29,49,59.2,322,0,33,102,3.1,2,82,424,5.2,17,8,2,27,10,91,2,1,3
5805,10,2018-11-10,south-florida,@,Cincinnati,L (23-35),14,32,43.8,232,3,29,81,2.8,0,61,313,5.1,8,4,0,12,8,80,0,0,0
5806,11,2018-11-17,south-florida,@,Temple,L (17-27),14,23,60.9,82,0,48,184,3.8,2,71,266,3.7,3,10,2,15,7,55,3,2,5
5807,,11 Games,south-florida,,,,222,372,59.7,2771,14,435,2234,5.1,26,807,5005,6.2,123,110,14,247,90,819,9,11,20
5808,1,2014-08-31,utah-state,@,Tennessee,L (7-38),18,35,51.4,144,1,24,100,4.2,0,59,244,4.1,6,4,1,11,5,42,1,2,3
5809,2,2014-09-06,utah-state,,Idaho State,W (40-20),13,30,43.3,116,0,45,311,6.9,3,75,427,5.7,5,14,2,21,14,160,1,1,2
5810,3,2014-09-13,utah-state,,Wake Forest,W (36-24),32,44,72.7,331,3,35,60,1.7,0,79,391,4.9,13,5,5,23,8,65,1,2,3
5811,4,2014-09-20,utah-state,@,Arkansas State,L (14-21),27,47,57.4,268,2,37,145,3.9,0,84,413,4.9,6,12,1,19,11,100,0,1,1
5812,5,2014-10-03,utah-state,@,Brigham Young,W (35-20),19,25,76.0,321,3,46,136,3.0,2,71,457,6.4,12,7,3,22,12,105,1,0,1
5813,6,2014-10-11,utah-state,,Air Force,W (34-16),22,31,71.0,311,2,28,77,2.8,2,59,388,6.6,9,5,0,14,3,43,1,0,1
5814,7,2014-10-18,utah-state,@,Colorado State,L (13-16),19,31,61.3,160,0,19,100,5.3,1,50,260,5.2,6,3,2,11,6,45,0,1,1
5815,8,2014-10-25,utah-state,,Nevada-Las Vegas,W (34-20),16,29,55.2,266,3,47,178,3.8,1,76,444,5.8,7,10,1,18,7,60,1,0,1
5816,9,2014-11-01,utah-state,@,Hawaii,W (35-14),15,16,93.8,230,4,50,235,4.7,0,66,465,7.0,6,13,2,21,12,96,0,0,0
5817,10,2014-11-07,utah-state,@,Wyoming,W (20-3),13,17,76.5,150,0,33,206,6.2,1,50,356,7.1,3,8,1,12,6,75,1,0,1
5818,11,2014-11-15,utah-state,,New Mexico,W (28-21),13,21,61.9,150,1,36,272,7.6,3,57,422,7.4,9,10,0,19,3,25,0,1,1
5819,12,2014-11-21,utah-state,,San Jose State,W (41-7),15,23,65.2,108,1,42,313,7.5,5,65,421,6.5,8,10,2,20,5,40,0,1,1
5820,13,2014-11-29,utah-state,@,Boise State,L (19-50),16,28,57.1,159,0,30,109,3.6,1,58,268,4.6,7,7,2,16,7,52,2,1,3
5821,14,2014-12-20,utah-state,N,Texas-El Paso*,W (21-6),5,12,41.7,68,0,40,279,7.0,3,52,347,6.7,2,12,2,16,2,10,1,1,2
5822,,14 Games,utah-state,,,,243,389,62.5,2782,20,512,2521,4.9,22,901,5303,5.9,99,120,24,243,101,918,10,11,21
5823,1,2015-09-03,utah-state,,Southern Utah,W (12-9),16,33,48.5,110,0,35,140,4.0,0,68,250,3.7,5,7,3,15,11,123,0,1,1
5824,2,2015-09-11,utah-state,@,Utah,L (14-24),22,35,62.9,256,2,32,117,3.7,0,67,373,5.6,12,8,1,21,6,61,1,2,3
5825,3,2015-09-19,utah-state,@,Washington,L (17-31),17,33,51.5,171,0,30,83,2.8,1,63,254,4.0,8,4,1,13,5,25,0,2,2
5826,4,2015-10-03,utah-state,,Colorado State,W (33-18),12,21,57.1,137,1,45,298,6.6,2,66,435,6.6,6,11,4,21,12,125,0,0,0
5827,5,2015-10-10,utah-state,@,Fresno State,W (56-14),19,27,70.4,281,1,43,201,4.7,7,70,482,6.9,11,9,1,21,7,59,1,0,1
5828,6,2015-10-16,utah-state,,Boise State,W (52-26),17,24,70.8,157,3,43,177,4.1,3,67,334,5.0,9,5,1,15,11,104,1,0,1
5829,7,2015-10-23,utah-state,@,San Diego State,L (14-48),9,20,45.0,95,1,36,144,4.0,1,56,239,4.3,4,8,4,16,5,55,3,1,4
5830,8,2015-10-30,utah-state,,Wyoming,W (58-27),16,19,84.2,296,4,43,296,6.9,3,62,592,9.5,13,18,3,34,3,25,1,0,1
5831,9,2015-11-07,utah-state,@,New Mexico,L (13-14),14,25,56.0,216,1,37,78,2.1,0,62,294,4.7,8,3,2,13,2,8,2,0,2
5832,10,2015-11-14,utah-state,@,Air Force,L (28-35),25,47,53.2,364,4,23,75,3.3,0,70,439,6.3,14,5,0,19,2,21,0,1,1
5833,11,2015-11-21,utah-state,,Nevada,W (31-27),14,29,48.3,109,0,42,204,4.9,2,71,313,4.4,5,12,2,19,3,30,1,2,3
5834,12,2015-11-28,utah-state,,Brigham Young,L (28-51),20,45,44.4,243,1,43,202,4.7,3,88,445,5.1,10,12,1,23,8,70,2,0,2
5835,13,2015-12-22,utah-state,N,Akron*,L (21-23),28,45,62.2,237,3,29,131,4.5,0,74,368,5.0,13,7,2,22,8,60,2,1,3
5836,,13 Games,utah-state,,,,229,403,56.8,2672,21,481,2146,4.5,22,884,4818,5.5,118,109,25,252,83,766,14,10,24
5837,1,2016-09-01,utah-state,,Weber State,W (45-6),11,17,64.7,100,0,44,428,9.7,6,61,528,8.7,7,16,0,23,4,30,0,0,0
5838,2,2016-09-10,utah-state,@,Southern California,L (7-45),25,39,64.1,204,1,26,49,1.9,0,65,253,3.9,10,1,2,13,5,38,0,1,1
5839,3,2016-09-16,utah-state,,Arkansas State,W (34-20),11,25,44.0,136,1,47,198,4.2,3,72,334,4.6,7,9,2,18,6,54,0,1,1
5840,4,2016-09-24,utah-state,,Air Force,L (20-27),30,48,62.5,372,1,32,42,1.3,1,80,414,5.2,15,4,3,22,7,46,1,1,2
5841,5,2016-10-01,utah-state,@,Boise State,L (10-21),29,51,56.9,287,1,25,71,2.8,0,76,358,4.7,10,4,4,18,12,90,0,0,0
5842,6,2016-10-08,utah-state,@,Colorado State,L (24-31),20,35,57.1,210,0,39,251,6.4,3,74,461,6.2,8,11,4,23,9,71,1,1,2
5843,7,2016-10-22,utah-state,,Fresno State,W (38-20),17,29,58.6,188,3,38,208,5.5,1,67,396,5.9,9,13,2,24,5,40,0,0,0
5844,8,2016-10-28,utah-state,,San Diego State,L (13-40),11,26,42.3,181,1,28,71,2.5,1,54,252,4.7,6,4,2,12,4,39,1,1,2
5845,9,2016-11-05,utah-state,@,Wyoming,L (28-52),24,45,53.3,303,1,24,111,4.6,3,69,414,6.0,11,4,6,21,7,58,1,1,2
5846,10,2016-11-12,utah-state,,New Mexico,L (21-24),21,27,77.8,263,1,28,128,4.6,2,55,391,7.1,10,7,4,21,7,75,0,1,1
5847,11,2016-11-19,utah-state,@,Nevada,L (37-38),10,18,55.6,127,0,50,396,7.9,4,68,523,7.7,6,15,0,21,9,74,1,1,2
5848,12,2016-11-26,utah-state,@,Brigham Young,L (10-28),12,23,52.2,103,0,28,97,3.5,1,51,200,3.9,6,4,1,11,11,94,1,1,2
5849,,12 Games,utah-state,,,,221,383,57.7,2474,10,409,2050,5.0,25,792,4524,5.7,105,92,30,227,86,709,6,9,15
5850,1,2017-09-01,utah-state,@,Wisconsin,L (10-59),25,41,61.0,219,0,27,85,3.1,1,68,304,4.5,11,3,2,16,9,93,1,3,4
5851,2,2017-09-07,utah-state,,Idaho State,W (51-13),27,32,84.4,341,2,49,255,5.2,3,81,596,7.4,17,12,1,30,9,48,1,1,2
5852,3,2017-09-16,utah-state,@,Wake Forest,L (10-46),15,37,40.5,225,1,31,42,1.4,0,68,267,3.9,7,4,0,11,4,39,0,1,1
5853,4,2017-09-23,utah-state,@,San Jose State,W (61-10),28,41,68.3,271,3,57,318,5.6,3,98,589,6.0,16,12,1,29,7,60,1,2,3
5854,5,2017-09-29,utah-state,,Brigham Young,W (40-24),16,30,53.3,176,2,44,112,2.5,1,74,288,3.9,6,7,1,14,4,38,0,1,1
5855,6,2017-10-07,utah-state,,Colorado State,L (14-27),18,34,52.9,149,1,29,63,2.2,0,63,212,3.4,5,5,3,14,7,73,0,0,0
5856,7,2017-10-14,utah-state,,Wyoming,L (23-28),20,39,51.3,232,1,37,131,3.5,1,76,363,4.8,12,9,2,23,4,50,2,3,5
5857,8,2017-10-21,utah-state,@,Nevada-Las Vegas,W (52-28),20,29,69.0,323,2,47,265,5.6,5,76,588,7.7,10,15,0,25,6,55,2,0,2
5858,9,2017-10-28,utah-state,,Boise State,L (14-41),18,34,52.9,186,1,27,93,3.4,1,61,279,4.6,7,4,2,13,7,72,0,0,0
5859,10,2017-11-04,utah-state,@,New Mexico,W (24-10),13,24,54.2,114,0,24,129,5.4,2,48,243,5.1,7,4,1,12,5,50,1,1,2
5860,11,2017-11-18,utah-state,,Hawaii,W (38-0),12,20,60.0,164,2,39,311,8.0,3,59,475,8.1,8,12,0,20,2,10,0,1,1
5861,12,2017-11-25,utah-state,@,Air Force,L (35-38),17,30,56.7,284,2,29,237,8.2,3,59,521,8.8,13,6,0,19,8,67,1,0,1
5862,13,2017-12-29,utah-state,N,New Mexico State*,L (20-26),25,44,56.8,254,0,45,187,4.2,1,89,441,5.0,12,8,2,22,8,73,2,0,2
5863,,13 Games,utah-state,,,,254,435,58.4,2938,17,485,2228,4.6,24,920,5166,5.6,131,101,15,248,80,728,11,13,24
5864,1,2018-08-31,utah-state,@,Michigan State,L (31-38),29,44,65.9,319,0,25,25,1.0,3,69,344,5.0,18,2,2,22,7,49,0,2,2
5865,2,2018-09-08,utah-state,,New Mexico State,W (60-13),17,31,54.8,172,1,46,274,6.0,3,77,446,5.8,8,11,3,22,10,91,1,1,2
5866,3,2018-09-13,utah-state,,Tennessee Tech,W (73-12),30,35,85.7,291,2,42,330,7.9,7,77,621,8.1,14,15,2,31,6,60,2,0,2
5867,4,2018-09-22,utah-state,,Air Force,W (42-32),26,38,68.4,356,2,24,133,5.5,4,62,489,7.9,19,3,0,22,5,35,2,0,2
5868,5,2018-10-05,utah-state,@,Brigham Young,W (45-20),18,28,64.3,165,4,42,223,5.3,1,70,388,5.5,8,10,1,19,12,125,0,0,0
5869,6,2018-10-13,utah-state,,Nevada-Las Vegas,W (59-28),22,31,71.0,377,5,38,221,5.8,2,69,598,8.7,14,9,1,24,5,55,1,0,1
5870,7,2018-10-20,utah-state,@,Wyoming,W (24-16),12,28,42.9,53,0,33,141,4.3,2,61,194,3.2,1,8,2,11,6,52,0,1,1
5871,8,2018-10-27,utah-state,,New Mexico,W (61-19),30,42,71.4,516,4,49,188,3.8,2,91,704,7.7,19,11,0,30,6,43,3,0,3
5872,9,2018-11-03,utah-state,@,Hawaii,W (56-17),19,24,79.2,175,1,54,426,7.9,7,78,601,7.7,11,17,1,29,12,105,1,0,1
5873,10,2018-11-10,utah-state,,San Jose State,W (62-24),35,50,70.0,510,5,39,296,7.6,3,89,806,9.1,19,11,3,33,10,82,0,0,0
5874,11,2018-11-17,utah-state,@,Colorado State,W (29-24),15,24,62.5,169,1,28,141,5.0,0,52,310,6.0,7,9,0,16,7,71,1,0,1
5875,,11 Games,utah-state,,,,253,375,67.5,3103,25,420,2398,5.7,34,795,5501,6.9,138,106,15,259,86,768,11,4,15
5876,1,2014-08-30,louisiana-tech,@,Oklahoma,L (16-48),22,36,61.1,191,2,29,54,1.9,0,65,245,3.8,10,3,2,15,5,32,0,1,1
5877,2,2014-09-06,louisiana-tech,@,Louisiana,W (48-20),22,33,66.7,295,2,35,238,6.8,3,68,533,7.8,9,9,2,20,5,35,0,0,0
5878,3,2014-09-11,louisiana-tech,@,North Texas,W (42-21),23,36,63.9,260,5,30,98,3.3,1,66,358,5.4,14,5,2,21,7,73,0,1,1
5879,4,2014-09-20,louisiana-tech,,Northwestern State,L (27-30),20,34,58.8,280,1,33,133,4.0,2,67,413,6.2,13,8,1,22,8,74,2,3,5
5880,5,2014-09-27,louisiana-tech,@,Auburn,L (17-45),20,35,57.1,216,0,33,105,3.2,2,68,321,4.7,7,5,2,14,5,40,1,1,2
5881,6,2014-10-04,louisiana-tech,,Texas-El Paso,W (55-3),7,17,41.2,187,3,43,256,6.0,3,60,443,7.4,7,12,0,19,4,35,1,1,2
5882,7,2014-10-18,louisiana-tech,,Texas-San Antonio,W (27-20),14,33,42.4,157,1,35,121,3.5,1,68,278,4.1,7,6,3,16,10,85,0,1,1
5883,8,2014-10-25,louisiana-tech,@,Southern Mississippi,W (31-20),27,46,58.7,423,3,26,30,1.2,1,72,453,6.3,17,3,3,23,4,40,2,0,2
5884,9,2014-11-01,louisiana-tech,,Western Kentucky,W (59-10),34,49,69.4,378,5,34,129,3.8,2,83,507,6.1,17,10,4,31,2,15,2,1,3
5885,10,2014-11-08,louisiana-tech,@,Alabama-Birmingham,W (40-24),19,34,55.9,200,2,46,228,5.0,3,80,428,5.4,11,11,2,24,2,15,2,1,3
5886,11,2014-11-22,louisiana-tech,@,Old Dominion,L (27-30),19,31,61.3,217,1,34,109,3.2,2,65,326,5.0,11,7,1,19,4,25,1,1,2
5887,12,2014-11-29,louisiana-tech,,Rice,W (76-31),22,35,62.9,408,4,36,269,7.5,6,71,677,9.5,14,10,2,26,3,15,0,1,1
5888,13,2014-12-06,louisiana-tech,@,Marshall,L (23-26),7,20,35.0,72,0,45,196,4.4,3,65,268,4.1,2,9,3,14,4,26,1,1,2
5889,14,2014-12-26,louisiana-tech,N,Illinois*,W (35-18),14,28,50.0,247,1,31,114,3.7,3,59,361,6.1,7,8,3,16,6,45,1,0,1
5890,,14 Games,louisiana-tech,,,,270,467,57.8,3531,30,490,2080,4.2,32,957,5611,5.9,146,106,30,280,69,555,13,13,26
5891,1,2015-09-05,louisiana-tech,,Southern,W (62-15),21,29,72.4,380,5,32,207,6.5,2,61,587,9.6,13,7,1,21,3,35,0,2,2
5892,2,2015-09-10,louisiana-tech,@,Western Kentucky,L (38-41),28,49,57.1,357,2,31,223,7.2,3,80,580,7.3,19,6,3,28,5,40,1,1,2
5893,3,2015-09-19,louisiana-tech,@,Kansas State,L (33-39),30,51,58.8,314,1,38,137,3.6,2,89,451,5.1,11,12,0,23,6,41,2,0,2
5894,4,2015-09-26,louisiana-tech,,Florida International,W (27-17),18,32,56.3,226,1,42,246,5.9,2,74,472,6.4,11,15,3,29,7,45,0,0,0
5895,5,2015-10-03,louisiana-tech,,Louisiana,W (43-14),20,33,60.6,290,2,35,138,3.9,2,68,428,6.3,13,9,5,27,8,76,1,0,1
5896,6,2015-10-10,louisiana-tech,@,Texas-San Antonio,W (34-31),28,44,63.6,351,1,31,93,3.0,2,75,444,5.9,17,5,2,24,5,40,0,2,2
5897,7,2015-10-17,louisiana-tech,@,Mississippi State,L (20-45),25,41,61.0,303,2,32,110,3.4,0,73,413,5.7,14,8,2,24,7,60,0,1,1
5898,8,2015-10-24,louisiana-tech,,Middle Tennessee State,W (45-16),19,33,57.6,301,2,35,169,4.8,3,68,470,6.9,10,10,2,22,5,46,0,0,0
5899,9,2015-10-30,louisiana-tech,@,Rice,W (42-17),17,27,63.0,320,4,33,135,4.1,2,60,455,7.6,12,7,2,21,2,20,0,0,0
5900,10,2015-11-07,louisiana-tech,,North Texas,W (56-13),18,27,66.7,299,0,36,274,7.6,7,63,573,9.1,10,14,1,25,3,32,2,1,3
5901,11,2015-11-21,louisiana-tech,@,Texas-El Paso,W (17-15),13,22,59.1,188,2,28,119,4.3,0,50,307,6.1,7,5,0,12,6,68,1,0,1
5902,12,2015-11-28,louisiana-tech,,Southern Mississippi,L (24-58),32,51,62.7,407,3,23,-2,-0.1,0,74,405,5.5,23,2,2,27,2,6,3,4,7
5903,13,2015-12-19,louisiana-tech,N,Arkansas State*,W (47-28),26,38,68.4,458,3,36,229,6.4,2,74,687,9.3,14,9,3,26,13,154,0,0,0
5904,,13 Games,louisiana-tech,,,,295,477,61.8,4194,28,432,2078,4.8,27,909,6272,6.9,174,109,26,309,72,663,10,11,21
5905,1,2016-09-03,louisiana-tech,@,Arkansas,L (20-21),19,31,61.3,212,0,23,79,3.4,2,54,291,5.4,10,5,1,16,3,20,0,1,1
5906,2,2016-09-10,louisiana-tech,,South Carolina State,W (53-24),41,60,68.3,518,5,30,209,7.0,1,90,727,8.1,24,10,0,34,6,62,2,2,4
5907,3,2016-09-17,louisiana-tech,@,Texas Tech,L (45-59),20,32,62.5,311,3,36,261,7.3,3,68,572,8.4,10,16,1,27,8,89,0,0,0
5908,4,2016-09-24,louisiana-tech,@,Middle Tennessee State,L (34-38),36,59,61.0,504,3,37,118,3.2,1,96,622,6.5,24,8,3,35,3,28,1,0,1
5909,5,2016-10-01,louisiana-tech,,Texas-El Paso,W (28-7),19,28,67.9,191,2,22,196,8.9,2,50,387,7.7,8,11,0,19,2,12,0,0,0
5910,6,2016-10-06,louisiana-tech,,Western Kentucky,W (55-52),33,45,73.3,454,5,27,107,4.0,2,72,561,7.8,15,7,4,26,5,64,0,0,0
5911,7,2016-10-15,louisiana-tech,@,Massachusetts,W (56-28),27,34,79.4,491,5,35,199,5.7,2,69,690,10.0,21,7,1,29,5,41,3,1,4
5912,8,2016-10-22,louisiana-tech,@,Florida International,W (44-24),22,30,73.3,269,2,25,145,5.8,2,55,414,7.5,10,8,0,18,8,60,0,0,0
5913,9,2016-10-29,louisiana-tech,,Rice,W (61-16),24,31,77.4,434,3,39,301,7.7,5,70,735,10.5,15,13,0,28,3,25,1,0,1
5914,10,2016-11-05,louisiana-tech,@,North Texas,W (45-24),18,30,60.0,253,4,40,226,5.7,2,70,479,6.8,11,12,7,30,3,30,0,1,1
5915,11,2016-11-12,louisiana-tech,,Texas-San Antonio,W (63-35),17,27,63.0,293,4,30,180,6.0,3,57,473,8.3,11,8,4,23,6,80,0,0,0
5916,12,2016-11-25,louisiana-tech,@,Southern Mississippi,L (24-39),22,39,56.4,246,0,16,8,0.5,2,55,254,4.6,12,2,2,16,7,50,0,3,3
5917,13,2016-12-03,louisiana-tech,@,Western Kentucky,L (44-58),35,57,61.4,502,3,22,5,0.2,1,79,507,6.4,20,5,1,26,8,64,0,1,1
5918,14,2016-12-23,louisiana-tech,N,Navy*,W (48-45),29,40,72.5,409,4,33,88,2.7,2,73,497,6.8,19,7,5,31,4,50,1,0,1
5919,,14 Games,louisiana-tech,,,,362,543,66.7,5087,43,415,2122,5.1,30,958,7209,7.5,210,119,29,358,71,675,8,9,17
5920,1,2017-09-02,louisiana-tech,,Northwestern State,W (52-24),18,35,51.4,276,2,37,221,6.0,3,72,497,6.9,12,9,1,22,5,50,3,0,3
5921,2,2017-09-09,louisiana-tech,,Mississippi State,L (21-57),13,30,43.3,163,1,50,152,3.0,1,80,315,3.9,5,12,3,20,3,28,2,1,3
5922,3,2017-09-16,louisiana-tech,@,Western Kentucky,W (23-22),22,39,56.4,306,1,30,122,4.1,1,69,428,6.2,14,4,2,20,3,25,0,1,1
5923,4,2017-09-23,louisiana-tech,@,South Carolina,L (16-17),23,33,69.7,281,1,28,80,2.9,0,61,361,5.9,12,4,1,17,3,18,0,1,1
5924,5,2017-09-30,louisiana-tech,,South Alabama,W (34-16),24,39,61.5,317,3,33,162,4.9,1,72,479,6.7,13,12,1,26,3,11,1,0,1
5925,6,2017-10-07,louisiana-tech,@,Alabama-Birmingham,L (22-23),17,29,58.6,209,2,34,154,4.5,1,63,363,5.8,10,9,2,21,10,95,0,0,0
5926,7,2017-10-21,louisiana-tech,,Southern Mississippi,L (27-34),11,28,39.3,194,0,34,161,4.7,2,62,355,5.7,6,8,0,15,4,30,1,1,2
5927,8,2017-10-28,louisiana-tech,@,Rice,W (42-28),21,32,65.6,237,1,39,180,4.6,4,71,417,5.9,13,10,1,24,4,25,0,0,0
5928,9,2017-11-04,louisiana-tech,,North Texas,L (23-24),16,28,57.1,168,0,41,147,3.6,2,69,315,4.6,9,7,3,19,5,37,0,0,0
5929,10,2017-11-11,louisiana-tech,,Florida Atlantic,L (23-48),30,51,58.8,326,1,45,186,4.1,1,96,512,5.3,20,10,2,32,5,58,0,0,0
5930,11,2017-11-18,louisiana-tech,@,Texas-El Paso,W (42-21),15,28,53.6,203,2,49,343,7.0,3,77,546,7.1,7,19,2,28,8,70,2,0,2
5931,12,2017-11-25,louisiana-tech,,Texas-San Antonio,W (20-6),7,21,33.3,101,0,37,193,5.2,2,58,294,5.1,6,10,3,19,3,30,1,1,2
5932,13,2017-12-20,louisiana-tech,N,Southern Methodist*,W (51-10),16,27,59.3,216,3,38,141,3.7,1,65,357,5.5,8,7,3,18,5,50,0,0,0
5933,,13 Games,louisiana-tech,,,,233,420,55.5,2997,17,495,2242,4.5,22,915,5239,5.7,135,121,24,281,61,527,10,5,15
5934,1,2018-09-01,louisiana-tech,@,South Alabama,W (30-26),19,29,65.5,209,2,48,231,4.8,2,77,440,5.7,8,11,3,22,6,55,0,3,3
5935,2,2018-09-08,louisiana-tech,,Southern,W (54-17),27,42,64.3,427,3,33,186,5.6,4,75,613,8.2,18,11,3,32,4,34,1,0,1
5936,3,2018-09-22,louisiana-tech,@,Louisiana State,L (21-38),27,50,54.0,330,3,26,87,3.3,0,76,417,5.5,14,5,2,21,6,48,1,1,2
5937,4,2018-09-29,louisiana-tech,@,North Texas,W (29-27),20,39,51.3,230,2,32,129,4.0,0,71,359,5.1,10,6,3,19,1,10,0,0,0
5938,5,2018-10-06,louisiana-tech,,Alabama-Birmingham,L (7-28),9,23,39.1,107,0,41,151,3.7,1,64,258,4.0,5,9,1,15,2,17,2,1,3
5939,6,2018-10-13,louisiana-tech,@,Texas-San Antonio,W (31-3),25,37,67.6,309,1,38,75,2.0,3,75,384,5.1,14,6,1,21,4,40,1,1,2
5940,7,2018-10-20,louisiana-tech,,Texas-El Paso,W (31-24),17,29,58.6,156,1,31,169,5.5,2,60,325,5.4,8,8,3,19,6,55,0,0,0
5941,8,2018-10-26,louisiana-tech,@,Florida Atlantic,W (21-13),17,35,48.6,217,1,40,113,2.8,2,75,330,4.4,11,7,3,21,4,44,0,0,0
5942,9,2018-11-03,louisiana-tech,@,Mississippi State,L (3-45),14,31,45.2,98,0,32,140,4.4,0,63,238,3.8,5,10,0,15,5,35,0,1,1
5943,10,2018-11-10,louisiana-tech,,Rice,W (28-13),21,34,61.8,314,1,33,110,3.3,3,67,424,6.3,10,10,0,20,5,37,1,2,3
5944,11,2018-11-17,louisiana-tech,@,Southern Mississippi,L (20-21),27,43,62.8,243,1,23,68,3.0,1,66,311,4.7,13,4,3,20,3,45,0,0,0
5945,,11 Games,louisiana-tech,,,,223,392,56.9,2640,15,377,1459,3.9,18,769,4099,5.3,116,87,22,225,46,420,6,9,15
5946,1,2014-08-30,middle-tennessee-state,,Savannah State,W (61-7),17,20,85.0,291,1,46,228,5.0,6,66,519,7.9,8,13,1,22,9,70,2,1,3
5947,2,2014-09-06,middle-tennessee-state,@,Minnesota,L (24-35),22,38,57.9,255,1,43,190,4.4,2,81,445,5.5,15,7,1,23,9,80,0,3,3
5948,3,2014-09-13,middle-tennessee-state,,Western Kentucky,W (50-47),17,28,60.7,218,1,61,323,5.3,5,89,541,6.1,11,16,1,28,7,62,0,0,0
5949,4,2014-09-20,middle-tennessee-state,@,Memphis,L (17-36),24,35,68.6,237,0,34,88,2.6,2,69,325,4.7,12,5,0,17,4,36,2,1,3
5950,5,2014-09-26,middle-tennessee-state,@,Old Dominion,W (41-28),25,30,83.3,259,2,57,280,4.9,2,87,539,6.2,11,18,0,29,9,85,2,0,2
5951,6,2014-10-04,middle-tennessee-state,,Southern Mississippi,W (37-31),22,27,81.5,344,2,39,239,6.1,3,66,583,8.8,13,9,0,22,6,49,1,0,1
5952,7,2014-10-11,middle-tennessee-state,@,Marshall,L (24-49),25,37,67.6,201,2,37,169,4.6,1,74,370,5.0,8,10,2,20,8,101,1,1,2
5953,8,2014-10-18,middle-tennessee-state,,Alabama-Birmingham,W (34-22),6,19,31.6,141,2,41,229,5.6,3,60,370,6.2,3,8,2,13,8,70,0,0,0
5954,9,2014-11-01,middle-tennessee-state,,Brigham Young,L (7-27),16,32,50.0,119,1,37,109,2.9,0,69,228,3.3,6,9,2,17,2,12,0,2,2
5955,10,2014-11-15,middle-tennessee-state,@,Florida International,L (28-38),21,33,63.6,286,3,45,142,3.2,1,78,428,5.5,12,9,1,22,7,70,2,3,5
5956,11,2014-11-22,middle-tennessee-state,,Florida Atlantic,W (35-34),20,27,74.1,160,2,46,310,6.7,3,73,470,6.4,7,15,0,22,3,20,1,1,2
5957,12,2014-11-29,middle-tennessee-state,@,Texas-El Paso,L (21-24),9,17,52.9,99,0,44,259,5.9,3,61,358,5.9,4,14,1,19,6,35,0,1,1
5958,,12 Games,middle-tennessee-state,,,,224,343,65.3,2610,17,530,2566,4.8,31,873,5176,5.9,110,133,11,254,78,690,11,13,24
5959,1,2015-09-05,middle-tennessee-state,,Jackson State,W (70-14),25,32,78.1,351,4,63,282,4.5,4,95,633,6.7,14,20,2,36,1,15,1,1,2
5960,2,2015-09-12,middle-tennessee-state,@,Alabama,L (10-37),23,43,53.5,189,1,31,86,2.8,0,74,275,3.7,11,3,1,15,8,67,3,1,4
5961,3,2015-09-19,middle-tennessee-state,,UNC Charlotte,W (73-14),24,29,82.8,379,5,49,316,6.4,4,78,695,8.9,12,12,1,25,3,36,2,0,2
5962,4,2015-09-26,middle-tennessee-state,@,Illinois,L (25-27),29,43,67.4,330,3,37,38,1.0,0,80,368,4.6,12,6,1,19,7,59,1,0,1
5963,5,2015-10-03,middle-tennessee-state,,Vanderbilt,L (13-17),32,51,62.7,286,1,23,34,1.5,0,74,320,4.3,13,4,1,18,5,30,2,0,2
5964,6,2015-10-10,middle-tennessee-state,@,Western Kentucky,L (28-58),28,43,65.1,296,3,30,123,4.1,1,73,419,5.7,13,7,2,22,4,41,1,1,2
5965,7,2015-10-17,middle-tennessee-state,,Florida International,W (42-34),17,26,65.4,261,0,43,200,4.7,6,69,461,6.7,10,12,0,22,8,87,1,1,2
5966,8,2015-10-24,middle-tennessee-state,@,Louisiana Tech,L (16-45),36,56,64.3,381,2,24,33,1.4,0,80,414,5.2,15,5,1,21,7,59,1,2,3
5967,9,2015-11-07,middle-tennessee-state,,Marshall,W (27-24),21,35,60.0,353,3,51,201,3.9,0,86,554,6.4,15,10,2,27,7,66,2,1,3
5968,10,2015-11-14,middle-tennessee-state,@,Florida Atlantic,W (24-17),18,32,56.3,301,2,45,178,4.0,1,77,479,6.2,12,8,2,22,5,45,1,1,2
5969,11,2015-11-21,middle-tennessee-state,,North Texas,W (41-7),30,41,73.2,329,3,39,165,4.2,2,80,494,6.2,14,14,2,30,1,5,1,1,2
5970,12,2015-11-28,middle-tennessee-state,@,Texas-San Antonio,W (42-7),24,30,80.0,257,1,43,199,4.6,4,73,456,6.2,8,18,2,28,1,5,2,0,2
5971,13,2015-12-24,middle-tennessee-state,N,Western Michigan*,L (31-45),26,39,66.7,327,3,26,115,4.4,1,65,442,6.8,11,7,0,18,5,40,1,1,2
5972,,13 Games,middle-tennessee-state,,,,333,500,66.6,4040,31,504,1970,3.9,23,1004,6010,6.0,160,126,17,303,62,555,19,10,29
5973,1,2016-09-03,middle-tennessee-state,,Alabama A&M,W (55-0),40,53,75.5,435,6,40,246,6.2,1,93,681,7.3,22,12,1,35,9,87,0,2,2
5974,2,2016-09-10,middle-tennessee-state,@,Vanderbilt,L (24-47),38,65,58.5,399,3,21,96,4.6,0,86,495,5.8,19,6,0,25,9,92,1,1,2
5975,3,2016-09-17,middle-tennessee-state,@,Bowling Green State,W (41-21),18,30,60.0,278,3,37,158,4.3,3,67,436,6.5,8,8,4,20,3,36,1,1,2
5976,4,2016-09-24,middle-tennessee-state,,Louisiana Tech,W (38-34),27,46,58.7,356,2,33,197,6.0,3,79,553,7.0,15,9,1,25,4,35,0,0,0
5977,5,2016-10-01,middle-tennessee-state,@,North Texas,W (30-13),24,45,53.3,295,2,32,182,5.7,1,77,477,6.2,13,7,4,24,9,79,0,1,1
5978,6,2016-10-15,middle-tennessee-state,,Western Kentucky,L (43-44),42,54,77.8,434,3,32,171,5.3,2,86,605,7.0,22,7,3,32,4,30,0,1,1
5979,7,2016-10-22,middle-tennessee-state,@,Missouri,W (51-45),24,42,57.1,284,4,39,316,8.1,2,81,600,7.4,11,11,5,27,9,65,0,0,0
5980,8,2016-10-29,middle-tennessee-state,@,Florida International,W (42-35),22,35,62.9,332,4,19,134,7.1,1,54,466,8.6,13,10,0,23,2,30,0,0,0
5981,9,2016-11-05,middle-tennessee-state,,Texas-San Antonio,L (25-45),22,38,57.9,259,2,28,110,3.9,1,66,369,5.6,9,9,1,19,4,32,1,3,4
5982,10,2016-11-12,middle-tennessee-state,@,Marshall,L (17-42),25,37,67.6,220,1,25,63,2.5,1,62,283,4.6,11,3,1,15,5,42,2,2,4
5983,11,2016-11-19,middle-tennessee-state,@,UNC Charlotte,W (38-31),26,44,59.1,250,4,30,221,7.4,1,74,471,6.4,12,8,1,21,8,90,0,2,2
5984,12,2016-11-26,middle-tennessee-state,,Florida Atlantic,W (77-56),11,16,68.8,262,1,57,495,8.7,9,73,757,10.4,10,18,0,28,3,22,0,0,0
5985,13,2016-12-24,middle-tennessee-state,N,Hawaii*,L (35-52),30,51,58.8,432,4,23,110,4.8,1,74,542,7.3,18,6,5,29,9,90,1,2,3
5986,,13 Games,middle-tennessee-state,,,,349,556,62.8,4236,39,416,2499,6.0,26,972,6735,6.9,183,114,26,323,78,730,6,15,21
5987,1,2017-09-02,middle-tennessee-state,,Vanderbilt,L (6-28),18,31,58.1,166,1,26,64,2.5,0,57,230,4.0,9,4,3,16,4,14,0,1,1
5988,2,2017-09-09,middle-tennessee-state,@,Syracuse,W (30-23),22,36,61.1,269,3,33,94,2.8,1,69,363,5.3,11,7,2,20,9,113,2,1,3
5989,3,2017-09-16,middle-tennessee-state,@,Minnesota,L (3-34),25,42,59.5,184,0,15,46,3.1,0,57,230,4.0,9,2,0,11,6,45,0,2,2
5990,4,2017-09-23,middle-tennessee-state,,Bowling Green State,W (24-13),24,32,75.0,290,2,43,243,5.7,1,75,533,7.1,14,12,1,27,3,23,2,1,3
5991,5,2017-09-30,middle-tennessee-state,@,Florida Atlantic,L (20-38),32,52,61.5,385,2,24,69,2.9,0,76,454,6.0,18,3,2,23,7,64,0,3,3
5992,6,2017-10-07,middle-tennessee-state,,Florida International,W (37-17),25,31,80.6,250,1,34,176,5.2,3,65,426,6.6,14,12,2,25,4,35,0,0,0
5993,7,2017-10-14,middle-tennessee-state,@,Alabama-Birmingham,L (23-25),24,44,54.5,263,1,32,131,4.1,0,76,394,5.2,14,9,3,26,10,88,0,2,2
5994,8,2017-10-20,middle-tennessee-state,,Marshall,L (10-38),14,33,42.4,220,1,31,53,1.7,0,64,273,4.3,8,3,4,15,5,60,1,1,2
5995,9,2017-11-04,middle-tennessee-state,,Texas-El Paso,W (30-3),13,30,43.3,190,3,36,210,5.8,1,66,400,6.1,7,9,2,18,9,92,0,1,1
5996,10,2017-11-11,middle-tennessee-state,@,UNC Charlotte,W (35-21),18,31,58.1,255,3,41,202,4.9,2,72,457,6.3,7,12,2,21,9,85,0,0,0
5997,11,2017-11-17,middle-tennessee-state,@,Western Kentucky,L (38-41),27,46,58.7,294,1,33,137,4.2,3,79,431,5.5,13,11,3,27,5,68,1,0,1
5998,12,2017-11-25,middle-tennessee-state,,Old Dominion,W (41-10),21,30,70.0,266,3,50,320,6.4,2,80,586,7.3,13,15,2,30,4,50,0,2,2
5999,13,2017-12-16,middle-tennessee-state,N,Arkansas State*,W (35-30),19,35,54.3,232,2,29,120,4.1,2,64,352,5.5,10,5,2,17,10,87,0,3,3
6000,,13 Games,middle-tennessee-state,,,,282,473,59.6,3264,23,427,1865,4.4,15,900,5129,5.7,147,104,28,276,85,824,6,17,23
6001,1,2018-09-01,middle-tennessee-state,@,Vanderbilt,L (7-35),24,36,66.7,178,1,36,116,3.2,0,72,294,4.1,8,10,3,21,6,40,1,1,2
6002,2,2018-09-08,middle-tennessee-state,,Tennessee-Martin,W (61-37),23,32,71.9,396,5,32,79,2.5,2,64,475,7.4,14,5,1,20,6,68,1,0,1
6003,3,2018-09-15,middle-tennessee-state,@,Georgia,L (7-49),20,30,66.7,130,1,38,158,4.2,0,68,288,4.2,4,10,0,14,3,35,1,1,2
6004,4,2018-09-29,middle-tennessee-state,,Florida Atlantic,W (25-24),27,40,67.5,259,1,36,137,3.8,2,76,396,5.2,14,8,0,22,3,29,1,1,2
6005,5,2018-10-05,middle-tennessee-state,@,Marshall,W (34-24),25,40,62.5,317,2,35,103,2.9,2,75,420,5.6,13,8,4,25,11,127,1,0,1
6006,6,2018-10-13,middle-tennessee-state,@,Florida International,L (21-24),15,27,55.6,142,0,40,187,4.7,3,67,329,4.9,8,11,2,21,5,52,0,1,1
6007,7,2018-10-20,middle-tennessee-state,,UNC Charlotte,W (21-13),14,20,70.0,111,3,32,33,1.0,0,52,144,2.8,6,3,0,9,2,20,1,1,2
6008,8,2018-10-27,middle-tennessee-state,@,Old Dominion,W (51-17),25,33,75.8,280,2,38,208,5.5,3,71,488,6.9,12,9,5,26,5,38,0,1,1
6009,9,2018-11-02,middle-tennessee-state,,Western Kentucky,W (29-10),24,42,57.1,228,2,43,256,6.0,0,85,484,5.7,12,13,2,27,3,34,0,0,0
6010,10,2018-11-10,middle-tennessee-state,@,Texas-El Paso,W (48-32),31,40,77.5,352,4,36,139,3.9,2,76,491,6.5,13,8,0,21,6,63,2,0,2
6011,11,2018-11-17,middle-tennessee-state,@,Kentucky,L (23-34),30,33,90.9,293,3,38,99,2.6,0,71,392,5.5,14,8,2,24,6,57,1,1,2
6012,,11 Games,middle-tennessee-state,,,,258,373,69.2,2686,24,404,1515,3.8,14,777,4201,5.4,118,93,19,230,56,563,9,7,16
6013,1,2014-08-28,louisiana-monroe,,Wake Forest,W (17-10),23,41,56.1,189,0,44,163,3.7,1,85,352,4.1,9,11,1,21,5,25,1,0,1
6014,2,2014-09-06,louisiana-monroe,,Idaho,W (38-31),24,45,53.3,384,2,37,150,4.1,3,82,534,6.5,15,10,4,29,5,40,0,1,1
6015,3,2014-09-13,louisiana-monroe,@,Louisiana State,L (0-31),16,30,53.3,77,0,18,16,0.9,0,48,93,1.9,5,0,1,6,5,45,1,0,1
6016,4,2014-09-27,louisiana-monroe,,Troy,W (22-20),28,43,65.1,328,2,33,29,0.9,0,76,357,4.7,14,4,1,19,0,0,0,1,1
6017,5,2014-10-04,louisiana-monroe,@,Arkansas State,L (14-28),27,47,57.4,276,2,25,72,2.9,0,72,348,4.8,12,4,0,16,8,69,2,0,2
6018,6,2014-10-11,louisiana-monroe,@,Kentucky,L (14-48),22,39,56.4,187,2,40,77,1.9,0,79,264,3.3,8,6,1,15,5,41,1,2,3
6019,7,2014-10-25,louisiana-monroe,,Texas State,L (18-22),25,40,62.5,250,0,42,144,3.4,1,82,394,4.8,12,7,1,20,5,34,0,1,1
6020,8,2014-11-01,louisiana-monroe,@,Texas A&M,L (16-21),28,49,57.1,269,0,30,78,2.6,1,79,347,4.4,14,4,1,19,4,20,0,1,1
6021,9,2014-11-08,louisiana-monroe,@,Appalachian State,L (29-31),20,41,48.8,244,2,30,55,1.8,1,71,299,4.2,13,5,2,20,8,78,0,0,0
6022,10,2014-11-15,louisiana-monroe,,Louisiana,L (27-34),39,56,69.6,483,2,21,-39,-1.9,1,77,444,5.8,18,1,2,21,0,0,3,0,3
6023,11,2014-11-22,louisiana-monroe,@,New Mexico State,W (30-17),35,50,70.0,350,1,27,70,2.6,1,77,420,5.5,14,4,1,19,4,40,1,1,2
6024,12,2014-11-29,louisiana-monroe,@,Georgia Southern,L (16-22),30,48,62.5,322,2,16,19,1.2,0,64,341,5.3,13,2,1,16,4,33,1,0,1
6025,,12 Games,louisiana-monroe,,,,317,529,59.9,3359,15,363,834,2.3,9,892,4193,4.7,147,58,16,221,53,425,10,7,17
6026,1,2015-09-05,louisiana-monroe,@,Georgia,L (14-51),23,29,79.3,206,2,26,45,1.7,0,55,251,4.6,9,3,0,12,5,30,0,1,1
6027,2,2015-09-12,louisiana-monroe,,Nicholls State,W (47-0),28,38,73.7,391,3,38,202,5.3,3,76,593,7.8,15,10,2,27,18,158,0,0,0
6028,3,2015-09-26,louisiana-monroe,@,Alabama,L (0-34),20,43,46.5,83,0,31,9,0.3,0,74,92,1.2,5,1,4,10,10,90,0,2,2
6029,4,2015-10-03,louisiana-monroe,,Georgia Southern,L (31-51),21,36,58.3,232,3,26,47,1.8,0,62,279,4.5,11,3,2,16,10,72,0,3,3
6030,5,2015-10-10,louisiana-monroe,@,Tulsa,L (24-34),25,48,52.1,231,1,29,173,6.0,2,77,404,5.2,13,6,2,21,8,73,2,1,3
6031,6,2015-10-17,louisiana-monroe,,Appalachian State,L (14-59),18,35,51.4,191,2,39,159,4.1,0,74,350,4.7,11,7,3,21,3,15,0,2,2
6032,7,2015-10-24,louisiana-monroe,@,Idaho,L (13-27),19,37,51.4,186,1,23,57,2.5,0,60,243,4.1,9,3,3,15,6,42,0,0,0
6033,8,2015-10-31,louisiana-monroe,@,Louisiana,L (24-30),16,35,45.7,265,3,34,76,2.2,0,69,341,4.9,11,4,0,15,5,45,2,0,2
6034,9,2015-11-07,louisiana-monroe,@,Troy,L (14-51),24,42,57.1,262,2,35,114,3.3,0,77,376,4.9,13,7,0,20,11,84,3,3,6
6035,10,2015-11-14,louisiana-monroe,,Arkansas State,L (21-59),10,31,32.3,100,1,44,152,3.5,2,75,252,3.4,3,5,2,10,6,43,1,4,5
6036,11,2015-11-19,louisiana-monroe,@,Texas State,L (3-16),16,33,48.5,83,0,24,98,4.1,0,57,181,3.2,4,5,1,10,3,28,1,1,2
6037,12,2015-11-28,louisiana-monroe,@,Hawaii,L (26-28),27,44,61.4,234,2,33,142,4.3,0,77,376,4.9,16,6,4,26,8,54,1,0,1
6038,13,2015-12-05,louisiana-monroe,,New Mexico State,W (42-35),9,26,34.6,239,5,43,64,1.5,0,69,303,4.4,7,5,1,13,2,20,1,2,3
6039,,13 Games,louisiana-monroe,,,,256,477,53.7,2703,25,425,1338,3.1,7,902,4041,4.5,127,65,24,216,95,754,11,19,30
6040,1,2016-09-03,louisiana-monroe,,Southern,W (38-21),20,33,60.6,208,2,46,325,7.1,3,79,533,6.7,10,16,0,26,7,73,0,2,2
6041,2,2016-09-10,louisiana-monroe,@,Oklahoma,L (17-59),23,37,62.2,272,2,29,78,2.7,0,66,350,5.3,11,4,0,15,4,36,1,0,1
6042,3,2016-09-17,louisiana-monroe,@,Georgia Southern,L (21-23),17,33,51.5,283,2,29,67,2.3,1,62,350,5.6,10,4,1,15,5,70,1,1,2
6043,4,2016-10-01,louisiana-monroe,@,Auburn,L (7-58),19,33,57.6,139,1,32,112,3.5,0,65,251,3.9,7,8,1,16,2,30,1,1,2
6044,5,2016-10-08,louisiana-monroe,,Idaho,L (31-34),20,38,52.6,302,2,38,221,5.8,2,76,523,6.9,13,12,2,27,2,15,1,3,4
6045,6,2016-10-15,louisiana-monroe,,Texas State,W (40-34),14,23,60.9,179,2,73,298,4.1,3,96,477,5.0,10,18,3,31,2,30,1,1,2
6046,7,2016-10-22,louisiana-monroe,@,New Mexico,L (17-59),12,22,54.5,120,1,41,115,2.8,1,63,235,3.7,6,6,0,12,6,52,0,2,2
6047,8,2016-10-29,louisiana-monroe,@,Arkansas State,L (10-51),14,29,48.3,162,0,42,174,4.1,1,71,336,4.7,8,7,2,17,7,51,0,2,2
6048,9,2016-11-05,louisiana-monroe,,South Alabama,W (42-35),26,39,66.7,279,3,46,181,3.9,3,85,460,5.4,14,10,3,27,4,40,0,1,1
6049,10,2016-11-12,louisiana-monroe,@,Georgia State,W (37-23),17,31,54.8,193,0,54,264,4.9,5,85,457,5.4,11,18,2,31,3,25,0,0,0
6050,11,2016-11-19,louisiana-monroe,@,Appalachian State,L (17-42),13,32,40.6,136,0,44,225,5.1,2,76,361,4.8,7,13,2,22,5,50,0,1,1
6051,12,2016-12-03,louisiana-monroe,,Louisiana,L (3-30),3,14,21.4,31,0,38,116,3.1,0,52,147,2.8,2,6,0,8,3,35,3,2,5
6052,,12 Games,louisiana-monroe,,,,198,364,54.4,2304,15,512,2176,4.3,21,876,4480,5.1,109,122,16,247,50,507,8,16,24
6053,1,2017-08-31,louisiana-monroe,@,Memphis,L (29-37),21,37,56.8,279,2,49,146,3.0,2,86,425,4.9,13,10,2,25,8,53,3,1,4
6054,2,2017-09-16,louisiana-monroe,,Southern Mississippi,L (17-28),11,27,40.7,112,0,37,218,5.9,2,64,330,5.2,5,9,1,15,5,54,1,0,1
6055,3,2017-09-23,louisiana-monroe,@,Louisiana,W (56-50),28,34,82.4,343,1,45,250,5.6,7,79,593,7.5,14,12,1,27,9,87,0,0,0
6056,4,2017-09-30,louisiana-monroe,,Coastal Carolina,W (51-43),12,20,60.0,101,1,40,243,6.1,4,60,344,5.7,5,9,2,16,4,35,0,0,0
6057,5,2017-10-07,louisiana-monroe,@,Texas State,W (45-27),24,37,64.9,433,3,41,156,3.8,2,78,589,7.6,15,9,0,24,6,57,0,0,0
6058,6,2017-10-14,louisiana-monroe,,Georgia State,L (37-47),23,37,62.2,314,3,37,117,3.2,1,74,431,5.8,10,8,1,19,4,25,1,0,1
6059,7,2017-10-21,louisiana-monroe,@,South Alabama,L (23-33),14,23,60.9,179,0,41,309,7.5,3,64,488,7.6,6,13,1,20,4,18,1,1,2
6060,8,2017-10-28,louisiana-monroe,@,Idaho,L (23-31),24,37,64.9,415,3,29,98,3.4,0,66,513,7.8,20,4,1,25,1,5,1,1,2
6061,9,2017-11-04,louisiana-monroe,,Appalachian State,W (52-45),24,32,75.0,356,3,38,213,5.6,3,70,569,8.1,15,11,2,28,6,55,0,1,1
6062,10,2017-11-18,louisiana-monroe,@,Auburn,L (14-42),16,36,44.4,217,1,41,116,2.8,1,77,333,4.3,11,3,2,16,3,14,1,2,3
6063,11,2017-11-25,louisiana-monroe,,Arkansas State,L (50-67),21,37,56.8,454,4,39,136,3.5,2,76,590,7.8,15,9,3,27,8,80,1,3,4
6064,12,2017-12-02,louisiana-monroe,@,Florida State,L (10-42),28,47,59.6,262,1,22,38,1.7,0,69,300,4.3,14,3,0,17,5,38,0,0,0
6065,,12 Games,louisiana-monroe,,,,246,404,60.9,3465,22,459,2040,4.4,27,863,5505,6.4,143,100,16,259,63,521,9,9,18
6066,1,2018-08-30,louisiana-monroe,,Southeastern Louisiana,W (34-31),35,53,66.0,346,2,43,208,4.8,2,96,554,5.8,15,14,2,31,10,75,1,1,2
6067,2,2018-09-08,louisiana-monroe,@,Southern Mississippi,W (21-20),15,28,53.6,195,2,30,159,5.3,0,58,354,6.1,7,6,0,13,8,55,1,1,2
6068,3,2018-09-15,louisiana-monroe,@,Texas A&M,L (10-48),15,28,53.6,225,1,29,103,3.6,0,57,328,5.8,7,6,1,14,4,38,0,1,1
6069,4,2018-09-22,louisiana-monroe,,Troy,L (27-35),29,48,60.4,290,2,36,200,5.6,2,84,490,5.8,15,11,1,27,10,94,0,1,1
6070,5,2018-09-29,louisiana-monroe,@,Georgia State,L (14-46),20,34,58.8,137,0,20,125,6.3,2,54,262,4.9,6,5,2,13,3,11,2,2,4
6071,6,2018-10-06,louisiana-monroe,@,Mississippi,L (21-70),23,38,60.5,297,1,38,130,3.4,1,76,427,5.6,13,10,2,25,2,15,2,0,2
6072,7,2018-10-13,louisiana-monroe,@,Coastal Carolina,W (45-20),16,22,72.7,224,1,34,242,7.1,5,56,466,8.3,8,11,1,20,2,30,1,0,1
6073,8,2018-10-20,louisiana-monroe,,Texas State,W (20-14),13,29,44.8,124,1,43,229,5.3,1,72,353,4.9,8,12,3,23,7,67,2,0,2
6074,9,2018-11-03,louisiana-monroe,,Georgia Southern,W (44-25),13,22,59.1,337,2,42,236,5.6,4,64,573,9.0,9,10,2,21,8,75,0,2,2
6075,10,2018-11-10,louisiana-monroe,@,South Alabama,W (38-10),28,33,84.8,376,2,38,175,4.6,3,71,551,7.8,16,8,2,26,1,15,1,0,1
6076,11,2018-11-17,louisiana-monroe,@,Arkansas State,L (17-31),17,28,60.7,218,1,26,58,2.2,1,54,276,5.1,10,4,2,16,5,63,0,3,3
6077,,11 Games,louisiana-monroe,,,,224,363,61.7,2769,15,379,1865,4.9,21,742,4634,6.2,114,97,18,229,60,538,10,11,21
6078,1,2014-08-30,arkansas-state,,Montana State,W (37-10),20,30,66.7,264,1,49,283,5.8,3,79,547,6.9,10,13,0,23,4,25,2,0,2
6079,2,2014-09-06,arkansas-state,@,Tennessee,L (19-34),22,36,61.1,190,1,42,141,3.4,2,78,331,4.2,9,8,0,17,9,75,1,0,1
6080,3,2014-09-13,arkansas-state,@,Miami (FL),L (20-41),23,42,54.8,236,1,47,93,2.0,2,89,329,3.7,15,6,3,24,9,84,1,1,2
6081,4,2014-09-20,arkansas-state,,Utah State,W (21-14),19,33,57.6,190,1,47,126,2.7,2,80,316,4.0,9,10,3,22,8,62,3,1,4
6082,5,2014-10-04,arkansas-state,,Louisiana-Monroe,W (28-14),21,36,58.3,284,1,51,288,5.6,3,87,572,6.6,11,15,3,29,11,110,1,2,3
6083,6,2014-10-11,arkansas-state,@,Georgia State,W (52-10),22,30,73.3,234,3,53,384,7.2,4,83,618,7.4,12,20,0,32,5,40,2,0,2
6084,7,2014-10-21,arkansas-state,@,Louisiana,L (40-55),27,39,69.2,342,3,37,253,6.8,2,76,595,7.8,12,9,1,22,7,51,0,1,1
6085,8,2014-11-01,arkansas-state,@,Idaho,W (44-28),21,29,72.4,244,0,48,198,4.1,5,77,442,5.7,11,8,1,20,11,99,1,0,1
6086,9,2014-11-08,arkansas-state,,South Alabama,W (45-10),17,34,50.0,186,2,49,214,4.4,3,83,400,4.8,8,13,1,22,8,77,0,0,0
6087,10,2014-11-15,arkansas-state,,Appalachian State,L (32-37),14,29,48.3,147,3,30,167,5.6,1,59,314,5.3,5,7,2,14,5,54,1,0,1
6088,11,2014-11-20,arkansas-state,@,Texas State,L (27-45),31,57,54.4,366,2,40,132,3.3,1,97,498,5.1,16,7,2,25,8,80,0,1,1
6089,12,2014-11-29,arkansas-state,,New Mexico State,W (68-35),16,22,72.7,295,2,51,469,9.2,7,73,764,10.5,10,22,2,34,14,107,0,2,2
6090,13,2015-01-04,arkansas-state,N,Toledo*,L (44-63),23,31,74.2,403,5,32,65,2.0,0,63,468,7.4,11,7,2,20,5,41,2,0,2
6091,,13 Games,arkansas-state,,,,276,448,61.6,3381,25,576,2813,4.9,35,1024,6194,6.0,139,145,20,304,104,905,14,8,22
6092,1,2015-09-05,arkansas-state,@,Southern California,L (6-55),17,37,45.9,193,0,50,208,4.2,1,87,401,4.6,8,11,0,19,8,88,2,2,4
6093,2,2015-09-12,arkansas-state,,Missouri,L (20-27),14,30,46.7,124,2,45,93,2.1,0,75,217,2.9,6,10,2,18,7,80,0,3,3
6094,3,2015-09-19,arkansas-state,,Missouri State,W (70-7),23,26,88.5,280,3,46,344,7.5,6,72,624,8.7,13,13,1,27,7,49,1,0,1
6095,4,2015-09-26,arkansas-state,@,Toledo,L (7-37),18,35,51.4,223,0,24,-14,-0.6,0,59,209,3.5,10,0,1,11,8,90,2,3,5
6096,5,2015-10-03,arkansas-state,,Idaho,W (49-35),16,25,64.0,188,1,53,333,6.3,6,78,521,6.7,11,16,2,29,15,169,1,1,2
6097,6,2015-10-13,arkansas-state,@,South Alabama,W (49-31),10,18,55.6,119,2,53,226,4.3,2,71,345,4.9,6,1,1,17,8,80,1,0,1
6098,7,2015-10-20,arkansas-state,,Louisiana,W (37-27),9,20,45.0,129,2,52,306,5.9,2,72,435,6.0,6,14,2,22,3,20,0,1,1
6099,8,2015-10-31,arkansas-state,,Georgia State,W (48-34),21,29,72.4,224,3,52,296,5.7,4,81,520,6.4,10,14,4,28,9,64,1,2,3
6100,9,2015-11-05,arkansas-state,@,Appalachian State,W (40-27),14,25,56.0,208,1,52,309,5.9,2,77,517,6.7,7,17,0,24,2,5,0,0,0
6101,10,2015-11-14,arkansas-state,@,Louisiana-Monroe,W (59-21),15,32,46.9,300,5,50,148,3.0,2,82,448,5.5,8,9,2,19,11,105,1,0,1
6102,11,2015-11-28,arkansas-state,@,New Mexico State,W (52-28),23,43,53.5,367,2,46,238,5.2,3,89,605,6.8,15,13,2,30,11,118,0,1,1
6103,12,2015-12-05,arkansas-state,,Texas State,W (55-17),12,16,75.0,192,2,46,353,7.7,5,62,545,8.8,9,13,1,23,9,67,1,0,1
6104,13,2015-12-19,arkansas-state,N,Louisiana Tech*,L (28-47),15,29,51.7,146,0,39,177,4.5,2,68,323,4.8,6,11,6,23,11,109,1,2,3
6105,,13 Games,arkansas-state,,,,207,365,56.7,2693,23,608,3017,5.0,35,973,5710,5.9,115,142,24,290,109,1044,11,15,26
6106,1,2016-09-02,arkansas-state,,Toledo,L (10-31),11,25,44.0,124,0,38,142,3.7,1,63,266,4.2,3,8,2,13,6,48,0,0,0
6107,2,2016-09-10,arkansas-state,@,Auburn,L (14-51),19,30,63.3,260,0,35,66,1.9,2,65,326,5.0,9,4,1,14,10,71,0,0,0
6108,3,2016-09-16,arkansas-state,@,Utah State,L (20-34),20,33,60.6,287,1,31,70,2.3,1,64,357,5.6,11,3,2,16,18,129,1,2,3
6109,4,2016-09-24,arkansas-state,,Central Arkansas,L (23-28),21,38,55.3,424,3,34,45,1.3,0,72,469,6.5,14,6,0,20,8,63,2,2,4
6110,5,2016-10-05,arkansas-state,,Georgia Southern,W (27-26),16,28,57.1,182,2,49,343,7.0,1,77,525,6.8,9,16,2,27,2,20,3,2,5
6111,6,2016-10-15,arkansas-state,,South Alabama,W (17-7),9,13,69.2,93,0,54,204,3.8,1,67,297,4.4,14,20,2,36,4,25,0,1,1
6112,7,2016-10-29,arkansas-state,,Louisiana-Monroe,W (51-10),24,41,58.5,316,5,31,118,3.8,2,72,434,6.0,16,5,3,24,7,58,0,0,0
6113,8,2016-11-03,arkansas-state,@,Georgia State,W (31-16),15,35,42.9,212,0,41,93,2.3,2,76,305,4.0,10,6,1,17,6,50,1,0,1
6114,9,2016-11-12,arkansas-state,,New Mexico State,W (41-22),22,29,75.9,293,3,38,160,4.2,2,67,453,6.8,10,8,0,18,6,51,0,1,1
6115,10,2016-11-17,arkansas-state,@,Troy,W (35-3),14,26,53.8,180,1,51,208,4.1,3,77,388,5.0,6,12,1,19,9,57,0,0,0
6116,11,2016-11-26,arkansas-state,@,Louisiana,L (19-24),35,57,61.4,393,1,33,128,3.9,1,90,521,5.8,20,8,0,28,6,58,0,1,1
6117,12,2016-12-03,arkansas-state,@,Texas State,W (36-14),13,21,61.9,179,2,44,178,4.0,3,65,357,5.5,7,9,2,18,10,65,0,0,0
6118,13,2016-12-17,arkansas-state,N,Central Florida*,W (31-13),12,26,46.2,205,3,38,29,0.8,0,64,234,3.7,5,3,0,8,15,140,1,0,1
6119,,13 Games,arkansas-state,,,,231,402,57.5,3148,21,517,1784,3.5,19,919,4932,5.4,134,108,16,258,107,835,8,9,17
6120,1,2017-09-02,arkansas-state,@,Nebraska,L (36-43),46,68,67.6,415,3,21,82,3.9,0,89,497,5.6,25,5,2,32,9,63,0,2,2
6121,2,2017-09-16,arkansas-state,,Arkansas-Pine Bluff,W (48-3),26,34,76.5,356,6,37,137,3.7,1,71,493,6.9,16,9,1,26,5,39,0,0,0
6122,3,2017-09-23,arkansas-state,@,Southern Methodist,L (21-44),23,43,53.5,284,2,29,143,4.9,1,72,427,5.9,14,6,0,20,12,93,1,1,2
6123,4,2017-10-04,arkansas-state,@,Georgia Southern,W (43-25),12,26,46.2,316,4,35,65,1.9,2,61,381,6.2,11,6,2,19,5,55,1,4,5
6124,5,2017-10-14,arkansas-state,,Coastal Carolina,W (51-17),24,37,64.9,286,5,37,189,5.1,0,74,475,6.4,16,10,2,27,6,59,0,0,0
6125,6,2017-10-19,arkansas-state,,Louisiana,W (47-3),24,39,61.5,309,2,42,264,6.3,3,81,573,7.1,12,14,4,30,7,60,1,0,1
6126,7,2017-10-28,arkansas-state,@,New Mexico State,W (37-21),25,40,62.5,297,4,40,120,3.0,1,80,417,5.2,16,6,5,27,13,126,1,1,2
6127,8,2017-11-11,arkansas-state,@,South Alabama,L (19-24),28,45,62.2,299,2,33,66,2.0,0,78,365,4.7,12,9,2,23,7,40,2,4,6
6128,9,2017-11-18,arkansas-state,,Texas State,W (30-12),20,33,60.6,229,1,61,233,3.8,3,94,462,4.9,10,14,1,25,6,39,0,0,0
6129,10,2017-11-25,arkansas-state,@,Louisiana-Monroe,W (67-50),26,38,68.4,520,4,44,261,5.9,4,82,781,9.5,21,8,2,31,10,108,0,1,1
6130,11,2017-12-02,arkansas-state,,Troy,L (25-32),31,50,62.0,437,2,44,169,3.8,1,94,606,6.4,21,9,2,32,7,65,0,3,3
6131,12,2017-12-16,arkansas-state,N,Middle Tennessee State*,L (30-35),32,58,55.2,358,3,39,104,2.7,1,97,462,4.8,17,9,4,30,7,81,2,1,3
6132,,12 Games,arkansas-state,,,,317,511,62.0,4106,38,462,1833,4.0,17,973,5939,6.1,191,105,27,322,94,828,8,17,25
6133,1,2018-09-01,arkansas-state,,Southeast Missouri State,W (48-21),28,40,70.0,497,7,39,188,4.8,0,79,685,8.7,18,10,2,30,12,119,1,2,3
6134,2,2018-09-08,arkansas-state,@,Alabama,L (7-57),22,51,43.1,218,1,31,173,5.6,0,82,391,4.8,12,6,1,19,10,84,0,1,1
6135,3,2018-09-15,arkansas-state,@,Tulsa,W (29-20),20,33,60.6,191,0,47,218,4.6,2,80,409,5.1,9,14,1,24,11,101,1,0,1
6136,4,2018-09-22,arkansas-state,,Nevada-Las Vegas,W (27-20),19,27,70.4,199,3,36,197,5.5,1,63,396,6.3,9,8,0,17,11,87,1,0,1
6137,5,2018-09-29,arkansas-state,@,Georgia Southern,L (21-28),38,51,74.5,376,1,36,117,3.3,1,87,493,5.7,18,10,0,28,5,39,1,0,1
6138,6,2018-10-09,arkansas-state,,Appalachian State,L (9-35),27,45,60.0,219,0,37,117,3.2,0,82,336,4.1,10,6,2,18,7,65,0,3,3
6139,7,2018-10-18,arkansas-state,,Georgia State,W (51-35),17,28,60.7,257,3,37,273,7.4,3,65,530,8.2,10,11,2,23,11,109,0,0,0
6140,8,2018-10-27,arkansas-state,@,Louisiana,L (43-47),17,31,54.8,270,1,45,208,4.6,5,76,478,6.3,10,14,3,27,4,65,0,1,1
6141,9,2018-11-03,arkansas-state,,South Alabama,W (38-14),27,40,67.5,354,3,37,155,4.2,2,77,509,6.6,15,8,3,26,3,15,0,0,0
6142,10,2018-11-10,arkansas-state,@,Coastal Carolina,W (44-16),23,29,79.3,281,4,29,173,6.0,2,58,454,7.8,11,9,3,23,10,71,1,0,1
6143,11,2018-11-17,arkansas-state,,Louisiana-Monroe,W (31-17),21,27,77.8,246,3,39,158,4.1,0,66,404,6.1,11,7,2,20,7,68,0,0,0
6144,,11 Games,arkansas-state,,,,259,402,64.4,3108,26,413,1977,4.8,16,815,5085,6.2,133,103,19,255,91,823,5,7,12
6145,1,2014-08-30,east-carolina,,North Carolina Central,W (52-7),33,46,71.7,374,4,28,208,7.4,3,74,582,7.9,19,9,4,32,8,72,1,1,2
6146,2,2014-09-06,east-carolina,@,South Carolina,L (23-33),32,46,69.6,321,1,21,132,6.3,1,67,453,6.8,20,4,3,27,4,40,0,2,2
6147,3,2014-09-13,east-carolina,@,Virginia Tech,W (28-21),23,47,48.9,427,3,25,75,3.0,1,72,502,7.0,16,2,2,20,13,114,1,0,1
6148,4,2014-09-20,east-carolina,,North Carolina,W (70-41),32,51,62.7,446,4,46,343,7.5,5,97,789,8.1,21,14,4,39,9,74,0,1,1
6149,5,2014-10-04,east-carolina,,Southern Methodist,W (45-24),31,41,75.6,410,4,33,171,5.2,2,74,581,7.9,20,10,0,30,5,53,1,0,1
6150,6,2014-10-11,east-carolina,@,South Florida,W (28-17),24,34,70.6,250,1,37,231,6.2,3,71,481,6.8,16,9,0,25,12,148,0,1,1
6151,7,2014-10-23,east-carolina,,Connecticut,W (31-21),39,65,60.0,445,2,35,135,3.9,2,100,580,5.8,18,8,5,31,11,105,0,1,1
6152,8,2014-11-01,east-carolina,@,Temple,L (10-20),24,42,57.1,217,0,46,211,4.6,1,88,428,4.9,12,15,3,30,12,116,5,0,5
6153,9,2014-11-13,east-carolina,N,Cincinnati,L (46-54),35,62,56.5,425,2,32,154,4.8,4,94,579,6.2,19,6,5,30,5,38,2,0,2
6154,10,2014-11-22,east-carolina,,Tulane,W (34-6),31,44,70.5,358,1,33,139,4.2,3,77,497,6.5,17,12,1,30,5,40,0,0,0
6155,11,2014-11-28,east-carolina,@,Tulsa,W (49-32),28,42,66.7,338,4,37,172,4.6,2,79,510,6.5,17,7,2,26,8,42,0,1,1
6156,12,2014-12-04,east-carolina,,Central Florida,L (30-32),36,49,73.5,397,3,27,14,0.5,1,76,411,5.4,20,5,1,26,12,127,1,2,3
6157,13,2015-01-03,east-carolina,N,Florida*,L (20-28),34,68,50.0,427,2,33,109,3.3,0,101,536,5.3,23,6,3,32,5,35,1,2,3
6158,,13 Games,east-carolina,,,,402,637,63.1,4835,31,433,2094,4.8,28,1070,6929,6.5,238,107,33,378,109,1004,12,11,23
6159,1,2015-09-05,east-carolina,,Towson,W (28-20),29,37,78.4,230,0,34,210,6.2,4,71,440,6.2,11,11,1,23,8,102,0,0,0
6160,2,2015-09-12,east-carolina,@,Florida,L (24-31),37,58,63.8,346,3,22,-13,-0.6,0,80,333,4.2,16,1,3,20,9,65,2,1,3
6161,3,2015-09-19,east-carolina,@,Navy,L (21-45),36,49,73.5,325,3,21,80,3.8,0,70,405,5.8,17,7,1,25,6,47,1,1,2
6162,4,2015-09-26,east-carolina,,Virginia Tech,W (35-28),14,20,70.0,228,2,43,182,4.2,3,63,410,6.5,10,6,3,19,7,97,1,1,2
6163,5,2015-10-03,east-carolina,@,Southern Methodist,W (49-23),19,26,73.1,249,3,54,306,5.7,4,80,555,6.9,11,14,1,26,5,45,0,2,2
6164,6,2015-10-10,east-carolina,@,Brigham Young,L (38-45),30,42,71.4,385,2,32,133,4.2,2,74,518,7.0,17,8,2,27,7,64,2,1,3
6165,7,2015-10-17,east-carolina,,Tulsa,W (30-17),20,29,69.0,239,1,43,143,3.3,1,72,382,5.3,11,7,0,18,9,78,0,1,1
6166,8,2015-10-22,east-carolina,,Temple,L (14-24),33,53,62.3,283,1,35,95,2.7,1,88,378,4.3,16,6,2,24,9,99,1,1,2
6167,9,2015-10-30,east-carolina,@,Connecticut,L (13-31),19,33,57.6,137,0,36,203,5.6,1,69,340,4.9,7,9,0,16,7,64,0,4,4
6168,10,2015-11-07,east-carolina,,South Florida,L (17-22),14,23,60.9,158,0,34,62,1.8,2,57,220,3.9,5,2,1,8,5,40,0,0,0
6169,11,2015-11-19,east-carolina,@,Central Florida,W (44-7),36,52,69.2,473,4,33,149,4.5,1,85,622,7.3,17,12,2,31,11,93,0,0,0
6170,12,2015-11-28,east-carolina,,Cincinnati,L (16-19),34,51,66.7,317,2,18,68,3.8,0,69,385,5.6,20,3,0,23,6,64,0,0,0
6171,,12 Games,east-carolina,,,,321,473,67.9,3370,21,405,1618,4.0,19,878,4988,5.7,158,86,16,260,89,858,7,12,19
6172,1,2016-09-03,east-carolina,,Western Carolina,W (52-7),29,33,87.9,413,5,38,275,7.2,2,71,688,9.7,17,11,0,28,3,25,1,0,1
6173,2,2016-09-10,east-carolina,,North Carolina State,W (33-30),33,43,76.7,297,1,33,148,4.5,3,76,445,5.9,12,9,2,23,4,36,1,1,2
6174,3,2016-09-17,east-carolina,@,South Carolina,L (15-20),44,58,75.9,400,1,33,119,3.6,0,91,519,5.7,24,6,4,34,8,75,2,2,4
6175,4,2016-09-24,east-carolina,@,Virginia Tech,L (17-54),17,34,50.0,362,2,35,81,2.3,0,69,443,6.4,10,6,0,16,5,43,1,0,1
6176,5,2016-10-01,east-carolina,,Central Florida,L (29-47),38,70,54.3,488,3,32,33,1.0,1,102,521,5.1,22,3,5,30,2,15,2,3,5
6177,6,2016-10-08,east-carolina,@,South Florida,L (22-38),33,56,58.9,308,1,35,168,4.8,1,91,476,5.2,15,8,1,24,2,19,0,1,1
6178,7,2016-10-22,east-carolina,@,Cincinnati,L (19-31),28,43,65.1,283,2,44,221,5.0,0,87,504,5.8,13,13,2,28,4,34,1,2,3
6179,8,2016-10-29,east-carolina,,Connecticut,W (41-3),33,47,70.2,294,4,40,136,3.4,1,87,430,4.9,16,8,1,25,5,35,0,0,0
6180,9,2016-11-05,east-carolina,@,Tulsa,L (24-45),38,62,61.3,436,2,30,38,1.3,1,92,474,5.2,20,6,1,27,13,117,0,0,0
6181,10,2016-11-12,east-carolina,,Southern Methodist,L (31-55),29,49,59.2,314,1,32,152,4.8,3,81,466,5.8,13,12,2,27,9,84,2,3,5
6182,11,2016-11-19,east-carolina,,Navy,L (31-66),16,25,64.0,238,3,25,176,7.0,1,50,414,8.3,6,6,0,12,1,5,1,0,1
6183,12,2016-11-26,east-carolina,@,Temple,L (10-37),21,34,61.8,183,1,27,42,1.6,0,61,225,3.7,9,4,0,13,4,33,1,0,1
6184,,12 Games,east-carolina,,,,359,554,64.8,4016,26,404,1589,3.9,13,958,5605,5.9,177,92,18,287,60,521,12,12,24
6185,1,2017-09-02,east-carolina,,James Madison,L (14-34),28,53,52.8,292,0,28,75,2.7,2,81,367,4.5,17,3,8,28,8,61,1,3,4
6186,2,2017-09-09,east-carolina,@,West Virginia,L (20-56),23,47,48.9,328,2,32,142,4.4,0,79,470,5.9,13,6,2,21,8,103,0,2,2
6187,3,2017-09-16,east-carolina,,Virginia Tech,L (17-64),11,30,36.7,241,2,31,40,1.3,0,61,281,4.6,6,3,3,12,6,40,2,1,3
6188,4,2017-09-24,east-carolina,@,Connecticut,W (41-38),30,39,76.9,426,3,47,170,3.6,2,86,596,6.9,19,10,1,30,8,78,0,0,0
6189,5,2017-09-30,east-carolina,,South Florida,L (31-61),21,46,45.7,306,2,36,108,3.0,2,82,414,5.0,13,7,3,23,6,58,0,2,2
6190,6,2017-10-07,east-carolina,,Temple,L (10-34),20,38,52.6,253,1,22,34,1.5,0,60,287,4.8,11,3,1,15,8,96,0,1,1
6191,7,2017-10-14,east-carolina,@,Central Florida,L (21-63),15,33,45.5,160,3,37,187,5.1,0,70,347,5.0,8,5,3,16,10,50,0,1,1
6192,8,2017-10-21,east-carolina,,Brigham Young,W (33-17),20,30,66.7,298,2,35,115,3.3,1,65,413,6.4,12,8,2,22,2,15,1,0,1
6193,9,2017-11-04,east-carolina,@,Houston,L (27-52),54,74,73.0,468,3,24,36,1.5,0,98,504,5.1,27,4,2,33,7,51,1,2,3
6194,10,2017-11-11,east-carolina,,Tulane,L (24-31),25,53,47.2,228,1,32,161,5.0,2,85,389,4.6,12,9,3,24,2,20,0,1,1
6195,11,2017-11-18,east-carolina,,Cincinnati,W (48-20),32,46,69.6,464,5,33,114,3.5,1,79,578,7.3,19,6,3,28,7,54,0,0,0
6196,12,2017-11-25,east-carolina,@,Memphis,L (13-70),28,54,51.9,351,2,37,115,3.1,0,91,466,5.1,15,8,4,27,8,74,0,3,3
6197,,12 Games,east-carolina,,,,307,543,56.5,3815,26,394,1297,3.3,10,937,5112,5.5,172,72,35,279,80,700,5,16,21
6198,1,2018-09-02,east-carolina,,North Carolina A&T,L (23-28),38,66,57.6,314,2,29,68,2.3,0,95,382,4.0,16,6,6,28,5,45,1,2,3
6199,2,2018-09-08,east-carolina,,North Carolina,W (41-19),19,33,57.6,290,1,49,220,4.5,4,82,510,6.2,15,9,2,26,4,40,0,0,0
6200,3,2018-09-22,east-carolina,@,South Florida,L (13-20),22,50,44.0,256,0,46,156,3.4,1,96,412,4.3,11,10,3,24,2,10,0,1,1
6201,4,2018-09-29,east-carolina,,Old Dominion,W (37-35),25,45,55.6,313,3,38,179,4.7,2,83,492,5.9,17,6,2,25,8,86,0,2,2
6202,5,2018-10-06,east-carolina,@,Temple,L (6-49),18,39,46.2,120,0,28,76,2.7,0,67,196,2.9,4,5,3,12,2,25,0,0,0
6203,6,2018-10-13,east-carolina,,Houston,L (20-42),38,63,60.3,374,1,31,41,1.3,1,94,415,4.4,20,4,3,27,8,69,1,3,4
6204,7,2018-10-20,east-carolina,,Central Florida,L (10-37),29,56,51.8,406,1,38,90,2.4,0,94,496,5.3,18,9,2,29,8,60,4,1,5
6205,8,2018-11-03,east-carolina,,Memphis,L (41-59),34,62,54.8,449,3,29,107,3.7,2,91,556,6.1,18,8,3,29,4,45,1,0,1
6206,9,2018-11-10,east-carolina,@,Tulane,L (18-24),21,68,30.9,360,2,26,90,3.5,0,94,450,4.8,13,6,4,23,7,69,0,1,1
6207,10,2018-11-17,east-carolina,,Connecticut,W (55-21),22,33,66.7,242,4,54,415,7.7,3,87,657,7.6,9,23,2,34,5,48,0,0,0
6208,,10 Games,east-carolina,,,,266,515,51.7,3124,17,368,1442,3.9,13,883,4566,5.2,141,86,30,257,53,497,7,10,17
6209,1,2014-08-28,northern-illinois,,Presbyterian,W (55-3),19,32,59.4,211,2,77,424,5.5,5,109,635,5.8,10,26,0,36,6,55,0,0,0
6210,2,2014-09-06,northern-illinois,@,Northwestern,W (23-15),13,23,56.5,180,2,55,221,4.0,1,78,401,5.1,7,10,3,20,8,75,0,0,0
6211,3,2014-09-13,northern-illinois,@,Nevada-Las Vegas,W (48-34),18,28,64.3,285,3,69,331,4.8,3,97,616,6.4,15,20,0,35,8,95,1,0,1
6212,4,2014-09-20,northern-illinois,@,Arkansas,L (14-52),19,31,61.3,180,2,32,123,3.8,0,63,303,4.8,8,8,1,17,9,67,1,0,1
6213,5,2014-10-04,northern-illinois,,Kent State,W (17-14),15,25,60.0,198,0,39,181,4.6,2,64,379,5.9,5,8,2,15,9,81,0,1,1
6214,6,2014-10-11,northern-illinois,,Central Michigan,L (17-34),18,33,54.5,231,2,33,110,3.3,0,66,341,5.2,10,7,2,19,3,34,0,1,1
6215,7,2014-10-18,northern-illinois,,Miami (OH),W (51-41),16,22,72.7,225,1,55,433,7.9,6,77,658,8.5,9,20,1,30,5,43,1,0,1
6216,8,2014-10-25,northern-illinois,@,Eastern Michigan,W (28-17),10,17,58.8,54,0,44,332,7.5,4,61,386,6.3,2,14,2,18,3,37,0,0,0
6217,9,2014-11-05,northern-illinois,@,Ball State,W (35-21),18,31,58.1,149,0,62,236,3.8,4,93,385,4.1,11,12,1,24,8,85,2,0,2
6218,10,2014-11-11,northern-illinois,,Toledo,W (27-24),14,22,63.6,190,1,46,226,4.9,2,68,416,6.1,7,10,0,17,5,34,0,0,0
6219,11,2014-11-18,northern-illinois,@,Ohio,W (21-14),16,24,66.7,184,2,41,141,3.4,1,65,325,5.0,8,10,1,19,6,85,1,0,1
6220,12,2014-11-28,northern-illinois,@,Western Michigan,W (31-21),9,20,45.0,159,1,34,196,5.8,3,54,355,6.6,5,10,0,15,3,22,2,0,2
6221,13,2014-12-05,northern-illinois,N,Bowling Green State,W (51-17),29,49,59.2,218,2,51,334,6.5,4,100,552,5.5,12,17,0,29,5,40,1,1,2
6222,14,2014-12-23,northern-illinois,N,Marshall*,L (23-52),15,28,53.6,225,1,50,200,4.0,1,78,425,5.4,12,11,2,25,4,41,0,0,0
6223,,14 Games,northern-illinois,,,,229,385,59.5,2689,19,688,3488,5.1,36,1073,6177,5.8,121,183,15,319,82,794,9,3,12
6224,1,2015-09-05,northern-illinois,,Nevada-Las Vegas,W (38-30),21,26,80.8,360,2,42,185,4.4,3,68,545,8.0,13,11,0,24,7,55,0,0,0
6225,2,2015-09-12,northern-illinois,,Murray State,W (57-26),31,41,75.6,389,4,43,254,5.9,3,84,643,7.7,18,11,1,30,5,58,2,0,2
6226,3,2015-09-19,northern-illinois,@,Ohio State,L (13-20),14,31,45.2,80,0,43,110,2.6,1,74,190,2.6,4,6,0,10,5,31,0,2,2
6227,4,2015-09-26,northern-illinois,@,Boston College,L (14-17),11,25,44.0,81,0,31,72,2.3,1,56,153,2.7,4,4,2,10,7,45,1,1,2
6228,5,2015-10-03,northern-illinois,@,Central Michigan,L (19-29),12,30,40.0,105,0,59,211,3.6,2,89,316,3.6,6,11,0,17,8,69,3,1,4
6229,6,2015-10-10,northern-illinois,,Ball State,W (59-41),29,32,90.6,363,2,59,273,4.6,6,91,636,7.0,18,16,1,35,5,86,1,0,1
6230,7,2015-10-17,northern-illinois,@,Miami (OH),W (45-12),17,26,65.4,203,1,37,311,8.4,5,63,514,8.2,9,12,0,21,2,32,2,0,2
6231,8,2015-10-24,northern-illinois,,Eastern Michigan,W (49-21),24,38,63.2,267,4,59,324,5.5,3,97,591,6.1,11,20,3,34,8,70,0,0,0
6232,9,2015-11-03,northern-illinois,@,Toledo,W (32-27),16,25,64.0,277,2,54,124,2.3,1,79,401,5.1,8,9,1,18,6,55,1,1,2
6233,10,2015-11-11,northern-illinois,@,Buffalo,W (41-30),15,24,62.5,190,2,67,334,5.0,3,91,524,5.8,8,16,0,24,6,59,1,1,2
6234,11,2015-11-18,northern-illinois,,Western Michigan,W (27-19),11,23,47.8,158,2,43,289,6.7,2,66,447,6.8,8,9,2,19,5,39,0,1,1
6235,12,2015-11-24,northern-illinois,,Ohio,L (21-26),20,34,58.8,255,2,38,73,1.9,1,72,328,4.6,9,9,0,18,6,50,1,0,1
6236,13,2015-12-04,northern-illinois,N,Bowling Green State,L (14-34),12,28,42.9,152,1,38,107,2.8,0,66,259,3.9,6,9,2,17,6,49,2,3,5
6237,14,2015-12-23,northern-illinois,N,Boise State*,L (7-55),7,21,33.3,38,0,30,-5,-0.2,0,51,33,0.6,3,2,2,7,5,30,3,0,3
6238,,14 Games,northern-illinois,,,,240,404,59.4,2918,22,643,2662,4.1,31,1047,5580,5.3,125,145,14,284,81,728,17,10,27
6239,1,2016-09-03,northern-illinois,@,Wyoming,L (34-40),24,39,61.5,329,3,37,133,3.6,2,76,462,6.1,12,6,1,19,12,106,1,0,1
6240,2,2016-09-10,northern-illinois,@,South Florida,L (17-48),22,35,62.9,161,1,41,157,3.8,1,76,318,4.2,8,9,2,19,4,50,0,0,0
6241,3,2016-09-17,northern-illinois,,San Diego State,L (28-42),17,35,48.6,213,3,39,155,4.0,1,74,368,5.0,6,10,5,21,8,103,0,2,2
6242,4,2016-09-24,northern-illinois,,Western Illinois,L (23-28),25,37,67.6,251,2,41,301,7.3,1,78,552,7.1,9,13,3,25,10,93,0,1,1
6243,5,2016-10-01,northern-illinois,@,Ball State,W (31-24),26,41,63.4,298,2,46,355,7.7,2,87,653,7.5,16,13,1,30,6,60,2,1,3
6244,6,2016-10-08,northern-illinois,@,Western Michigan,L (30-45),15,31,48.4,233,1,42,251,6.0,2,73,484,6.6,9,13,3,25,6,64,0,2,2
6245,7,2016-10-15,northern-illinois,,Central Michigan,L (28-34),18,30,60.0,165,3,37,174,4.7,1,67,339,5.1,8,7,1,16,3,26,0,2,2
6246,8,2016-10-22,northern-illinois,,Buffalo,W (44-7),16,30,53.3,199,1,51,312,6.1,4,81,511,6.3,11,15,2,28,3,22,0,1,1
6247,9,2016-11-01,northern-illinois,,Bowling Green State,W (45-20),21,31,67.7,193,0,49,286,5.8,6,80,479,6.0,9,21,2,29,11,91,0,1,1
6248,10,2016-11-09,northern-illinois,N,Toledo,L (24-31),24,43,55.8,227,3,43,214,5.0,0,86,441,5.1,13,9,1,23,8,85,0,1,1
6249,11,2016-11-16,northern-illinois,@,Eastern Michigan,W (31-24),11,25,44.0,161,1,52,324,6.2,3,77,485,6.3,8,11,1,20,9,95,0,1,1
6250,12,2016-11-25,northern-illinois,@,Kent State,W (31-21),13,23,56.5,258,0,71,215,3.0,4,94,473,5.0,12,12,3,27,4,45,1,1,2
6251,,12 Games,northern-illinois,,,,232,400,58.0,2688,20,549,2877,5.2,27,949,5565,5.9,121,139,25,282,84,840,4,13,17
6252,1,2017-09-01,northern-illinois,,Boston College,L (20-23),16,39,41.0,203,2,35,164,4.7,0,74,367,5.0,10,5,3,18,8,70,0,1,1
6253,2,2017-09-09,northern-illinois,,Eastern Illinois,W (38-10),24,35,68.6,269,3,47,230,4.9,2,82,499,6.1,11,12,3,26,15,194,2,1,3
6254,3,2017-09-16,northern-illinois,@,Nebraska,W (21-17),15,23,65.2,128,0,27,108,4.0,1,50,236,4.7,5,7,1,13,3,25,1,0,1
6255,4,2017-09-30,northern-illinois,@,San Diego State,L (28-34),23,38,60.5,262,3,44,156,3.5,1,82,418,5.1,11,9,3,23,4,42,1,3,4
6256,5,2017-10-07,northern-illinois,,Kent State,W (24-3),13,22,59.1,114,3,50,152,3.0,0,72,266,3.7,7,9,0,15,7,59,1,2,3
6257,6,2017-10-14,northern-illinois,@,Buffalo,W (14-13),20,31,64.5,224,1,55,219,4.0,1,86,443,5.2,11,15,2,28,3,35,2,0,2
6258,7,2017-10-21,northern-illinois,@,Bowling Green State,W (48-17),21,34,61.8,239,3,55,338,6.1,2,89,577,6.5,13,16,0,29,6,39,1,0,1
6259,8,2017-10-26,northern-illinois,,Eastern Michigan,W (30-27),23,40,57.5,278,2,36,114,3.2,2,76,392,5.2,10,6,2,18,9,72,1,0,1
6260,9,2017-11-02,northern-illinois,@,Toledo,L (17-27),24,44,54.5,245,0,40,185,4.6,2,84,430,5.1,12,11,2,25,7,45,0,2,2
6261,10,2017-11-09,northern-illinois,,Ball State,W (63-17),11,24,45.8,211,5,45,222,4.9,2,69,433,6.3,9,9,2,20,1,5,1,0,1
6262,11,2017-11-15,northern-illinois,,Western Michigan,W (35-31),6,11,54.5,64,1,49,248,5.1,3,60,312,5.2,2,13,2,17,7,65,3,0,3
6263,12,2017-11-24,northern-illinois,@,Central Michigan,L (24-31),20,36,55.6,128,1,40,137,3.4,1,76,265,3.5,8,9,2,19,7,60,0,2,2
6264,13,2017-12-26,northern-illinois,N,Duke*,L (14-36),15,28,53.6,234,1,29,65,2.2,1,57,299,5.2,6,5,2,13,3,11,0,0,0
6265,,13 Games,northern-illinois,,,,231,405,57.0,2599,25,552,2338,4.2,18,957,4937,5.2,115,126,24,264,80,722,13,11,24
6266,1,2018-09-01,northern-illinois,@,Iowa,L (7-33),15,26,57.7,110,1,36,101,2.8,0,62,211,3.4,6,8,1,15,7,65,1,1,2
6267,2,2018-09-08,northern-illinois,,Utah,L (6-17),18,33,54.5,111,0,43,117,2.7,0,76,228,3.0,6,8,1,15,4,43,1,1,2
6268,3,2018-09-15,northern-illinois,,Central Michigan,W (24-16),12,20,60.0,104,3,48,180,3.8,0,68,284,4.2,5,8,2,15,4,44,0,1,1
6269,4,2018-09-22,northern-illinois,@,Florida State,L (19-37),20,41,48.8,215,2,20,6,0.3,1,61,221,3.6,9,3,1,13,3,15,0,0,0
6270,5,2018-09-29,northern-illinois,@,Eastern Michigan,W (26-23),20,35,57.1,121,1,62,235,3.8,2,97,356,3.7,5,17,2,24,8,68,1,2,3
6271,6,2018-10-06,northern-illinois,@,Ball State,W (24-16),18,29,62.1,143,1,43,227,5.3,2,72,370,5.1,10,13,0,23,6,38,0,1,1
6272,7,2018-10-13,northern-illinois,,Ohio,W (24-21),17,33,51.5,145,0,46,255,5.5,3,79,400,5.1,10,13,2,25,12,109,0,0,0
6273,8,2018-10-27,northern-illinois,@,Brigham Young,W (7-6),10,21,47.6,115,0,36,89,2.5,1,57,204,3.6,5,4,2,11,10,80,0,0,0
6274,9,2018-11-01,northern-illinois,@,Akron,W (36-26),21,28,75.0,188,1,61,296,4.9,2,89,484,5.4,12,20,2,34,7,85,1,0,1
6275,10,2018-11-07,northern-illinois,,Toledo,W (38-15),13,19,68.4,131,1,44,296,6.7,3,63,427,6.8,7,13,0,20,5,58,1,1,2
6276,11,2018-11-14,northern-illinois,,Miami (OH),L (7-13),15,33,45.5,157,0,37,212,5.7,1,70,369,5.3,6,8,1,15,9,90,1,1,2
6277,,11 Games,northern-illinois,,,,179,318,56.3,1540,10,476,2014,4.2,15,794,3554,4.5,81,115,14,210,75,695,6,8,14
6278,1,2014-08-30,southern-mississippi,@,Mississippi State,L (0-49),20,42,47.6,212,0,33,71,2.2,0,75,283,3.8,6,8,1,15,6,37,1,2,3
6279,2,2014-09-06,southern-mississippi,,Alcorn State,W (26-20),21,33,63.6,208,2,42,207,4.9,0,75,415,5.5,7,11,4,22,4,40,0,0,0
6280,3,2014-09-13,southern-mississippi,@,Alabama,L (12-52),19,37,51.4,207,0,18,56,3.1,0,55,263,4.8,9,3,1,13,6,50,0,0,0
6281,4,2014-09-20,southern-mississippi,,Appalachian State,W (21-20),22,36,61.1,268,1,25,61,2.4,2,61,329,5.4,9,5,2,16,9,103,0,2,2
6282,5,2014-09-27,southern-mississippi,,Rice,L (23-41),24,46,52.2,283,2,23,40,1.7,1,69,323,4.7,12,2,4,18,6,55,1,2,3
6283,6,2014-10-04,southern-mississippi,@,Middle Tennessee State,L (31-37),36,55,65.5,426,3,34,111,3.3,1,89,537,6.0,23,7,0,30,6,48,1,1,2
6284,7,2014-10-18,southern-mississippi,@,North Texas,W (30-20),27,41,65.9,305,2,41,201,4.9,1,82,506,6.2,16,12,2,30,6,70,0,2,2
6285,8,2014-10-25,southern-mississippi,,Louisiana Tech,L (20-31),32,49,65.3,379,1,26,-31,-1.2,1,75,348,4.6,19,2,1,22,9,83,0,2,2
6286,9,2014-11-01,southern-mississippi,@,Texas-El Paso,L (14-35),20,47,42.6,309,1,27,93,3.4,0,74,402,5.4,11,6,0,17,9,95,3,2,5
6287,10,2014-11-08,southern-mississippi,,Marshall,L (17-63),11,20,55.0,114,0,54,186,3.4,2,74,300,4.1,7,11,5,23,7,68,2,1,3
6288,11,2014-11-13,southern-mississippi,@,Texas-San Antonio,L (10-12),21,34,61.8,257,1,25,57,2.3,0,59,314,5.3,10,4,3,17,7,62,2,1,3
6289,12,2014-11-29,southern-mississippi,,Alabama-Birmingham,L (24-45),24,42,57.1,263,1,28,97,3.5,1,70,360,5.1,13,6,7,26,2,20,1,0,1
6290,,12 Games,southern-mississippi,,,,277,482,57.5,3231,14,376,1149,3.1,9,858,4380,5.1,142,77,30,249,77,731,11,15,26
6291,1,2015-09-05,southern-mississippi,,Mississippi State,L (16-34),30,44,68.2,311,1,36,102,2.8,0,80,413,5.2,15,4,1,20,7,59,0,2,2
6292,2,2015-09-12,southern-mississippi,,Austin Peay,W (52-6),22,40,55.0,275,3,30,239,8.0,3,70,514,7.3,12,9,3,24,6,70,0,1,1
6293,3,2015-09-19,southern-mississippi,@,Texas State,W (56-50),19,27,70.4,333,4,46,280,6.1,4,73,613,8.4,14,6,2,22,15,130,1,0,1
6294,4,2015-09-26,southern-mississippi,@,Nebraska,L (28-36),26,42,61.9,447,2,23,11,0.5,2,65,458,7.0,15,1,3,19,9,80,1,0,1
6295,5,2015-10-03,southern-mississippi,,North Texas,W (49-14),27,36,75.0,325,4,33,248,7.5,3,69,573,8.3,11,11,2,24,8,87,0,0,0
6296,6,2015-10-09,southern-mississippi,@,Marshall,L (10-31),29,58,50.0,314,1,35,125,3.6,0,93,439,4.7,13,8,5,26,8,55,4,1,5
6297,7,2015-10-17,southern-mississippi,,Texas-San Antonio,W (32-10),23,31,74.2,343,2,44,213,4.8,1,75,556,7.4,11,9,3,23,8,85,1,3,4
6298,8,2015-10-24,southern-mississippi,@,UNC Charlotte,W (44-10),25,40,62.5,268,4,38,212,5.6,1,78,480,6.2,10,10,2,22,7,63,2,0,2
6299,9,2015-10-31,southern-mississippi,,Texas-El Paso,W (34-13),23,33,69.7,277,4,36,246,6.8,1,69,523,7.6,14,7,3,24,4,41,1,0,1
6300,10,2015-11-14,southern-mississippi,@,Rice,W (65-10),28,37,75.7,501,7,35,181,5.2,2,72,682,9.5,18,7,1,26,6,59,1,0,1
6301,11,2015-11-21,southern-mississippi,,Old Dominion,W (56-31),21,37,56.8,302,2,48,310,6.5,6,85,612,7.2,15,15,3,33,4,40,1,1,2
6302,12,2015-11-28,southern-mississippi,@,Louisiana Tech,W (58-24),24,37,64.9,386,3,36,169,4.7,4,73,555,7.6,18,6,1,25,6,65,0,1,1
6303,13,2015-12-05,southern-mississippi,@,Western Kentucky,L (28-45),15,30,50.0,181,1,32,159,5.0,2,62,340,5.5,8,6,0,14,5,52,1,3,4
6304,14,2015-12-26,southern-mississippi,N,Washington*,L (31-44),26,39,66.7,353,2,30,22,0.7,2,69,375,5.4,14,5,3,22,4,45,0,0,0
6305,,14 Games,southern-mississippi,,,,338,531,63.7,4616,40,502,2517,5.0,31,1033,7133,6.9,188,104,32,324,97,931,13,12,25
6306,1,2016-09-03,southern-mississippi,@,Kentucky,W (44-35),18,28,64.3,258,2,67,296,4.4,3,95,554,5.8,10,18,4,32,7,50,0,3,3
6307,2,2016-09-10,southern-mississippi,,Savannah State,W (56-0),21,29,72.4,246,4,48,371,7.7,3,77,617,8.0,10,18,0,28,5,40,0,1,1
6308,3,2016-09-17,southern-mississippi,,Troy,L (31-37),24,52,46.2,263,1,29,158,5.4,2,81,421,5.2,13,5,2,20,16,135,1,2,3
6309,4,2016-09-24,southern-mississippi,@,Texas-El Paso,W (34-7),16,27,59.3,176,3,39,202,5.2,0,66,378,5.7,9,8,1,18,4,30,2,0,2
6310,5,2016-10-01,southern-mississippi,,Rice,W (44-28),25,36,69.4,591,4,34,111,3.3,1,70,702,10.0,15,6,2,23,7,52,2,1,3
6311,6,2016-10-08,southern-mississippi,@,Texas-San Antonio,L (32-55),25,50,50.0,378,3,39,179,4.6,1,89,557,6.3,18,10,3,31,5,57,2,1,3
6312,7,2016-10-15,southern-mississippi,@,Louisiana State,L (10-45),25,37,67.6,161,0,36,81,2.3,1,73,242,3.3,9,4,3,16,6,42,1,0,1
6313,8,2016-10-29,southern-mississippi,,Marshall,W (24-14),22,40,55.0,300,1,45,174,3.9,2,85,474,5.6,14,10,2,26,4,44,1,0,1
6314,9,2016-11-05,southern-mississippi,,UNC Charlotte,L (27-38),32,53,60.4,404,2,29,94,3.2,2,82,498,6.1,15,7,3,25,8,60,0,3,3
6315,10,2016-11-12,southern-mississippi,@,Old Dominion,L (35-51),12,24,50.0,230,1,55,222,4.0,4,79,452,5.7,9,12,0,21,4,34,4,1,5
6316,11,2016-11-19,southern-mississippi,@,North Texas,L (23-29),11,27,40.7,182,0,43,203,4.7,3,70,385,5.5,6,9,4,19,9,79,1,3,4
6317,12,2016-11-25,southern-mississippi,,Louisiana Tech,W (39-24),29,33,87.9,342,3,44,84,1.9,2,77,426,5.5,17,6,3,26,9,85,1,0,1
6318,13,2016-12-17,southern-mississippi,N,Louisiana*,W (28-21),25,42,59.5,346,2,32,135,4.2,2,74,481,6.5,12,8,2,22,13,131,1,1,2
6319,,13 Games,southern-mississippi,,,,285,478,59.6,3877,26,540,2310,4.3,26,1018,6187,6.1,157,121,29,307,97,839,16,16,32
6320,1,2017-09-02,southern-mississippi,,Kentucky,L (17-24),22,40,55.0,309,2,38,55,1.4,0,78,364,4.7,10,7,2,19,8,69,3,0,3
6321,2,2017-09-09,southern-mississippi,,Southern,W (45-0),20,32,62.5,280,2,44,197,4.5,2,76,477,6.3,15,9,3,27,5,35,2,0,2
6322,3,2017-09-16,southern-mississippi,@,Louisiana-Monroe,W (28-17),17,32,53.1,250,3,48,284,5.9,1,80,534,6.7,8,12,3,23,12,125,0,1,1
6323,4,2017-09-30,southern-mississippi,,North Texas,L (28-43),19,42,45.2,270,1,29,145,5.0,3,71,415,5.8,10,7,1,18,6,64,0,0,0
6324,5,2017-10-07,southern-mississippi,@,Texas-San Antonio,W (31-29),15,21,71.4,212,3,30,246,8.2,1,51,458,9.0,9,9,0,18,3,35,2,0,2
6325,6,2017-10-14,southern-mississippi,,Texas-El Paso,W (24-0),16,27,59.3,221,1,45,202,4.5,2,72,423,5.9,8,11,1,20,10,94,1,2,3
6326,7,2017-10-21,southern-mississippi,@,Louisiana Tech,W (34-27),32,53,60.4,301,3,45,190,4.2,0,98,491,5.0,16,10,1,30,6,40,1,2,3
6327,8,2017-10-28,southern-mississippi,,Alabama-Birmingham,L (12-30),19,38,50.0,266,1,26,81,3.1,0,64,347,5.4,7,5,2,14,5,41,0,1,1
6328,9,2017-11-04,southern-mississippi,@,Tennessee,L (10-24),13,34,38.2,161,0,42,118,2.8,1,76,279,3.7,7,8,3,18,14,120,1,1,2
6329,10,2017-11-11,southern-mississippi,@,Rice,W (43-34),22,31,71.0,331,3,36,186,5.2,2,67,517,7.7,16,12,0,28,10,86,0,0,0
6330,11,2017-11-18,southern-mississippi,,UNC Charlotte,W (66-21),20,27,74.1,221,1,42,363,8.6,5,69,584,8.5,11,13,3,27,5,34,0,0,0
6331,12,2017-11-25,southern-mississippi,@,Marshall,W (28-27),16,35,45.7,170,3,45,201,4.5,1,80,371,4.6,8,10,4,22,8,85,1,0,1
6332,13,2017-12-27,southern-mississippi,N,Florida State*,L (13-42),15,27,55.6,129,1,28,131,4.7,1,55,260,4.7,7,4,1,12,7,44,1,0,1
6333,,13 Games,southern-mississippi,,,,246,439,56.0,3121,24,498,2399,4.8,19,937,5520,5.9,132,117,24,276,99,872,12,7,19
6334,1,2018-09-01,southern-mississippi,,Jackson State,W (55-7),25,33,75.8,255,4,45,202,4.5,1,78,457,5.9,15,13,1,29,4,35,1,2,3
6335,2,2018-09-08,southern-mississippi,,Louisiana-Monroe,L (20-21),31,46,67.4,378,2,34,58,1.7,0,80,436,5.5,18,4,1,23,4,45,2,2,4
6336,3,2018-09-22,southern-mississippi,,Rice,W (40-22),25,34,73.5,428,4,31,138,4.5,1,65,566,8.7,16,9,0,25,5,39,0,1,1
6337,4,2018-09-29,southern-mississippi,@,Auburn,L (13-24),30,44,68.2,215,1,21,45,2.1,0,65,260,4.0,11,2,2,15,7,46,1,2,3
6338,5,2018-10-13,southern-mississippi,@,North Texas,L (7-30),30,44,68.2,317,1,28,50,1.8,0,72,367,5.1,14,4,2,20,3,32,1,1,2
6339,6,2018-10-20,southern-mississippi,,Texas-San Antonio,W (27-17),28,33,84.8,269,1,46,218,4.7,2,79,487,6.2,14,10,0,24,7,60,2,1,3
6340,7,2018-10-27,southern-mississippi,@,UNC Charlotte,L (17-20),27,39,69.2,297,2,34,129,3.8,0,73,426,5.8,14,8,3,25,6,43,0,3,3
6341,8,2018-11-03,southern-mississippi,,Marshall,W (26-24),16,25,64.0,134,1,45,88,2.0,1,70,222,3.2,4,4,5,13,10,90,2,0,2
6342,9,2018-11-10,southern-mississippi,@,Alabama-Birmingham,L (23-26),16,39,41.0,160,1,34,5,0.1,1,73,165,2.3,6,5,4,15,8,58,0,1,1
6343,10,2018-11-17,southern-mississippi,,Louisiana Tech,W (21-20),26,31,83.9,226,1,33,54,1.6,2,64,280,4.4,14,3,2,19,4,38,1,0,1
6344,,10 Games,southern-mississippi,,,,254,368,69.0,2679,18,351,987,2.8,8,719,3666,5.1,126,62,20,208,58,486,10,13,23
6345,1,2014-08-30,memphis,,Austin Peay,W (63-0),20,27,74.1,242,2,55,303,5.5,7,82,545,6.6,10,14,4,28,6,55,1,1,2
6346,2,2014-09-06,memphis,@,UCLA,L (35-42),27,42,64.3,305,1,39,164,4.2,3,81,469,5.8,17,5,2,24,10,110,0,0,0
6347,3,2014-09-20,memphis,,Middle Tennessee State,W (36-17),21,35,60.0,219,2,51,261,5.1,1,86,480,5.6,14,11,1,26,6,35,0,1,1
6348,4,2014-09-27,memphis,@,Mississippi,L (3-24),13,31,41.9,81,0,31,23,0.7,0,62,104,1.7,4,4,5,13,9,105,1,1,2
6349,5,2014-10-04,memphis,N,Cincinnati,W (41-14),18,25,72.0,311,2,69,299,4.3,3,94,610,6.5,14,16,0,30,8,72,0,0,0
6350,6,2014-10-11,memphis,,Houston,L (24-28),26,37,70.3,243,2,41,125,3.0,1,78,368,4.7,12,7,1,20,4,41,2,3,5
6351,7,2014-10-25,memphis,@,Southern Methodist,W (48-10),20,27,74.1,352,2,53,230,4.3,4,80,582,7.3,17,10,2,29,8,69,1,0,1
6352,8,2014-10-31,memphis,,Tulsa,W (40-20),18,31,58.1,183,0,41,243,5.9,4,72,426,5.9,7,13,3,23,4,40,1,0,1
6353,9,2014-11-07,memphis,@,Temple,W (16-13),21,28,75.0,230,1,40,82,2.1,0,68,312,4.6,13,3,1,17,6,46,1,0,1
6354,10,2014-11-15,memphis,@,Tulane,W (38-7),14,25,56.0,178,1,40,156,3.9,2,65,334,5.1,8,5,0,13,4,51,2,0,2
6355,11,2014-11-22,memphis,,South Florida,W (31-20),18,23,78.3,232,2,39,238,6.1,2,62,470,7.6,8,10,1,19,6,58,0,0,0
6356,12,2014-11-29,memphis,,Connecticut,W (41-10),22,41,53.7,194,4,44,178,4.0,1,85,372,4.4,10,12,6,28,4,40,0,0,0
6357,13,2014-12-22,memphis,N,Brigham Young*,W (55-48),24,46,52.2,306,4,51,174,3.4,3,97,480,4.9,15,8,1,24,6,43,2,3,5
6358,,13 Games,memphis,,,,262,418,62.7,3076,23,594,2476,4.2,31,1012,5552,5.5,149,118,27,294,81,765,11,9,20
6359,1,2015-09-05,memphis,,Missouri State,W (63-7),16,21,76.2,202,3,60,317,5.3,5,81,519,6.4,9,16,2,27,9,92,0,0,0
6360,2,2015-09-12,memphis,@,Kansas,W (55-23),24,27,88.9,370,2,52,281,5.4,5,79,651,8.2,0,0,0,34,7,58,3,0,3
6361,3,2015-09-19,memphis,@,Bowling Green State,W (44-41),29,40,72.5,386,3,50,155,3.1,2,90,541,6.0,14,11,3,28,7,78,0,0,0
6362,4,2015-09-24,memphis,,Cincinnati,W (53-46),24,36,66.7,412,2,37,158,4.3,4,73,570,7.8,16,6,0,22,9,100,1,0,1
6363,5,2015-10-02,memphis,@,South Florida,W (24-17),20,33,60.6,305,2,39,120,3.1,1,72,425,5.9,12,7,1,20,7,75,0,0,0
6364,6,2015-10-17,memphis,,Mississippi,W (37-24),39,53,73.6,384,3,41,107,2.6,1,94,491,5.2,21,7,3,31,10,80,0,1,1
6365,7,2015-10-23,memphis,@,Tulsa,W (66-42),32,44,72.7,447,4,52,257,4.9,5,96,704,7.3,18,11,6,35,12,120,1,0,1
6366,8,2015-10-31,memphis,,Tulane,W (41-13),27,44,61.4,358,1,39,223,5.7,3,83,581,7.0,16,16,0,32,8,106,0,0,0
6367,9,2015-11-07,memphis,,Navy,L (20-45),26,42,61.9,305,1,31,133,4.3,1,73,438,6.0,13,7,1,21,4,43,2,1,3
6368,10,2015-11-14,memphis,@,Houston,L (34-35),20,32,62.5,278,2,54,212,3.9,2,86,490,5.7,11,14,1,26,7,45,1,1,2
6369,11,2015-11-21,memphis,@,Temple,L (12-31),25,34,73.5,156,0,35,76,2.2,0,69,232,3.4,10,3,0,13,8,79,0,0,0
6370,12,2015-11-28,memphis,,Southern Methodist,W (63-0),13,22,59.1,288,7,42,195,4.6,0,64,483,7.5,10,8,2,20,5,60,1,1,2
6371,13,2015-12-30,memphis,N,Auburn*,L (10-31),16,37,43.2,106,0,31,99,3.2,0,68,205,3.0,6,5,2,13,6,40,0,1,1
6372,,13 Games,memphis,,,,311,465,66.9,3997,30,563,2333,4.1,29,1028,6330,6.2,156,111,21,322,99,976,9,5,14
6373,1,2016-09-03,memphis,,Southeast Missouri State,W (35-17),26,40,65.0,295,3,32,117,3.7,1,72,412,5.7,18,5,4,27,4,40,1,2,3
6374,2,2016-09-17,memphis,,Kansas,W (43-7),15,25,60.0,189,2,47,205,4.4,2,72,394,5.5,6,12,1,19,8,89,0,0,0
6375,3,2016-09-24,memphis,,Bowling Green State,W (77-3),23,32,71.9,395,6,45,240,5.3,4,77,635,8.2,13,9,3,25,9,85,0,0,0
6376,4,2016-10-01,memphis,@,Mississippi,L (28-48),31,47,66.0,355,0,31,119,3.8,4,78,474,6.1,16,7,4,27,7,52,1,3,4
6377,5,2016-10-06,memphis,,Temple,W (34-27),17,26,65.4,174,0,31,151,4.9,2,57,325,5.7,10,4,1,15,3,25,1,0,1
6378,6,2016-10-14,memphis,@,Tulane,W (24-14),21,34,61.8,236,1,33,163,4.9,1,67,399,6.0,7,8,1,16,7,79,2,1,3
6379,7,2016-10-22,memphis,@,Navy,L (28-42),25,40,62.5,333,2,31,98,3.2,1,71,431,6.1,18,6,0,24,3,25,1,0,1
6380,8,2016-10-29,memphis,,Tulsa,L (30-59),19,40,47.5,349,3,42,159,3.8,1,82,508,6.2,11,9,2,22,12,98,2,2,4
6381,9,2016-11-05,memphis,@,Southern Methodist,W (51-7),24,33,72.7,314,4,39,160,4.1,1,72,474,6.6,13,10,1,24,3,26,0,0,0
6382,10,2016-11-12,memphis,,South Florida,L (42-49),29,46,63.0,331,3,35,277,7.9,2,81,608,7.5,15,12,2,29,6,60,0,1,1
6383,11,2016-11-18,memphis,@,Cincinnati,W (34-7),16,20,80.0,159,2,53,172,3.2,2,73,331,4.5,10,9,1,20,5,45,1,0,1
6384,12,2016-11-25,memphis,,Houston,W (48-44),30,45,66.7,409,4,34,146,4.3,2,79,555,7.0,19,6,3,28,10,94,0,0,0
6385,13,2016-12-20,memphis,N,Western Kentucky*,L (31-51),27,49,55.1,418,4,32,73,2.3,0,81,491,6.1,18,5,4,27,5,53,2,1,3
6386,,13 Games,memphis,,,,303,477,63.5,3957,34,485,2080,4.3,23,962,6037,6.3,174,102,27,303,82,771,11,10,21
6387,1,2017-08-31,memphis,,Louisiana-Monroe,W (37-29),10,25,40.0,97,0,39,319,8.2,4,64,416,6.5,4,10,2,16,10,96,1,1,2
6388,2,2017-09-16,memphis,,UCLA,W (48-45),23,39,59.0,398,6,37,162,4.4,0,76,560,7.4,15,5,6,26,11,109,1,2,3
6389,3,2017-09-23,memphis,,Southern Illinois,W (44-31),22,36,61.1,288,2,36,176,4.9,2,72,464,6.4,15,8,1,24,8,90,0,0,0
6390,4,2017-09-30,memphis,@,Central Florida,L (13-40),27,49,55.1,321,1,24,75,3.1,1,73,396,5.4,14,6,5,25,3,20,1,3,4
6391,5,2017-10-06,memphis,@,Connecticut,W (70-31),39,55,70.9,480,8,45,231,5.1,2,100,711,7.1,21,12,1,34,12,104,0,0,0
6392,6,2017-10-14,memphis,,Navy,W (30-27),24,40,60.0,279,3,29,118,4.1,0,69,397,5.8,14,6,4,24,9,39,1,0,1
6393,7,2017-10-19,memphis,@,Houston,W (42-38),33,53,62.3,471,1,23,30,1.3,4,76,501,6.6,20,4,4,28,2,10,1,1,2
6394,8,2017-10-27,memphis,,Tulane,W (56-26),18,31,58.1,298,3,32,259,8.1,4,63,557,8.8,12,6,0,18,8,80,0,1,1
6395,9,2017-11-03,memphis,@,Tulsa,W (41-14),28,40,70.0,333,4,37,191,5.2,1,77,524,6.8,17,6,5,28,10,77,0,0,0
6396,10,2017-11-18,memphis,,Southern Methodist,W (66-45),22,28,78.6,331,2,46,333,7.2,7,74,664,9.0,16,15,1,32,11,132,0,1,1
6397,11,2017-11-25,memphis,,East Carolina,W (70-13),10,15,66.7,302,3,34,333,9.8,5,49,635,13.0,8,14,1,23,8,88,0,0,0
6398,12,2017-12-02,memphis,@,Central Florida,L (55-62),30,44,68.2,471,4,45,282,6.3,3,89,753,8.5,18,12,2,32,14,127,1,1,2
6399,13,2017-12-30,memphis,,Iowa State*,L (20-21),21,33,63.6,286,2,26,53,2.0,0,59,339,5.7,14,2,1,17,5,34,0,0,0
6400,,13 Games,memphis,,,,307,488,62.9,4355,39,453,2562,5.7,33,941,6917,7.4,188,106,33,327,111,1006,6,10,16
6401,1,2018-09-01,memphis,,Mercer,W (66-14),28,39,71.8,428,5,47,324,6.9,3,86,752,8.7,19,11,2,32,7,57,1,0,1
6402,2,2018-09-08,memphis,@,Navy,L (21-22),15,25,60.0,145,0,24,233,9.7,3,49,378,7.7,8,6,0,14,4,20,3,1,4
6403,3,2018-09-14,memphis,,Georgia State,W (59-22),19,27,70.4,269,5,35,410,11.7,3,62,679,11.0,14,13,0,27,10,79,0,1,1
6404,4,2018-09-22,memphis,,South Alabama,W (52-35),22,30,73.3,292,2,46,271,5.9,5,76,563,7.4,14,14,3,31,5,50,0,0,0
6405,5,2018-09-28,memphis,@,Tulane,L (24-40),14,30,46.7,246,2,21,31,1.5,1,51,277,5.4,8,2,3,13,4,20,0,0,0
6406,6,2018-10-06,memphis,,Connecticut,W (55-14),17,19,89.5,256,2,40,378,9.5,6,59,634,10.7,9,16,1,26,9,90,0,0,0
6407,7,2018-10-13,memphis,,Central Florida,L (30-31),17,29,58.6,209,0,52,281,5.4,3,81,490,6.0,10,14,3,27,7,43,2,0,2
6408,8,2018-10-20,memphis,@,Missouri,L (33-65),15,38,39.5,208,2,43,200,4.7,2,81,408,5.0,12,9,4,25,8,65,0,2,2
6409,9,2018-11-03,memphis,@,East Carolina,W (59-41),21,30,70.0,362,3,52,277,5.3,5,82,639,7.8,11,14,1,26,9,56,0,0,0
6410,10,2018-11-10,memphis,,Tulsa,W (47-21),16,23,69.6,202,2,55,297,5.4,3,78,499,6.4,10,14,2,26,8,79,1,0,1
6411,11,2018-11-16,memphis,@,Southern Methodist,W (28-18),18,31,58.1,226,2,43,208,4.8,2,74,434,5.9,12,7,2,21,12,143,0,2,2
6412,,11 Games,memphis,,,,202,321,62.9,2843,25,458,2910,6.4,36,779,5753,7.4,127,120,21,268,83,702,7,6,13
6413,1,2014-08-28,tulane,@,Tulsa,L (31-38),22,44,50.0,262,3,30,254,8.5,1,74,516,7.0,13,6,3,22,9,96,1,1,2
6414,2,2014-09-06,tulane,,Georgia Tech,L (21-38),17,35,48.6,231,2,25,96,3.8,1,60,327,5.5,10,6,1,17,10,69,0,3,3
6415,3,2014-09-13,tulane,,Southeastern Louisiana,W (35-20),14,30,46.7,238,3,40,122,3.1,2,70,360,5.1,10,5,6,21,12,115,1,2,3
6416,4,2014-09-20,tulane,@,Duke,L (13-47),14,36,38.9,160,0,58,231,4.0,2,94,391,4.2,7,17,4,28,13,92,1,4,5
6417,5,2014-09-27,tulane,@,Rutgers,L (6-31),18,29,62.1,152,0,31,152,4.9,1,60,304,5.1,4,7,2,13,7,62,0,0,0
6418,6,2014-10-11,tulane,,Connecticut,W (12-3),19,26,73.1,135,1,33,167,5.1,0,59,302,5.1,6,8,0,14,7,64,0,0,0
6419,7,2014-10-18,tulane,@,Central Florida,L (13-20),18,42,42.9,147,0,36,131,3.6,1,78,278,3.6,6,9,3,18,9,84,0,2,2
6420,8,2014-10-31,tulane,,Cincinnati,L (14-38),24,35,68.6,205,1,33,175,5.3,1,68,380,5.6,12,9,0,21,4,51,1,0,1
6421,9,2014-11-08,tulane,@,Houston,W (31-24),24,35,68.6,237,3,36,124,3.4,1,71,361,5.1,11,9,2,22,5,64,1,1,2
6422,10,2014-11-15,tulane,,Memphis,L (7-38),26,48,54.2,196,0,39,155,4.0,1,87,351,4.0,10,9,2,21,3,30,2,3,5
6423,11,2014-11-22,tulane,@,East Carolina,L (6-34),25,43,58.1,301,0,27,24,0.9,0,70,325,4.6,11,2,2,15,7,79,0,1,1
6424,12,2014-12-06,tulane,,Temple,L (3-10),19,40,47.5,151,0,31,115,3.7,0,71,266,3.7,5,6,3,14,4,35,0,1,1
6425,,12 Games,tulane,,,,240,443,54.2,2415,13,419,1746,4.2,11,862,4161,4.8,105,93,28,226,90,841,7,18,25
6426,1,2015-09-03,tulane,,Duke,L (7-37),24,42,57.1,246,1,23,25,1.1,0,65,271,4.2,8,3,3,14,5,25,0,1,1
6427,2,2015-09-12,tulane,@,Georgia Tech,L (10-65),15,33,45.5,177,1,33,71,2.2,0,66,248,3.8,9,8,1,18,4,34,1,1,2
6428,3,2015-09-19,tulane,,Maine,W (38-7),18,31,58.1,292,1,42,205,4.9,4,73,497,6.8,14,6,0,20,7,65,1,1,2
6429,4,2015-10-03,tulane,,Central Florida,W (45-31),17,29,58.6,225,5,44,170,3.9,1,73,395,5.4,7,8,2,17,7,67,1,0,1
6430,5,2015-10-10,tulane,@,Temple,L (10-49),17,30,56.7,102,1,27,8,0.3,0,57,110,1.9,5,2,1,8,9,102,0,2,2
6431,6,2015-10-16,tulane,,Houston,L (7-42),14,33,42.4,150,0,32,112,3.5,1,65,262,4.0,6,4,1,11,12,133,0,0,0
6432,7,2015-10-24,tulane,@,Navy,L (14-31),27,38,71.1,263,1,27,123,4.6,1,65,386,5.9,18,2,1,21,9,80,2,1,3
6433,8,2015-10-31,tulane,@,Memphis,L (13-41),10,24,41.7,131,0,42,139,3.3,2,66,270,4.1,6,8,3,17,6,50,0,0,0
6434,9,2015-11-07,tulane,,Connecticut,L (3-7),13,40,32.5,106,0,25,34,1.4,0,65,140,2.2,6,3,0,9,2,10,0,1,1
6435,10,2015-11-14,tulane,@,Army,W (34-31),14,29,48.3,252,2,28,115,4.1,1,57,367,6.4,11,7,0,18,2,10,0,1,1
6436,11,2015-11-21,tulane,@,Southern Methodist,L (21-49),13,33,39.4,128,2,33,200,6.1,1,66,328,5.0,7,8,2,17,4,40,0,0,0
6437,12,2015-11-27,tulane,,Tulsa,L (34-45),23,41,56.1,343,4,41,187,4.6,0,82,530,6.5,15,9,1,25,3,25,0,2,2
6438,,12 Games,tulane,,,,205,403,50.9,2415,18,397,1389,3.5,11,800,3804,4.8,112,68,15,195,70,641,5,10,15
6439,1,2016-09-01,tulane,@,Wake Forest,L (3-7),12,23,52.2,134,0,47,146,3.1,0,70,280,4.0,6,7,1,14,4,30,1,0,1
6440,2,2016-09-10,tulane,,Southern,W (66-21),2,6,33.3,12,0,57,437,7.7,7,63,449,7.1,0,20,2,22,4,35,0,1,1
6441,3,2016-09-17,tulane,,Navy,L (14-21),3,12,25.0,21,0,47,240,5.1,2,59,261,4.4,0,14,0,14,9,71,0,0,0
6442,4,2016-09-24,tulane,,Louisiana,W (41-39),13,26,50.0,181,4,48,130,2.7,0,74,311,4.2,7,7,0,14,6,40,0,1,1
6443,5,2016-10-01,tulane,@,Massachusetts,W (31-24),11,21,52.4,168,1,64,280,4.4,3,85,448,5.3,8,16,3,27,6,50,1,0,1
6444,6,2016-10-14,tulane,,Memphis,L (14-24),11,30,36.7,144,1,44,169,3.8,1,74,313,4.2,7,9,4,20,7,62,2,1,3
6445,7,2016-10-22,tulane,@,Tulsa,L (27-50),3,19,15.8,37,0,49,355,7.2,4,68,392,5.8,2,12,1,15,9,85,1,0,1
6446,8,2016-10-29,tulane,,Southern Methodist,L (31-35),13,26,50.0,164,2,46,227,4.9,2,72,391,5.4,7,9,2,18,10,100,0,1,1
6447,9,2016-11-05,tulane,@,Central Florida,L (6-37),5,21,23.8,68,0,64,280,4.4,1,85,348,4.1,3,16,3,22,6,65,2,3,5
6448,10,2016-11-12,tulane,@,Houston,L (18-30),21,42,50.0,241,2,36,100,2.8,0,78,341,4.4,11,5,1,17,5,33,1,0,1
6449,11,2016-11-19,tulane,,Temple,L (0-31),4,13,30.8,24,0,33,118,3.6,0,46,142,3.1,0,8,0,8,6,50,2,0,2
6450,12,2016-11-26,tulane,@,Connecticut,W (38-13),11,19,57.9,166,0,55,257,4.7,5,74,423,5.7,8,8,1,17,5,40,0,1,1
6451,,12 Games,tulane,,,,109,258,42.2,1360,10,590,2739,4.6,25,848,4099,4.8,59,131,18,208,77,661,10,8,18
6452,1,2017-09-02,tulane,,Grambling State,W (43-14),10,15,66.7,185,3,51,296,5.8,3,66,481,7.3,9,15,2,26,8,75,0,0,0
6453,2,2017-09-09,tulane,@,Navy,L (21-23),8,13,61.5,71,0,46,191,4.2,2,59,262,4.4,1,10,0,11,7,41,0,0,0
6454,3,2017-09-16,tulane,@,Oklahoma,L (14-56),6,12,50.0,54,0,62,237,3.8,2,74,291,3.9,3,16,1,20,2,20,1,1,2
6455,4,2017-09-23,tulane,,Army,W (21-17),10,22,45.5,103,0,30,253,8.4,3,52,356,6.8,5,8,2,15,6,59,0,0,0
6456,5,2017-10-07,tulane,,Tulsa,W (62-28),9,13,69.2,165,1,70,488,7.0,8,83,653,7.9,7,22,2,31,6,60,0,0,0
6457,6,2017-10-14,tulane,@,Florida International,L (10-23),5,16,31.3,36,0,40,203,5.1,1,56,239,4.3,1,14,3,18,1,15,1,1,2
6458,7,2017-10-21,tulane,,South Florida,L (28-34),9,19,47.4,221,2,47,194,4.1,2,66,415,6.3,8,12,3,23,12,137,0,1,1
6459,8,2017-10-27,tulane,@,Memphis,L (26-56),15,31,48.4,203,3,52,122,2.3,1,83,325,3.9,6,11,1,18,4,27,1,0,1
6460,9,2017-11-04,tulane,,Cincinnati,L (16-17),17,24,70.8,196,0,35,132,3.8,1,59,328,5.6,8,5,3,16,6,39,0,0,0
6461,10,2017-11-11,tulane,@,East Carolina,W (31-24),12,20,60.0,121,0,52,325,6.3,4,72,446,6.2,5,17,0,22,8,70,1,2,3
6462,11,2017-11-18,tulane,,Houston,W (20-17),17,25,68.0,251,1,47,166,3.5,1,72,417,5.8,12,11,0,23,5,42,0,1,1
6463,12,2017-11-25,tulane,@,Southern Methodist,L (38-41),18,31,58.1,314,2,43,171,4.0,3,74,485,6.6,13,12,2,27,5,40,1,0,1
6464,,12 Games,tulane,,,,136,241,56.4,1920,12,575,2778,4.8,31,816,4698,5.8,78,153,19,250,70,625,5,6,11
6465,1,2018-08-30,tulane,,Wake Forest,L (17-23),19,38,50.0,283,2,41,153,3.7,0,79,436,5.5,8,9,3,20,9,83,1,0,1
6466,2,2018-09-08,tulane,,Nicholls State,W (42-17),12,16,75.0,190,1,41,268,6.5,5,57,458,8.0,9,12,1,22,9,78,1,0,1
6467,3,2018-09-15,tulane,@,Alabama-Birmingham,L (24-31),7,26,26.9,180,2,40,175,4.4,1,66,355,5.4,6,8,3,17,2,25,2,1,3
6468,4,2018-09-22,tulane,@,Ohio State,L (6-49),10,16,62.5,156,0,41,107,2.6,1,57,263,4.6,8,5,1,14,6,55,0,0,0
6469,5,2018-09-28,tulane,,Memphis,W (40-24),13,22,59.1,178,1,56,318,5.7,4,78,496,6.4,9,13,0,22,9,95,0,0,0
6470,6,2018-10-06,tulane,@,Cincinnati,L (21-37),12,31,38.7,132,2,38,134,3.5,1,69,266,3.9,5,7,2,14,12,90,1,0,1
6471,7,2018-10-20,tulane,,Southern Methodist,L (23-27),14,22,63.6,153,0,46,168,3.7,2,68,321,4.7,7,10,1,18,10,96,2,1,3
6472,8,2018-10-27,tulane,@,Tulsa,W (24-17),10,19,52.6,92,0,55,312,5.7,3,74,404,5.5,5,9,3,17,8,70,1,0,1
6473,9,2018-11-03,tulane,@,South Florida,W (41-15),4,11,36.4,61,0,52,365,7.0,5,63,426,6.8,1,15,1,17,7,52,1,0,1
6474,10,2018-11-10,tulane,,East Carolina,W (24-18),12,28,42.9,372,3,49,163,3.3,0,77,535,6.9,10,7,0,17,8,93,1,0,1
6475,11,2018-11-15,tulane,@,Houston,L (17-48),10,24,41.7,147,0,43,212,4.9,2,67,359,5.4,6,12,0,18,5,43,1,3,4
6476,,11 Games,tulane,,,,123,253,48.6,1944,11,502,2375,4.7,24,755,4319,5.7,74,107,15,196,85,780,11,5,16
6477,1,2014-08-28,tulsa,,Tulane,W (38-31),31,53,58.5,438,4,36,154,4.3,0,89,592,6.7,20,7,3,30,9,90,0,2,2
6478,2,2014-09-06,tulsa,,Oklahoma,L (7-52),27,50,54.0,234,1,34,94,2.8,0,84,328,3.9,14,8,1,23,6,62,1,3,4
6479,3,2014-09-13,tulsa,@,Florida Atlantic,L (21-50),24,52,46.2,269,1,27,94,3.5,2,79,363,4.6,12,9,3,24,5,25,1,2,3
6480,4,2014-09-27,tulsa,,Texas State,L (34-37),23,40,57.5,234,2,56,200,3.6,2,96,434,4.5,10,13,2,25,4,34,0,1,1
6481,5,2014-10-04,tulsa,@,Colorado State,L (17-42),18,35,51.4,263,1,45,127,2.8,1,80,390,4.9,9,8,2,19,4,30,1,2,3
6482,6,2014-10-11,tulsa,@,Temple,L (24-35),21,36,58.3,260,2,50,178,3.6,1,86,438,5.1,12,11,1,24,8,108,0,0,0
6483,7,2014-10-18,tulsa,,South Florida,L (30-38),22,34,64.7,314,1,41,174,4.2,1,75,488,6.5,11,7,2,20,11,114,1,0,1
6484,8,2014-10-31,tulsa,@,Memphis,L (20-40),28,54,51.9,349,2,34,62,1.8,0,88,411,4.7,19,2,1,22,11,111,0,0,0
6485,9,2014-11-08,tulsa,,Southern Methodist,W (38-28),16,25,64.0,286,5,47,215,4.6,0,72,501,7.0,10,13,3,26,5,40,1,0,1
6486,10,2014-11-14,tulsa,@,Central Florida,L (7-31),10,29,34.5,72,1,27,129,4.8,0,56,201,3.6,4,7,0,11,6,64,0,3,3
6487,11,2014-11-22,tulsa,@,Houston,L (28-38),28,41,68.3,258,2,35,158,4.5,2,76,416,5.5,12,12,1,25,4,35,0,3,3
6488,12,2014-11-28,tulsa,,East Carolina,L (32-49),15,32,46.9,199,1,45,189,4.2,2,77,388,5.0,7,10,4,21,5,55,0,2,2
6489,,12 Games,tulsa,,,,263,481,54.7,3176,23,477,1774,3.7,11,958,4950,5.2,140,107,23,270,78,768,5,18,23
6490,1,2015-09-05,tulsa,,Florida Atlantic,W (47-44),21,35,60.0,424,2,51,194,3.8,4,86,618,7.2,14,13,4,31,4,26,2,2,4
6491,2,2015-09-12,tulsa,@,New Mexico,W (40-21),16,30,53.3,321,2,59,279,4.7,2,89,600,6.7,0,0,0,31,7,56,1,0,1
6492,3,2015-09-19,tulsa,@,Oklahoma,L (38-52),34,51,66.7,427,4,40,176,4.4,1,91,603,6.6,21,7,3,31,8,60,0,0,0
6493,4,2015-10-03,tulsa,,Houston,L (24-38),26,45,57.8,326,0,43,130,3.0,3,88,456,5.2,14,6,3,23,10,71,1,1,2
6494,5,2015-10-10,tulsa,,Louisiana-Monroe,W (34-24),28,45,62.2,341,2,62,222,3.6,2,107,563,5.3,16,13,2,31,10,82,0,0,0
6495,6,2015-10-17,tulsa,@,East Carolina,L (17-30),19,41,46.3,288,1,45,175,3.9,1,86,463,5.4,11,8,3,22,7,53,1,1,2
6496,7,2015-10-23,tulsa,,Memphis,L (42-66),24,36,66.7,421,4,45,113,2.5,2,81,534,6.6,13,8,6,27,11,76,2,1,3
6497,8,2015-10-31,tulsa,@,Southern Methodist,W (40-31),19,27,70.4,240,0,57,179,3.1,4,84,419,5.0,10,12,0,22,7,70,0,0,0
6498,9,2015-11-07,tulsa,,Central Florida,W (45-30),10,18,55.6,150,2,46,275,6.0,3,64,425,6.6,5,13,3,21,3,38,2,2,4
6499,10,2015-11-14,tulsa,@,Cincinnati,L (38-49),30,50,60.0,375,2,39,213,5.5,3,89,588,6.6,14,10,2,26,7,53,1,0,1
6500,11,2015-11-21,tulsa,,Navy,L (21-44),32,37,86.5,278,0,34,78,2.3,3,71,356,5.0,13,5,2,20,5,50,2,0,2
6501,12,2015-11-27,tulsa,@,Tulane,W (45-34),19,33,57.6,367,3,31,41,1.3,1,64,408,6.4,17,2,1,20,6,51,0,1,1
6502,13,2015-12-26,tulsa,N,Virginia Tech*,L (52-55),27,44,61.4,374,3,39,189,4.8,4,83,563,6.8,15,11,1,27,6,44,0,0,0
6503,,13 Games,tulsa,,,,305,492,62.0,4332,25,591,2264,3.8,33,1083,6596,6.1,163,108,30,332,91,730,12,8,20
6504,1,2016-09-03,tulsa,,San Jose State,W (45-10),13,25,52.0,207,1,58,305,5.3,3,83,512,6.2,9,19,0,28,2,25,0,0,0
6505,2,2016-09-10,tulsa,@,Ohio State,L (3-48),15,32,46.9,127,0,37,61,1.6,0,69,188,2.7,9,4,1,14,5,46,2,4,6
6506,3,2016-09-17,tulsa,,North Carolina A&T,W (58-21),25,39,64.1,358,4,38,136,3.6,2,77,494,6.4,16,8,4,28,6,60,1,1,2
6507,4,2016-09-24,tulsa,@,Fresno State,W (48-41),24,34,70.6,281,4,68,344,5.1,2,102,625,6.1,10,22,2,34,8,71,1,1,2
6508,5,2016-10-07,tulsa,,Southern Methodist,W (43-40),25,44,56.8,247,1,59,315,5.3,4,103,562,5.5,17,15,2,34,17,149,0,1,1
6509,6,2016-10-15,tulsa,@,Houston,L (31-38),27,51,52.9,365,1,35,94,2.7,3,86,459,5.3,18,6,3,27,5,25,1,1,2
6510,7,2016-10-22,tulsa,,Tulane,W (50-27),14,23,60.9,236,3,58,330,5.7,3,81,566,7.0,9,17,3,29,6,36,2,0,2
6511,8,2016-10-29,tulsa,@,Memphis,W (59-30),20,33,60.6,234,2,54,362,6.7,6,87,596,6.9,13,14,2,29,7,63,1,0,1
6512,9,2016-11-05,tulsa,,East Carolina,W (45-24),22,38,57.9,274,3,54,342,6.3,3,92,616,6.7,14,18,5,37,10,86,0,0,0
6513,10,2016-11-12,tulsa,@,Navy,L (40-42),16,27,59.3,369,4,38,207,5.4,1,65,576,8.9,13,10,0,23,3,35,0,1,1
6514,11,2016-11-19,tulsa,@,Central Florida,W (35-20),12,25,48.0,126,2,56,348,6.2,3,81,474,5.9,5,15,1,21,3,26,0,1,1
6515,12,2016-11-25,tulsa,,Cincinnati,W (40-37),25,39,64.1,305,3,65,306,4.7,2,104,611,5.9,18,14,3,35,3,37,1,2,3
6516,13,2016-12-19,tulsa,N,Central Michigan*,W (55-10),29,39,74.4,320,5,46,261,5.7,1,85,581,6.8,14,20,0,34,3,25,0,0,0
6517,,13 Games,tulsa,,,,267,449,59.5,3449,33,666,3411,5.1,33,1115,6860,6.2,165,182,26,373,78,684,9,12,21
6518,1,2017-08-31,tulsa,@,Oklahoma State,L (24-59),20,38,52.6,188,0,60,244,4.1,2,98,432,4.4,10,14,2,26,6,48,2,0,2
6519,2,2017-09-09,tulsa,,Louisiana,W (66-42),14,20,70.0,243,1,72,424,5.9,8,92,667,7.3,9,21,3,33,5,46,1,0,1
6520,3,2017-09-16,tulsa,@,Toledo,L (51-54),12,20,60.0,125,0,68,423,6.2,6,88,548,6.2,4,21,4,29,9,97,0,0,0
6521,4,2017-09-23,tulsa,,New Mexico,L (13-16),13,27,48.1,131,0,31,155,5.0,1,58,286,4.9,8,6,1,15,6,59,0,1,1
6522,5,2017-09-30,tulsa,,Navy,L (21-31),12,18,66.7,115,1,39,229,5.9,2,57,344,6.0,4,6,2,12,5,40,0,0,0
6523,6,2017-10-07,tulsa,@,Tulane,L (28-62),12,20,60.0,273,1,28,139,5.0,3,48,412,8.6,6,9,1,16,4,36,1,1,2
6524,7,2017-10-14,tulsa,,Houston,W (45-17),9,18,50.0,128,1,53,288,5.4,4,71,416,5.9,3,16,1,20,9,70,0,1,1
6525,8,2017-10-21,tulsa,@,Connecticut,L (14-20),17,28,60.7,259,0,44,194,4.4,2,72,453,6.3,11,9,3,23,5,47,0,1,1
6526,9,2017-10-27,tulsa,@,Southern Methodist,L (34-38),9,25,36.0,212,1,53,246,4.6,3,78,458,5.9,6,12,4,22,8,73,0,1,1
6527,10,2017-11-03,tulsa,,Memphis,L (14-41),18,31,58.1,157,0,35,145,4.1,2,66,302,4.6,7,8,2,17,14,103,0,1,1
6528,11,2017-11-16,tulsa,@,South Florida,L (20-27),14,28,50.0,191,0,55,166,3.0,2,83,357,4.3,7,13,2,22,7,46,0,0,0
6529,12,2017-11-25,tulsa,,Temple,L (22-43),6,19,31.6,55,1,54,314,5.8,1,73,369,5.1,2,18,5,25,6,55,1,2,3
6530,,12 Games,tulsa,,,,156,292,53.4,2077,6,592,2967,5.0,36,884,5044,5.7,77,153,30,260,84,720,5,8,13
6531,1,2018-09-01,tulsa,,Central Arkansas,W (38-27),15,24,62.5,196,2,63,274,4.3,3,87,470,5.4,6,18,1,25,9,92,1,0,1
6532,2,2018-09-08,tulsa,@,Texas,L (21-28),13,26,50.0,164,1,38,189,5.0,2,64,353,5.5,7,9,1,17,6,45,0,2,2
6533,3,2018-09-15,tulsa,,Arkansas State,L (20-29),19,27,70.4,172,1,42,167,4.0,1,69,339,4.9,7,10,2,19,8,64,2,1,3
6534,4,2018-09-20,tulsa,@,Temple,L (17-31),22,41,53.7,195,0,66,208,3.2,2,107,403,3.8,12,18,2,32,8,73,2,3,5
6535,5,2018-10-04,tulsa,@,Houston,L (26-41),13,31,41.9,227,1,57,199,3.5,1,88,426,4.8,8,11,0,19,9,85,2,1,3
6536,6,2018-10-12,tulsa,,South Florida,L (24-25),6,21,28.6,79,1,49,220,4.5,2,70,299,4.3,5,10,1,16,10,81,0,0,0
6537,7,2018-10-20,tulsa,@,Arkansas,L (0-23),8,25,32.0,127,0,40,133,3.3,0,65,260,4.0,5,9,1,15,4,43,1,1,2
6538,8,2018-10-27,tulsa,,Tulane,L (17-24),12,26,46.2,180,1,35,135,3.9,1,61,315,5.2,8,8,1,17,8,57,1,0,1
6539,9,2018-11-03,tulsa,,Connecticut,W (49-19),9,14,64.3,168,4,57,470,8.2,3,71,638,9.0,7,18,0,25,6,60,1,0,1
6540,10,2018-11-10,tulsa,@,Memphis,L (21-47),14,26,53.8,140,1,41,112,2.7,2,67,252,3.8,9,5,2,16,6,46,1,0,1
6541,11,2018-11-17,tulsa,@,Navy,L (29-37),19,28,67.9,206,0,44,164,3.7,4,72,370,5.1,11,10,1,22,7,75,1,1,2
6542,,11 Games,tulsa,,,,150,289,51.9,1854,12,532,2271,4.3,21,821,4125,5.0,85,126,12,223,81,721,12,9,21
6543,1,2014-09-01,louisville,,Miami (FL),W (31-13),20,28,71.4,206,2,43,130,3.0,1,71,336,4.7,10,11,0,21,7,57,2,0,2
6544,2,2014-09-06,louisville,,Murray State,W (66-21),25,39,64.1,278,3,49,325,6.6,6,88,603,6.9,13,15,3,31,3,19,0,0,0
6545,3,2014-09-13,louisville,@,Virginia,L (21-23),20,43,46.5,203,2,27,79,2.9,1,70,282,4.0,9,6,2,17,7,50,2,2,4
6546,4,2014-09-20,louisville,@,Florida International,W (34-3),20,36,55.6,324,2,35,12,0.3,1,71,336,4.7,9,6,1,16,7,36,2,0,2
6547,5,2014-09-27,louisville,,Wake Forest,W (20-10),16,32,50.0,206,0,49,215,4.4,2,81,421,5.2,9,11,1,21,11,89,3,0,3
6548,6,2014-10-03,louisville,@,Syracuse,W (28-6),12,22,54.5,174,1,48,178,3.7,2,70,352,5.0,6,11,1,18,9,75,1,1,2
6549,7,2014-10-11,louisville,@,Clemson,L (17-23),15,30,50.0,212,1,38,52,1.4,1,68,264,3.9,6,3,1,10,11,65,2,0,2
6550,8,2014-10-18,louisville,,North Carolina State,W (30-18),21,36,58.3,203,2,33,166,5.0,1,69,369,5.3,10,11,0,21,4,33,0,0,0
6551,9,2014-10-30,louisville,,Florida State,L (31-42),20,38,52.6,330,1,33,158,4.8,3,71,488,6.9,14,9,1,24,3,14,1,1,2
6552,10,2014-11-08,louisville,@,Boston College,W (38-19),17,24,70.8,257,2,40,166,4.2,3,64,423,6.6,10,9,2,21,10,87,1,0,1
6553,11,2014-11-22,louisville,@,Notre Dame,W (31-28),8,21,38.1,180,1,50,229,4.6,3,71,409,5.8,7,14,2,23,8,57,0,1,1
6554,12,2014-11-29,louisville,,Kentucky,W (44-40),22,35,62.9,389,3,39,83,2.1,3,74,472,6.4,16,4,2,22,3,15,2,2,4
6555,13,2014-12-30,louisville,N,Georgia*,L (14-37),21,44,47.7,314,1,27,62,2.3,1,71,376,5.3,14,6,0,20,7,44,0,3,3
6556,,13 Games,louisville,,,,237,428,55.4,3276,21,511,1855,3.6,28,939,5131,5.5,133,116,16,265,90,641,16,10,26
6557,1,2015-09-05,louisville,N,Auburn,L (24-31),17,33,51.5,167,0,48,238,5.0,3,81,405,5.0,9,17,1,27,5,35,1,1,2
6558,2,2015-09-12,louisville,,Houston,L (31-34),27,45,60.0,325,2,26,70,2.7,2,71,395,5.6,15,7,3,25,9,80,2,2,4
6559,3,2015-09-17,louisville,,Clemson,L (17-20),20,35,57.1,253,0,28,19,0.7,1,63,272,4.3,10,3,3,16,2,15,0,2,2
6560,4,2015-09-26,louisville,,Samford,W (45-3),18,28,64.3,274,2,46,288,6.3,4,74,562,7.6,13,12,0,25,9,89,0,2,2
6561,5,2015-10-03,louisville,@,North Carolina State,W (20-13),10,27,37.0,103,1,45,203,4.5,1,72,306,4.3,7,10,3,20,6,50,0,0,0
6562,6,2015-10-17,louisville,@,Florida State,L (21-41),20,35,57.1,307,3,30,99,3.3,0,65,406,6.2,13,6,1,20,9,84,1,1,2
6563,7,2015-10-24,louisville,,Boston College,W (17-14),15,26,57.7,230,0,48,135,2.8,1,74,365,4.9,10,8,0,18,8,49,2,2,4
6564,8,2015-10-30,louisville,@,Wake Forest,W (20-19),23,32,71.9,249,2,42,68,1.6,0,74,317,4.3,12,3,2,17,10,89,1,0,1
6565,9,2015-11-07,louisville,,Syracuse,W (41-17),24,36,66.7,362,3,31,217,7.0,1,67,579,8.6,12,11,0,23,9,84,3,1,4
6566,10,2015-11-14,louisville,,Virginia,W (38-31),11,22,50.0,159,2,37,266,7.2,3,59,425,7.2,9,11,3,23,5,53,2,0,2
6567,11,2015-11-21,louisville,@,Pittsburgh,L (34-45),20,38,52.6,355,3,24,-1,0.0,1,62,354,5.7,13,2,2,17,8,50,0,1,1
6568,12,2015-11-28,louisville,@,Kentucky,W (38-24),10,26,38.5,175,1,40,314,7.9,4,66,489,7.4,6,13,1,20,7,46,0,3,3
6569,13,2015-12-30,louisville,N,Texas A&M*,W (27-21),12,26,46.2,227,2,46,307,6.7,2,72,534,7.4,7,12,2,21,10,90,0,0,0
6570,,13 Games,louisville,,,,227,409,55.5,3186,21,491,2223,4.5,23,900,5409,6.0,136,115,21,272,97,814,12,15,27
6571,1,2016-09-01,louisville,,UNC Charlotte,W (70-14),26,35,74.3,391,8,35,272,7.8,2,70,663,9.5,20,14,4,38,10,49,2,1,3
6572,2,2016-09-09,louisville,@,Syracuse,W (62-28),21,40,52.5,431,1,41,414,10.1,7,81,845,10.4,16,13,1,30,9,100,2,1,3
6573,3,2016-09-17,louisville,,Florida State,W (63-20),13,20,65.0,216,1,46,314,6.8,7,66,530,8.0,8,13,3,24,5,56,0,1,1
6574,4,2016-09-24,louisville,@,Marshall,W (59-28),24,44,54.5,417,5,41,273,6.7,3,85,690,8.1,14,15,4,33,12,143,2,1,3
6575,5,2016-10-01,louisville,@,Clemson,L (36-42),27,44,61.4,295,1,55,273,5.0,3,99,568,5.7,12,16,3,31,11,104,2,1,3
6576,6,2016-10-14,louisville,,Duke,W (24-14),13,26,50.0,181,1,35,288,8.2,2,61,469,7.7,6,14,1,21,4,32,1,0,1
6577,7,2016-10-22,louisville,,North Carolina State,W (54-13),21,36,58.3,390,3,44,163,3.7,3,80,553,6.9,12,10,2,24,12,94,2,0,2
6578,8,2016-10-29,louisville,@,Virginia,W (32-25),24,41,58.5,361,4,34,147,4.3,0,75,508,6.8,16,10,1,27,7,68,1,1,2
6579,9,2016-11-05,louisville,@,Boston College,W (52-7),19,29,65.5,305,4,36,210,5.8,3,65,515,7.9,13,6,3,22,0,0,2,1,3
6580,10,2016-11-12,louisville,,Wake Forest,W (44-12),14,26,53.8,145,1,37,346,9.4,4,63,491,7.8,7,13,0,20,4,55,3,0,3
6581,11,2016-11-17,louisville,@,Houston,L (10-36),20,43,46.5,211,1,40,101,2.5,0,83,312,3.8,8,10,0,18,15,114,3,0,3
6582,12,2016-11-26,louisville,,Kentucky,L (38-41),16,25,64.0,281,2,46,280,6.1,3,71,561,7.9,12,14,0,26,4,48,1,3,4
6583,13,2016-12-31,louisville,N,Louisiana State*,L (9-29),10,27,37.0,153,0,35,67,1.9,0,62,220,3.5,6,4,1,11,8,56,1,0,1
6584,,13 Games,louisville,,,,248,436,56.9,3777,32,525,3148,6.0,37,961,6925,7.2,150,152,23,325,101,919,22,10,32
6585,1,2017-09-02,louisville,N,Purdue,W (35-28),30,46,65.2,378,2,33,146,4.4,1,79,524,6.6,16,8,3,27,16,110,3,0,3
6586,2,2017-09-09,louisville,@,North Carolina,W (47-35),25,39,64.1,393,3,44,312,7.1,3,83,705,8.5,18,15,2,35,6,61,0,0,0
6587,3,2017-09-16,louisville,,Clemson,L (21-47),21,42,50.0,317,3,27,116,4.3,0,69,433,6.3,13,7,1,21,4,35,0,1,1
6588,4,2017-09-23,louisville,,Kent State,W (42-3),23,30,76.7,374,2,27,165,6.1,3,57,539,9.5,12,9,2,23,4,30,2,2,4
6589,5,2017-09-30,louisville,,Murray State,W (55-10),32,45,71.1,364,4,46,312,6.8,3,91,676,7.4,18,16,4,38,7,69,2,0,2
6590,6,2017-10-05,louisville,@,North Carolina State,L (25-39),26,48,54.2,354,1,29,116,4.0,2,77,470,6.1,12,12,1,25,10,69,0,1,1
6591,7,2017-10-14,louisville,,Boston College,L (42-45),19,39,48.7,332,2,36,293,8.1,4,75,625,8.3,12,13,0,25,4,30,1,1,2
6592,8,2017-10-21,louisville,@,Florida State,W (31-28),13,21,61.9,156,1,44,293,6.7,3,65,449,6.9,7,14,1,22,2,13,1,0,1
6593,9,2017-10-28,louisville,@,Wake Forest,L (32-42),28,46,60.9,332,1,42,191,4.5,3,88,523,5.9,19,10,1,30,0,0,0,1,1
6594,10,2017-11-11,louisville,,Virginia,W (38-21),15,26,57.7,195,3,43,298,6.9,2,69,493,7.1,9,15,3,27,6,65,2,0,2
6595,11,2017-11-18,louisville,,Syracuse,W (56-10),17,30,56.7,316,3,42,411,9.8,5,72,727,10.1,12,15,0,27,11,85,0,0,0
6596,12,2017-11-25,louisville,@,Kentucky,W (44-17),15,21,71.4,216,2,43,346,8.0,3,64,562,8.8,11,16,5,32,6,55,0,0,0
6597,13,2017-12-30,louisville,N,Mississippi State*,L (27-31),13,31,41.9,171,2,39,187,4.8,1,70,358,5.1,9,7,4,20,6,42,0,4,4
6598,,13 Games,louisville,,,,277,464,59.7,3898,29,495,3186,6.4,33,959,7084,7.4,168,157,27,352,82,664,11,10,21
6599,1,2018-09-01,louisville,N,Alabama,L (14-51),20,39,51.3,252,2,25,27,1.1,0,64,279,4.4,13,1,5,19,11,93,0,2,2
6600,2,2018-09-08,louisville,,Indiana State,W (31-7),14,22,63.6,164,1,38,199,5.2,2,60,363,6.1,6,12,1,19,7,75,1,1,2
6601,3,2018-09-15,louisville,,Western Kentucky,W (20-17),10,21,47.6,88,0,38,204,5.4,2,59,292,4.9,4,11,2,17,5,40,0,1,1
6602,4,2018-09-22,louisville,@,Virginia,L (3-27),16,28,57.1,148,0,29,66,2.3,0,57,214,3.8,11,3,0,14,6,52,1,2,3
6603,5,2018-09-29,louisville,,Florida State,L (24-28),24,45,53.3,306,2,38,115,3.0,1,83,421,5.1,11,11,2,24,8,75,1,2,3
6604,6,2018-10-05,louisville,,Georgia Tech,L (31-66),27,44,61.4,370,3,23,113,4.9,1,67,483,7.2,14,7,2,23,4,35,2,1,3
6605,7,2018-10-13,louisville,@,Boston College,L (20-38),17,35,48.6,170,0,32,47,1.5,3,67,217,3.2,10,4,1,15,4,33,0,1,1
6606,8,2018-10-27,louisville,,Wake Forest,L (35-56),30,54,55.6,358,1,36,174,4.8,4,90,532,5.9,19,11,1,31,5,31,1,0,1
6607,9,2018-11-03,louisville,@,Clemson,L (16-77),17,34,50.0,231,0,36,81,2.3,1,70,312,4.5,8,8,0,16,10,100,1,2,3
6608,10,2018-11-09,louisville,@,Syracuse,L (23-54),14,31,45.2,210,1,39,203,5.2,2,70,413,5.9,7,9,2,18,17,125,2,2,4
6609,11,2018-11-17,louisville,,North Carolina State,L (10-52),13,25,52.0,157,0,38,254,6.7,1,63,411,6.5,8,11,0,19,12,68,1,1,2
6610,,11 Games,louisville,,,,202,378,53.4,2454,10,372,1483,4.0,17,750,3937,5.2,111,88,16,215,89,727,10,15,25
6611,1,2014-08-30,north-texas,@,Texas,L (7-38),3,17,17.6,15,0,43,79,1.8,0,60,94,1.6,0,6,2,8,6,56,0,4,4
6612,2,2014-09-06,north-texas,,Southern Methodist,W (43-6),12,17,70.6,108,0,55,245,4.5,3,72,353,4.9,6,11,0,17,15,166,0,0,0
6613,3,2014-09-11,north-texas,,Louisiana Tech,L (21-42),18,34,52.9,175,0,36,104,2.9,3,70,279,4.0,7,7,4,18,9,90,2,0,2
6614,4,2014-09-20,north-texas,,Nicholls State,W (77-3),13,17,76.5,202,3,38,324,8.5,5,55,526,9.6,7,13,0,20,5,40,1,0,1
6615,5,2014-10-04,north-texas,@,Indiana,L (24-49),18,34,52.9,205,3,35,143,4.1,0,69,348,5.0,9,12,1,22,2,10,0,2,2
6616,6,2014-10-11,north-texas,@,Alabama-Birmingham,L (21-56),20,36,55.6,291,2,43,160,3.7,1,79,451,5.7,12,12,0,24,3,30,3,2,5
6617,7,2014-10-18,north-texas,,Southern Mississippi,L (20-30),20,35,57.1,287,0,26,108,4.2,2,61,395,6.5,11,6,4,21,4,55,0,0,0
6618,8,2014-10-25,north-texas,@,Rice,L (21-41),16,34,47.1,190,1,33,26,0.8,1,67,216,3.2,7,6,3,16,4,40,1,1,2
6619,9,2014-11-08,north-texas,,Florida Atlantic,W (31-10),13,17,76.5,107,1,52,235,4.5,3,69,342,5.0,5,13,1,19,3,35,1,1,2
6620,10,2014-11-15,north-texas,@,Texas-El Paso,L (17-35),15,27,55.6,101,1,30,100,3.3,1,57,201,3.5,6,4,3,13,5,25,0,1,1
6621,11,2014-11-22,north-texas,,Florida International,W (17-14),9,20,45.0,105,1,44,161,3.7,1,64,266,4.2,5,8,3,16,2,30,0,2,2
6622,12,2014-11-29,north-texas,@,Texas-San Antonio,L (27-34),24,43,55.8,287,1,37,150,4.1,1,80,437,5.5,11,8,0,19,5,53,1,0,1
6623,,12 Games,north-texas,,,,181,331,54.7,2073,13,472,1835,3.9,21,803,3908,4.9,86,106,21,213,63,630,9,13,22
6624,1,2015-09-12,north-texas,@,Southern Methodist,L (13-31),16,34,47.1,128,0,33,112,3.4,1,67,240,3.6,7,7,3,17,7,73,2,2,4
6625,2,2015-09-19,north-texas,,Rice,L (24-38),19,35,54.3,303,2,27,175,6.5,1,62,478,7.7,13,6,1,20,4,45,2,1,3
6626,3,2015-09-26,north-texas,@,Iowa,L (16-62),17,43,39.5,173,1,45,183,4.1,0,88,356,4.0,8,14,0,22,8,62,1,2,3
6627,4,2015-10-03,north-texas,@,Southern Mississippi,L (14-49),14,32,43.8,201,1,49,185,3.8,1,81,386,4.8,7,14,5,26,5,40,0,1,1
6628,5,2015-10-10,north-texas,,Portland State,L (7-66),16,41,39.0,122,1,31,76,2.5,0,72,198,2.8,4,7,2,13,8,74,1,0,1
6629,6,2015-10-15,north-texas,,Western Kentucky,L (28-55),17,35,48.6,228,4,35,203,5.8,0,70,431,6.2,9,13,0,22,5,37,1,1,2
6630,7,2015-10-24,north-texas,@,Marshall,L (13-30),15,37,40.5,128,1,40,209,5.2,0,77,337,4.4,5,14,3,22,5,28,0,1,1
6631,8,2015-10-31,north-texas,,Texas-San Antonio,W (30-23),11,22,50.0,104,0,38,267,7.0,3,60,371,6.2,7,12,1,20,8,79,1,0,1
6632,9,2015-11-07,north-texas,@,Louisiana Tech,L (13-56),25,45,55.6,234,2,36,82,2.3,0,81,316,3.9,11,9,0,20,3,35,3,1,4
6633,10,2015-11-14,north-texas,@,Tennessee,L (0-24),13,26,50.0,107,0,32,92,2.9,0,58,199,3.4,8,6,0,14,5,35,0,0,0
6634,11,2015-11-21,north-texas,@,Middle Tennessee State,L (7-41),17,28,60.7,133,0,39,191,4.9,1,67,324,4.8,3,15,0,18,6,52,2,1,3
6635,12,2015-11-28,north-texas,,Texas-El Paso,L (17-20),10,29,34.5,76,0,31,129,4.2,0,60,205,3.4,1,8,1,10,10,120,1,1,2
6636,,12 Games,north-texas,,,,190,407,46.7,1937,12,436,1904,4.4,7,843,3841,4.6,83,125,16,224,74,680,14,11,25
6637,1,2016-09-03,north-texas,,Southern Methodist,L (21-34),32,50,64.0,311,2,29,83,2.9,1,79,394,5.0,20,5,1,26,6,68,0,3,3
6638,2,2016-09-10,north-texas,,Bethune-Cookman,W (41-20),15,33,45.5,121,0,51,329,6.5,4,84,450,5.4,7,18,3,28,4,48,0,1,1
6639,3,2016-09-17,north-texas,@,Florida,L (0-32),6,22,27.3,66,0,28,-13,-0.5,0,50,53,1.1,3,2,3,8,7,70,0,1,1
6640,4,2016-09-24,north-texas,@,Rice,W (42-35),17,29,58.6,224,1,42,215,5.1,5,71,439,6.2,9,8,2,19,10,70,1,0,1
6641,5,2016-10-01,north-texas,,Middle Tennessee State,L (13-30),33,54,61.1,303,1,22,5,0.2,1,76,308,4.1,11,3,2,16,9,90,0,0,0
6642,6,2016-10-08,north-texas,,Marshall,W (38-21),18,28,64.3,206,1,54,252,4.7,3,82,458,5.6,10,11,2,23,10,78,2,0,2
6643,7,2016-10-22,north-texas,@,Army,W (35-18),9,17,52.9,118,1,33,202,6.1,3,50,320,6.4,6,7,2,15,10,91,0,1,1
6644,8,2016-10-29,north-texas,@,Texas-San Antonio,L (17-31),27,38,71.1,257,1,34,152,4.5,1,72,409,5.7,12,8,2,22,2,25,2,2,4
6645,9,2016-11-05,north-texas,,Louisiana Tech,L (24-45),23,34,67.6,207,1,30,82,2.7,2,64,289,4.5,10,7,1,18,10,99,0,1,1
6646,10,2016-11-12,north-texas,@,Western Kentucky,L (7-45),17,33,51.5,117,0,20,115,5.8,1,53,232,4.4,4,3,0,7,8,66,1,1,2
6647,11,2016-11-19,north-texas,,Southern Mississippi,W (29-23),14,29,48.3,267,2,29,111,3.8,1,58,378,6.5,9,6,3,18,12,95,2,1,3
6648,12,2016-11-26,north-texas,@,Texas-El Paso,L (24-52),23,42,54.8,197,2,27,107,4.0,1,69,304,4.4,9,9,3,21,3,35,0,0,0
6649,13,2016-12-27,north-texas,N,Army*,L (31-38),27,40,67.5,314,3,27,96,3.6,1,67,410,6.1,11,7,1,19,6,55,0,2,2
6650,,13 Games,north-texas,,,,261,449,58.1,2708,15,426,1736,4.1,24,875,4444,5.1,121,94,25,240,97,890,8,13,21
6651,1,2017-09-02,north-texas,,Lamar,W (59-14),17,24,70.8,232,3,59,438,7.4,5,83,670,8.1,11,21,0,31,5,40,1,0,1
6652,2,2017-09-09,north-texas,@,Southern Methodist,L (32-54),32,47,68.1,424,3,27,69,2.6,1,74,493,6.7,17,4,1,22,7,58,1,2,3
6653,3,2017-09-16,north-texas,@,Iowa,L (14-31),18,29,62.1,193,1,17,112,6.6,1,46,305,6.6,10,5,2,17,13,119,1,1,2
6654,4,2017-09-23,north-texas,,Alabama-Birmingham,W (46-43),15,29,51.7,261,3,44,287,6.5,2,73,548,7.5,11,14,3,28,4,33,2,0,2
6655,5,2017-09-30,north-texas,@,Southern Mississippi,W (43-28),24,41,58.5,366,2,46,174,3.8,3,87,540,6.2,11,10,3,24,3,19,1,1,2
6656,6,2017-10-14,north-texas,,Texas-San Antonio,W (29-26),20,35,57.1,354,3,31,104,3.4,1,66,458,6.9,14,5,0,19,3,29,0,1,1
6657,7,2017-10-21,north-texas,@,Florida Atlantic,L (31-69),31,47,66.0,283,2,33,137,4.2,2,80,420,5.3,15,9,1,25,6,41,1,2,3
6658,8,2017-10-28,north-texas,,Old Dominion,W (45-38),25,36,69.4,309,1,41,151,3.7,4,77,460,6.0,15,8,1,24,3,45,1,1,2
6659,9,2017-11-04,north-texas,@,Louisiana Tech,W (24-23),23,37,62.2,211,1,41,204,5.0,2,78,415,5.3,10,15,1,26,4,45,0,1,1
6660,10,2017-11-11,north-texas,,Texas-El Paso,W (45-10),23,35,65.7,213,4,39,259,6.6,2,74,472,6.4,10,13,4,27,4,40,1,0,1
6661,11,2017-11-18,north-texas,,Army,W (52-49),24,36,66.7,386,4,33,103,3.1,3,69,489,7.1,13,9,3,25,1,1,0,1,1
6662,12,2017-11-25,north-texas,@,Rice,W (30-14),18,25,72.0,195,1,44,188,4.3,1,69,383,5.6,11,13,1,25,3,20,0,1,1
6663,13,2017-12-02,north-texas,@,Florida Atlantic,L (17-41),28,45,62.2,356,1,35,81,2.3,1,80,437,5.5,20,5,1,26,6,57,0,2,2
6664,14,2017-12-16,north-texas,N,Troy*,L (30-50),30,54,55.6,303,3,25,-8,-0.3,0,79,295,3.7,16,2,3,21,7,66,3,2,5
6665,,14 Games,north-texas,,,,328,520,63.1,4086,32,515,2299,4.5,28,1035,6385,6.2,184,133,24,340,69,613,12,15,27
6666,1,2018-09-01,north-texas,,Southern Methodist,W (46-23),41,51,80.4,461,3,43,68,1.6,0,94,529,5.6,27,5,2,34,5,40,0,0,0
6667,2,2018-09-08,north-texas,,Incarnate Word,W (58-16),32,49,65.3,454,4,42,153,3.6,3,91,607,6.7,19,9,4,32,5,61,0,1,1
6668,3,2018-09-15,north-texas,@,Arkansas,W (44-17),24,46,52.2,281,1,29,95,3.3,2,75,376,5.0,11,3,4,18,9,102,1,0,1
6669,4,2018-09-22,north-texas,@,Liberty,W (47-7),16,27,59.3,185,2,47,346,7.4,5,74,531,7.2,10,15,0,25,4,45,0,0,0
6670,5,2018-09-29,north-texas,,Louisiana Tech,L (27-29),22,35,62.9,296,3,37,131,3.5,1,72,427,5.9,13,9,1,23,4,55,2,0,2
6671,6,2018-10-06,north-texas,@,Texas-El Paso,W (27-24),23,34,67.6,294,2,35,134,3.8,1,69,428,6.2,12,8,1,21,3,40,0,0,0
6672,7,2018-10-13,north-texas,,Southern Mississippi,W (30-7),24,38,63.2,292,1,33,165,5.0,3,71,457,6.4,13,10,1,24,5,55,1,0,1
6673,8,2018-10-20,north-texas,@,Alabama-Birmingham,L (21-29),29,40,72.5,336,3,23,64,2.8,0,63,400,6.3,16,3,5,24,4,50,1,0,1
6674,9,2018-10-27,north-texas,,Rice,W (41-17),18,35,51.4,333,2,24,164,6.8,3,59,497,8.4,13,9,5,27,2,16,2,0,2
6675,10,2018-11-10,north-texas,@,Old Dominion,L (31-34),26,44,59.1,240,2,38,155,4.1,2,82,395,4.8,12,9,2,23,4,60,1,1,2
6676,11,2018-11-15,north-texas,,Florida Atlantic,W (41-38),23,35,65.7,303,2,37,208,5.6,3,72,511,7.1,14,8,3,25,4,40,0,2,2
6677,,11 Games,north-texas,,,,278,434,64.1,3475,25,388,1683,4.3,23,822,5158,6.3,160,88,28,276,49,564,8,4,12
6678,1,2014-09-12,cincinnati,,Toledo,W (58-34),29,42,69.0,436,6,30,148,4.9,2,72,584,8.1,21,6,1,28,2,30,0,0,0
6679,2,2014-09-20,cincinnati,N,Miami (OH),W (31-24),25,39,64.1,271,4,30,99,3.3,0,69,370,5.4,13,7,2,22,4,30,0,2,2
6680,3,2014-09-27,cincinnati,@,Ohio State,L (28-50),21,33,63.6,352,4,19,70,3.7,0,52,422,8.1,10,5,0,15,6,40,0,0,0
6681,4,2014-10-04,cincinnati,N,Memphis,L (14-41),16,40,40.0,255,1,25,97,3.9,1,65,352,5.4,13,4,2,19,6,55,1,1,2
6682,5,2014-10-11,cincinnati,@,Miami (FL),L (34-55),31,60,51.7,355,3,29,67,2.3,0,89,422,4.7,17,5,4,26,5,54,0,3,3
6683,6,2014-10-18,cincinnati,@,Southern Methodist,W (41-3),17,27,63.0,268,1,46,240,5.2,3,73,508,7.0,12,14,3,29,6,69,0,0,0
6684,7,2014-10-24,cincinnati,N,South Florida,W (34-17),27,37,73.0,317,1,50,273,5.5,3,87,590,6.8,16,12,3,31,4,37,3,0,3
6685,8,2014-10-31,cincinnati,@,Tulane,W (38-14),17,26,65.4,214,3,35,265,7.6,1,61,479,7.9,11,8,2,21,5,35,1,2,3
6686,9,2014-11-13,cincinnati,N,East Carolina,W (54-46),29,45,64.4,436,4,33,150,4.5,2,78,586,7.5,19,9,1,29,8,64,1,3,4
6687,10,2014-11-22,cincinnati,@,Connecticut,W (41-0),20,36,55.6,176,3,48,249,5.2,2,84,425,5.1,10,13,1,24,2,25,0,1,1
6688,11,2014-11-29,cincinnati,@,Temple,W (14-6),19,31,61.3,174,1,33,81,2.5,1,64,255,4.0,9,4,1,14,3,20,1,0,1
6689,12,2014-12-06,cincinnati,N,Houston,W (38-31),25,38,65.8,348,2,43,152,3.5,3,81,500,6.2,20,11,2,33,1,10,0,0,0
6690,13,2014-12-27,cincinnati,N,Virginia Tech*,L (17-33),18,37,48.6,345,2,33,144,4.4,0,70,489,7.0,14,5,0,19,7,73,1,2,3
6691,,13 Games,cincinnati,,,,294,491,59.9,3947,35,454,2035,4.5,18,945,5982,6.3,185,103,22,310,59,542,8,14,22
6692,1,2015-09-05,cincinnati,,Alabama A&M,W (52-10),26,38,68.4,340,3,51,296,5.8,4,89,636,7.1,17,14,3,34,8,79,2,0,2
6693,2,2015-09-12,cincinnati,,Temple,L (26-34),30,52,57.7,427,2,31,130,4.2,1,83,557,6.7,21,8,5,34,5,51,1,4,5
6694,3,2015-09-19,cincinnati,@,Miami (OH),W (37-33),22,40,55.0,263,1,54,282,5.2,3,94,545,5.8,15,15,3,33,7,55,2,2,4
6695,4,2015-09-24,cincinnati,@,Memphis,L (46-53),38,64,59.4,620,4,36,132,3.7,1,100,752,7.5,27,8,3,38,11,101,0,3,3
6696,5,2015-10-01,cincinnati,,Miami (FL),W (34-23),22,33,66.7,279,2,34,167,4.9,2,67,446,6.7,13,9,0,22,7,75,0,1,1
6697,6,2015-10-16,cincinnati,@,Brigham Young,L (24-38),16,31,51.6,220,1,46,121,2.6,2,77,341,4.4,13,6,2,21,9,65,0,0,0
6698,7,2015-10-24,cincinnati,,Connecticut,W (37-13),26,35,74.3,327,2,49,285,5.8,2,84,612,7.3,14,14,0,28,10,105,1,0,1
6699,8,2015-10-31,cincinnati,,Central Florida,W (52-7),27,32,84.4,489,6,42,237,5.6,1,74,726,9.8,17,11,5,33,7,62,0,1,1
6700,9,2015-11-07,cincinnati,@,Houston,L (30-33),28,51,54.9,523,4,18,66,3.7,0,69,589,8.5,20,3,1,24,11,85,1,2,3
6701,10,2015-11-14,cincinnati,,Tulsa,W (49-38),29,42,69.0,386,2,41,266,6.5,5,83,652,7.9,21,11,1,33,10,68,2,1,3
6702,11,2015-11-20,cincinnati,@,South Florida,L (27-65),28,51,54.9,333,1,35,97,2.8,2,86,430,5.0,14,10,1,25,4,42,2,4,6
6703,12,2015-11-28,cincinnati,@,East Carolina,W (19-16),30,47,63.8,270,1,43,157,3.7,1,90,427,4.7,16,12,2,30,5,50,0,1,1
6704,13,2015-12-24,cincinnati,N,San Diego State*,L (7-42),19,31,61.3,202,0,32,77,2.4,1,63,279,4.4,9,5,1,15,10,110,0,3,3
6705,,13 Games,cincinnati,,,,341,547,62.3,4679,29,512,2313,4.5,25,1059,6992,6.6,217,126,27,370,104,948,11,22,33
6706,1,2016-09-01,cincinnati,,Tennessee-Martin,W (28-7),21,34,61.8,260,2,34,140,4.1,1,68,400,5.9,13,8,1,22,5,60,2,1,3
6707,2,2016-09-10,cincinnati,@,Purdue,W (38-20),19,32,59.4,250,3,46,262,5.7,2,78,512,6.6,12,9,1,22,5,45,0,0,0
6708,3,2016-09-15,cincinnati,,Houston,L (16-40),22,39,56.4,277,2,25,30,1.2,0,64,307,4.8,11,1,1,13,2,15,0,3,3
6709,4,2016-09-24,cincinnati,,Miami (OH),W (27-20),25,38,65.8,276,0,48,187,3.9,3,86,463,5.4,15,12,1,28,5,60,1,2,3
6710,5,2016-10-01,cincinnati,,South Florida,L (20-45),23,41,56.1,263,1,35,130,3.7,2,76,393,5.2,11,8,2,21,4,40,1,3,4
6711,6,2016-10-08,cincinnati,@,Connecticut,L (9-20),29,56,51.8,315,0,22,2,0.1,0,78,317,4.1,18,2,2,22,5,57,0,1,1
6712,7,2016-10-22,cincinnati,,East Carolina,W (31-19),23,40,57.5,348,4,35,165,4.7,0,75,513,6.8,11,12,2,25,9,82,0,0,0
6713,8,2016-10-29,cincinnati,@,Temple,L (13-34),15,27,55.6,119,2,22,67,3.0,0,49,186,3.8,8,2,0,10,4,35,2,0,2
6714,9,2016-11-05,cincinnati,,Brigham Young,L (3-20),19,32,59.4,199,0,25,96,3.8,0,57,295,5.2,12,4,0,16,4,40,0,1,1
6715,10,2016-11-12,cincinnati,@,Central Florida,L (3-24),19,42,45.2,220,0,36,107,3.0,0,78,327,4.2,11,6,1,18,2,15,1,2,3
6716,11,2016-11-18,cincinnati,,Memphis,L (7-34),23,34,67.6,144,1,35,100,2.9,0,69,244,3.5,9,7,1,17,5,52,1,2,3
6717,12,2016-11-25,cincinnati,@,Tulsa,L (37-40),21,38,55.3,400,4,33,134,4.1,0,71,534,7.5,12,5,1,18,5,43,0,0,0
6718,,12 Games,cincinnati,,,,259,453,57.2,3071,19,396,1420,3.6,8,849,4491,5.3,143,76,13,232,55,544,8,15,23
6719,1,2017-08-31,cincinnati,,Austin Peay,W (26-14),17,28,60.7,151,3,29,97,3.3,1,57,248,4.4,7,6,2,15,7,70,0,0,0
6720,2,2017-09-09,cincinnati,@,Michigan,L (14-36),15,40,37.5,132,1,30,68,2.3,1,70,200,2.9,6,4,3,13,4,30,0,2,2
6721,3,2017-09-16,cincinnati,@,Miami (OH),W (21-17),24,43,55.8,222,1,35,139,4.0,0,78,361,4.6,10,8,3,21,6,56,0,2,2
6722,4,2017-09-23,cincinnati,@,Navy,L (32-42),28,46,60.9,381,3,23,58,2.5,1,69,439,6.4,19,3,0,22,6,60,1,0,1
6723,5,2017-09-30,cincinnati,,Marshall,L (21-38),22,45,48.9,211,1,26,138,5.3,2,71,349,4.9,9,7,5,21,7,78,3,0,3
6724,6,2017-10-07,cincinnati,,Central Florida,L (23-51),23,40,57.5,278,1,26,113,4.3,2,66,391,5.9,13,6,2,21,9,74,0,1,1
6725,7,2017-10-14,cincinnati,@,South Florida,L (3-33),21,37,56.8,178,0,33,95,2.9,0,70,273,3.9,9,7,5,21,11,98,1,1,2
6726,8,2017-10-21,cincinnati,,Southern Methodist,L (28-31),22,35,62.9,189,2,42,249,5.9,1,77,438,5.7,11,14,1,26,6,46,1,1,2
6727,9,2017-11-04,cincinnati,@,Tulane,W (17-16),18,27,66.7,248,1,35,208,5.9,1,62,456,7.4,11,8,0,19,12,123,0,0,0
6728,10,2017-11-10,cincinnati,,Temple,L (24-35),21,37,56.8,221,2,35,184,5.3,1,72,405,5.6,8,10,3,21,11,107,1,0,1
6729,11,2017-11-18,cincinnati,@,East Carolina,L (20-48),15,28,53.6,187,3,31,139,4.5,0,59,326,5.5,6,11,0,17,10,90,0,1,1
6730,12,2017-11-25,cincinnati,,Connecticut,W (22-21),19,28,67.9,199,2,26,136,5.2,1,54,335,6.2,11,8,0,19,5,44,0,1,1
6731,,12 Games,cincinnati,,,,245,434,56.5,2597,20,371,1624,4.4,11,805,4221,5.2,120,92,24,236,94,876,7,9,16
6732,1,2018-09-01,cincinnati,@,UCLA,W (26-17),14,26,53.8,110,0,51,194,3.8,3,77,304,3.9,7,11,0,18,7,45,1,0,1
6733,2,2018-09-08,cincinnati,@,Miami (OH),W (21-0),6,11,54.5,45,1,51,188,3.7,2,62,233,3.8,3,9,1,13,8,86,0,0,0
6734,3,2018-09-15,cincinnati,,Alabama A&M,W (63-7),21,26,80.8,332,3,55,409,7.4,5,81,741,9.1,12,26,0,38,7,75,0,1,1
6735,4,2018-09-22,cincinnati,,Ohio,W (34-30),19,31,61.3,274,2,34,150,4.4,3,65,424,6.5,12,10,2,24,14,150,0,1,1
6736,5,2018-09-29,cincinnati,@,Connecticut,W (49-7),23,29,79.3,339,2,53,320,6.0,5,82,659,8.0,18,13,0,31,11,113,1,0,1
6737,6,2018-10-06,cincinnati,,Tulane,W (37-21),15,25,60.0,174,2,48,272,5.7,3,73,446,6.1,8,10,4,22,7,65,2,1,3
6738,7,2018-10-20,cincinnati,@,Temple,L (17-24),14,34,41.2,111,0,47,200,4.3,2,81,311,3.8,8,11,1,20,7,65,2,1,3
6739,8,2018-10-27,cincinnati,@,Southern Methodist,W (26-20),33,50,66.0,352,2,39,125,3.2,0,89,477,5.4,15,9,1,25,6,51,1,2,3
6740,9,2018-11-03,cincinnati,,Navy,W (42-0),14,20,70.0,189,2,41,262,6.4,4,61,451,7.4,8,14,0,22,4,30,0,0,0
6741,10,2018-11-10,cincinnati,,South Florida,W (35-23),17,24,70.8,194,2,52,238,4.6,3,76,432,5.7,8,14,2,24,5,22,2,0,2
6742,11,2018-11-17,cincinnati,@,Central Florida,L (13-38),11,26,42.3,127,0,55,252,4.6,1,81,379,4.7,6,13,1,20,9,70,3,0,3
6743,,11 Games,cincinnati,,,,187,302,61.9,2247,16,526,2610,5.0,31,828,4857,5.9,105,140,12,257,85,772,12,6,18
6744,1,2014-08-30,penn-state,N,Central Florida,W (26-24),32,47,68.1,454,1,28,57,2.0,1,75,511,6.8,14,7,3,24,9,90,1,2,3
6745,2,2014-09-06,penn-state,,Akron,W (21-3),22,37,59.5,319,3,31,106,3.4,0,68,425,6.3,16,7,4,27,3,25,1,2,3
6746,3,2014-09-13,penn-state,@,Rutgers,W (13-10),25,44,56.8,309,0,33,64,1.9,1,77,373,4.8,13,4,2,19,5,40,0,1,1
6747,4,2014-09-20,penn-state,,Massachusetts,W (48-7),18,32,56.3,236,1,45,228,5.1,5,77,464,6.0,11,11,1,23,6,52,0,0,0
6748,5,2014-09-27,penn-state,,Northwestern,L (6-29),22,46,47.8,216,0,25,50,2.0,0,71,266,3.7,9,3,2,14,4,35,1,1,2
6749,6,2014-10-11,penn-state,@,Michigan,L (13-18),21,33,63.6,160,1,35,54,1.5,0,68,214,3.1,8,7,1,16,5,23,0,1,1
6750,7,2014-10-25,penn-state,,Ohio State,L (24-31),31,50,62.0,224,1,31,16,0.5,1,81,240,3.0,11,5,4,20,4,42,0,2,2
6751,8,2014-11-01,penn-state,,Maryland,L (19-20),18,42,42.9,177,1,41,42,1.0,0,83,219,2.6,10,4,2,16,8,64,3,1,4
6752,9,2014-11-08,penn-state,@,Indiana,W (13-7),12,29,41.4,168,0,37,162,4.4,1,66,330,5.0,7,6,2,15,7,55,0,2,2
6753,10,2014-11-15,penn-state,,Temple,W (30-13),12,26,46.2,112,0,47,254,5.4,2,73,366,5.0,5,13,1,19,5,45,1,2,3
6754,11,2014-11-22,penn-state,@,Illinois,L (14-16),8,16,50.0,93,1,47,172,3.7,1,63,265,4.2,5,8,2,15,5,34,1,0,1
6755,12,2014-11-29,penn-state,,Michigan State,L (10-34),21,45,46.7,195,0,22,38,1.7,1,67,233,3.5,11,4,1,16,4,35,1,1,2
6756,13,2014-12-27,penn-state,N,Boston College*,W (31-30),34,50,68.0,371,4,29,82,2.8,0,79,453,5.7,17,5,3,25,10,60,2,0,2
6757,,13 Games,penn-state,,,,276,497,55.5,3034,13,451,1325,2.9,13,948,4359,4.6,137,84,28,249,75,600,11,15,26
6758,1,2015-09-05,penn-state,@,Temple,L (10-27),11,25,44.0,103,0,27,77,2.9,1,52,180,3.5,4,4,1,9,6,39,0,1,1
6759,2,2015-09-12,penn-state,,Buffalo,W (27-14),14,27,51.9,128,1,39,200,5.1,2,66,328,5.0,5,9,1,15,7,65,0,0,0
6760,3,2015-09-19,penn-state,,Rutgers,W (28-3),10,19,52.6,141,0,41,330,8.0,4,60,471,7.9,4,13,0,17,8,80,0,1,1
6761,4,2015-09-26,penn-state,,San Diego State,W (37-21),22,36,61.1,328,3,34,72,2.1,0,70,400,5.7,14,2,3,19,5,37,1,0,1
6762,5,2015-10-03,penn-state,,Army,W (20-14),10,19,52.6,156,1,34,108,3.2,1,53,264,5.0,5,7,0,12,3,20,0,0,0
6763,6,2015-10-10,penn-state,,Indiana,W (29-7),22,40,55.0,266,2,32,154,4.8,2,72,420,5.8,14,5,3,22,3,30,1,0,1
6764,7,2015-10-17,penn-state,@,Ohio State,L (10-38),7,13,53.8,120,1,40,195,4.9,0,53,315,5.9,2,8,4,14,3,22,1,0,1
6765,8,2015-10-24,penn-state,N,Maryland,W (31-30),13,30,43.3,315,3,31,48,1.5,1,61,363,6.0,11,4,1,16,6,39,3,0,3
6766,9,2015-10-31,penn-state,,Illinois,W (39-0),22,33,66.7,280,3,37,120,3.2,2,70,400,5.7,12,9,2,23,3,25,2,0,2
6767,10,2015-11-07,penn-state,@,Northwestern,L (21-23),22,41,53.7,237,1,30,125,4.2,2,71,362,5.1,8,6,3,17,9,70,1,1,2
6768,11,2015-11-21,penn-state,,Michigan,L (16-28),13,32,40.6,137,1,22,70,3.2,0,54,207,3.8,4,4,6,14,3,30,1,0,1
6769,12,2015-11-28,penn-state,@,Michigan State,L (16-55),27,47,57.4,296,2,25,122,4.9,0,72,418,5.8,10,9,1,20,6,45,2,2,4
6770,13,2016-01-02,penn-state,N,Georgia*,L (17-24),22,42,52.4,281,2,32,120,3.8,0,74,401,5.4,12,3,1,16,6,39,0,1,1
6771,,13 Games,penn-state,,,,215,404,53.2,2788,20,424,1741,4.1,15,828,4529,5.5,105,83,26,214,68,541,12,6,18
6772,1,2016-09-03,penn-state,,Kent State,W (33-13),16,31,51.6,209,2,38,145,3.8,1,69,354,5.1,9,9,1,19,5,55,1,0,1
6773,2,2016-09-10,penn-state,@,Pittsburgh,L (39-42),24,35,68.6,332,1,31,74,2.4,4,66,406,6.2,12,6,2,20,4,35,3,1,4
6774,3,2016-09-17,penn-state,,Temple,W (34-27),18,24,75.0,287,1,37,116,3.1,3,61,403,6.6,8,8,5,21,7,62,2,1,3
6775,4,2016-09-24,penn-state,@,Michigan,L (10-49),16,27,59.3,121,1,28,70,2.5,0,55,191,3.5,6,3,3,12,2,13,1,1,2
6776,5,2016-10-01,penn-state,,Minnesota,W (29-26),19,42,45.2,335,1,28,136,4.9,2,70,471,6.7,8,7,4,19,5,65,0,0,0
6777,6,2016-10-08,penn-state,,Maryland,W (38-14),10,19,52.6,152,2,62,372,6.0,3,81,524,6.5,5,21,2,28,6,45,1,0,1
6778,7,2016-10-22,penn-state,,Ohio State,W (24-21),8,23,34.8,154,1,33,165,5.0,1,56,319,5.7,6,6,1,13,1,5,1,0,1
6779,8,2016-10-29,penn-state,@,Purdue,W (62-24),13,25,52.0,254,3,38,257,6.8,5,63,511,8.1,10,11,3,24,11,91,0,0,0
6780,9,2016-11-05,penn-state,,Iowa,W (41-14),11,18,61.1,240,2,52,359,6.9,3,70,599,8.6,9,15,0,24,9,86,0,0,0
6781,10,2016-11-12,penn-state,@,Indiana,W (45-31),16,30,53.3,332,2,45,77,1.7,3,75,409,5.5,11,5,2,18,5,40,0,2,2
6782,11,2016-11-19,penn-state,@,Rutgers,W (39-0),17,33,51.5,210,1,49,339,6.9,3,82,549,6.7,8,16,1,25,3,15,1,0,1
6783,12,2016-11-26,penn-state,,Michigan State,W (45-12),18,24,75.0,386,4,33,77,2.3,2,57,463,8.1,14,4,0,18,1,15,0,0,0
6784,13,2016-12-03,penn-state,N,Wisconsin,W (38-31),22,31,71.0,384,4,29,51,1.8,1,60,435,7.3,16,3,2,21,3,25,2,0,2
6785,14,2017-01-02,penn-state,N,Southern California*,L (49-52),18,29,62.1,254,4,33,211,6.4,3,62,465,7.5,12,8,3,23,5,65,0,3,3
6786,,14 Games,penn-state,,,,226,391,57.8,3650,29,536,2449,4.6,34,927,6099,6.6,134,122,29,285,67,617,12,8,20
6787,1,2017-09-02,penn-state,,Akron,W (52-0),21,31,67.7,322,2,34,247,7.3,4,65,569,8.8,14,7,3,24,5,45,0,1,1
6788,2,2017-09-09,penn-state,,Pittsburgh,W (33-14),15,28,53.6,164,3,24,148,6.2,1,52,312,6.0,7,6,1,14,1,15,0,1,1
6789,3,2017-09-16,penn-state,,Georgia State,W (56-0),21,29,72.4,360,5,24,166,6.9,3,53,526,9.9,11,8,0,19,5,45,0,0,0
6790,4,2017-09-23,penn-state,@,Iowa,W (21-19),31,48,64.6,284,1,51,295,5.8,1,99,579,5.8,14,15,0,29,8,90,1,1,2
6791,5,2017-09-30,penn-state,,Indiana,W (45-14),24,37,64.9,331,3,37,39,1.1,1,74,370,5.0,15,4,1,20,2,7,0,1,1
6792,6,2017-10-07,penn-state,@,Northwestern,W (31-7),29,41,70.7,286,1,38,95,2.5,3,79,381,4.8,14,6,3,23,3,30,0,0,0
6793,7,2017-10-21,penn-state,,Michigan,W (42-13),17,26,65.4,282,1,35,224,6.4,5,61,506,8.3,12,10,3,25,1,10,0,1,1
6794,8,2017-10-28,penn-state,@,Ohio State,L (38-39),17,29,58.6,192,2,35,91,2.6,2,64,283,4.4,9,5,3,17,9,73,0,0,0
6795,9,2017-11-04,penn-state,@,Michigan State,L (24-27),27,48,56.3,401,3,21,65,3.1,0,69,466,6.8,17,4,1,22,7,86,0,3,3
6796,10,2017-11-11,penn-state,,Rutgers,W (35-6),16,21,76.2,214,2,31,90,2.9,3,52,304,5.8,11,6,1,18,4,20,0,0,0
6797,11,2017-11-18,penn-state,,Nebraska,W (56-44),26,39,66.7,346,4,35,263,7.5,4,74,609,8.2,18,9,5,32,5,39,1,0,1
6798,12,2017-11-25,penn-state,@,Maryland,W (66-3),25,40,62.5,248,3,48,286,6.0,6,88,534,6.1,12,13,3,28,2,10,0,0,0
6799,13,2017-12-30,penn-state,N,Washington*,W (35-28),32,41,78.0,342,2,38,203,5.3,3,79,545,6.9,18,6,1,25,2,20,1,2,3
6800,,13 Games,penn-state,,,,301,458,65.7,3772,32,451,2212,4.9,36,909,5984,6.6,172,99,25,296,54,490,3,10,13
6801,1,2018-09-01,penn-state,,Appalachian State,W (45-38),21,36,58.3,230,1,43,204,4.7,5,79,434,5.5,11,10,3,24,2,10,0,0,0
6802,2,2018-09-08,penn-state,@,Pittsburgh,W (51-6),15,31,48.4,179,3,33,211,6.4,3,64,390,6.1,8,10,5,23,4,45,2,0,2
6803,3,2018-09-15,penn-state,,Kent State,W (63-10),14,25,56.0,346,3,45,297,6.6,6,70,643,9.2,9,14,3,26,9,85,0,1,1
6804,4,2018-09-21,penn-state,@,Illinois,W (63-24),13,20,65.0,204,3,51,387,7.6,6,71,591,8.3,7,20,4,31,8,72,1,1,2
6805,5,2018-09-29,penn-state,,Ohio State,L (26-27),16,32,50.0,286,2,44,206,4.7,1,76,492,6.5,9,9,4,22,7,64,1,0,1
6806,6,2018-10-13,penn-state,,Michigan State,L (17-21),19,32,59.4,192,1,32,205,6.4,1,64,397,6.2,9,5,0,14,6,41,1,0,1
6807,7,2018-10-20,penn-state,@,Indiana,W (33-28),20,37,54.1,243,1,36,174,4.8,3,73,417,5.7,12,8,0,20,3,40,1,1,2
6808,8,2018-10-27,penn-state,,Iowa,W (30-24),13,29,44.8,194,1,35,118,3.4,2,64,312,4.9,10,6,0,16,6,47,1,1,2
6809,9,2018-11-03,penn-state,@,Michigan,L (7-42),8,17,47.1,118,0,30,68,2.3,1,47,186,4.0,5,5,1,11,4,35,1,2,3
6810,10,2018-11-10,penn-state,,Wisconsin,W (22-10),19,25,76.0,160,1,47,183,3.9,1,72,343,4.8,8,13,2,23,3,22,2,0,2
6811,11,2018-11-17,penn-state,@,Rutgers,W (20-7),17,37,45.9,183,2,39,139,3.6,0,76,322,4.2,8,9,2,19,3,43,1,1,2
6812,,11 Games,penn-state,,,,175,321,54.5,2335,18,435,2192,5.0,29,756,4527,6.0,96,109,24,229,55,504,11,7,18
6813,1,2014-08-30,florida-state,N,Oklahoma State,W (37-31),25,40,62.5,370,1,31,106,3.4,2,71,476,6.7,12,7,4,23,8,71,0,2,2
6814,2,2014-09-06,florida-state,,Citadel,W (37-12),25,32,78.1,284,2,35,210,6.0,2,67,494,7.4,13,15,0,28,3,20,0,0,0
6815,3,2014-09-20,florida-state,,Clemson,W (23-17),21,39,53.8,304,1,27,13,0.5,2,66,317,4.8,11,5,1,17,8,41,0,2,2
6816,4,2014-09-27,florida-state,@,North Carolina State,W (56-41),26,38,68.4,365,4,33,166,5.0,4,71,531,7.5,18,7,3,28,9,58,2,2,4
6817,5,2014-10-04,florida-state,,Wake Forest,W (43-3),24,41,58.5,304,1,33,171,5.2,2,74,475,6.4,12,9,2,23,5,48,1,1,2
6818,6,2014-10-11,florida-state,@,Syracuse,W (38-20),30,36,83.3,317,3,36,165,4.6,2,72,482,6.7,16,9,4,29,6,36,2,0,2
6819,7,2014-10-18,florida-state,,Notre Dame,W (31-27),23,31,74.2,273,2,26,50,1.9,2,57,323,5.7,12,4,2,18,9,84,0,1,1
6820,8,2014-10-30,florida-state,@,Louisville,W (42-31),25,48,52.1,401,3,30,173,5.8,3,78,574,7.4,18,7,0,25,7,53,0,3,3
6821,9,2014-11-08,florida-state,,Virginia,W (34-20),22,35,62.9,261,1,39,115,2.9,3,74,376,5.1,13,5,2,20,6,46,1,2,3
6822,10,2014-11-15,florida-state,@,Miami (FL),W (30-26),25,42,59.5,304,1,19,114,6.0,2,61,418,6.9,13,6,1,20,2,15,2,1,3
6823,11,2014-11-22,florida-state,,Boston College,W (20-17),22,32,68.8,281,1,29,110,3.8,1,61,391,6.4,15,7,0,22,5,40,0,1,1
6824,12,2014-11-29,florida-state,,Florida,W (24-19),12,24,50.0,125,2,41,181,4.4,0,65,306,4.7,6,8,3,17,8,63,0,4,4
6825,13,2014-12-06,florida-state,N,Georgia Tech,W (37-35),21,30,70.0,309,3,33,179,5.4,1,63,488,7.7,11,12,1,24,5,45,0,0,0
6826,14,2015-01-01,florida-state,N,Oregon*,L (20-59),29,48,60.4,348,1,39,180,4.6,1,87,528,6.1,17,10,1,28,6,48,4,1,5
6827,,14 Games,florida-state,,,,330,516,64.0,4246,26,451,1933,4.3,27,967,6179,6.4,187,111,24,322,87,668,12,20,32
6828,1,2015-09-05,florida-state,,Texas State,W (59-16),25,32,78.1,370,5,41,266,6.5,3,73,636,8.7,16,14,0,30,5,35,1,0,1
6829,2,2015-09-12,florida-state,,South Florida,W (34-14),14,26,53.8,163,1,46,278,6.0,3,72,441,6.1,10,10,1,21,7,50,0,0,0
6830,3,2015-09-18,florida-state,@,Boston College,W (14-0),15,24,62.5,119,1,33,98,3.0,0,57,217,3.8,7,5,3,15,4,26,0,0,0
6831,4,2015-10-03,florida-state,@,Wake Forest,W (24-16),20,31,64.5,202,1,21,127,6.0,2,52,329,6.3,7,6,1,14,10,100,0,0,0
6832,5,2015-10-10,florida-state,,Miami (FL),W (29-24),25,33,75.8,291,1,36,248,6.9,2,69,539,7.8,13,10,2,25,7,43,0,0,0
6833,6,2015-10-17,florida-state,,Louisville,W (41-21),27,39,69.2,377,3,32,133,4.2,2,71,510,7.2,13,7,4,24,10,75,0,0,0
6834,7,2015-10-24,florida-state,@,Georgia Tech,L (16-22),20,31,64.5,210,0,24,70,2.9,1,55,280,5.1,11,4,2,17,6,45,0,1,1
6835,8,2015-10-31,florida-state,,Syracuse,W (45-21),25,38,65.8,354,3,34,221,6.5,3,72,575,8.0,11,12,0,23,9,77,0,0,0
6836,9,2015-11-07,florida-state,@,Clemson,L (13-23),16,29,55.2,164,0,30,197,6.6,1,59,361,6.1,6,7,1,14,9,65,1,1,2
6837,10,2015-11-14,florida-state,,North Carolina State,W (34-17),23,37,62.2,283,2,38,196,5.2,2,75,479,6.4,15,11,2,28,6,38,2,3,5
6838,11,2015-11-21,florida-state,,Chattanooga,W (52-13),17,23,73.9,235,2,37,193,5.2,5,60,428,7.1,11,11,3,25,3,30,1,0,1
6839,12,2015-11-28,florida-state,@,Florida,W (27-2),14,28,50.0,160,1,30,144,4.8,2,58,304,5.2,5,9,1,15,7,52,0,0,0
6840,13,2015-12-31,florida-state,N,Houston*,L (24-38),23,48,47.9,397,2,23,16,0.7,1,71,413,5.8,16,1,0,17,6,66,1,4,5
6841,,13 Games,florida-state,,,,264,419,63.0,3325,22,425,2187,5.1,27,844,5512,6.5,141,107,20,268,89,702,6,9,15
6842,1,2016-09-05,florida-state,N,Mississippi,W (45-34),33,52,63.5,419,2,41,161,3.9,2,93,580,6.2,17,12,3,32,15,127,0,0,0
6843,2,2016-09-10,florida-state,,Charleston Southern,W (52-8),26,35,74.3,269,3,36,169,4.7,3,71,438,6.2,11,13,2,26,6,60,0,1,1
6844,3,2016-09-17,florida-state,@,Louisville,L (20-63),8,24,33.3,113,2,43,171,4.0,0,67,284,4.2,6,12,2,20,8,84,1,1,2
6845,4,2016-09-24,florida-state,@,South Florida,W (55-35),11,19,57.9,169,1,63,478,7.6,6,82,647,7.9,8,20,3,31,4,50,1,0,1
6846,5,2016-10-01,florida-state,,North Carolina,L (35-37),20,32,62.5,372,0,43,223,5.2,5,75,595,7.9,15,12,3,30,13,120,0,0,0
6847,6,2016-10-08,florida-state,@,Miami (FL),W (20-19),21,33,63.6,240,2,43,167,3.9,0,76,407,5.4,10,10,2,22,8,77,0,1,1
6848,7,2016-10-15,florida-state,,Wake Forest,W (17-6),22,37,59.5,319,1,38,123,3.2,1,75,442,5.9,13,13,1,27,4,42,3,1,4
6849,8,2016-10-29,florida-state,,Clemson,L (34-37),17,35,48.6,286,1,28,163,5.8,4,63,449,7.1,13,6,4,23,13,111,0,1,1
6850,9,2016-11-05,florida-state,@,North Carolina State,W (24-20),22,39,56.4,330,1,24,63,2.6,2,63,393,6.2,12,7,1,20,6,59,1,0,1
6851,10,2016-11-11,florida-state,,Boston College,W (45-7),21,31,67.7,236,5,39,180,4.6,1,70,416,5.9,11,11,2,24,4,33,0,0,0
6852,11,2016-11-19,florida-state,@,Syracuse,W (45-14),19,31,61.3,320,2,45,334,7.4,4,76,654,8.6,16,16,1,33,9,85,3,1,4
6853,12,2016-11-26,florida-state,,Florida,W (31-13),15,26,57.7,138,1,40,249,6.2,3,66,387,5.9,6,10,2,18,3,35,2,1,3
6854,13,2016-12-30,florida-state,N,Michigan*,W (33-32),9,27,33.3,222,2,35,149,4.3,2,62,371,6.0,5,7,3,15,7,65,1,1,2
6855,,13 Games,florida-state,,,,244,421,58.0,3433,23,518,2630,5.1,33,939,6063,6.5,143,149,29,321,100,948,12,8,20
6856,1,2017-09-02,florida-state,N,Alabama,L (7-24),19,33,57.6,210,1,27,40,1.5,0,60,250,4.2,10,4,1,15,4,30,1,2,3
6857,2,2017-09-23,florida-state,,North Carolina State,L (21-27),22,39,56.4,278,1,26,104,4.0,0,65,382,5.9,9,6,0,15,11,93,1,0,1
6858,3,2017-09-30,florida-state,@,Wake Forest,W (26-19),11,21,52.4,121,1,43,149,3.5,1,64,270,4.2,4,8,3,15,8,70,1,0,1
6859,4,2017-10-07,florida-state,,Miami (FL),L (20-24),17,28,60.7,203,2,43,203,4.7,0,71,406,5.7,9,12,1,22,7,65,0,2,2
6860,5,2017-10-14,florida-state,@,Duke,W (17-10),18,21,85.7,197,1,40,228,5.7,1,61,425,7.0,10,12,1,23,7,51,0,2,2
6861,6,2017-10-21,florida-state,,Louisville,L (28-31),16,28,57.1,248,2,38,155,4.1,0,66,403,6.1,12,10,1,23,4,40,1,2,3
6862,7,2017-10-27,florida-state,@,Boston College,L (3-35),12,27,44.4,149,0,29,64,2.2,0,56,213,3.8,7,3,0,10,7,71,2,1,3
6863,8,2017-11-04,florida-state,,Syracuse,W (27-24),12,19,63.2,136,1,37,207,5.6,2,56,343,6.1,5,7,1,13,4,34,1,0,1
6864,9,2017-11-11,florida-state,@,Clemson,L (14-31),13,32,40.6,208,1,24,21,0.9,1,56,229,4.1,6,3,3,12,4,55,1,1,2
6865,10,2017-11-18,florida-state,,Delaware State,W (77-6),18,24,75.0,236,4,32,246,7.7,5,56,482,8.6,9,14,0,23,5,45,0,0,0
6866,11,2017-11-25,florida-state,@,Florida,W (38-22),10,21,47.6,128,2,34,88,2.6,1,55,216,3.9,5,5,2,12,7,55,0,1,1
6867,12,2017-12-02,florida-state,,Louisiana-Monroe,W (42-10),15,23,65.2,199,1,45,305,6.8,5,68,504,7.4,10,16,0,26,4,30,0,2,2
6868,13,2017-12-27,florida-state,N,Southern Mississippi*,W (42-13),19,29,65.5,238,4,45,214,4.8,1,74,452,6.1,14,10,1,25,6,60,0,0,0
6869,,13 Games,florida-state,,,,202,345,58.6,2551,21,463,2024,4.4,17,808,4575,5.7,110,110,14,234,78,699,8,13,21
6870,1,2018-09-03,florida-state,,Virginia Tech,L (3-24),22,35,62.9,233,0,28,94,3.4,0,63,327,5.2,8,3,1,12,7,36,2,3,5
6871,2,2018-09-08,florida-state,,Samford,W (36-26),31,46,67.4,320,3,35,134,3.8,1,81,454,5.6,16,6,3,25,9,69,1,0,1
6872,3,2018-09-15,florida-state,@,Syracuse,L (7-30),18,37,48.6,178,0,23,62,2.7,1,60,240,4.0,7,3,1,11,11,90,0,1,1
6873,4,2018-09-22,florida-state,,Northern Illinois,W (37-19),23,32,71.9,352,2,57,121,2.1,2,89,473,5.3,13,10,0,23,9,60,3,1,4
6874,5,2018-09-29,florida-state,@,Louisville,W (28-24),16,27,59.3,294,4,31,76,2.5,0,58,370,6.4,10,5,1,16,7,55,1,0,1
6875,6,2018-10-06,florida-state,@,Miami (FL),L (27-28),16,32,50.0,130,2,33,70,2.1,0,65,200,3.1,9,5,0,14,7,80,1,1,2
6876,7,2018-10-20,florida-state,,Wake Forest,W (38-17),28,41,68.3,341,2,28,130,4.6,3,69,471,6.8,13,4,2,19,6,55,1,0,1
6877,8,2018-10-27,florida-state,,Clemson,L (10-59),20,40,50.0,268,1,35,-21,-0.6,0,75,247,3.3,11,1,2,14,16,134,1,1,2
6878,9,2018-11-03,florida-state,@,North Carolina State,L (28-47),29,48,60.4,421,4,20,24,1.2,0,68,445,6.5,13,3,1,17,16,121,1,1,2
6879,10,2018-11-10,florida-state,@,Notre Dame,L (13-42),23,48,47.9,216,0,30,106,3.5,2,78,322,4.1,11,6,3,20,5,35,1,1,2
6880,11,2018-11-17,florida-state,,Boston College,W (22-21),19,39,48.7,322,1,36,156,4.3,1,75,478,6.4,11,7,1,19,7,56,0,2,2
6881,,11 Games,florida-state,,,,245,425,57.6,3075,19,356,952,2.7,10,781,4027,5.2,122,53,15,190,100,791,12,11,23
6882,1,2014-08-28,south-carolina,,Texas A&M,L (28-52),20,40,50.0,366,4,22,67,3.0,0,62,433,7.0,14,5,4,23,4,21,0,1,1
6883,2,2014-09-06,south-carolina,,East Carolina,W (33-23),25,38,65.8,266,1,38,175,4.6,2,76,441,5.8,15,10,1,26,5,60,0,1,1
6884,3,2014-09-13,south-carolina,,Georgia,W (38-35),21,30,70.0,271,3,42,176,4.2,2,72,447,6.2,13,13,1,27,7,69,1,1,2
6885,4,2014-09-20,south-carolina,@,Vanderbilt,W (48-34),22,34,64.7,237,3,34,212,6.2,2,68,449,6.6,10,12,2,24,5,35,1,0,1
6886,5,2014-09-27,south-carolina,,Missouri,L (20-21),21,37,56.8,219,1,42,119,2.8,1,79,338,4.3,7,9,2,18,8,71,0,0,0
6887,6,2014-10-04,south-carolina,@,Kentucky,L (38-45),23,37,62.2,218,1,48,282,5.9,4,85,500,5.9,13,16,3,32,4,35,0,3,3
6888,7,2014-10-18,south-carolina,,Furman,W (41-10),16,28,57.1,281,2,43,267,6.2,3,71,548,7.7,11,14,1,26,7,53,2,0,2
6889,8,2014-10-25,south-carolina,@,Auburn,L (35-42),30,53,56.6,416,5,33,119,3.6,0,86,535,6.2,20,7,3,30,4,20,0,3,3
6890,9,2014-11-01,south-carolina,,Tennessee,L (42-45),21,34,61.8,377,3,39,248,6.4,3,73,625,8.6,14,12,0,26,7,51,0,1,1
6891,10,2014-11-15,south-carolina,@,Florida,W (23-20),22,42,52.4,206,0,38,95,2.5,3,80,301,3.8,8,8,3,19,6,67,1,0,1
6892,11,2014-11-22,south-carolina,,South Alabama,W (37-12),11,20,55.0,244,2,37,210,5.7,1,57,454,8.0,7,12,1,20,6,57,4,1,5
6893,12,2014-11-29,south-carolina,@,Clemson,L (17-35),23,41,56.1,276,1,33,63,1.9,1,74,339,4.6,8,8,2,18,2,6,1,0,1
6894,13,2014-12-27,south-carolina,N,Miami (FL)*,W (24-21),22,34,64.7,294,2,30,60,2.0,1,64,354,5.5,10,5,1,16,5,61,0,0,0
6895,,13 Games,south-carolina,,,,277,468,59.2,3671,28,479,2093,4.4,23,947,5764,6.1,150,131,24,305,70,606,10,11,21
6896,1,2015-09-03,south-carolina,N,North Carolina,W (17-13),12,27,44.4,140,1,47,254,5.4,1,74,394,5.3,7,15,0,22,8,60,0,0,0
6897,2,2015-09-12,south-carolina,,Kentucky,L (22-26),17,27,63.0,222,1,34,195,5.7,1,61,417,6.8,10,9,3,22,5,50,0,1,1
6898,3,2015-09-19,south-carolina,@,Georgia,L (20-52),10,22,45.5,84,0,39,174,4.5,2,61,258,4.2,7,8,1,16,4,40,0,1,1
6899,4,2015-09-26,south-carolina,,Central Florida,W (31-14),12,25,48.0,184,2,43,216,5.0,1,68,400,5.9,9,10,1,20,2,20,1,0,1
6900,5,2015-10-03,south-carolina,@,Missouri,L (10-24),17,30,56.7,186,1,34,112,3.3,0,64,298,4.7,9,7,1,17,4,35,0,3,3
6901,6,2015-10-10,south-carolina,,Louisiana State,L (24-45),15,30,50.0,209,2,20,74,3.7,0,50,283,5.7,6,6,0,12,5,32,0,1,1
6902,7,2015-10-17,south-carolina,,Vanderbilt,W (19-10),17,29,58.6,272,1,37,152,4.1,0,66,424,6.4,10,6,1,17,6,39,1,1,2
6903,8,2015-10-31,south-carolina,@,Texas A&M,L (28-35),15,24,62.5,192,0,43,253,5.9,4,67,445,6.6,8,11,0,19,5,26,0,2,2
6904,9,2015-11-07,south-carolina,@,Tennessee,L (24-27),20,39,51.3,233,3,40,152,3.8,0,79,385,4.9,11,10,2,23,6,40,1,0,1
6905,10,2015-11-14,south-carolina,,Florida,L (14-24),14,25,56.0,180,2,23,21,0.9,0,48,201,4.2,9,1,3,13,4,45,0,2,2
6906,11,2015-11-21,south-carolina,,Citadel,L (22-23),28,43,65.1,367,1,25,72,2.9,1,68,439,6.5,14,4,0,18,7,51,0,0,0
6907,12,2015-11-28,south-carolina,,Clemson,L (32-37),14,30,46.7,221,3,38,181,4.8,1,68,402,5.9,7,10,0,17,4,30,0,1,1
6908,,12 Games,south-carolina,,,,191,351,54.4,2490,17,423,1856,4.4,11,774,4346,5.6,107,97,12,216,60,468,3,12,15
6909,1,2016-09-01,south-carolina,@,Vanderbilt,W (13-10),16,30,53.3,187,0,32,121,3.8,1,62,308,5.0,10,4,0,14,7,51,2,0,2
6910,2,2016-09-10,south-carolina,@,Mississippi State,L (14-27),20,39,51.3,209,2,31,34,1.1,0,70,243,3.5,12,5,1,18,6,70,1,1,2
6911,3,2016-09-17,south-carolina,,East Carolina,W (20-15),16,28,57.1,195,0,25,117,4.7,2,53,312,5.9,8,3,2,13,7,65,0,0,0
6912,4,2016-09-24,south-carolina,@,Kentucky,L (10-17),15,30,50.0,177,0,35,91,2.6,1,65,268,4.1,10,5,1,16,5,45,0,0,0
6913,5,2016-10-01,south-carolina,,Texas A&M,L (13-24),22,35,62.9,217,0,35,161,4.6,1,70,378,5.4,11,8,2,21,3,20,1,1,2
6914,6,2016-10-09,south-carolina,,Georgia,L (14-28),26,36,72.2,288,0,26,30,1.2,2,62,318,5.1,9,4,0,13,5,42,2,1,3
6915,7,2016-10-22,south-carolina,,Massachusetts,W (34-28),17,26,65.4,201,2,44,194,4.4,3,70,395,5.6,6,11,4,21,6,67,2,0,2
6916,8,2016-10-29,south-carolina,,Tennessee,W (24-21),15,21,71.4,167,2,49,158,3.2,1,70,325,4.6,8,9,2,19,7,77,0,0,0
6917,9,2016-11-05,south-carolina,,Missouri,W (31-21),22,28,78.6,254,2,49,174,3.6,2,77,428,5.6,10,11,1,22,6,45,0,0,0
6918,10,2016-11-12,south-carolina,@,Florida,L (7-20),18,33,54.5,213,0,30,43,1.4,1,63,256,4.1,10,4,1,15,2,10,1,1,2
6919,11,2016-11-19,south-carolina,,Western Carolina,W (44-31),15,24,62.5,166,0,56,422,7.5,4,80,588,7.4,8,19,1,28,3,25,1,0,1
6920,12,2016-11-26,south-carolina,@,Clemson,L (7-56),14,29,48.3,107,1,29,111,3.8,0,58,218,3.8,5,6,3,14,5,54,0,1,1
6921,13,2016-12-29,south-carolina,N,South Florida*,L (39-46),32,43,74.4,390,3,34,91,2.7,2,77,481,6.2,20,4,3,27,3,35,3,2,5
6922,,13 Games,south-carolina,,,,248,402,61.7,2771,12,475,1747,3.7,20,877,4518,5.2,127,93,21,241,65,606,13,7,20
6923,1,2017-09-02,south-carolina,N,North Carolina State,W (35-28),17,29,58.6,215,3,21,31,1.5,1,50,246,4.9,8,4,0,12,6,45,0,1,1
6924,2,2017-09-09,south-carolina,@,Missouri,W (31-13),18,28,64.3,187,1,40,172,4.3,2,68,359,5.3,9,9,2,20,4,29,0,0,0
6925,3,2017-09-16,south-carolina,,Kentucky,L (13-23),24,37,64.9,304,2,20,54,2.7,0,57,358,6.3,11,3,0,14,7,45,0,2,2
6926,4,2017-09-23,south-carolina,,Louisiana Tech,W (17-16),22,35,62.9,295,1,31,154,5.0,1,66,449,6.8,12,11,0,23,1,15,1,1,2
6927,5,2017-09-30,south-carolina,@,Texas A&M,L (17-24),17,30,56.7,256,2,26,23,0.9,0,56,279,5.0,11,2,1,14,2,10,1,0,1
6928,6,2017-10-07,south-carolina,,Arkansas,W (48-22),16,31,51.6,199,3,36,159,4.4,0,67,358,5.3,9,9,1,19,3,25,0,0,0
6929,7,2017-10-14,south-carolina,@,Tennessee,W (15-9),15,24,62.5,129,0,40,194,4.9,1,64,323,5.0,8,11,0,19,8,59,0,0,0
6930,8,2017-10-28,south-carolina,,Vanderbilt,W (34-27),19,29,65.5,174,1,37,212,5.7,3,66,386,5.8,8,14,4,26,7,50,0,0,0
6931,9,2017-11-04,south-carolina,@,Georgia,L (10-24),21,36,58.3,227,1,17,43,2.5,0,53,270,5.1,11,1,2,14,2,15,0,2,2
6932,10,2017-11-11,south-carolina,,Florida,W (28-20),19,29,65.5,249,0,47,220,4.7,4,76,469,6.2,13,9,2,24,3,26,1,3,4
6933,11,2017-11-18,south-carolina,,Wofford,W (31-10),22,28,78.6,194,1,38,195,5.1,3,66,389,5.9,9,13,1,23,3,31,0,0,0
6934,12,2017-11-25,south-carolina,,Clemson,L (10-34),16,29,55.2,126,1,25,81,3.2,0,54,207,3.8,6,4,0,10,9,76,0,2,2
6935,13,2018-01-01,south-carolina,N,Michigan*,W (26-19),19,32,59.4,239,2,26,61,2.3,1,58,300,5.2,10,2,1,13,7,68,2,1,3
6936,,13 Games,south-carolina,,,,245,397,61.7,2794,18,404,1599,4.0,16,801,4393,5.5,125,92,14,231,62,494,5,12,17
6937,1,2018-09-01,south-carolina,,Coastal Carolina,W (49-15),25,35,71.4,294,5,37,267,7.2,2,72,561,7.8,15,16,1,32,9,99,0,0,0
6938,2,2018-09-08,south-carolina,,Georgia,L (17-41),31,48,64.6,282,2,20,54,2.7,0,68,336,4.9,16,1,2,19,3,40,0,2,2
6939,3,2018-09-22,south-carolina,@,Vanderbilt,W (37-14),19,28,67.9,261,1,48,273,5.7,3,76,534,7.0,14,12,2,28,8,54,2,1,3
6940,4,2018-09-29,south-carolina,@,Kentucky,L (10-24),17,34,50.0,193,1,35,133,3.8,0,69,326,4.7,8,11,1,20,11,94,1,3,4
6941,5,2018-10-06,south-carolina,,Missouri,W (37-35),20,35,57.1,249,3,47,128,2.7,0,82,377,4.6,13,4,1,18,9,83,1,0,1
6942,6,2018-10-13,south-carolina,,Texas A&M,L (23-26),17,35,48.6,223,3,18,76,4.2,0,53,299,5.6,8,6,5,19,4,39,1,1,2
6943,7,2018-10-27,south-carolina,,Tennessee,W (27-24),11,16,68.8,152,1,40,224,5.6,2,56,376,6.7,6,12,1,19,2,9,0,1,1
6944,8,2018-11-03,south-carolina,@,Mississippi,W (48-44),22,32,68.8,363,2,36,145,4.0,3,68,508,7.5,12,6,0,18,5,51,0,0,0
6945,9,2018-11-10,south-carolina,@,Florida,L (31-35),18,28,64.3,239,2,36,147,4.1,2,64,386,6.0,10,7,1,18,7,41,0,1,1
6946,10,2018-11-17,south-carolina,,Chattanooga,W (49-9),29,36,80.6,364,4,42,238,5.7,3,78,602,7.7,13,17,3,33,6,48,0,0,0
6947,,10 Games,south-carolina,,,,209,327,63.9,2620,24,359,1685,4.7,15,686,4305,6.3,115,92,17,224,64,558,5,9,14
6948,1,2014-08-28,akron,,Howard,W (41-0),27,43,62.8,396,5,29,117,4.0,1,72,513,7.1,7,15,2,24,7,70,0,0,0
6949,2,2014-09-06,akron,@,Penn State,L (3-21),24,46,52.2,208,0,25,69,2.8,0,71,277,3.9,12,4,1,17,7,64,0,0,0
6950,3,2014-09-20,akron,,Marshall,L (17-48),25,52,48.1,251,1,23,92,4.0,1,75,343,4.6,10,8,7,25,10,94,2,2,4
6951,4,2014-09-27,akron,@,Pittsburgh,W (21-10),17,35,48.6,213,1,36,169,4.7,2,71,382,5.4,11,9,0,20,10,64,0,1,1
6952,5,2014-10-04,akron,,Eastern Michigan,W (31-6),33,50,66.0,355,2,31,197,6.4,2,81,552,6.8,17,10,0,27,15,124,0,0,0
6953,6,2014-10-11,akron,,Miami (OH),W (29-19),20,36,55.6,167,0,37,151,4.1,3,73,318,4.4,11,8,5,24,9,128,2,0,2
6954,7,2014-10-18,akron,@,Ohio,L (20-23),23,46,50.0,268,2,25,84,3.4,0,71,352,5.0,11,4,3,18,10,83,1,2,3
6955,8,2014-10-25,akron,@,Ball State,L (21-35),21,39,53.8,200,1,34,125,3.7,2,73,325,4.5,9,11,0,20,7,45,1,4,5
6956,9,2014-11-04,akron,,Bowling Green State,L (10-27),31,63,49.2,304,0,27,94,3.5,1,90,398,4.4,16,9,1,26,7,55,2,3,5
6957,10,2014-11-11,akron,@,Buffalo,L (24-55),19,35,54.3,161,0,30,68,2.3,2,65,229,3.5,7,8,0,15,9,98,2,0,2
6958,11,2014-11-18,akron,,Massachusetts,W (30-6),26,40,65.0,277,2,37,134,3.6,1,77,411,5.3,14,9,4,27,4,40,2,0,2
6959,12,2014-11-28,akron,@,Kent State,L (24-27),17,42,40.5,191,0,30,188,6.3,3,72,379,5.3,7,8,2,17,6,59,0,2,2
6960,,12 Games,akron,,,,283,527,53.7,2991,14,364,1488,4.1,18,891,4479,5.0,132,103,25,260,101,924,12,14,26
6961,1,2015-09-05,akron,@,Oklahoma,L (3-41),6,26,23.1,88,0,44,138,3.1,0,70,226,3.2,5,4,1,10,9,62,1,0,1
6962,2,2015-09-12,akron,,Pittsburgh,L (7-24),7,22,31.8,63,0,24,47,2.0,1,46,110,2.4,3,4,1,8,9,85,1,0,1
6963,3,2015-09-19,akron,,Savannah State,W (52-9),18,33,54.5,335,2,47,291,6.2,5,80,626,7.8,13,15,3,31,4,51,0,2,2
6964,4,2015-09-26,akron,@,Louisiana,W (35-14),13,29,44.8,238,2,42,220,5.2,3,71,458,6.5,7,11,4,22,11,92,0,1,1
6965,5,2015-10-03,akron,,Ohio,L (12-14),18,38,47.4,231,0,35,88,2.5,0,73,319,4.4,13,5,2,20,10,79,0,1,1
6966,6,2015-10-10,akron,@,Eastern Michigan,W (47-21),14,22,63.6,222,4,53,278,5.2,2,75,500,6.7,10,15,3,28,8,54,0,0,0
6967,7,2015-10-17,akron,@,Bowling Green State,L (10-59),15,30,50.0,104,1,42,167,4.0,0,72,271,3.8,6,9,1,16,9,85,2,2,4
6968,8,2015-10-31,akron,,Central Michigan,L (6-14),22,36,61.1,252,1,25,25,1.0,0,61,277,4.5,11,3,1,15,5,34,0,1,1
6969,9,2015-11-07,akron,@,Massachusetts,W (17-13),15,27,55.6,174,1,41,155,3.8,1,68,329,4.8,9,8,1,18,6,65,1,2,3
6970,10,2015-11-14,akron,@,Miami (OH),W (37-28),13,28,46.4,221,1,45,193,4.3,4,73,414,5.7,9,10,1,20,9,80,0,2,2
6971,11,2015-11-21,akron,,Buffalo,W (42-21),17,30,56.7,258,4,45,217,4.8,2,75,475,6.3,10,13,2,25,7,73,0,0,0
6972,12,2015-11-27,akron,,Kent State,W (20-0),11,19,57.9,140,1,51,229,4.5,1,70,369,5.3,11,11,4,26,7,60,1,0,1
6973,13,2015-12-22,akron,N,Utah State*,W (23-21),15,30,50.0,182,1,42,100,2.4,1,72,282,3.9,9,6,2,17,5,34,0,1,1
6974,,13 Games,akron,,,,184,370,49.7,2508,18,536,2148,4.0,20,906,4656,5.1,116,114,26,256,99,854,6,12,18
6975,1,2016-09-03,akron,,Virginia Military Institute,W (47-24),25,38,65.8,425,6,29,151,5.2,1,67,576,8.6,16,7,1,24,13,111,1,1,2
6976,2,2016-09-10,akron,@,Wisconsin,L (10-54),14,25,56.0,136,0,21,88,4.2,0,46,224,4.9,4,4,2,10,8,66,1,1,2
6977,3,2016-09-17,akron,@,Marshall,W (65-38),21,32,65.6,379,4,30,145,4.8,2,62,524,8.5,15,5,6,26,13,136,1,0,1
6978,4,2016-09-24,akron,,Appalachian State,L (38-45),31,43,72.1,353,3,26,133,5.1,2,69,486,7.0,18,9,3,30,9,72,0,2,2
6979,5,2016-10-01,akron,@,Kent State,W (31-27),11,28,39.3,237,2,32,141,4.4,2,60,378,6.3,11,6,1,18,6,64,1,2,3
6980,6,2016-10-08,akron,,Miami (OH),W (35-13),15,29,51.7,174,3,35,125,3.6,2,64,299,4.7,8,6,2,16,1,5,0,0,0
6981,7,2016-10-15,akron,,Western Michigan,L (0-41),13,31,41.9,153,0,28,130,4.6,0,59,283,4.8,6,10,1,17,9,47,0,2,2
6982,8,2016-10-22,akron,@,Ball State,W (35-25),28,41,68.3,352,3,30,177,5.9,2,71,529,7.5,14,9,3,26,8,51,1,0,1
6983,9,2016-10-27,akron,@,Buffalo,L (20-41),18,42,42.9,178,1,42,128,3.0,0,84,306,3.6,7,9,2,18,4,40,0,1,1
6984,10,2016-11-02,akron,,Toledo,L (17-48),18,36,50.0,348,2,25,96,3.8,0,61,444,7.3,12,8,1,21,5,63,0,2,2
6985,11,2016-11-09,akron,,Bowling Green State,L (28-38),11,24,45.8,197,1,50,177,3.5,2,74,374,5.1,8,5,1,14,8,85,3,3,6
6986,12,2016-11-22,akron,@,Ohio,L (3-9),12,27,44.4,131,0,32,95,3.0,0,59,226,3.8,7,5,2,14,7,67,0,0,0
6987,,12 Games,akron,,,,217,396,54.8,3063,25,380,1586,4.2,13,776,4649,6.0,126,83,25,234,91,807,8,14,22
6988,1,2017-09-02,akron,@,Penn State,L (0-52),14,29,48.3,86,0,34,73,2.1,0,63,159,2.5,7,4,1,12,9,84,0,1,1
6989,2,2017-09-09,akron,,Arkansas-Pine Bluff,W (52-3),17,26,65.4,197,1,44,267,6.1,5,70,464,6.6,9,15,3,27,11,130,0,0,0
6990,3,2017-09-16,akron,,Iowa State,L (14-41),27,44,61.4,293,2,24,38,1.6,0,68,331,4.9,13,4,2,19,7,79,1,2,3
6991,4,2017-09-23,akron,@,Troy,L (17-22),20,40,50.0,268,1,35,99,2.8,1,75,367,4.9,12,7,4,23,12,100,1,2,3
6992,5,2017-09-30,akron,@,Bowling Green State,W (34-23),14,25,56.0,183,2,40,178,4.5,2,65,361,5.6,7,10,2,19,1,5,2,1,3
6993,6,2017-10-07,akron,,Ball State,W (31-3),18,31,58.1,249,2,31,134,4.3,1,62,383,6.2,13,6,0,19,2,15,0,0,0
6994,7,2017-10-15,akron,@,Western Michigan,W (14-13),13,24,54.2,127,1,31,88,2.8,1,55,215,3.9,8,3,3,14,9,93,0,1,1
6995,8,2017-10-21,akron,@,Toledo,L (21-48),23,40,57.5,291,3,24,42,1.8,0,64,333,5.2,16,2,5,23,0,0,1,1,2
6996,9,2017-10-28,akron,,Buffalo,W (21-20),21,29,72.4,286,3,25,81,3.2,0,54,367,6.8,12,7,0,19,4,49,0,1,1
6997,10,2017-11-07,akron,@,Miami (OH),L (14-24),19,38,50.0,218,1,30,55,1.8,1,68,273,4.0,10,6,2,18,5,57,0,0,0
6998,11,2017-11-14,akron,,Ohio,W (37-34),22,38,57.9,322,4,32,121,3.8,1,70,443,6.3,11,7,0,18,16,167,0,0,0
6999,12,2017-11-21,akron,,Kent State,W (24-14),6,20,30.0,69,1,39,122,3.1,1,59,191,3.2,4,8,3,15,5,20,0,1,1
7000,13,2017-12-02,akron,N,Toledo,L (28-45),18,42,42.9,283,3,33,113,3.4,1,75,396,5.3,12,6,2,20,3,25,1,1,2
7001,14,2017-12-19,akron,@,Florida Atlantic*,L (3-50),10,21,47.6,77,0,37,69,1.9,0,58,146,2.5,3,5,4,12,4,49,0,0,0
7002,,14 Games,akron,,,,242,447,54.1,2949,24,459,1480,3.2,14,906,4429,4.9,137,90,31,258,88,873,6,11,17
7003,1,2018-09-08,akron,,Morgan State,W (41-7),18,31,58.1,237,3,39,200,5.1,2,70,437,6.2,9,13,4,26,6,73,1,2,3
7004,2,2018-09-15,akron,@,Northwestern,W (39-34),17,28,60.7,277,2,36,90,2.5,0,64,367,5.7,7,6,2,15,15,140,0,0,0
7005,3,2018-09-22,akron,@,Iowa State,L (13-26),12,28,42.9,153,1,31,91,2.9,0,59,244,4.1,8,4,3,15,6,45,0,1,1
7006,4,2018-10-06,akron,,Miami (OH),L (17-41),19,35,54.3,203,1,28,56,2.0,0,63,259,4.1,9,5,2,16,8,86,2,3,5
7007,5,2018-10-13,akron,@,Buffalo,L (6-24),12,29,41.4,115,0,32,120,3.8,0,61,235,3.9,5,7,1,13,5,46,0,1,1
7008,6,2018-10-20,akron,@,Kent State,W (24-23),19,35,54.3,219,1,39,143,3.7,2,74,362,4.9,13,5,1,19,7,65,0,1,1
7009,7,2018-10-27,akron,,Central Michigan,W (17-10),10,27,37.0,149,1,37,154,4.2,1,64,303,4.7,6,8,2,16,4,37,4,0,4
7010,8,2018-11-01,akron,,Northern Illinois,L (26-36),21,38,55.3,326,3,28,35,1.3,0,66,361,5.5,14,1,4,19,7,50,0,2,2
7011,9,2018-11-10,akron,@,Eastern Michigan,L (7-27),4,15,26.7,29,0,30,72,2.4,0,45,101,2.2,1,4,1,6,2,25,1,3,4
7012,10,2018-11-17,akron,,Bowling Green State,L (6-21),12,28,42.9,148,0,28,79,2.8,0,56,227,4.1,7,6,2,15,8,61,0,0,0
7013,,10 Games,akron,,,,144,294,49.0,1856,12,328,1040,3.2,5,622,2896,4.7,79,59,22,160,68,628,8,13,21
7014,1,2014-09-01,miami-fl,@,Louisville,L (13-31),17,29,58.6,174,1,27,70,2.6,0,56,244,4.4,6,4,2,12,7,46,1,2,3
7015,2,2014-09-06,miami-fl,,Florida A&M,W (41-7),17,30,56.7,218,2,33,198,6.0,3,63,416,6.6,10,10,1,21,4,40,1,2,3
7016,3,2014-09-13,miami-fl,,Arkansas State,W (41-20),16,26,61.5,342,4,35,146,4.2,2,61,488,8.0,9,8,3,20,11,93,1,1,2
7017,4,2014-09-20,miami-fl,@,Nebraska,L (31-41),28,42,66.7,359,3,23,76,3.3,1,65,435,6.7,16,6,2,24,9,82,1,2,3
7018,5,2014-09-27,miami-fl,,Duke,W (22-10),20,34,58.8,223,2,41,203,5.0,1,75,426,5.7,9,12,0,21,8,93,2,0,2
7019,6,2014-10-04,miami-fl,@,Georgia Tech,L (17-28),16,25,64.0,245,1,19,107,5.6,1,44,352,8.0,11,6,2,19,5,38,0,2,2
7020,7,2014-10-11,miami-fl,,Cincinnati,W (55-34),17,25,68.0,286,3,35,335,9.6,3,60,621,10.4,9,9,2,20,13,155,1,0,1
7021,8,2014-10-23,miami-fl,@,Virginia Tech,W (30-6),7,16,43.8,92,1,53,364,6.9,3,69,456,6.6,5,16,1,22,4,28,0,0,0
7022,9,2014-11-01,miami-fl,,North Carolina,W (47-20),12,19,63.2,199,3,49,295,6.0,3,68,494,7.3,9,14,0,23,6,45,1,0,1
7023,10,2014-11-15,miami-fl,,Florida State,L (26-30),16,34,47.1,316,2,40,176,4.4,1,74,492,6.6,9,10,0,19,5,51,2,1,3
7024,11,2014-11-22,miami-fl,@,Virginia,L (13-30),20,33,60.6,263,1,23,64,2.8,0,56,327,5.8,10,4,1,15,9,59,1,1,2
7025,12,2014-11-29,miami-fl,,Pittsburgh,L (23-35),22,45,48.9,296,2,28,125,4.5,0,73,421,5.8,14,5,2,21,7,57,0,0,0
7026,13,2014-12-27,miami-fl,N,South Carolina*,L (21-24),19,33,57.6,236,1,40,186,4.7,1,73,422,5.8,10,10,1,21,5,40,1,1,2
7027,,13 Games,miami-fl,,,,227,391,58.1,3249,26,446,2345,5.3,19,837,5594,6.7,127,114,17,258,93,827,12,12,24
7028,1,2015-09-05,miami-fl,,Bethune-Cookman,W (45-0),17,31,54.8,184,2,26,195,7.5,3,57,379,6.6,10,9,1,20,4,30,1,0,1
7029,2,2015-09-11,miami-fl,@,Florida Atlantic,W (44-20),22,34,64.7,300,1,44,226,5.1,4,78,526,6.7,13,12,2,27,8,64,0,0,0
7030,3,2015-09-19,miami-fl,,Nebraska,W (36-33),25,42,59.5,379,2,33,132,4.0,1,75,511,6.8,18,4,2,24,13,114,0,1,1
7031,4,2015-10-01,miami-fl,@,Cincinnati,L (23-34),25,40,62.5,281,0,32,146,4.6,2,72,427,5.9,12,7,2,21,6,50,0,0,0
7032,5,2015-10-10,miami-fl,@,Florida State,L (24-29),29,49,59.2,405,3,19,20,1.1,0,68,425,6.3,17,2,0,19,7,73,0,0,0
7033,6,2015-10-17,miami-fl,,Virginia Tech,W (30-20),19,30,63.3,296,2,39,99,2.5,1,69,395,5.7,12,5,3,20,9,81,0,0,0
7034,7,2015-10-24,miami-fl,,Clemson,L (0-58),13,32,40.6,93,0,29,53,1.8,0,61,146,2.4,2,4,0,6,7,88,0,3,3
7035,8,2015-10-31,miami-fl,@,Duke,W (30-27),20,29,69.0,272,2,39,119,3.1,0,68,391,5.8,12,7,2,21,23,194,1,1,2
7036,9,2015-11-07,miami-fl,,Virginia,W (27-21),20,26,76.9,286,2,33,143,4.3,1,59,429,7.3,9,7,2,18,7,52,0,1,1
7037,10,2015-11-14,miami-fl,@,North Carolina,L (21-59),24,43,55.8,326,1,32,99,3.1,2,75,425,5.7,17,6,2,25,12,103,1,1,2
7038,11,2015-11-21,miami-fl,,Georgia Tech,W (38-21),16,26,61.5,300,1,28,86,3.1,3,54,386,7.1,11,4,0,15,9,76,0,0,0
7039,12,2015-11-27,miami-fl,@,Pittsburgh,W (29-24),21,35,60.0,261,1,40,116,2.9,1,75,377,5.0,10,8,2,20,7,64,0,0,0
7040,13,2015-12-26,miami-fl,N,Washington State*,L (14-20),17,32,53.1,219,1,30,125,4.2,1,62,344,5.5,9,4,0,13,9,105,1,2,3
7041,,13 Games,miami-fl,,,,268,449,59.7,3602,18,424,1559,3.7,19,873,5161,5.9,152,79,18,249,121,1094,4,9,13
7042,1,2016-09-03,miami-fl,,Florida A&M,W (70-3),13,21,61.9,150,4,36,373,10.4,5,57,523,9.2,8,13,1,22,6,54,1,0,1
7043,2,2016-09-10,miami-fl,,Florida Atlantic,W (38-10),17,31,54.8,191,0,39,279,7.2,5,70,470,6.7,8,13,0,21,9,90,0,2,2
7044,3,2016-09-17,miami-fl,@,Appalachian State,W (45-10),22,28,78.6,385,3,31,164,5.3,3,59,549,9.3,15,3,0,18,9,73,0,1,1
7045,4,2016-10-01,miami-fl,@,Georgia Tech,W (35-21),13,19,68.4,241,1,27,114,4.2,2,46,355,7.7,10,7,1,18,4,39,0,0,0
7046,5,2016-10-08,miami-fl,,Florida State,L (19-20),19,32,59.4,214,2,28,62,2.2,0,60,276,4.6,10,5,5,20,10,110,0,1,1
7047,6,2016-10-15,miami-fl,,North Carolina,L (13-20),16,32,50.0,224,0,36,139,3.9,1,68,363,5.3,10,6,1,17,4,43,1,0,1
7048,7,2016-10-20,miami-fl,@,Virginia Tech,L (16-37),23,38,60.5,323,2,29,42,1.4,0,67,365,5.4,12,3,0,15,6,62,0,1,1
7049,8,2016-10-29,miami-fl,@,Notre Dame,L (27-30),26,42,61.9,288,1,35,18,0.5,1,77,306,4.0,15,3,2,20,10,86,0,1,1
7050,9,2016-11-05,miami-fl,,Pittsburgh,W (51-28),32,47,68.1,356,4,36,178,4.9,2,83,534,6.4,15,7,0,22,8,71,0,0,0
7051,10,2016-11-12,miami-fl,@,Virginia,W (34-14),14,29,48.3,228,2,42,222,5.3,2,71,450,6.3,6,12,2,20,7,45,1,1,2
7052,11,2016-11-19,miami-fl,@,North Carolina State,W (27-13),22,38,57.9,286,0,32,129,4.0,3,70,415,5.9,14,8,2,24,6,45,0,0,0
7053,12,2016-11-26,miami-fl,,Duke,W (40-21),22,35,62.9,396,4,30,172,5.7,0,65,568,8.7,11,11,2,24,8,69,0,0,0
7054,13,2016-12-28,miami-fl,N,West Virginia*,W (31-14),24,34,70.6,282,4,34,81,2.4,0,68,363,5.3,14,4,2,20,8,89,0,0,0
7055,,13 Games,miami-fl,,,,263,426,61.7,3564,27,435,1973,4.5,24,861,5537,6.4,148,95,18,261,95,876,3,7,10
7056,1,2017-09-02,miami-fl,,Bethune-Cookman,W (41-13),18,31,58.1,233,3,34,317,9.3,2,65,550,8.5,11,15,2,28,7,68,0,0,0
7057,2,2017-09-23,miami-fl,,Toledo,W (52-30),27,36,75.0,333,3,26,254,9.8,4,62,587,9.5,13,12,2,27,8,75,0,1,1
7058,3,2017-09-29,miami-fl,@,Duke,W (31-6),15,26,57.7,270,2,35,139,4.0,2,61,409,6.7,9,8,2,19,5,59,0,1,1
7059,4,2017-10-07,miami-fl,@,Florida State,W (24-20),19,44,43.2,254,3,29,83,2.9,0,73,337,4.6,12,6,2,20,6,79,0,1,1
7060,5,2017-10-14,miami-fl,,Georgia Tech,W (25-24),23,38,60.5,297,1,36,184,5.1,1,74,481,6.5,12,12,0,24,6,45,0,0,0
7061,6,2017-10-21,miami-fl,,Syracuse,W (27-19),26,43,60.5,344,2,32,136,4.3,1,75,480,6.4,14,7,1,22,5,42,1,0,1
7062,7,2017-10-28,miami-fl,@,North Carolina,W (24-19),17,41,41.5,356,3,32,59,1.8,0,73,415,5.7,10,4,2,16,5,60,1,1,2
7063,8,2017-11-04,miami-fl,,Virginia Tech,W (28-10),12,24,50.0,219,2,33,211,6.4,2,57,430,7.5,11,7,3,21,7,66,0,3,3
7064,9,2017-11-11,miami-fl,,Notre Dame,W (41-8),15,24,62.5,137,1,42,237,5.6,3,66,374,5.7,6,11,1,18,1,5,0,0,0
7065,10,2017-11-18,miami-fl,,Virginia,W (44-28),15,28,53.6,210,3,32,148,4.6,2,60,358,6.0,10,5,0,15,4,40,0,2,2
7066,11,2017-11-24,miami-fl,@,Pittsburgh,L (14-24),15,36,41.7,187,2,23,45,2.0,0,59,232,3.9,9,4,1,14,6,52,1,0,1
7067,12,2017-12-02,miami-fl,N,Clemson,L (3-38),14,29,48.3,110,0,30,104,3.5,0,59,214,3.6,3,7,0,10,4,30,1,2,3
7068,13,2017-12-30,miami-fl,,Wisconsin*,L (24-34),11,26,42.3,203,1,29,174,6.0,2,55,377,6.9,8,8,1,17,4,20,0,3,3
7069,,13 Games,miami-fl,,,,227,426,53.3,3153,26,413,2091,5.1,19,839,5244,6.3,128,106,17,251,68,641,4,14,18
7070,1,2018-09-02,miami-fl,N,Louisiana State,L (17-33),15,35,42.9,259,1,34,83,2.4,1,69,342,5.0,9,6,3,18,11,85,0,2,2
7071,2,2018-09-08,miami-fl,,Savannah State,W (77-0),19,31,61.3,255,5,37,239,6.5,5,68,494,7.3,8,11,1,20,1,15,1,1,2
7072,3,2018-09-15,miami-fl,@,Toledo,W (49-24),13,23,56.5,205,2,53,268,5.1,5,76,473,6.2,7,16,1,24,0,0,0,0,0
7073,4,2018-09-22,miami-fl,,Florida International,W (31-17),20,29,69.0,240,3,49,248,5.1,1,78,488,6.3,11,15,1,27,6,60,1,1,2
7074,5,2018-09-27,miami-fl,,North Carolina,W (47-10),8,12,66.7,125,1,34,229,6.7,2,46,354,7.7,4,10,0,14,7,65,1,1,2
7075,6,2018-10-06,miami-fl,,Florida State,W (28-27),13,32,40.6,204,4,46,102,2.2,0,78,306,3.9,8,9,3,20,6,50,1,0,1
7076,7,2018-10-13,miami-fl,@,Virginia,L (13-16),15,29,51.7,190,0,29,149,5.1,1,58,339,5.8,9,6,1,16,8,71,0,3,3
7077,8,2018-10-26,miami-fl,@,Boston College,L (14-27),19,39,48.7,150,1,36,155,4.3,1,75,305,4.1,8,10,1,19,6,28,0,2,2
7078,9,2018-11-03,miami-fl,,Duke,L (12-20),13,28,46.4,111,0,44,300,6.8,2,72,411,5.7,5,10,1,16,6,73,2,0,2
7079,10,2018-11-10,miami-fl,@,Georgia Tech,L (21-27),14,23,60.9,165,0,30,134,4.5,3,53,299,5.6,6,7,0,13,7,49,3,0,3
7080,11,2018-11-17,miami-fl,@,Virginia Tech,W (38-14),21,34,61.8,171,2,32,168,5.3,2,66,339,5.1,7,8,2,17,11,71,0,0,0
7081,,11 Games,miami-fl,,,,170,315,54.0,2075,19,424,2075,4.9,23,739,4150,5.6,82,108,14,204,69,567,9,10,19
7082,1,2014-08-29,syracuse,,Villanova,W (27-26),22,35,62.9,184,1,34,136,4.0,2,69,320,4.6,12,4,5,21,7,55,0,0,0
7083,2,2014-09-13,syracuse,@,Central Michigan,W (40-3),20,30,66.7,175,1,49,289,5.9,3,79,464,5.9,9,15,1,25,9,41,0,0,0
7084,3,2014-09-20,syracuse,,Maryland,L (20-34),14,28,50.0,219,0,51,370,7.3,2,79,589,7.5,9,15,2,26,8,69,1,1,2
7085,4,2014-09-27,syracuse,N,Notre Dame,L (15-31),22,38,57.9,294,0,30,135,4.5,1,68,429,6.3,9,6,2,17,10,85,0,1,1
7086,5,2014-10-03,syracuse,,Louisville,L (6-28),17,37,45.9,201,0,26,44,1.7,0,63,245,3.9,7,6,1,14,7,60,0,2,2
7087,6,2014-10-11,syracuse,,Florida State,L (20-38),21,36,58.3,256,2,31,156,5.0,0,67,412,6.1,11,8,1,20,7,64,0,3,3
7088,7,2014-10-18,syracuse,@,Wake Forest,W (30-7),22,32,68.8,171,0,38,199,5.2,1,70,370,5.3,9,7,1,17,6,55,0,0,0
7089,8,2014-10-25,syracuse,@,Clemson,L (6-16),12,28,42.9,82,0,34,88,2.6,0,62,170,2.7,4,6,0,10,5,30,1,2,3
7090,9,2014-11-01,syracuse,,North Carolina State,L (17-24),22,42,52.4,307,2,37,38,1.0,0,79,345,4.4,10,8,2,20,6,61,1,2,3
7091,10,2014-11-08,syracuse,,Duke,L (10-27),17,32,53.1,105,0,37,119,3.2,1,69,224,3.2,4,7,1,12,7,55,0,2,2
7092,11,2014-11-22,syracuse,@,Pittsburgh,L (7-30),10,25,40.0,149,0,29,106,3.7,1,54,255,4.7,7,5,0,12,6,67,1,2,3
7093,12,2014-11-29,syracuse,@,Boston College,L (7-28),8,20,40.0,66,0,28,62,2.2,1,48,128,2.7,2,5,1,8,8,67,0,2,2
7094,,12 Games,syracuse,,,,207,383,54.0,2209,6,424,1742,4.1,12,807,3951,4.9,93,92,17,202,86,709,4,17,21
7095,1,2015-09-04,syracuse,,Rhode Island,W (47-0),10,20,50.0,114,2,58,312,5.4,2,78,426,5.5,6,16,1,23,3,36,0,1,1
7096,2,2015-09-12,syracuse,,Wake Forest,W (30-17),8,14,57.1,221,2,37,149,4.0,0,51,370,7.3,5,9,1,15,4,30,0,0,0
7097,3,2015-09-19,syracuse,,Central Michigan,W (30-27),11,17,64.7,161,2,30,165,5.5,2,47,326,6.9,6,5,0,11,6,60,0,1,1
7098,4,2015-09-26,syracuse,,Louisiana State,L (24-34),16,38,42.1,154,3,31,127,4.1,0,69,281,4.1,8,8,5,21,4,36,0,1,1
7099,5,2015-10-10,syracuse,@,South Florida,L (24-45),21,34,61.8,232,2,33,73,2.2,1,67,305,4.6,12,7,4,23,6,64,2,1,3
7100,6,2015-10-17,syracuse,@,Virginia,L (38-44),16,22,72.7,150,2,43,184,4.3,2,65,334,5.1,8,10,3,21,4,32,2,0,2
7101,7,2015-10-24,syracuse,,Pittsburgh,L (20-23),22,31,71.0,217,2,23,136,5.9,0,54,353,6.5,10,5,1,16,4,39,0,2,2
7102,8,2015-10-31,syracuse,@,Florida State,L (21-45),12,25,48.0,130,0,42,173,4.1,2,67,303,4.5,3,11,0,14,5,45,1,0,1
7103,9,2015-11-07,syracuse,@,Louisville,L (17-41),19,37,51.4,184,1,36,102,2.8,1,73,286,3.9,6,5,2,13,4,20,1,2,3
7104,10,2015-11-14,syracuse,,Clemson,L (27-37),8,21,38.1,80,0,34,242,7.1,3,55,322,5.9,4,10,2,16,9,83,1,0,1
7105,11,2015-11-21,syracuse,@,North Carolina State,L (29-42),10,21,47.6,152,2,32,140,4.4,1,53,292,5.5,6,5,4,15,9,77,1,1,2
7106,12,2015-11-28,syracuse,,Boston College,W (20-17),12,27,44.4,88,1,45,155,3.4,1,72,243,3.4,5,8,4,17,6,55,1,0,1
7107,,12 Games,syracuse,,,,165,307,53.7,1883,19,444,1958,4.4,15,751,3841,5.1,79,99,27,205,64,577,9,9,18
7108,1,2016-09-02,syracuse,,Colgate,W (33-7),40,46,87.0,437,2,35,117,3.3,1,81,554,6.8,18,5,2,25,6,55,1,0,1
7109,2,2016-09-09,syracuse,,Louisville,L (28-62),27,53,50.9,293,3,40,121,3.0,1,93,414,4.5,12,9,3,24,8,55,1,1,2
7110,3,2016-09-17,syracuse,,South Florida,L (20-45),32,50,64.0,350,2,55,199,3.6,0,105,549,5.2,16,11,3,30,10,69,1,2,3
7111,4,2016-09-24,syracuse,@,Connecticut,W (31-24),26,40,65.0,407,2,26,62,2.4,1,66,469,7.1,16,3,0,19,4,25,0,0,0
7112,5,2016-10-01,syracuse,N,Notre Dame,L (33-50),31,51,60.8,363,2,37,126,3.4,3,88,489,5.6,16,6,3,25,5,45,0,0,0
7113,6,2016-10-08,syracuse,@,Wake Forest,L (9-28),17,26,65.4,168,0,40,158,4.0,1,66,326,4.9,8,6,0,14,7,63,1,1,2
7114,7,2016-10-15,syracuse,,Virginia Tech,W (31-17),30,55,54.5,405,2,45,156,3.5,2,100,561,5.6,18,11,3,32,8,55,0,1,1
7115,8,2016-10-22,syracuse,@,Boston College,W (28-20),32,38,84.2,434,3,33,99,3.0,1,71,533,7.5,14,5,4,23,16,135,2,1,3
7116,9,2016-11-05,syracuse,@,Clemson,L (0-54),24,40,60.0,172,0,28,105,3.8,0,68,277,4.1,10,4,1,15,10,55,0,3,3
7117,10,2016-11-12,syracuse,,North Carolina State,L (20-35),14,25,56.0,190,1,28,28,1.0,1,53,218,4.1,5,4,1,10,5,45,1,1,2
7118,11,2016-11-19,syracuse,,Florida State,L (14-45),16,37,43.2,196,2,35,37,1.1,0,72,233,3.2,9,1,3,13,10,77,0,2,2
7119,12,2016-11-26,syracuse,@,Pittsburgh,L (61-76),43,61,70.5,440,5,45,228,5.1,4,106,668,6.3,21,14,3,38,7,50,0,1,1
7120,,12 Games,syracuse,,,,332,522,63.6,3855,24,447,1436,3.2,15,969,5291,5.5,163,79,26,268,96,729,7,13,20
7121,1,2017-09-01,syracuse,,Central Connecticut State,W (50-7),37,52,71.2,431,3,41,155,3.8,3,93,586,6.3,21,10,3,34,4,28,2,0,2
7122,2,2017-09-09,syracuse,,Middle Tennessee State,L (23-30),27,44,61.4,182,0,49,126,2.6,2,93,308,3.3,9,10,6,25,4,40,1,1,2
7123,3,2017-09-16,syracuse,,Central Michigan,W (41-17),19,35,54.3,279,2,44,300,6.8,2,79,579,7.3,9,7,2,18,9,104,2,1,3
7124,4,2017-09-23,syracuse,@,Louisiana State,L (26-35),34,55,61.8,308,2,27,76,2.8,1,82,384,4.7,17,6,1,24,7,38,0,1,1
7125,5,2017-09-30,syracuse,@,North Carolina State,L (25-33),30,48,62.5,385,1,30,59,2.0,2,78,444,5.7,13,5,2,20,12,93,0,1,1
7126,6,2017-10-07,syracuse,,Pittsburgh,W (27-24),33,49,67.3,365,2,42,135,3.2,1,91,500,5.5,14,9,3,26,9,58,0,0,0
7127,7,2017-10-13,syracuse,,Clemson,W (27-24),20,33,60.6,278,3,50,162,3.2,0,83,440,5.3,12,11,5,28,12,100,1,0,1
7128,8,2017-10-21,syracuse,@,Miami (FL),L (19-27),14,42,33.3,135,0,51,264,5.2,1,93,399,4.3,7,15,1,23,3,22,0,4,4
7129,9,2017-11-04,syracuse,@,Florida State,L (24-27),31,55,56.4,314,2,40,149,3.7,1,95,463,4.9,14,6,1,21,2,20,0,1,1
7130,10,2017-11-11,syracuse,,Wake Forest,L (43-64),38,67,56.7,443,3,32,178,5.6,2,99,621,6.3,22,9,2,33,3,25,0,2,2
7131,11,2017-11-18,syracuse,@,Louisville,L (10-56),13,34,38.2,138,0,45,197,4.4,1,79,335,4.2,8,12,2,22,7,52,0,4,4
7132,12,2017-11-25,syracuse,,Boston College,L (14-42),24,34,70.6,280,2,28,137,4.9,0,62,417,6.7,11,8,0,19,2,13,2,1,3
7133,,12 Games,syracuse,,,,320,548,58.4,3538,20,479,1938,4.0,16,1027,5476,5.3,157,108,28,293,74,593,8,16,24
7134,1,2018-08-31,syracuse,@,Western Michigan,W (55-42),11,28,39.3,226,2,62,334,5.4,5,90,560,6.2,7,17,2,26,5,45,1,0,1
7135,2,2018-09-08,syracuse,,Wagner,W (62-10),24,37,64.9,241,5,43,215,5.0,2,80,456,5.7,13,13,0,26,5,50,0,1,1
7136,3,2018-09-15,syracuse,,Florida State,W (30-7),18,31,58.1,219,1,57,222,3.9,2,88,441,5.0,10,11,4,25,8,33,0,0,0
7137,4,2018-09-22,syracuse,,Connecticut,W (51-21),22,32,68.8,295,2,46,341,7.4,3,78,636,8.2,11,15,0,26,11,100,1,0,1
7138,5,2018-09-29,syracuse,@,Clemson,L (23-27),26,41,63.4,250,0,26,61,2.3,2,67,311,4.6,8,4,0,12,5,31,0,1,1
7139,6,2018-10-06,syracuse,@,Pittsburgh,L (37-44),18,38,47.4,195,1,40,189,4.7,3,78,384,4.9,9,10,1,20,5,24,1,2,3
7140,7,2018-10-20,syracuse,,North Carolina,W (40-37),28,52,53.8,406,3,33,140,4.2,2,85,546,6.4,15,8,2,25,6,53,1,1,2
7141,8,2018-10-27,syracuse,,North Carolina State,W (51-41),30,42,71.4,480,3,37,81,2.2,3,79,561,7.1,19,5,6,30,9,65,0,0,0
7142,9,2018-11-03,syracuse,@,Wake Forest,W (41-24),23,35,65.7,157,0,60,264,4.4,5,95,421,4.4,7,15,3,25,9,77,0,0,0
7143,10,2018-11-09,syracuse,,Louisville,W (54-23),14,27,51.9,192,1,54,344,6.4,5,81,536,6.6,6,13,4,23,7,65,2,1,3
7144,11,2018-11-17,syracuse,N,Notre Dame,L (3-36),15,35,42.9,115,0,38,119,3.1,0,73,234,3.2,6,9,1,16,3,45,0,3,3
7145,,11 Games,syracuse,,,,229,398,57.5,2776,18,496,2310,4.7,32,894,5086,5.7,111,120,23,254,73,588,6,9,15
7146,1,2014-08-30,virginia-tech,,William & Mary,W (34-9),24,31,77.4,266,2,42,222,5.3,2,73,488,6.7,9,12,3,24,10,75,1,1,2
7147,2,2014-09-06,virginia-tech,@,Ohio State,W (35-21),23,36,63.9,199,2,41,125,3.0,2,77,324,4.2,12,7,2,21,10,107,1,2,3
7148,3,2014-09-13,virginia-tech,,East Carolina,L (21-28),30,56,53.6,298,3,33,91,2.8,0,89,389,4.4,17,6,3,26,8,64,0,2,2
7149,4,2014-09-20,virginia-tech,,Georgia Tech,L (24-27),28,39,71.8,297,0,33,127,3.8,2,72,424,5.9,17,7,0,24,12,79,0,3,3
7150,5,2014-09-27,virginia-tech,,Western Michigan,W (35-17),14,32,43.8,178,2,47,308,6.6,1,79,486,6.2,9,13,4,26,9,69,0,2,2
7151,6,2014-10-04,virginia-tech,@,North Carolina,W (34-17),18,27,66.7,186,1,57,171,3.0,2,84,357,4.3,9,9,2,20,8,45,0,1,1
7152,7,2014-10-16,virginia-tech,@,Pittsburgh,L (16-21),26,45,57.8,265,1,22,26,1.2,0,67,291,4.3,12,2,2,16,8,45,1,0,1
7153,8,2014-10-23,virginia-tech,,Miami (FL),L (6-30),18,28,64.3,142,1,31,120,3.9,0,59,262,4.4,6,7,2,15,4,40,3,0,3
7154,9,2014-11-01,virginia-tech,,Boston College,L (31-33),31,49,63.3,345,2,29,69,2.4,2,78,414,5.3,12,5,0,17,6,40,1,0,1
7155,10,2014-11-15,virginia-tech,@,Duke,W (17-16),13,24,54.2,148,2,49,145,3.0,0,73,293,4.0,5,10,1,16,7,75,0,1,1
7156,11,2014-11-22,virginia-tech,@,Wake Forest,L (3-6),16,29,55.2,143,0,39,111,2.8,0,68,254,3.7,7,8,2,17,4,25,2,1,3
7157,12,2014-11-28,virginia-tech,,Virginia,W (24-20),15,35,42.9,235,2,40,198,5.0,0,75,433,5.8,10,9,2,21,8,71,2,1,3
7158,13,2014-12-27,virginia-tech,N,Cincinnati*,W (33-17),15,25,60.0,124,1,44,210,4.8,1,69,334,4.8,5,10,3,18,4,35,0,1,1
7159,,13 Games,virginia-tech,,,,271,456,59.4,2826,19,507,1923,3.8,12,963,4749,4.9,130,105,26,261,98,770,11,15,26
7160,1,2015-09-07,virginia-tech,,Ohio State,L (24-42),15,25,60.0,192,3,44,128,2.9,0,69,320,4.6,7,10,1,18,5,50,1,1,2
7161,2,2015-09-12,virginia-tech,,Furman,W (42-3),19,31,61.3,284,2,41,299,7.3,3,72,583,8.1,10,14,1,25,11,114,0,0,0
7162,3,2015-09-19,virginia-tech,@,Purdue,W (51-24),16,26,61.5,233,2,56,238,4.3,2,82,471,5.7,9,11,0,20,11,87,1,0,1
7163,4,2015-09-26,virginia-tech,@,East Carolina,L (28-35),20,35,57.1,281,1,42,158,3.8,3,77,439,5.7,10,8,2,20,11,89,0,1,1
7164,5,2015-10-03,virginia-tech,,Pittsburgh,L (13-17),9,20,45.0,91,1,33,9,0.3,0,53,100,1.9,6,4,2,12,5,40,0,3,3
7165,6,2015-10-09,virginia-tech,,North Carolina State,W (28-13),14,29,48.3,158,3,36,200,5.6,1,65,358,5.5,6,9,5,20,7,48,0,0,0
7166,7,2015-10-17,virginia-tech,@,Miami (FL),L (20-30),17,27,63.0,201,2,35,160,4.6,0,62,361,5.8,8,11,1,20,8,69,1,3,4
7167,8,2015-10-24,virginia-tech,,Duke,L (43-45),24,47,51.1,270,3,53,182,3.4,2,100,452,4.5,15,13,0,28,5,35,0,0,0
7168,9,2015-10-31,virginia-tech,@,Boston College,W (26-10),16,23,69.6,194,1,46,81,1.8,0,69,275,4.0,9,6,2,17,11,98,1,1,2
7169,10,2015-11-12,virginia-tech,@,Georgia Tech,W (23-21),15,29,51.7,178,1,39,165,4.2,2,68,343,5.0,7,9,1,17,8,58,1,1,2
7170,11,2015-11-21,virginia-tech,,North Carolina,L (27-30),20,35,57.1,273,2,47,130,2.8,1,82,403,4.9,13,7,2,22,6,54,1,2,3
7171,12,2015-11-28,virginia-tech,@,Virginia,W (23-20),15,29,51.7,237,2,30,67,2.2,0,59,304,5.2,7,4,1,12,3,35,0,1,1
7172,13,2015-12-26,virginia-tech,N,Tulsa*,W (55-52),23,38,60.5,344,1,43,254,5.9,5,81,598,7.4,16,12,2,30,5,40,1,1,2
7173,,13 Games,virginia-tech,,,,223,394,56.6,2936,24,545,2071,3.8,19,939,5007,5.3,123,118,20,261,96,817,7,14,21
7174,1,2016-09-03,virginia-tech,,Liberty,W (36-13),25,41,61.0,252,4,48,206,4.3,0,89,458,5.1,15,8,1,24,4,33,4,0,4
7175,2,2016-09-10,virginia-tech,N,Tennessee,L (24-45),20,28,71.4,214,1,45,186,4.1,2,73,400,5.5,11,7,3,21,8,101,5,0,5
7176,3,2016-09-17,virginia-tech,,Boston College,W (49-0),16,27,59.3,253,5,50,223,4.5,2,77,476,6.2,10,12,3,25,7,55,0,1,1
7177,4,2016-09-24,virginia-tech,,East Carolina,W (54-17),15,23,65.2,295,3,45,167,3.7,3,68,462,6.8,11,6,1,18,4,28,0,0,0
7178,5,2016-10-08,virginia-tech,@,North Carolina,W (34-3),7,17,41.2,75,2,66,189,2.9,2,83,264,3.2,4,12,2,18,5,29,2,0,2
7179,6,2016-10-15,virginia-tech,@,Syracuse,L (17-31),20,33,60.6,307,2,39,161,4.1,0,72,468,6.5,15,6,0,21,7,53,1,1,2
7180,7,2016-10-20,virginia-tech,,Miami (FL),W (37-16),22,34,64.7,272,3,44,251,5.7,1,78,523,6.7,14,11,3,28,2,25,0,0,0
7181,8,2016-10-27,virginia-tech,@,Pittsburgh,W (39-36),24,43,55.8,406,2,39,150,3.8,1,82,556,6.8,19,8,2,29,4,35,0,0,0
7182,9,2016-11-05,virginia-tech,@,Duke,W (24-21),15,27,55.6,192,0,52,207,4.0,2,79,399,5.1,9,13,1,23,6,58,0,0,0
7183,10,2016-11-12,virginia-tech,,Georgia Tech,L (20-30),32,47,68.1,316,1,33,121,3.7,2,80,437,5.5,16,9,0,25,4,35,2,2,4
7184,11,2016-11-19,virginia-tech,@,Notre Dame,W (34-31),22,29,75.9,267,2,47,152,3.2,2,76,419,5.5,9,13,3,25,5,35,1,1,2
7185,12,2016-11-26,virginia-tech,,Virginia,W (52-10),18,30,60.0,290,3,51,289,5.7,3,81,579,7.1,13,15,1,29,3,35,2,0,2
7186,13,2016-12-03,virginia-tech,N,Clemson,L (35-42),22,36,61.1,284,1,35,102,2.9,4,71,386,5.4,12,5,2,19,8,89,0,2,2
7187,14,2016-12-29,virginia-tech,N,Arkansas*,W (35-24),21,34,61.8,243,2,41,170,4.1,3,75,413,5.5,14,9,2,26,4,55,1,1,2
7188,,14 Games,virginia-tech,,,,279,449,62.1,3666,31,635,2574,4.1,27,1084,6240,5.8,172,134,24,331,71,666,18,8,26
7189,1,2017-09-03,virginia-tech,N,West Virginia,W (31-24),15,27,55.6,235,1,45,234,5.2,3,72,469,6.5,8,11,2,21,5,34,0,0,0
7190,2,2017-09-09,virginia-tech,,Delaware,W (27-0),16,28,57.1,222,2,27,81,3.0,0,55,303,5.5,9,4,2,15,2,10,1,0,1
7191,3,2017-09-16,virginia-tech,@,East Carolina,W (64-17),25,33,75.8,388,5,62,287,4.6,3,95,675,7.1,16,16,2,34,7,69,0,0,0
7192,4,2017-09-23,virginia-tech,,Old Dominion,W (38-0),21,32,65.6,311,3,57,271,4.8,2,89,582,6.5,16,14,2,32,2,25,0,1,1
7193,5,2017-09-30,virginia-tech,,Clemson,L (17-31),30,45,66.7,252,1,28,90,3.2,1,73,342,4.7,11,6,0,17,4,31,1,2,3
7194,6,2017-10-07,virginia-tech,@,Boston College,W (23-10),22,33,66.7,322,1,48,109,2.3,1,81,431,5.3,14,6,0,20,9,67,0,1,1
7195,7,2017-10-21,virginia-tech,,North Carolina,W (59-7),15,27,55.6,202,4,46,181,3.9,1,73,383,5.2,11,7,3,21,7,60,0,0,0
7196,8,2017-10-28,virginia-tech,,Duke,W (24-3),13,27,48.1,200,1,48,187,3.9,2,75,387,5.2,9,11,3,23,3,40,0,0,0
7197,9,2017-11-04,virginia-tech,@,Miami (FL),L (10-28),20,32,62.5,197,0,43,102,2.4,1,75,299,4.0,11,8,3,22,4,60,2,2,4
7198,10,2017-11-11,virginia-tech,@,Georgia Tech,L (22-28),14,26,53.8,153,0,36,105,2.9,2,62,258,4.2,7,6,1,14,4,42,0,0,0
7199,11,2017-11-18,virginia-tech,,Pittsburgh,W (20-14),17,37,45.9,218,1,40,157,3.9,1,77,375,4.9,11,7,0,18,4,25,0,1,1
7200,12,2017-11-24,virginia-tech,@,Virginia,W (10-0),14,21,66.7,143,1,53,202,3.8,0,74,345,4.7,7,12,1,20,4,20,0,1,1
7201,13,2017-12-28,virginia-tech,N,Oklahoma State*,L (21-30),23,42,54.8,270,1,50,248,5.0,2,92,518,5.6,12,18,1,31,5,65,1,1,2
7202,,13 Games,virginia-tech,,,,245,410,59.8,3113,21,583,2254,3.9,19,993,5367,5.4,142,126,20,288,60,548,5,9,14
7203,1,2018-09-03,virginia-tech,@,Florida State,W (24-3),16,26,61.5,207,2,37,112,3.0,0,63,319,5.1,8,7,0,15,5,55,0,0,0
7204,2,2018-09-08,virginia-tech,,William & Mary,W (62-17),16,23,69.6,281,1,46,305,6.6,7,69,586,8.5,14,16,2,32,2,20,1,0,1
7205,3,2018-09-22,virginia-tech,@,Old Dominion,L (35-49),17,34,50.0,282,3,49,318,6.5,2,83,600,7.2,11,15,0,26,7,95,0,1,1
7206,4,2018-09-29,virginia-tech,@,Duke,W (31-14),17,28,60.7,332,3,41,81,2.0,1,69,413,6.0,13,4,0,17,4,26,0,0,0
7207,5,2018-10-06,virginia-tech,,Notre Dame,L (23-45),31,52,59.6,309,2,33,132,4.0,0,85,441,5.2,18,6,1,25,6,41,1,1,2
7208,6,2018-10-13,virginia-tech,@,North Carolina,W (22-19),20,36,55.6,221,2,41,154,3.8,1,77,375,4.9,12,8,0,20,8,59,0,2,2
7209,7,2018-10-25,virginia-tech,,Georgia Tech,L (28-49),15,22,68.2,201,2,25,122,4.9,2,47,323,6.9,8,7,1,16,8,87,1,0,1
7210,8,2018-11-03,virginia-tech,,Boston College,L (21-31),25,43,58.1,281,3,36,111,3.1,0,79,392,5.0,14,8,1,23,8,59,1,1,2
7211,9,2018-11-10,virginia-tech,@,Pittsburgh,L (22-52),23,38,60.5,240,3,48,192,4.0,0,86,432,5.0,10,15,3,28,3,34,0,0,0
7212,10,2018-11-17,virginia-tech,,Miami (FL),L (14-38),18,36,50.0,216,1,33,119,3.6,1,69,335,4.9,12,8,2,22,3,35,1,2,3
7213,,10 Games,virginia-tech,,,,198,338,58.6,2570,22,389,1646,4.2,14,727,4216,5.8,120,94,10,224,54,511,5,7,12
7214,1,2014-08-30,west-virginia,N,Alabama,L (23-33),29,45,64.4,365,1,24,28,1.2,0,69,393,5.7,17,5,0,22,6,55,0,0,0
7215,2,2014-09-06,west-virginia,,Towson,W (54-0),38,44,86.4,355,2,52,251,4.8,5,96,606,6.3,18,14,1,33,3,35,1,0,1
7216,3,2014-09-13,west-virginia,@,Maryland,W (40-37),37,49,75.5,511,4,59,183,3.1,1,108,694,6.4,18,13,2,33,4,40,3,1,4
7217,4,2014-09-20,west-virginia,,Oklahoma,L (33-45),25,41,61.0,376,2,40,137,3.4,2,81,513,6.3,14,9,3,26,5,55,1,2,3
7218,5,2014-10-04,west-virginia,,Kansas,W (33-14),20,37,54.1,302,1,42,255,6.1,1,79,557,7.1,11,9,5,25,5,45,2,1,3
7219,6,2014-10-11,west-virginia,@,Texas Tech,W (37-34),28,44,63.6,301,2,50,249,5.0,2,94,550,5.9,14,11,4,29,7,63,1,0,1
7220,7,2014-10-18,west-virginia,,Baylor,W (41-27),23,35,65.7,322,3,50,134,2.7,2,85,456,5.4,13,10,10,33,14,138,2,1,3
7221,8,2014-10-25,west-virginia,@,Oklahoma State,W (34-10),21,30,70.0,238,2,44,210,4.8,1,74,448,6.1,9,11,2,22,7,57,0,0,0
7222,9,2014-11-01,west-virginia,,Texas Christian,L (30-31),15,26,57.7,162,1,54,195,3.6,1,80,357,4.5,8,9,0,17,6,40,3,2,5
7223,10,2014-11-08,west-virginia,@,Texas,L (16-33),36,49,73.5,248,0,41,200,4.9,2,90,448,5.0,13,10,1,24,8,57,1,1,2
7224,11,2014-11-20,west-virginia,,Kansas State,L (20-26),27,48,56.3,310,2,37,123,3.3,0,85,433,5.1,14,9,4,27,8,77,2,2,4
7225,12,2014-11-29,west-virginia,@,Iowa State,W (37-24),21,41,51.2,285,3,38,285,7.5,1,79,570,7.2,15,9,1,25,5,50,2,0,2
7226,13,2014-12-29,west-virginia,N,Texas A&M*,L (37-45),20,45,44.4,346,3,32,126,3.9,0,77,472,6.1,11,6,4,21,7,45,1,0,1
7227,,13 Games,west-virginia,,,,340,534,63.7,4121,26,563,2376,4.2,18,1097,6497,5.9,175,125,37,337,85,757,19,10,29
7228,1,2015-09-05,west-virginia,,Georgia Southern,W (44-0),16,26,61.5,359,2,40,185,4.6,3,66,544,8.2,11,10,0,21,5,37,0,0,0
7229,2,2015-09-12,west-virginia,,Liberty,W (41-17),27,32,84.4,313,3,45,172,3.8,2,77,485,6.3,15,9,1,25,6,58,0,0,0
7230,3,2015-09-26,west-virginia,,Maryland,W (45-6),23,37,62.2,297,4,59,304,5.2,2,96,601,6.3,16,15,6,37,10,124,1,1,2
7231,4,2015-10-03,west-virginia,@,Oklahoma,L (24-44),17,32,53.1,173,1,54,196,3.6,2,86,369,4.3,9,10,8,27,11,111,2,3,5
7232,5,2015-10-10,west-virginia,,Oklahoma State,L (26-33),18,37,48.6,188,1,61,255,4.2,2,98,443,4.5,9,14,3,26,11,107,3,1,4
7233,6,2015-10-17,west-virginia,@,Baylor,L (38-62),18,39,46.2,289,4,44,182,4.1,0,83,471,5.7,8,9,5,22,8,80,0,1,1
7234,7,2015-10-29,west-virginia,@,Texas Christian,L (10-40),16,39,41.0,160,1,37,167,4.5,0,76,327,4.3,7,10,4,21,9,114,0,1,1
7235,8,2015-11-07,west-virginia,,Texas Tech,W (31-26),12,24,50.0,149,0,57,300,5.3,4,81,449,5.5,7,17,4,28,4,40,0,2,2
7236,9,2015-11-14,west-virginia,,Texas,W (38-20),10,12,83.3,122,2,51,257,5.0,2,63,379,6.0,6,12,0,18,5,48,0,1,1
7237,10,2015-11-21,west-virginia,@,Kansas,W (49-0),16,32,50.0,204,1,55,426,7.7,5,87,630,7.2,11,18,1,30,5,52,0,2,2
7238,11,2015-11-28,west-virginia,,Iowa State,W (30-6),12,26,46.2,202,1,45,213,4.7,2,71,415,5.8,6,13,0,19,5,45,0,1,1
7239,12,2015-12-05,west-virginia,@,Kansas State,L (23-24),19,42,45.2,281,1,42,166,4.0,1,84,447,5.3,14,8,0,22,3,40,1,0,1
7240,13,2016-01-02,west-virginia,N,Arizona State*,W (43-42),28,51,54.9,532,5,33,144,4.4,0,84,676,8.0,20,8,1,29,5,54,0,2,2
7241,,13 Games,west-virginia,,,,232,429,54.1,3269,26,623,2967,4.8,25,1052,6236,5.9,139,153,33,325,87,910,7,15,22
7242,1,2016-09-03,west-virginia,,Missouri,W (26-11),23,37,62.2,253,0,48,241,5.0,2,85,494,5.8,13,9,2,24,4,45,1,2,3
7243,2,2016-09-10,west-virginia,,Youngstown State,W (38-21),20,33,60.6,389,5,46,235,5.1,0,79,624,7.9,16,11,3,30,6,49,0,1,1
7244,3,2016-09-24,west-virginia,N,Brigham Young,W (35-32),31,40,77.5,332,1,35,149,4.3,3,75,481,6.4,17,7,2,26,4,38,1,1,2
7245,4,2016-10-01,west-virginia,,Kansas State,W (17-16),24,41,58.5,298,1,35,124,3.5,1,76,422,5.6,15,6,0,21,6,60,1,1,2
7246,5,2016-10-15,west-virginia,@,Texas Tech,W (48-17),21,31,67.7,318,1,46,332,7.2,5,77,650,8.4,12,15,1,28,9,95,0,0,0
7247,6,2016-10-22,west-virginia,,Texas Christian,W (34-10),16,23,69.6,231,4,48,158,3.3,0,71,389,5.5,12,11,2,25,7,45,0,0,0
7248,7,2016-10-29,west-virginia,@,Oklahoma State,L (20-37),24,39,61.5,212,1,41,209,5.1,1,80,421,5.3,14,12,1,27,6,46,1,2,3
7249,8,2016-11-05,west-virginia,,Kansas,W (48-21),17,28,60.7,264,3,47,341,7.3,3,75,605,8.1,11,13,4,28,6,59,1,0,1
7250,9,2016-11-12,west-virginia,@,Texas,W (24-20),21,35,60.0,269,1,38,114,3.0,2,73,383,5.2,15,7,0,22,5,55,1,3,4
7251,10,2016-11-19,west-virginia,,Oklahoma,L (28-56),12,27,44.4,191,2,38,388,10.2,2,65,579,8.9,6,14,2,22,7,91,3,1,4
7252,11,2016-11-26,west-virginia,@,Iowa State,W (49-19),13,23,56.5,341,5,51,272,5.3,2,74,613,8.3,10,13,2,25,8,70,0,0,0
7253,12,2016-12-03,west-virginia,,Baylor,W (24-21),10,26,38.5,111,2,62,311,5.0,1,88,422,4.8,5,14,6,25,6,62,0,0,0
7254,13,2016-12-28,west-virginia,N,Miami (FL)*,L (14-31),17,26,65.4,134,0,39,95,2.4,2,65,229,3.5,6,3,2,11,11,108,1,0,1
7255,,13 Games,west-virginia,,,,249,409,60.9,3343,26,574,2969,5.2,24,983,6312,6.4,152,135,27,314,85,823,10,11,21
7256,1,2017-09-03,west-virginia,N,Virginia Tech,L (24-31),31,54,57.4,371,3,35,221,6.3,0,89,592,6.7,17,12,0,29,9,81,0,1,1
7257,2,2017-09-09,west-virginia,,East Carolina,W (56-20),24,34,70.6,403,5,47,211,4.5,3,81,614,7.6,15,13,3,31,4,55,0,0,0
7258,3,2017-09-16,west-virginia,,Delaware State,W (59-16),24,34,70.6,334,4,35,204,5.8,4,69,538,7.8,10,11,2,23,6,60,2,1,3
7259,4,2017-09-23,west-virginia,@,Kansas,W (56-34),25,39,64.1,347,2,43,288,6.7,5,82,635,7.7,15,14,2,31,4,42,0,1,1
7260,5,2017-10-07,west-virginia,@,Texas Christian,L (24-31),25,45,55.6,366,3,39,142,3.6,0,84,508,6.0,15,9,4,28,2,25,1,1,2
7261,6,2017-10-14,west-virginia,,Texas Tech,W (46-35),32,41,78.0,352,5,29,44,1.5,1,70,396,5.7,16,5,7,28,9,93,0,1,1
7262,7,2017-10-21,west-virginia,@,Baylor,W (38-36),26,37,70.3,375,5,29,118,4.1,0,66,493,7.5,15,7,1,23,11,134,0,0,0
7263,8,2017-10-28,west-virginia,,Oklahoma State,L (39-50),20,42,47.6,285,2,30,62,2.1,1,72,347,4.8,10,6,3,19,6,41,1,4,5
7264,9,2017-11-04,west-virginia,,Iowa State,W (20-16),20,25,80.0,316,2,47,208,4.4,0,72,524,7.3,12,11,0,23,8,85,0,1,1
7265,10,2017-11-11,west-virginia,@,Kansas State,W (28-23),27,46,58.7,372,4,26,120,4.6,0,72,492,6.8,13,7,0,20,3,21,2,2,4
7266,11,2017-11-18,west-virginia,,Texas,L (14-28),20,34,58.8,239,1,29,56,1.9,0,63,295,4.7,12,3,2,17,6,49,2,0,2
7267,12,2017-11-25,west-virginia,@,Oklahoma,L (31-59),10,20,50.0,137,0,51,250,4.9,4,71,387,5.5,4,14,6,24,6,39,2,0,2
7268,13,2017-12-26,west-virginia,N,Utah*,L (14-30),10,30,33.3,124,1,21,29,1.4,0,51,153,3.0,5,1,0,6,5,51,2,2,4
7269,,13 Games,west-virginia,,,,294,481,61.1,4021,37,461,1953,4.2,18,942,5974,6.3,159,113,30,302,79,776,12,14,26
7270,1,2018-09-01,west-virginia,N,Tennessee,W (40-14),25,34,73.5,429,5,27,118,4.4,0,61,547,9.0,18,6,2,26,4,35,1,0,1
7271,2,2018-09-08,west-virginia,,Youngstown State,W (52-17),22,29,75.9,336,4,46,289,6.3,3,75,625,8.3,17,11,1,29,12,114,0,1,1
7272,3,2018-09-22,west-virginia,,Kansas State,W (35-6),25,36,69.4,356,5,28,108,3.9,0,64,464,7.3,16,3,1,20,3,35,1,3,4
7273,4,2018-09-29,west-virginia,@,Texas Tech,W (42-34),27,41,65.9,370,3,32,119,3.7,2,73,489,6.7,15,8,3,26,12,115,0,0,0
7274,5,2018-10-06,west-virginia,,Kansas,W (38-22),28,41,68.3,332,4,39,177,4.5,1,80,509,6.4,14,15,0,29,7,50,1,3,4
7275,6,2018-10-13,west-virginia,@,Iowa State,L (14-30),11,15,73.3,100,1,27,52,1.9,0,42,152,3.6,2,7,0,9,9,103,0,1,1
7276,7,2018-10-25,west-virginia,,Baylor,W (58-14),21,31,67.7,396,4,33,172,5.2,3,64,568,8.9,13,5,4,22,6,64,0,0,0
7277,8,2018-11-03,west-virginia,@,Texas,W (42-41),28,42,66.7,346,3,33,232,7.0,2,75,578,7.7,16,9,3,28,14,120,0,0,0
7278,9,2018-11-10,west-virginia,,Texas Christian,W (47-10),26,41,63.4,371,3,40,164,4.1,3,81,535,6.6,15,11,0,26,2,15,1,1,2
7279,10,2018-11-17,west-virginia,@,Oklahoma State,L (41-45),27,48,56.3,364,2,43,189,4.4,3,91,553,6.1,17,7,1,25,5,24,1,0,1
7280,,10 Games,west-virginia,,,,240,358,67.0,3400,34,348,1620,4.7,17,706,5020,7.1,143,82,15,240,74,675,5,9,14
7281,1,2014-08-30,boston-college,N,Massachusetts,W (30-7),17,25,68.0,173,1,61,338,5.5,2,86,511,5.9,9,17,1,27,7,55,0,1,1
7282,2,2014-09-05,boston-college,,Pittsburgh,L (20-30),10,28,35.7,134,1,34,142,4.2,2,62,276,4.5,5,9,1,15,3,25,0,2,2
7283,3,2014-09-13,boston-college,,Southern California,W (37-31),5,14,35.7,54,0,54,452,8.4,5,68,506,7.4,2,17,0,19,2,25,0,1,1
7284,4,2014-09-20,boston-college,,Maine,W (40-10),12,21,57.1,136,1,64,413,6.5,4,85,549,6.5,4,24,0,28,3,26,0,1,1
7285,5,2014-09-27,boston-college,,Colorado State,L (21-24),12,18,66.7,169,0,49,239,4.9,3,67,408,6.1,9,9,3,21,5,35,0,1,1
7286,6,2014-10-11,boston-college,@,North Carolina State,W (30-14),12,19,63.2,101,0,57,310,5.4,4,76,411,5.4,6,17,1,24,4,30,1,0,1
7287,7,2014-10-18,boston-college,,Clemson,L (13-17),9,20,45.0,143,2,36,120,3.3,0,56,263,4.7,5,5,1,11,3,30,0,0,0
7288,8,2014-10-25,boston-college,@,Wake Forest,W (23-17),11,15,73.3,165,1,44,202,4.6,2,59,367,6.2,7,11,2,20,7,54,1,0,1
7289,9,2014-11-01,boston-college,@,Virginia Tech,W (33-31),8,15,53.3,110,2,47,258,5.5,2,62,368,5.9,3,7,1,11,3,20,0,0,0
7290,10,2014-11-08,boston-college,,Louisville,L (19-38),9,20,45.0,166,1,43,166,3.9,2,63,332,5.3,7,7,4,18,5,45,0,4,4
7291,11,2014-11-22,boston-college,@,Florida State,L (17-20),6,11,54.5,73,1,51,240,4.7,1,62,313,5.0,2,16,1,19,3,20,0,0,0
7292,12,2014-11-29,boston-college,,Syracuse,W (28-7),13,17,76.5,160,1,49,142,2.9,2,66,302,4.6,10,7,2,19,4,36,1,0,1
7293,13,2014-12-27,boston-college,N,Penn State*,L (30-31),11,20,55.0,97,2,46,289,6.3,2,66,386,5.8,4,11,1,16,9,97,0,0,0
7294,,13 Games,boston-college,,,,135,243,55.6,1681,13,635,3311,5.2,31,878,4992,5.7,73,157,18,248,58,498,3,10,13
7295,1,2015-09-05,boston-college,,Maine,W (24-3),14,25,56.0,155,1,49,204,4.2,2,74,359,4.9,10,9,2,21,5,35,0,0,0
7296,2,2015-09-12,boston-college,,Howard,W (76-0),12,15,80.0,136,2,40,347,8.7,8,55,483,8.8,5,18,1,24,6,40,0,0,0
7297,3,2015-09-18,boston-college,,Florida State,L (0-14),5,15,33.3,56,0,43,139,3.2,0,58,195,3.4,3,8,1,12,6,66,1,1,2
7298,4,2015-09-26,boston-college,,Northern Illinois,W (17-14),5,14,35.7,92,1,63,234,3.7,1,77,326,4.2,4,13,1,18,5,55,0,1,1
7299,5,2015-10-03,boston-college,@,Duke,L (7-9),8,21,38.1,141,1,41,164,4.0,0,62,305,4.9,5,8,0,13,6,60,1,0,1
7300,6,2015-10-10,boston-college,,Wake Forest,L (0-3),6,20,30.0,74,0,54,196,3.6,0,74,270,3.6,3,10,5,18,9,51,3,1,4
7301,7,2015-10-17,boston-college,@,Clemson,L (17-34),7,23,30.4,87,1,38,159,4.2,1,61,246,4.0,3,7,1,11,8,80,0,0,0
7302,8,2015-10-24,boston-college,@,Louisville,L (14-17),9,22,40.9,93,0,30,-14,-0.5,1,52,79,1.5,3,1,0,4,4,25,1,0,1
7303,9,2015-10-31,boston-college,,Virginia Tech,L (10-26),8,21,38.1,143,0,35,75,2.1,1,56,218,3.9,6,3,6,15,6,48,3,1,4
7304,10,2015-11-07,boston-college,,North Carolina State,L (8-24),23,37,62.2,257,1,34,28,0.8,0,71,285,4.0,11,4,1,16,3,35,1,3,4
7305,11,2015-11-21,boston-college,N,Notre Dame,L (16-19),12,22,54.5,88,1,36,214,5.9,1,58,302,5.2,5,7,1,13,9,75,1,0,1
7306,12,2015-11-28,boston-college,@,Syracuse,L (17-20),1,13,7.7,9,0,40,230,5.8,2,53,239,4.5,1,8,0,9,11,119,0,2,2
7307,,12 Games,boston-college,,,,110,248,44.4,1331,8,503,1976,3.9,17,751,3307,4.4,59,96,19,174,78,689,11,9,20
7308,1,2016-09-03,boston-college,N,Georgia Tech,L (14-17),11,17,64.7,144,0,37,176,4.8,2,54,320,5.9,6,7,2,15,7,39,2,1,3
7309,2,2016-09-10,boston-college,@,Massachusetts,W (26-7),12,22,54.5,191,2,41,153,3.7,1,63,344,5.5,8,6,0,14,5,45,0,1,1
7310,3,2016-09-17,boston-college,@,Virginia Tech,L (0-49),9,29,31.0,80,0,28,44,1.6,0,57,124,2.2,4,2,0,6,12,93,1,1,2
7311,4,2016-09-24,boston-college,,Wagner,W (42-10),12,20,60.0,190,2,56,300,5.4,4,76,490,6.4,9,14,0,23,7,85,0,0,0
7312,5,2016-10-01,boston-college,,Buffalo,W (35-3),15,27,55.6,258,2,57,142,2.5,3,84,400,4.8,10,10,1,21,4,28,2,0,2
7313,6,2016-10-07,boston-college,,Clemson,L (10-56),12,24,50.0,96,1,48,155,3.2,0,72,251,3.5,7,7,1,15,6,52,1,1,2
7314,7,2016-10-22,boston-college,,Syracuse,L (20-28),7,20,35.0,64,0,40,223,5.6,1,60,287,4.8,4,8,4,16,8,66,1,1,2
7315,8,2016-10-29,boston-college,@,North Carolina State,W (21-14),19,34,55.9,218,1,44,168,3.8,1,78,386,4.9,11,7,3,21,6,44,1,1,2
7316,9,2016-11-05,boston-college,,Louisville,L (7-52),14,25,56.0,150,1,37,57,1.5,0,62,207,3.3,6,3,0,9,6,70,2,1,3
7317,10,2016-11-11,boston-college,@,Florida State,L (7-45),4,13,30.8,50,0,35,96,2.7,1,48,146,3.0,2,4,2,8,6,50,0,0,0
7318,11,2016-11-19,boston-college,,Connecticut,W (30-0),14,19,73.7,183,1,52,154,3.0,1,71,337,4.7,7,8,1,16,9,73,0,0,0
7319,12,2016-11-26,boston-college,@,Wake Forest,W (17-14),10,23,43.5,74,1,39,93,2.4,1,62,167,2.7,6,4,0,10,8,55,1,0,1
7320,13,2016-12-26,boston-college,N,Maryland*,W (36-30),11,23,47.8,171,3,52,177,3.4,1,75,348,4.6,7,8,0,15,6,46,1,1,2
7321,,13 Games,boston-college,,,,150,296,50.7,1869,14,566,1938,3.4,16,862,3807,4.4,87,88,14,189,90,746,12,8,20
7322,1,2017-09-01,boston-college,@,Northern Illinois,W (23-20),26,42,61.9,191,2,50,148,3.0,0,92,339,3.7,8,11,2,21,8,79,0,1,1
7323,2,2017-09-09,boston-college,,Wake Forest,L (10-34),18,41,43.9,163,1,41,142,3.5,0,82,305,3.7,8,10,1,19,0,0,1,3,4
7324,3,2017-09-16,boston-college,,Notre Dame,L (20-49),24,41,58.5,215,2,44,185,4.2,0,85,400,4.7,12,10,0,22,6,35,1,2,3
7325,4,2017-09-23,boston-college,@,Clemson,L (7-34),15,32,46.9,141,0,34,97,2.9,1,66,238,3.6,6,5,1,12,2,20,0,2,2
7326,5,2017-09-30,boston-college,,Central Michigan,W (28-8),14,21,66.7,85,1,53,224,4.2,3,74,309,4.2,4,10,3,17,6,43,2,0,2
7327,6,2017-10-07,boston-college,,Virginia Tech,L (10-23),14,33,42.4,191,1,33,153,4.6,0,66,344,5.2,7,7,2,16,5,27,0,0,0
7328,7,2017-10-14,boston-college,@,Louisville,W (45-42),12,28,42.9,191,1,59,364,6.2,5,87,555,6.4,11,16,0,27,1,10,0,1,1
7329,8,2017-10-21,boston-college,@,Virginia,W (41-10),19,24,79.2,275,3,47,237,5.0,1,71,512,7.2,12,7,0,19,5,52,0,0,0
7330,9,2017-10-27,boston-college,,Florida State,W (35-3),7,21,33.3,88,2,55,241,4.4,3,76,329,4.3,3,12,4,19,1,10,0,0,0
7331,10,2017-11-11,boston-college,,North Carolina State,L (14-17),10,22,45.5,111,0,54,236,4.4,2,76,347,4.6,6,14,0,20,3,15,1,1,2
7332,11,2017-11-18,boston-college,N,Connecticut,W (39-16),7,15,46.7,55,1,49,330,6.7,4,64,385,6.0,1,12,1,14,3,25,1,0,1
7333,12,2017-11-25,boston-college,@,Syracuse,W (42-14),16,20,80.0,248,1,56,333,5.9,4,76,581,7.6,11,13,0,24,1,15,1,0,1
7334,13,2017-12-27,boston-college,N,Iowa*,L (20-27),16,27,59.3,208,1,43,175,4.1,1,70,383,5.5,12,4,0,16,6,57,1,2,3
7335,,13 Games,boston-college,,,,198,367,54.0,2162,16,618,2865,4.6,24,985,5027,5.1,101,131,14,246,47,388,8,12,20
7336,1,2018-09-01,boston-college,,Massachusetts,W (55-21),21,27,77.8,326,4,59,273,4.6,3,86,599,7.0,14,16,1,31,7,38,0,0,0
7337,2,2018-09-08,boston-college,,Holy Cross,W (62-14),16,20,80.0,245,4,52,365,7.0,4,72,610,8.5,8,14,0,22,5,40,1,0,1
7338,3,2018-09-13,boston-college,@,Wake Forest,W (41-34),16,25,64.0,304,5,44,220,5.0,1,69,524,7.6,9,9,1,19,4,35,1,0,1
7339,4,2018-09-22,boston-college,@,Purdue,L (13-30),15,29,51.7,144,1,34,85,2.5,1,63,229,3.6,7,7,0,14,7,60,0,4,4
7340,5,2018-09-29,boston-college,,Temple,W (45-35),16,34,47.1,148,3,66,275,4.2,3,100,423,4.2,9,13,6,28,10,79,2,0,2
7341,6,2018-10-06,boston-college,@,North Carolina State,L (23-28),14,25,56.0,198,1,25,120,4.8,1,50,318,6.4,6,6,0,12,6,37,1,0,1
7342,7,2018-10-13,boston-college,,Louisville,W (38-20),16,22,72.7,179,1,61,251,4.1,3,83,430,5.2,6,14,0,20,7,60,2,0,2
7343,8,2018-10-26,boston-college,,Miami (FL),W (27-14),17,30,56.7,210,1,53,223,4.2,2,83,433,5.2,10,11,1,22,8,70,0,1,1
7344,9,2018-11-03,boston-college,@,Virginia Tech,W (31-21),15,26,57.7,177,1,49,219,4.5,3,75,396,5.3,8,10,1,19,4,39,1,0,1
7345,10,2018-11-10,boston-college,,Clemson,L (7-27),14,24,58.3,104,0,33,9,0.3,0,57,113,2.0,6,2,0,8,6,42,0,0,0
7346,11,2018-11-17,boston-college,@,Florida State,L (21-22),18,38,47.4,297,1,49,125,2.6,2,87,422,4.9,13,7,0,20,5,40,0,2,2
7347,,11 Games,boston-college,,,,178,300,59.3,2332,22,525,2165,4.1,23,825,4497,5.5,96,109,10,215,69,540,8,7,15
7348,1,2014-08-28,rutgers,N,Washington State,W (41-38),16,27,59.3,281,2,43,215,5.0,3,70,496,7.1,10,11,1,22,8,78,0,1,1
7349,2,2014-09-06,rutgers,,Howard,W (38-25),16,22,72.7,288,4,38,109,2.9,1,60,397,6.6,10,8,2,20,3,41,1,0,1
7350,3,2014-09-13,rutgers,,Penn State,L (10-13),15,31,48.4,192,0,31,102,3.3,1,62,294,4.7,8,7,0,15,9,75,0,5,5
7351,4,2014-09-20,rutgers,@,Navy,W (31-24),11,14,78.6,151,0,56,284,5.1,4,70,435,6.2,7,16,1,24,2,24,1,0,1
7352,5,2014-09-27,rutgers,,Tulane,W (31-6),14,21,66.7,291,4,40,171,4.3,0,61,462,7.6,8,11,1,20,4,30,0,1,1
7353,6,2014-10-04,rutgers,,Michigan,W (26-24),23,40,57.5,402,3,30,74,2.5,0,70,476,6.8,13,5,0,18,9,85,0,0,0
7354,7,2014-10-18,rutgers,@,Ohio State,L (17-56),18,29,62.1,196,0,38,149,3.9,2,67,345,5.1,10,7,1,18,0,0,2,1,3
7355,8,2014-10-25,rutgers,@,Nebraska,L (24-42),12,26,46.2,205,1,38,143,3.8,2,64,348,5.4,8,7,0,15,4,26,0,1,1
7356,9,2014-11-01,rutgers,,Wisconsin,L (0-37),7,27,25.9,63,0,29,76,2.6,0,56,139,2.5,3,5,0,8,4,35,0,1,1
7357,10,2014-11-15,rutgers,,Indiana,W (45-23),16,27,59.3,217,2,40,212,5.3,4,67,429,6.4,8,9,2,19,5,41,1,0,1
7358,11,2014-11-22,rutgers,@,Michigan State,L (3-45),14,31,45.2,139,0,29,95,3.3,0,60,234,3.9,6,8,1,15,3,25,0,3,3
7359,12,2014-11-29,rutgers,@,Maryland,W (41-38),28,42,66.7,347,4,35,144,4.1,1,77,491,6.4,15,8,1,24,7,60,2,0,2
7360,13,2014-12-26,rutgers,N,North Carolina*,W (40-21),9,20,45.0,184,2,42,340,8.1,3,62,524,8.5,8,15,0,23,3,25,0,0,0
7361,,13 Games,rutgers,,,,199,357,55.7,2956,22,489,2114,4.3,21,846,5070,6.0,114,117,10,241,61,545,7,13,20
7362,1,2015-09-05,rutgers,,Norfolk State,W (63-13),13,15,86.7,248,4,47,291,6.2,4,62,539,8.7,8,17,1,26,9,60,1,0,1
7363,2,2015-09-12,rutgers,,Washington State,L (34-37),23,29,79.3,204,1,37,198,5.4,1,66,402,6.1,12,12,2,26,11,100,2,1,3
7364,3,2015-09-19,rutgers,@,Penn State,L (3-28),27,42,64.3,251,0,32,43,1.3,0,74,294,4.0,14,5,1,20,8,29,1,2,3
7365,4,2015-09-26,rutgers,,Kansas,W (27-14),18,25,72.0,201,2,58,312,5.4,2,83,513,6.2,13,15,3,31,10,80,1,2,3
7366,5,2015-10-10,rutgers,,Michigan State,L (24-31),15,26,57.7,208,3,32,141,4.4,0,58,349,6.0,7,8,0,15,3,20,0,0,0
7367,6,2015-10-17,rutgers,@,Indiana,W (55-52),28,43,65.1,386,3,40,210,5.3,4,83,596,7.2,15,10,0,25,1,10,0,1,1
7368,7,2015-10-24,rutgers,,Ohio State,L (7-49),13,27,48.1,189,1,29,104,3.6,0,56,293,5.2,6,6,0,12,7,55,0,1,1
7369,8,2015-10-31,rutgers,@,Wisconsin,L (10-48),6,20,30.0,82,0,38,83,2.2,0,58,165,2.8,3,5,0,8,6,40,1,1,2
7370,9,2015-11-07,rutgers,@,Michigan,L (16-49),11,27,40.7,97,0,32,128,4.0,0,59,225,3.8,6,7,4,17,7,80,0,1,1
7371,10,2015-11-14,rutgers,,Nebraska,L (14-31),14,28,50.0,170,1,39,89,2.3,1,67,259,3.9,8,7,0,15,4,23,0,2,2
7372,11,2015-11-21,rutgers,@,Army,W (31-21),13,21,61.9,105,0,39,254,6.5,4,60,359,6.0,6,11,1,18,4,35,0,0,0
7373,12,2015-11-28,rutgers,,Maryland,L (41-46),21,33,63.6,344,4,47,186,4.0,1,80,530,6.6,14,8,1,23,9,92,0,1,1
7374,,12 Games,rutgers,,,,202,336,60.1,2485,19,470,2039,4.3,17,806,4524,5.6,112,111,13,236,79,624,6,12,18
7375,1,2016-09-03,rutgers,@,Washington,L (13-48),24,40,60.0,168,0,48,136,2.8,1,88,304,3.5,9,9,3,21,4,35,2,1,3
7376,2,2016-09-10,rutgers,,Howard,W (52-14),11,23,47.8,137,3,52,379,7.3,3,75,516,6.9,8,18,0,26,6,61,0,1,1
7377,3,2016-09-17,rutgers,,New Mexico,W (37-28),12,30,40.0,173,2,32,177,5.5,1,62,350,5.6,7,6,1,14,5,37,1,0,1
7378,4,2016-09-24,rutgers,,Iowa,L (7-14),13,24,54.2,190,1,53,193,3.6,0,77,383,5.0,8,13,0,21,4,50,1,0,1
7379,5,2016-10-01,rutgers,@,Ohio State,L (0-58),3,16,18.8,33,0,38,83,2.2,0,54,116,2.1,2,6,1,9,4,21,0,0,0
7380,6,2016-10-08,rutgers,,Michigan,L (0-78),2,18,11.1,5,0,36,34,0.9,0,54,39,0.7,0,2,0,2,7,41,1,0,1
7381,7,2016-10-15,rutgers,,Illinois,L (7-24),17,30,56.7,182,1,50,203,4.1,0,80,385,4.8,11,11,1,23,4,36,4,1,5
7382,8,2016-10-22,rutgers,@,Minnesota,L (32-34),23,40,57.5,222,3,36,150,4.2,0,76,372,4.9,13,8,1,22,6,30,1,2,3
7383,9,2016-11-05,rutgers,,Indiana,L (27-33),19,36,52.8,258,1,34,93,2.7,1,70,351,5.0,8,5,0,13,8,80,1,0,1
7384,10,2016-11-12,rutgers,@,Michigan State,L (0-49),6,18,33.3,40,0,36,109,3.0,0,54,149,2.8,3,5,0,8,6,50,0,2,2
7385,11,2016-11-19,rutgers,,Penn State,L (0-39),7,17,41.2,48,0,33,39,1.2,0,50,87,1.7,2,3,0,5,6,50,0,0,0
7386,12,2016-11-26,rutgers,@,Maryland,L (13-31),22,40,55.0,203,0,40,147,3.7,2,80,350,4.4,10,10,2,22,3,25,1,0,1
7387,,12 Games,rutgers,,,,159,332,47.9,1659,11,488,1743,3.6,8,820,3402,4.1,81,96,9,186,63,516,12,7,19
7388,1,2017-09-01,rutgers,,Washington,L (14-30),24,35,68.6,178,2,42,131,3.1,0,77,309,4.0,9,9,1,19,4,25,0,2,2
7389,2,2017-09-09,rutgers,,Eastern Michigan,L (13-16),17,38,44.7,198,0,30,128,4.3,1,68,326,4.8,7,5,3,15,9,88,0,2,2
7390,3,2017-09-16,rutgers,,Morgan State,W (65-0),13,19,68.4,152,2,54,326,6.0,7,73,478,6.5,6,15,4,25,8,60,1,0,1
7391,4,2017-09-23,rutgers,@,Nebraska,L (17-27),15,29,51.7,126,0,24,68,2.8,1,53,194,3.7,7,4,1,12,4,35,0,2,2
7392,5,2017-09-30,rutgers,,Ohio State,L (0-56),11,27,40.7,92,0,41,117,2.9,0,68,209,3.1,7,4,2,13,10,80,0,2,2
7393,6,2017-10-14,rutgers,@,Illinois,W (35-24),6,12,50.0,102,0,47,274,5.8,5,59,376,6.4,4,10,3,17,8,75,3,0,3
7394,7,2017-10-21,rutgers,,Purdue,W (14-12),9,18,50.0,87,1,37,130,3.5,1,55,217,3.9,3,5,0,8,4,35,0,0,0
7395,8,2017-10-28,rutgers,@,Michigan,L (14-35),8,16,50.0,101,0,31,94,3.0,2,47,195,4.1,4,4,1,9,3,20,0,0,0
7396,9,2017-11-04,rutgers,N,Maryland,W (31-24),8,18,44.4,107,1,46,239,5.2,2,64,346,5.4,4,16,1,21,6,49,1,1,2
7397,10,2017-11-11,rutgers,@,Penn State,L (6-35),7,20,35.0,43,0,40,175,4.4,0,60,218,3.6,2,8,0,10,4,41,1,0,1
7398,11,2017-11-18,rutgers,@,Indiana,L (0-41),11,24,45.8,103,0,33,87,2.6,0,57,190,3.3,4,6,1,11,6,49,2,0,2
7399,12,2017-11-25,rutgers,,Michigan State,L (7-40),6,19,31.6,98,1,12,14,1.2,0,31,112,3.6,2,1,2,5,5,44,1,2,3
7400,,12 Games,rutgers,,,,135,275,49.1,1387,7,437,1783,4.1,19,712,3170,4.5,59,87,19,165,71,601,9,11,20
7401,1,2018-09-01,rutgers,,Texas State,W (35-7),20,29,69.0,205,1,46,218,4.7,3,75,423,5.6,11,10,2,23,7,50,1,3,4
7402,2,2018-09-08,rutgers,@,Ohio State,L (3-52),11,30,36.7,65,0,31,69,2.2,0,61,134,2.2,4,4,4,12,7,72,0,2,2
7403,3,2018-09-15,rutgers,@,Kansas,L (14-55),14,31,45.2,124,0,33,150,4.5,1,64,274,4.3,6,7,1,14,5,60,3,3,6
7404,4,2018-09-22,rutgers,,Buffalo,L (13-42),18,37,48.6,168,0,38,116,3.1,1,75,284,3.8,7,6,1,14,9,97,0,0,0
7405,5,2018-09-29,rutgers,,Indiana,L (17-24),19,36,52.8,193,1,23,98,4.3,1,59,291,4.9,10,6,3,19,6,63,0,1,1
7406,6,2018-10-06,rutgers,,Illinois,L (17-38),29,46,63.0,267,1,30,119,4.0,1,76,386,5.1,14,8,3,25,10,105,0,3,3
7407,7,2018-10-13,rutgers,@,Maryland,L (7-34),2,17,11.8,8,0,45,171,3.8,1,62,179,2.9,0,11,3,14,4,23,0,5,5
7408,8,2018-10-20,rutgers,,Northwestern,L (15-18),15,31,48.4,81,0,26,107,4.1,1,57,188,3.3,2,7,1,10,7,60,0,0,0
7409,9,2018-11-03,rutgers,@,Wisconsin,L (17-31),20,39,51.3,261,1,26,72,2.8,1,65,333,5.1,10,2,1,13,4,50,0,0,0
7410,10,2018-11-10,rutgers,,Michigan,L (7-42),9,20,45.0,59,0,33,193,5.8,1,53,252,4.8,3,7,1,11,3,30,1,1,2
7411,11,2018-11-17,rutgers,,Penn State,L (7-20),5,16,31.3,46,0,55,188,3.4,1,71,234,3.3,1,13,3,17,5,62,1,2,3
7412,,11 Games,rutgers,,,,162,332,48.8,1477,4,386,1501,3.9,12,718,2978,4.1,68,81,23,172,67,672,6,20,26
7413,1,2016-09-03,richmond,@,Virginia,W (37-20),24,35,68.6,337,3,41,187,4.6,1,76,524,6.9,16,8,0,24,8,70,0,0,0
7414,1,2018-09-01,richmond,@,Virginia,L (13-42),12,29,41.4,191,0,19,34,1.8,0,48,225,4.7,8,1,0,9,5,69,0,2,2
7415,1,2014-08-30,georgia-tech,,Wofford,W (38-19),11,16,68.8,282,2,43,226,5.3,3,59,508,8.6,9,12,0,21,5,50,0,0,0
7416,2,2014-09-06,georgia-tech,@,Tulane,W (38-21),3,8,37.5,15,0,57,344,6.0,4,65,359,5.5,2,20,2,24,4,35,2,1,3
7417,3,2014-09-13,georgia-tech,,Georgia Southern,W (42-38),11,24,45.8,188,4,53,348,6.6,2,77,536,7.0,7,19,2,28,4,55,0,0,0
7418,4,2014-09-20,georgia-tech,@,Virginia Tech,W (27-24),7,18,38.9,125,1,44,250,5.7,1,62,375,6.0,6,12,1,19,8,60,1,0,1
7419,5,2014-10-04,georgia-tech,,Miami (FL),W (28-17),4,7,57.1,53,0,65,318,4.9,4,72,371,5.2,2,18,1,21,7,69,0,0,0
7420,6,2014-10-11,georgia-tech,,Duke,L (25-31),14,26,53.8,201,0,46,282,6.1,3,72,483,6.7,9,17,0,26,8,69,1,2,3
7421,7,2014-10-18,georgia-tech,@,North Carolina,L (43-48),8,18,44.4,235,3,51,376,7.4,3,69,611,8.9,7,22,0,29,5,32,1,0,1
7422,8,2014-10-25,georgia-tech,@,Pittsburgh,W (56-28),5,12,41.7,147,1,64,465,7.3,7,76,612,8.1,4,23,0,27,3,15,1,0,1
7423,9,2014-11-01,georgia-tech,,Virginia,W (35-10),7,13,53.8,141,3,63,268,4.3,2,76,409,5.4,6,15,2,23,4,30,0,1,1
7424,10,2014-11-08,georgia-tech,@,North Carolina State,W (56-23),7,8,87.5,70,1,64,479,7.5,5,72,549,7.6,4,24,2,30,8,62,2,0,2
7425,11,2014-11-15,georgia-tech,,Clemson,W (28-6),8,11,72.7,102,1,50,251,5.0,0,61,353,5.8,6,9,1,16,2,10,2,0,2
7426,12,2014-11-29,georgia-tech,@,Georgia,W (30-24),6,16,37.5,64,1,70,399,5.7,3,86,463,5.4,4,27,1,32,5,24,2,0,2
7427,13,2014-12-06,georgia-tech,N,Florida State,L (35-37),8,14,57.1,134,1,59,331,5.6,4,73,465,6.4,8,19,1,28,3,20,0,1,1
7428,14,2014-12-31,georgia-tech,N,Mississippi State*,W (49-34),7,12,58.3,125,1,61,452,7.4,6,73,577,7.9,4,22,0,26,3,45,0,1,1
7429,,14 Games,georgia-tech,,,,106,203,52.2,1882,19,790,4789,6.1,47,993,6671,6.7,78,259,13,350,69,576,12,6,18
7430,1,2015-09-03,georgia-tech,,Alcorn State,W (69-6),4,5,80.0,77,1,52,476,9.2,9,57,553,9.7,4,20,2,26,0,0,1,0,1
7431,2,2015-09-12,georgia-tech,,Tulane,W (65-10),8,10,80.0,132,3,56,439,7.8,6,66,571,8.7,7,21,0,28,2,24,1,0,1
7432,3,2015-09-19,georgia-tech,@,Notre Dame,L (22-30),8,24,33.3,121,2,47,216,4.6,1,71,337,4.7,6,12,3,21,4,30,1,0,1
7433,4,2015-09-26,georgia-tech,@,Duke,L (20-34),6,22,27.3,143,1,60,173,2.9,1,82,316,3.9,5,11,0,16,1,5,1,1,2
7434,5,2015-10-03,georgia-tech,,North Carolina,L (31-38),12,21,57.1,162,1,59,255,4.3,3,80,417,5.2,8,17,2,27,4,39,1,1,2
7435,6,2015-10-10,georgia-tech,@,Clemson,L (24-43),6,14,42.9,159,2,42,71,1.7,0,56,230,4.1,5,6,1,12,5,50,0,1,1
7436,7,2015-10-17,georgia-tech,,Pittsburgh,L (28-31),6,15,40.0,106,1,40,376,9.4,3,55,482,8.8,3,15,1,19,5,54,1,1,2
7437,8,2015-10-24,georgia-tech,,Florida State,W (22-16),4,10,40.0,67,0,49,261,5.3,1,59,328,5.6,2,12,1,15,5,41,0,2,2
7438,9,2015-10-31,georgia-tech,@,Virginia,L (21-27),13,31,41.9,251,2,33,144,4.4,1,64,395,6.2,12,6,0,18,6,42,2,0,2
7439,10,2015-11-12,georgia-tech,,Virginia Tech,L (21-23),4,13,30.8,97,0,47,161,3.4,2,60,258,4.3,4,6,5,15,3,26,3,0,3
7440,11,2015-11-21,georgia-tech,@,Miami (FL),L (21-38),4,9,44.4,59,0,57,314,5.5,3,66,373,5.7,3,16,0,19,1,5,2,2,4
7441,12,2015-11-28,georgia-tech,,Georgia,L (7-13),6,18,33.3,82,1,41,194,4.7,0,59,276,4.7,4,11,2,17,2,13,1,2,3
7442,,12 Games,georgia-tech,,,,81,192,42.2,1456,14,583,3080,5.3,30,775,4536,5.9,63,153,17,233,38,329,14,10,24
7443,1,2016-09-03,georgia-tech,N,Boston College,W (17-14),8,15,53.3,119,0,44,119,2.7,2,59,238,4.0,4,7,1,12,3,28,1,0,1
7444,2,2016-09-10,georgia-tech,,Mercer,W (35-10),5,10,50.0,80,0,52,364,7.0,5,62,444,7.2,3,20,2,25,1,10,2,0,2
7445,3,2016-09-17,georgia-tech,,Vanderbilt,W (38-7),8,16,50.0,222,2,46,289,6.3,3,62,511,8.2,5,14,2,21,4,55,0,1,1
7446,4,2016-09-22,georgia-tech,,Clemson,L (7-26),4,14,28.6,29,0,38,95,2.5,1,52,124,2.4,1,7,3,11,2,15,0,1,1
7447,5,2016-10-01,georgia-tech,,Miami (FL),L (21-35),11,19,57.9,94,1,54,267,4.9,2,73,361,4.9,5,17,0,22,4,41,2,1,3
7448,6,2016-10-08,georgia-tech,@,Pittsburgh,L (34-37),7,10,70.0,130,1,45,241,5.4,2,55,371,6.7,5,13,0,18,5,46,0,0,0
7449,7,2016-10-15,georgia-tech,,Georgia Southern,W (35-24),7,11,63.6,172,1,44,265,6.0,4,55,437,7.9,7,11,1,19,3,30,0,0,0
7450,8,2016-10-29,georgia-tech,,Duke,W (38-35),10,14,71.4,264,2,47,341,7.3,3,61,605,9.9,9,11,0,20,8,46,2,0,2
7451,9,2016-11-05,georgia-tech,@,North Carolina,L (20-48),4,9,44.4,144,1,59,374,6.3,1,68,518,7.6,4,19,1,24,4,26,2,0,2
7452,10,2016-11-12,georgia-tech,@,Virginia Tech,W (30-20),2,7,28.6,34,0,58,309,5.3,3,65,343,5.3,1,12,2,15,7,35,1,0,1
7453,11,2016-11-19,georgia-tech,,Virginia,W (31-17),5,10,50.0,122,1,31,199,6.4,2,41,321,7.8,4,4,0,8,4,50,0,0,0
7454,12,2016-11-26,georgia-tech,@,Georgia,W (28-27),6,10,60.0,164,0,42,226,5.4,4,52,390,7.5,5,10,0,15,4,45,1,1,2
7455,13,2016-12-31,georgia-tech,N,Kentucky*,W (33-18),6,14,42.9,105,0,51,266,5.2,2,65,371,5.7,4,15,2,21,8,74,0,0,0
7456,,13 Games,georgia-tech,,,,83,159,52.2,1679,9,611,3355,5.5,34,770,5034,6.5,57,160,14,231,57,501,11,4,15
7457,1,2017-09-04,georgia-tech,N,Tennessee,L (41-42),5,10,50.0,120,0,86,535,6.2,6,96,655,6.8,4,29,0,33,4,37,2,0,2
7458,2,2017-09-09,georgia-tech,,Jacksonville State,W (37-10),5,7,71.4,112,3,49,210,4.3,2,56,322,5.8,5,8,4,17,8,70,0,0,0
7459,3,2017-09-23,georgia-tech,,Pittsburgh,W (35-17),4,7,57.1,48,0,67,436,6.5,5,74,484,6.5,2,21,2,25,4,18,4,0,4
7460,4,2017-09-30,georgia-tech,,North Carolina,W (33-7),5,10,50.0,53,1,66,403,6.1,3,76,456,6.0,3,18,1,22,1,5,2,0,2
7461,5,2017-10-14,georgia-tech,@,Miami (FL),L (24-25),3,7,42.9,55,1,53,226,4.3,1,60,281,4.7,1,14,1,16,1,6,1,0,1
7462,6,2017-10-21,georgia-tech,,Wake Forest,W (38-24),5,11,45.5,68,0,66,427,6.5,5,77,495,6.4,5,21,3,29,5,45,0,0,0
7463,7,2017-10-28,georgia-tech,@,Clemson,L (10-24),3,13,23.1,32,0,43,198,4.6,1,56,230,4.1,2,7,1,10,2,20,1,0,1
7464,8,2017-11-04,georgia-tech,@,Virginia,L (36-40),6,22,27.3,179,1,52,220,4.2,3,74,399,5.4,5,11,0,16,6,45,0,2,2
7465,9,2017-11-11,georgia-tech,,Virginia Tech,W (28-22),2,8,25.0,140,2,57,261,4.6,2,65,401,6.2,2,15,2,19,5,45,0,1,1
7466,10,2017-11-18,georgia-tech,@,Duke,L (20-43),3,14,21.4,82,1,47,277,5.9,2,61,359,5.9,2,13,0,15,5,63,0,1,1
7467,11,2017-11-25,georgia-tech,,Georgia,L (7-38),2,9,22.2,38,1,46,188,4.1,0,55,226,4.1,1,11,0,12,3,40,0,1,1
7468,,11 Games,georgia-tech,,,,43,118,36.4,927,10,632,3381,5.3,30,750,4308,5.7,32,168,14,214,44,394,10,5,15
7469,1,2018-09-01,georgia-tech,,Alcorn State,W (41-0),9,18,50.0,104,1,54,439,8.1,4,72,543,7.5,4,20,1,25,3,30,2,1,3
7470,2,2018-09-08,georgia-tech,@,South Florida,L (38-49),9,18,50.0,183,1,57,419,7.4,4,75,602,8.0,6,19,2,27,8,80,1,2,3
7471,3,2018-09-15,georgia-tech,@,Pittsburgh,L (19-24),6,15,40.0,66,0,56,320,5.7,3,71,386,5.4,4,16,2,22,5,35,1,1,2
7472,4,2018-09-22,georgia-tech,,Clemson,L (21-49),3,8,37.5,57,1,56,146,2.6,2,64,203,3.2,2,10,3,15,4,30,1,0,1
7473,5,2018-09-29,georgia-tech,,Bowling Green State,W (63-17),5,7,71.4,160,0,49,372,7.6,7,56,532,9.5,5,16,2,23,3,54,0,0,0
7474,6,2018-10-05,georgia-tech,@,Louisville,W (66-31),1,2,50.0,12,0,65,542,8.3,8,67,554,8.3,1,27,0,28,4,50,0,0,0
7475,7,2018-10-13,georgia-tech,,Duke,L (14-28),7,17,41.2,125,1,61,229,3.8,1,78,354,4.5,5,14,1,20,3,18,3,0,3
7476,8,2018-10-25,georgia-tech,@,Virginia Tech,W (49-28),0,1,0.0,0,0,78,465,6.0,7,79,465,5.9,0,31,4,35,6,50,0,0,0
7477,9,2018-11-03,georgia-tech,@,North Carolina,W (38-28),2,2,100.0,104,1,74,461,6.2,4,76,565,7.4,2,24,1,27,3,20,3,0,3
7478,10,2018-11-10,georgia-tech,,Miami (FL),W (27-21),3,4,75.0,73,1,53,231,4.4,2,57,304,5.3,3,12,0,15,3,35,1,0,1
7479,11,2018-11-17,georgia-tech,,Virginia,W (30-27),1,8,12.5,37,0,52,268,5.2,1,60,305,5.1,1,11,1,13,3,25,0,0,0
7480,,11 Games,georgia-tech,,,,46,100,46.0,921,6,655,3892,5.9,43,755,4813,6.4,33,200,17,250,45,427,12,4,16
7481,1,2016-09-02,colgate,@,Syracuse,L (7-33),11,24,45.8,98,1,32,45,1.4,0,56,143,2.6,5,5,1,11,3,35,0,0,0
7482,1,2017-09-16,colgate,@,Buffalo,L (10-33),6,23,26.1,56,0,38,167,4.4,1,61,223,3.7,4,12,2,18,3,25,0,0,0
7483,1,2018-11-17,colgate,@,Army,L (14-28),11,16,68.8,63,0,28,188,6.7,1,44,251,5.7,3,9,1,13,7,55,1,0,1
7484,1,2014-08-29,nevada-las-vegas,@,Arizona,L (13-58),22,41,53.7,252,1,31,119,3.8,0,72,371,5.2,14,5,1,20,7,64,0,1,1
7485,2,2014-09-06,nevada-las-vegas,,Northern Colorado,W (13-12),11,20,55.0,121,1,48,211,4.4,0,68,332,4.9,6,13,0,19,6,75,0,4,4
7486,3,2014-09-13,nevada-las-vegas,,Northern Illinois,L (34-48),24,42,57.1,397,2,32,102,3.2,2,74,499,6.7,18,3,5,26,5,32,0,1,1
7487,4,2014-09-20,nevada-las-vegas,@,Houston,L (14-47),16,39,41.0,146,0,39,170,4.4,2,78,316,4.1,5,7,4,16,11,105,0,3,3
7488,5,2014-09-27,nevada-las-vegas,@,San Diego State,L (17-34),18,33,54.5,346,1,38,109,2.9,1,71,455,6.4,13,9,4,26,8,72,0,2,2
7489,6,2014-10-04,nevada-las-vegas,@,San Jose State,L (10-33),11,28,39.3,116,0,31,105,3.4,1,59,221,3.7,5,6,1,12,3,15,1,1,2
7490,7,2014-10-10,nevada-las-vegas,,Fresno State,W (30-27),29,40,72.5,332,1,46,146,3.2,2,86,478,5.6,15,5,2,22,8,61,0,1,1
7491,8,2014-10-25,nevada-las-vegas,@,Utah State,L (20-34),22,38,57.9,267,3,27,15,0.6,0,65,282,4.3,10,2,1,13,4,35,1,2,3
7492,9,2014-11-01,nevada-las-vegas,,New Mexico,L (28-31),28,44,63.6,271,0,37,214,5.8,4,81,485,6.0,14,13,2,29,10,69,1,2,3
7493,10,2014-11-08,nevada-las-vegas,,Air Force,L (21-48),22,45,48.9,306,1,30,33,1.1,2,75,339,4.5,12,5,2,19,3,30,0,0,0
7494,11,2014-11-15,nevada-las-vegas,@,Brigham Young,L (23-42),20,45,44.4,204,1,45,199,4.4,1,90,403,4.5,10,7,1,18,6,43,0,1,1
7495,12,2014-11-22,nevada-las-vegas,@,Hawaii,L (35-37),24,44,54.5,423,3,26,51,2.0,2,70,474,6.8,17,4,1,22,7,80,0,1,1
7496,13,2014-11-29,nevada-las-vegas,,Nevada,L (27-49),21,39,53.8,171,2,36,205,5.7,1,75,376,5.0,9,12,4,25,3,35,1,3,4
7497,,13 Games,nevada-las-vegas,,,,268,498,53.8,3352,16,466,1679,3.6,18,964,5031,5.2,148,91,28,267,81,716,4,22,26
7498,1,2015-09-05,nevada-las-vegas,@,Northern Illinois,L (30-38),22,40,55.0,329,2,47,164,3.5,1,87,493,5.7,15,10,3,28,3,30,0,1,1
7499,2,2015-09-12,nevada-las-vegas,,UCLA,L (3-37),6,23,26.1,56,0,43,181,4.2,0,66,237,3.6,2,7,2,11,8,85,1,1,2
7500,3,2015-09-19,nevada-las-vegas,@,Michigan,L (7-28),14,26,53.8,143,1,36,92,2.6,0,62,235,3.8,8,6,1,15,2,10,0,2,2
7501,4,2015-09-26,nevada-las-vegas,,Idaho State,W (80-8),10,15,66.7,109,4,54,517,9.6,6,69,626,9.1,5,20,0,25,10,95,0,0,0
7502,5,2015-10-03,nevada-las-vegas,@,Nevada,W (23-17),13,19,68.4,134,0,44,167,3.8,2,63,301,4.8,8,8,2,18,8,76,0,1,1
7503,6,2015-10-10,nevada-las-vegas,,San Jose State,L (27-33),15,30,50.0,217,2,48,186,3.9,1,78,403,5.2,8,14,1,23,4,40,0,2,2
7504,7,2015-10-16,nevada-las-vegas,@,Fresno State,L (28-31),12,24,50.0,111,2,48,188,3.9,2,72,299,4.2,8,10,2,20,2,16,0,0,0
7505,8,2015-10-31,nevada-las-vegas,,Boise State,L (27-55),30,51,58.8,387,0,25,100,4.0,1,76,487,6.4,17,6,5,28,5,39,0,2,2
7506,9,2015-11-07,nevada-las-vegas,,Hawaii,W (41-21),15,24,62.5,258,2,53,289,5.5,3,77,547,7.1,9,11,2,22,6,60,1,1,2
7507,10,2015-11-14,nevada-las-vegas,@,Colorado State,L (35-49),22,44,50.0,330,3,36,172,4.8,2,80,502,6.3,13,9,2,24,5,60,0,0,0
7508,11,2015-11-21,nevada-las-vegas,,San Diego State,L (14-52),18,35,51.4,190,2,32,80,2.5,0,67,270,4.0,10,5,3,18,3,14,2,2,4
7509,12,2015-11-28,nevada-las-vegas,@,Wyoming,L (28-35),19,34,55.9,273,3,34,183,5.4,1,68,456,6.7,13,9,1,23,1,13,0,1,1
7510,,12 Games,nevada-las-vegas,,,,196,365,53.7,2537,21,500,2319,4.6,19,865,4856,5.6,116,115,24,255,57,538,4,13,17
7511,1,2016-09-01,nevada-las-vegas,,Jackson State,W (63-13),11,13,84.6,223,3,44,280,6.4,4,57,503,8.8,8,13,0,21,6,61,1,0,1
7512,2,2016-09-10,nevada-las-vegas,@,UCLA,L (21-42),11,28,39.3,153,1,35,175,5.0,2,63,328,5.2,8,10,0,18,7,70,0,2,2
7513,3,2016-09-17,nevada-las-vegas,@,Central Michigan,L (21-44),15,41,36.6,131,1,38,182,4.8,1,79,313,4.0,7,8,0,15,9,94,0,2,2
7514,4,2016-09-24,nevada-las-vegas,,Idaho,L (30-33),14,26,53.8,175,1,49,364,7.4,2,75,539,7.2,9,15,2,26,6,58,0,2,2
7515,5,2016-10-01,nevada-las-vegas,,Fresno State,W (45-20),8,16,50.0,129,1,54,364,6.7,5,70,493,7.0,4,13,2,19,4,45,0,0,0
7516,6,2016-10-08,nevada-las-vegas,@,San Diego State,L (7-26),2,13,15.4,9,0,36,113,3.1,0,49,122,2.5,1,7,1,9,0,0,0,1,1
7517,7,2016-10-15,nevada-las-vegas,@,Hawaii,W (41-38),19,29,65.5,279,2,51,256,5.0,3,80,535,6.7,12,15,2,29,8,86,0,0,0
7518,8,2016-10-22,nevada-las-vegas,,Colorado State,L (23-42),7,23,30.4,185,2,32,175,5.5,1,55,360,6.5,6,11,0,17,5,21,1,1,2
7519,9,2016-10-29,nevada-las-vegas,@,San Jose State,L (24-30),12,30,40.0,185,1,40,217,5.4,2,70,402,5.7,7,10,3,20,11,87,0,1,1
7520,10,2016-11-12,nevada-las-vegas,,Wyoming,W (69-66),20,33,60.6,252,3,64,401,6.3,5,97,653,6.7,13,18,0,31,4,35,1,0,1
7521,11,2016-11-18,nevada-las-vegas,@,Boise State,L (25-42),10,20,50.0,113,1,44,189,4.3,2,64,302,4.7,5,12,0,17,6,54,0,0,0
7522,12,2016-11-26,nevada-las-vegas,,Nevada,L (10-45),9,22,40.9,121,0,34,182,5.4,1,56,303,5.4,5,8,1,14,1,3,0,1,1
7523,,12 Games,nevada-las-vegas,,,,138,294,46.9,1955,16,521,2898,5.6,28,815,4853,6.0,85,140,11,236,67,614,3,10,13
7524,1,2017-09-02,nevada-las-vegas,,Howard,L (40-43),11,21,52.4,220,1,46,344,7.5,3,67,564,8.4,9,16,0,25,13,90,3,0,3
7525,2,2017-09-09,nevada-las-vegas,@,Idaho,W (44-16),10,16,62.5,193,1,50,357,7.1,4,66,550,8.3,5,16,1,22,5,47,0,1,1
7526,3,2017-09-23,nevada-las-vegas,@,Ohio State,L (21-54),11,20,55.0,88,0,41,176,4.3,2,61,264,4.3,4,8,5,17,4,30,0,2,2
7527,4,2017-09-30,nevada-las-vegas,,San Jose State,W (41-13),11,16,68.8,203,2,52,345,6.6,4,68,548,8.1,9,15,1,25,6,55,0,0,0
7528,5,2017-10-07,nevada-las-vegas,,San Diego State,L (10-41),12,28,42.9,177,1,31,106,3.4,0,59,283,4.8,7,5,0,12,5,49,0,0,0
7529,6,2017-10-14,nevada-las-vegas,@,Air Force,L (30-34),12,27,44.4,145,0,39,266,6.8,3,66,411,6.2,6,9,0,15,2,20,1,1,2
7530,7,2017-10-21,nevada-las-vegas,,Utah State,L (28-52),13,30,43.3,85,0,53,375,7.1,4,83,460,5.5,3,20,2,25,4,32,1,2,3
7531,8,2017-10-28,nevada-las-vegas,@,Fresno State,W (26-16),17,29,58.6,155,0,44,173,3.9,2,73,328,4.5,10,9,3,22,5,35,0,0,0
7532,9,2017-11-04,nevada-las-vegas,,Hawaii,W (31-23),20,31,64.5,281,2,42,131,3.1,2,73,412,5.6,15,7,1,23,4,36,0,1,1
7533,10,2017-11-10,nevada-las-vegas,,Brigham Young,L (21-31),20,33,60.6,325,2,34,122,3.6,1,67,447,6.7,12,9,0,21,6,75,0,2,2
7534,11,2017-11-17,nevada-las-vegas,@,New Mexico,W (38-35),13,25,52.0,211,1,46,323,7.0,3,71,534,7.5,10,14,1,25,1,5,0,0,0
7535,12,2017-11-25,nevada-las-vegas,@,Nevada,L (16-23),12,23,52.2,160,0,50,164,3.3,1,73,324,4.4,7,14,1,22,1,5,1,0,1
7536,,12 Games,nevada-las-vegas,,,,162,299,54.2,2243,10,528,2882,5.5,29,827,5125,6.2,97,142,15,254,56,479,6,9,15
7537,1,2018-09-01,nevada-las-vegas,@,Southern California,L (21-43),12,27,44.4,97,2,43,308,7.2,1,70,405,5.8,4,13,0,17,4,35,1,0,1
7538,2,2018-09-08,nevada-las-vegas,,Texas-El Paso,W (52-24),6,14,42.9,119,3,56,414,7.4,4,70,533,7.6,5,21,3,29,3,29,0,0,0
7539,3,2018-09-15,nevada-las-vegas,,Prairie View A&M,W (46-17),11,21,52.4,130,1,64,318,5.0,5,85,448,5.3,8,18,2,28,4,29,2,1,3
7540,4,2018-09-22,nevada-las-vegas,@,Arkansas State,L (20-27),5,21,23.8,23,0,49,310,6.3,3,70,333,4.8,2,11,2,15,6,40,1,3,4
7541,5,2018-10-06,nevada-las-vegas,,New Mexico,L (14-50),15,35,42.9,123,2,27,43,1.6,0,62,166,2.7,8,3,2,13,3,25,1,1,2
7542,6,2018-10-13,nevada-las-vegas,@,Utah State,L (28-59),18,36,50.0,250,3,48,154,3.2,1,84,404,4.8,10,8,3,21,9,70,0,1,1
7543,7,2018-10-19,nevada-las-vegas,,Air Force,L (35-41),26,38,68.4,261,3,33,139,4.2,2,71,400,5.6,12,6,5,23,6,40,0,1,1
7544,8,2018-10-27,nevada-las-vegas,@,San Jose State,L (37-50),28,50,56.0,387,4,37,167,4.5,1,87,554,6.4,14,9,2,25,4,35,0,3,3
7545,9,2018-11-03,nevada-las-vegas,,Fresno State,L (3-48),15,35,42.9,105,0,41,197,4.8,0,76,302,4.0,6,12,0,18,8,57,0,1,1
7546,10,2018-11-10,nevada-las-vegas,@,San Diego State,W (27-24),16,24,66.7,237,1,43,199,4.6,2,67,436,6.5,9,9,1,19,5,51,1,1,2
7547,11,2018-11-17,nevada-las-vegas,@,Hawaii,L (28-35),10,24,41.7,87,2,53,221,4.2,2,77,308,4.0,4,12,0,16,8,97,0,0,0
7548,,11 Games,nevada-las-vegas,,,,162,325,49.8,1819,21,494,2470,5.0,21,819,4289,5.2,82,122,20,224,60,508,6,12,18
7549,1,2017-08-31,holy-cross,@,Connecticut,L (20-27),33,56,58.9,358,1,26,89,3.4,1,82,447,5.5,18,4,2,24,10,65,1,0,1
7550,1,2018-09-08,holy-cross,@,Boston College,L (14-62),12,22,54.5,66,0,43,197,4.6,0,65,263,4.0,2,9,2,13,8,51,0,2,2
7551,1,2016-09-03,villanova,@,Pittsburgh,L (7-28),16,32,50.0,119,0,33,53,1.6,0,65,172,2.6,8,4,2,14,7,55,1,1,2
7552,1,2017-09-09,villanova,@,Temple,L (13-16),27,41,65.9,382,1,30,20,0.7,0,71,402,5.7,16,3,0,19,5,35,1,0,1
7553,1,2018-09-01,villanova,@,Temple,W (19-17),29,40,72.5,254,3,37,151,4.1,0,77,405,5.3,14,9,3,26,9,82,0,1,1
7554,1,2016-09-10,illinois-state,@,Northwestern,W (9-7),30,41,73.2,287,0,30,85,2.8,1,71,372,5.2,15,8,2,25,9,89,0,2,2
7555,1,2018-09-22,illinois-state,@,Colorado State,W (35-19),14,29,48.3,271,2,42,267,6.4,3,71,538,7.6,10,11,1,22,9,81,0,0,0
7556,1,2014-08-30,air-force,,Nicholls State,W (44-16),3,6,50.0,19,0,73,539,7.4,6,79,558,7.1,1,26,0,27,9,109,0,0,0
7557,2,2014-09-06,air-force,@,Wyoming,L (13-17),17,32,53.1,226,0,52,151,2.9,1,84,377,4.5,12,9,0,21,4,25,2,0,2
7558,3,2014-09-13,air-force,@,Georgia State,W (48-38),12,15,80.0,224,2,65,315,4.8,4,80,539,6.7,11,18,2,31,2,20,0,0,0
7559,4,2014-09-27,air-force,,Boise State,W (28-14),5,12,41.7,48,1,60,287,4.8,2,72,335,4.7,2,12,2,16,5,47,2,0,2
7560,5,2014-10-04,air-force,,Navy,W (30-21),12,17,70.6,166,4,48,198,4.1,0,65,364,5.6,5,12,1,18,6,65,0,0,0
7561,6,2014-10-11,air-force,@,Utah State,L (16-34),15,29,51.7,224,0,51,155,3.0,1,80,379,4.7,10,6,2,18,4,30,2,2,4
7562,7,2014-10-18,air-force,,New Mexico,W (35-31),5,9,55.6,159,1,74,269,3.6,4,83,428,5.2,4,19,0,23,1,5,1,0,1
7563,8,2014-11-01,air-force,@,Army,W (23-6),8,12,66.7,141,2,62,242,3.9,0,74,383,5.2,6,13,2,21,1,5,0,1,1
7564,9,2014-11-08,air-force,@,Nevada-Las Vegas,W (48-21),6,7,85.7,156,1,78,386,4.9,5,85,542,6.4,4,21,1,26,2,30,1,0,1
7565,10,2014-11-15,air-force,,Nevada,W (45-38),11,15,73.3,129,3,65,342,5.3,3,80,471,5.9,6,20,2,28,5,48,0,0,0
7566,11,2014-11-21,air-force,@,San Diego State,L (14-30),12,27,44.4,189,1,41,140,3.4,1,68,329,4.8,5,11,0,16,3,20,3,1,4
7567,12,2014-11-28,air-force,,Colorado State,W (27-24),6,15,40.0,135,0,63,242,3.8,3,78,377,4.8,5,16,1,22,1,15,1,0,1
7568,13,2014-12-20,air-force,N,Western Michigan*,W (38-24),5,10,50.0,77,0,64,284,4.4,4,74,361,4.9,3,15,2,20,3,41,1,0,1
7569,,13 Games,air-force,,,,117,206,56.8,1893,15,796,3550,4.5,34,1002,5443,5.4,74,198,15,287,46,460,13,4,17
7570,1,2015-09-05,air-force,,Morgan State,W (63-7),4,7,57.1,119,2,63,394,6.3,5,70,513,7.3,4,22,3,29,6,57,0,0,0
7571,2,2015-09-12,air-force,,San Jose State,W (37-16),3,11,27.3,24,0,69,428,6.2,5,80,452,5.7,0,0,0,23,5,48,0,1,1
7572,3,2015-09-19,air-force,@,Michigan State,L (21-35),6,9,66.7,149,1,51,279,5.5,2,60,428,7.1,5,16,3,24,7,95,2,1,3
7573,4,2015-10-03,air-force,@,Navy,L (11-33),5,12,41.7,73,0,56,204,3.6,1,68,277,4.1,3,12,0,15,3,25,3,1,4
7574,5,2015-10-10,air-force,,Wyoming,W (31-17),5,10,50.0,80,1,58,299,5.2,3,68,379,5.6,2,14,0,16,2,30,1,1,2
7575,6,2015-10-17,air-force,@,Colorado State,L (23-38),10,16,62.5,137,0,56,269,4.8,3,72,406,5.6,5,14,2,21,5,45,1,1,2
7576,7,2015-10-24,air-force,,Fresno State,W (42-14),6,11,54.5,128,1,79,458,5.8,5,90,586,6.5,5,21,0,26,5,38,1,0,1
7577,8,2015-10-31,air-force,@,Hawaii,W (58-7),3,9,33.3,80,0,83,496,6.0,7,92,576,6.3,3,27,2,32,3,30,0,0,0
7578,9,2015-11-07,air-force,,Army,W (20-3),7,10,70.0,156,2,47,196,4.2,0,57,352,6.2,5,9,0,14,2,20,0,0,0
7579,10,2015-11-14,air-force,,Utah State,W (35-28),11,17,64.7,271,1,64,309,4.8,4,81,580,7.2,10,15,2,27,4,20,0,0,0
7580,11,2015-11-20,air-force,@,Boise State,W (37-30),9,16,56.3,279,2,54,328,6.1,2,70,607,8.7,8,15,0,23,4,58,1,3,4
7581,12,2015-11-28,air-force,@,New Mexico,L (35-47),6,16,37.5,167,3,38,222,5.8,2,54,389,7.2,4,9,1,14,1,14,0,3,3
7582,13,2015-12-05,air-force,@,San Diego State,L (24-27),5,11,45.5,35,0,46,305,6.6,3,57,340,6.0,3,11,0,14,2,9,0,0,0
7583,14,2015-12-29,air-force,N,California*,L (36-55),7,15,46.7,149,2,53,285,5.4,3,68,434,6.4,7,14,2,23,4,47,2,1,3
7584,,14 Games,air-force,,,,87,170,51.2,1847,15,817,4472,5.5,45,987,6319,6.4,64,199,15,301,53,536,11,12,23
7585,1,2016-09-03,air-force,,Abilene Christian,W (37-21),6,11,54.5,201,3,66,407,6.2,2,77,608,7.9,5,22,2,29,7,57,2,0,2
7586,2,2016-09-10,air-force,,Georgia State,W (48-14),3,9,33.3,67,0,83,464,5.6,5,92,531,5.8,2,28,0,30,2,30,0,0,0
7587,3,2016-09-24,air-force,@,Utah State,W (27-20),5,13,38.5,113,1,52,213,4.1,2,65,326,5.0,3,13,1,17,8,66,0,0,0
7588,4,2016-10-01,air-force,,Navy,W (28-14),8,15,53.3,257,2,53,173,3.3,1,68,430,6.3,8,10,0,18,5,70,0,1,1
7589,5,2016-10-08,air-force,@,Wyoming,L (26-35),6,19,31.6,188,2,39,149,3.8,1,58,337,5.8,6,6,0,12,4,45,1,3,4
7590,6,2016-10-15,air-force,N,New Mexico,L (40-45),12,24,50.0,280,2,49,251,5.1,3,73,531,7.3,11,12,1,24,4,41,0,0,0
7591,7,2016-10-22,air-force,,Hawaii,L (27-34),1,10,10.0,20,0,87,389,4.5,3,97,409,4.2,1,24,2,27,4,35,2,1,3
7592,8,2016-10-28,air-force,@,Fresno State,W (31-21),5,9,55.6,97,1,73,327,4.5,2,82,424,5.2,4,19,0,23,6,47,1,0,1
7593,9,2016-11-05,air-force,@,Army,W (31-12),6,9,66.7,195,1,52,249,4.8,3,61,444,7.3,6,12,2,20,9,99,1,0,1
7594,10,2016-11-12,air-force,,Colorado State,W (49-46),3,8,37.5,49,0,68,485,7.1,7,76,534,7.0,2,22,2,26,3,36,1,1,2
7595,11,2016-11-19,air-force,@,San Jose State,W (41-38),3,7,42.9,33,1,63,458,7.3,4,70,491,7.0,1,25,1,27,7,85,1,1,2
7596,12,2016-11-25,air-force,,Boise State,W (27-20),3,6,50.0,45,0,77,314,4.1,2,83,359,4.3,1,23,1,25,3,30,0,1,1
7597,13,2016-12-30,air-force,N,South Alabama*,W (45-21),7,10,70.0,207,1,60,257,4.3,4,70,464,6.6,6,14,4,24,5,25,0,0,0
7598,,13 Games,air-force,,,,68,150,45.3,1752,14,822,4136,5.0,39,972,5888,6.1,56,230,16,302,67,666,9,8,17
7599,1,2017-09-02,air-force,,Virginia Military Institute,W (62-0),10,14,71.4,190,2,67,457,6.8,7,81,647,8.0,6,26,0,32,5,53,0,0,0
7600,2,2017-09-16,air-force,@,Michigan,L (13-29),1,9,11.1,64,1,49,168,3.4,0,58,232,4.0,1,10,4,15,3,29,0,1,1
7601,3,2017-09-23,air-force,,San Diego State,L (24-28),2,6,33.3,33,0,60,220,3.7,3,66,253,3.8,1,13,0,14,5,52,0,1,1
7602,4,2017-09-30,air-force,@,New Mexico,L (38-56),9,18,50.0,158,3,63,238,3.8,2,81,396,4.9,8,15,3,26,2,15,2,0,2
7603,5,2017-10-07,air-force,@,Navy,L (45-48),10,17,58.8,281,2,55,340,6.2,4,72,621,8.6,8,18,1,27,3,25,2,0,2
7604,6,2017-10-14,air-force,,Nevada-Las Vegas,W (34-30),4,8,50.0,72,0,78,401,5.1,5,86,473,5.5,3,25,2,30,5,56,4,0,4
7605,7,2017-10-20,air-force,@,Nevada,W (45-42),4,7,57.1,41,0,89,552,6.2,6,96,593,6.2,3,32,1,36,5,58,1,1,2
7606,8,2017-10-28,air-force,@,Colorado State,W (45-28),2,4,50.0,64,1,74,413,5.6,4,78,477,6.1,1,26,3,30,4,28,0,1,1
7607,9,2017-11-04,air-force,,Army,L (0-21),6,13,46.2,95,0,34,95,2.8,0,47,190,4.0,4,8,0,12,3,21,0,0,0
7608,10,2017-11-11,air-force,,Wyoming,L (14-28),10,22,45.5,175,1,61,203,3.3,1,83,378,4.6,9,11,2,22,5,55,2,1,3
7609,11,2017-11-18,air-force,@,Boise State,L (19-44),7,13,53.8,115,0,51,181,3.5,2,64,296,4.6,5,12,1,18,6,63,3,0,3
7610,12,2017-11-25,air-force,,Utah State,W (38-35),4,12,33.3,33,0,82,407,5.0,4,94,440,4.7,3,23,2,28,2,10,0,1,1
7611,,12 Games,air-force,,,,69,143,48.3,1321,10,763,3675,4.8,38,906,4996,5.5,52,219,19,290,48,465,14,6,20
7612,1,2018-09-01,air-force,,Stony Brook,W (38-0),2,8,25.0,29,0,77,333,4.3,4,85,362,4.3,2,19,2,23,3,30,2,0,2
7613,2,2018-09-08,air-force,@,Florida Atlantic,L (27-33),8,13,61.5,164,1,56,209,3.7,2,69,373,5.4,5,11,3,19,5,50,0,1,1
7614,3,2018-09-22,air-force,@,Utah State,L (32-42),11,21,52.4,148,0,86,323,3.8,3,107,471,4.4,5,21,1,27,7,65,1,0,1
7615,4,2018-09-29,air-force,,Nevada,L (25-28),8,19,42.1,96,1,51,154,3.0,1,70,250,3.6,5,10,1,16,5,40,2,0,2
7616,5,2018-10-06,air-force,,Navy,W (35-7),6,10,60.0,142,1,55,257,4.7,4,65,399,6.1,6,10,1,17,3,32,0,0,0
7617,6,2018-10-12,air-force,@,San Diego State,L (17-21),8,17,47.1,62,0,51,214,4.2,2,68,276,4.1,4,9,1,14,5,56,0,1,1
7618,7,2018-10-19,air-force,@,Nevada-Las Vegas,W (41-35),9,11,81.8,217,1,52,355,6.8,4,63,572,9.1,7,17,2,26,9,76,2,0,2
7619,8,2018-10-27,air-force,,Boise State,L (38-48),11,16,68.8,242,3,51,201,3.9,2,67,443,6.6,9,13,1,23,4,25,0,0,0
7620,9,2018-11-03,air-force,@,Army,L (14-17),12,22,54.5,197,0,35,125,3.6,2,57,322,5.6,8,7,2,17,5,55,0,1,1
7621,10,2018-11-10,air-force,,New Mexico,W (42-24),5,6,83.3,145,2,67,478,7.1,4,73,623,8.5,4,23,0,27,2,11,3,0,3
7622,11,2018-11-17,air-force,@,Wyoming,L (27-35),5,9,55.6,53,0,65,362,5.6,3,74,415,5.6,3,22,0,25,5,66,0,2,2
7623,,11 Games,air-force,,,,85,152,55.9,1495,9,646,3011,4.7,31,798,4506,5.6,58,162,14,234,53,506,10,5,15
7624,1,2016-09-02,northwestern-state,@,Baylor,L (7-55),5,19,26.3,31,0,40,47,1.2,1,59,78,1.3,1,6,2,9,7,37,0,0,0
7625,1,2017-09-02,northwestern-state,@,Louisiana Tech,L (24-52),20,40,50.0,256,2,33,133,4.0,1,73,389,5.3,10,10,2,22,8,54,1,2,3
7626,1,2018-08-30,northwestern-state,@,Texas A&M,L (7-59),18,35,51.4,230,1,13,21,1.6,0,48,251,5.2,5,2,6,13,11,93,0,0,0
7627,1,2014-08-30,hawaii,,Washington,L (16-17),23,43,53.5,207,0,54,217,4.0,1,97,424,4.4,11,13,2,26,5,36,0,0,0
7628,2,2014-09-06,hawaii,,Oregon State,L (30-38),20,51,39.2,236,0,33,100,3.0,4,84,336,4.0,8,7,5,20,12,108,1,1,2
7629,3,2014-09-13,hawaii,,Northern Iowa,W (27-24),17,36,47.2,225,1,50,148,3.0,1,86,373,4.3,10,6,1,17,5,45,1,0,1
7630,4,2014-09-20,hawaii,@,Colorado,L (12-21),17,46,37.0,155,0,32,131,4.1,0,78,286,3.7,7,8,5,20,2,15,1,1,2
7631,5,2014-10-04,hawaii,@,Rice,L (14-28),12,27,44.4,117,2,45,144,3.2,0,72,261,3.6,4,11,2,17,5,40,1,1,2
7632,6,2014-10-11,hawaii,,Wyoming,W (38-28),17,26,65.4,281,3,50,232,4.6,2,76,513,6.8,14,10,1,25,3,40,3,0,3
7633,7,2014-10-18,hawaii,@,San Diego State,L (10-20),17,31,54.8,174,1,25,90,3.6,0,56,264,4.7,7,5,0,12,7,40,1,2,3
7634,8,2014-10-25,hawaii,,Nevada,L (18-26),18,32,56.3,201,1,29,102,3.5,1,61,303,5.0,8,7,1,16,3,25,1,1,2
7635,9,2014-11-01,hawaii,,Utah State,L (14-35),26,48,54.2,356,1,31,98,3.2,1,79,454,5.7,14,9,0,23,13,100,1,2,3
7636,10,2014-11-08,hawaii,@,Colorado State,L (22-49),17,49,34.7,211,1,36,141,3.9,1,85,352,4.1,12,7,2,21,2,30,1,2,3
7637,11,2014-11-15,hawaii,@,San Jose State,W (13-0),9,16,56.3,150,0,40,90,2.3,1,56,240,4.3,5,6,0,11,6,45,0,1,1
7638,12,2014-11-22,hawaii,,Nevada-Las Vegas,W (37-35),14,23,60.9,230,2,56,348,6.2,3,79,578,7.3,8,14,1,23,7,50,2,1,3
7639,13,2014-11-29,hawaii,@,Fresno State,L (21-28),22,39,56.4,247,3,46,106,2.3,0,85,353,4.2,11,7,4,22,10,76,0,2,2
7640,,13 Games,hawaii,,,,229,467,49.0,2790,15,527,1947,3.7,15,994,4737,4.8,119,110,24,253,80,650,13,14,27
7641,1,2015-09-03,hawaii,,Colorado,W (28-20),19,38,50.0,202,3,34,100,2.9,0,72,302,4.2,8,4,2,14,9,50,0,2,2
7642,2,2015-09-12,hawaii,@,Ohio State,L (0-38),8,26,30.8,85,0,35,80,2.3,0,61,165,2.7,4,6,2,12,6,36,2,2,4
7643,3,2015-09-19,hawaii,,California-Davis,W (47-27),17,24,70.8,272,2,31,193,6.2,3,55,465,8.5,13,5,4,22,7,42,1,0,1
7644,4,2015-09-26,hawaii,@,Wisconsin,L (0-28),16,34,47.1,240,0,18,15,0.8,0,52,255,4.9,9,1,1,11,11,100,0,0,0
7645,5,2015-10-03,hawaii,@,Boise State,L (0-55),11,38,28.9,88,0,30,82,2.7,0,68,170,2.5,5,4,3,12,7,61,1,3,4
7646,6,2015-10-10,hawaii,,San Diego State,L (14-28),19,39,48.7,198,0,28,53,1.9,2,67,251,3.7,6,4,4,14,4,30,1,2,3
7647,7,2015-10-17,hawaii,@,New Mexico,L (27-28),13,25,52.0,195,1,50,220,4.4,2,75,415,5.5,12,10,1,23,11,94,0,2,2
7648,8,2015-10-24,hawaii,@,Nevada,L (20-30),27,40,67.5,291,2,24,34,1.4,0,64,325,5.1,16,2,1,19,10,79,1,3,4
7649,9,2015-10-31,hawaii,,Air Force,L (7-58),15,35,42.9,180,0,12,-2,-0.2,0,47,178,3.8,7,0,0,7,9,86,2,2,4
7650,10,2015-11-07,hawaii,@,Nevada-Las Vegas,L (21-41),16,33,48.5,187,0,31,191,6.2,3,64,378,5.9,8,6,2,16,5,52,2,1,3
7651,11,2015-11-14,hawaii,,Fresno State,L (14-42),20,49,40.8,245,1,39,192,4.9,1,88,437,5.0,13,11,1,25,11,132,1,3,4
7652,12,2015-11-21,hawaii,,San Jose State,L (23-42),13,25,52.0,202,2,38,213,5.6,1,63,415,6.6,7,10,1,18,9,61,1,1,2
7653,13,2015-11-28,hawaii,,Louisiana-Monroe,W (28-26),8,16,50.0,116,1,54,240,4.4,3,70,356,5.1,5,14,3,22,8,74,1,0,1
7654,,13 Games,hawaii,,,,202,422,47.9,2501,12,424,1611,3.8,15,846,4112,4.9,113,77,25,215,107,897,13,21,34
7655,1,2016-08-26,hawaii,N,California,L (31-51),17,34,50.0,234,1,38,248,6.5,3,72,482,6.7,11,13,2,26,6,52,2,1,3
7656,2,2016-09-03,hawaii,@,Michigan,L (3-63),12,23,52.2,151,0,37,81,2.2,0,60,232,3.9,7,7,2,16,8,60,0,2,2
7657,3,2016-09-10,hawaii,,Tennessee-Martin,W (41-36),10,20,50.0,203,4,37,175,4.7,2,57,378,6.6,6,9,0,15,7,52,0,3,3
7658,4,2016-09-17,hawaii,@,Arizona,L (28-47),21,43,48.8,261,1,38,168,4.4,3,81,429,5.3,13,9,3,25,12,95,1,1,2
7659,5,2016-10-01,hawaii,,Nevada,W (38-17),15,18,83.3,222,2,40,344,8.6,3,58,566,9.8,9,13,2,24,10,90,1,0,1
7660,6,2016-10-08,hawaii,@,San Jose State,W (34-17),24,33,72.7,287,2,31,144,4.6,2,64,431,6.7,13,6,1,20,9,85,2,0,2
7661,7,2016-10-15,hawaii,,Nevada-Las Vegas,L (38-41),17,32,53.1,217,2,33,229,6.9,3,65,446,6.9,9,8,3,20,7,61,1,0,1
7662,8,2016-10-22,hawaii,@,Air Force,W (34-27),21,37,56.8,312,3,26,75,2.9,1,63,387,6.1,16,3,0,19,4,46,0,2,2
7663,9,2016-10-29,hawaii,,New Mexico,L (21-28),16,28,57.1,173,0,40,125,3.1,3,68,298,4.4,9,6,1,16,1,10,1,0,1
7664,10,2016-11-05,hawaii,@,San Diego State,L (0-55),25,45,55.6,167,0,27,48,1.8,0,72,215,3.0,12,3,0,15,8,69,0,4,4
7665,11,2016-11-12,hawaii,,Boise State,L (16-52),16,32,50.0,125,1,32,234,7.3,0,64,359,5.6,6,9,0,15,10,79,1,1,2
7666,12,2016-11-19,hawaii,@,Fresno State,W (14-13),20,31,64.5,227,0,23,49,2.1,2,54,276,5.1,7,3,1,11,11,89,0,1,1
7667,13,2016-11-26,hawaii,,Massachusetts,W (46-40),22,31,71.0,311,5,33,168,5.1,1,64,479,7.5,9,10,4,23,12,101,1,0,1
7668,14,2016-12-24,hawaii,N,Middle Tennessee State*,W (52-35),21,31,67.7,295,4,42,205,4.9,2,73,500,6.8,10,8,0,18,11,114,0,0,0
7669,,14 Games,hawaii,,,,257,438,58.7,3185,25,477,2293,4.8,25,915,5478,6.0,137,107,19,263,116,1003,10,15,25
7670,1,2017-08-26,hawaii,@,Massachusetts,W (38-35),25,38,65.8,391,3,35,112,3.2,2,73,503,6.9,12,6,0,18,9,88,0,1,1
7671,2,2017-09-02,hawaii,,Western Carolina,W (41-18),12,24,50.0,154,2,49,299,6.1,3,73,453,6.2,7,15,1,23,11,104,0,2,2
7672,3,2017-09-09,hawaii,@,UCLA,L (23-56),24,39,61.5,234,2,42,281,6.7,1,81,515,6.4,12,9,4,25,8,80,0,1,1
7673,4,2017-09-23,hawaii,@,Wyoming,L (21-28),29,40,72.5,280,1,38,170,4.5,2,78,450,5.8,13,9,2,24,10,96,0,2,2
7674,5,2017-09-30,hawaii,,Colorado State,L (21-51),31,47,66.0,362,2,21,150,7.1,1,68,512,7.5,15,6,0,21,7,41,1,0,1
7675,6,2017-10-07,hawaii,@,Nevada,L (21-35),18,27,66.7,229,2,35,248,7.1,1,62,477,7.7,8,11,1,20,11,114,1,1,2
7676,7,2017-10-14,hawaii,,San Jose State,W (37-26),13,24,54.2,177,2,50,274,5.5,3,74,451,6.1,9,13,1,23,7,41,1,0,1
7677,8,2017-10-28,hawaii,,San Diego State,L (7-28),19,33,57.6,160,0,23,35,1.5,1,56,195,3.5,7,1,4,12,6,46,0,0,0
7678,9,2017-11-04,hawaii,@,Nevada-Las Vegas,L (23-31),24,47,51.1,269,1,28,131,4.7,1,75,400,5.3,12,9,2,23,6,65,0,0,0
7679,10,2017-11-11,hawaii,,Fresno State,L (21-31),18,31,58.1,154,2,37,118,3.2,0,68,272,4.0,7,8,1,16,4,36,1,1,2
7680,11,2017-11-18,hawaii,@,Utah State,L (0-38),19,35,54.3,146,0,47,172,3.7,0,82,318,3.9,7,12,1,20,8,60,1,0,1
7681,12,2017-11-25,hawaii,,Brigham Young,L (20-30),28,38,73.7,258,2,15,28,1.9,0,53,286,5.4,11,2,0,13,6,55,1,0,1
7682,,12 Games,hawaii,,,,260,423,61.5,2814,19,420,2018,4.8,15,843,4832,5.7,120,101,17,238,93,826,6,8,14
7683,1,2018-08-25,hawaii,@,Colorado State,W (43-34),26,37,70.3,418,3,36,199,5.5,2,73,617,8.5,19,9,2,30,10,65,1,0,1
7684,2,2018-09-01,hawaii,,Navy,W (59-41),31,42,73.8,436,6,26,90,3.5,1,68,526,7.7,17,6,2,25,1,5,1,0,1
7685,3,2018-09-08,hawaii,,Rice,W (43-29),22,33,66.7,319,4,29,162,5.6,2,62,481,7.8,16,6,1,23,6,60,0,0,0
7686,4,2018-09-15,hawaii,@,Army,L (21-28),20,32,62.5,321,2,13,41,3.2,1,45,362,8.0,11,3,1,15,5,30,0,0,0
7687,5,2018-09-22,hawaii,,Duquesne,W (42-21),24,40,60.0,273,5,37,245,6.6,1,77,518,6.7,13,14,7,34,8,95,1,1,2
7688,6,2018-09-29,hawaii,@,San Jose State,W (44-41),34,57,59.6,341,4,42,134,3.2,1,99,475,4.8,16,11,1,28,6,65,1,1,2
7689,7,2018-10-06,hawaii,,Wyoming,W (17-13),19,29,65.5,148,2,37,156,4.2,0,66,304,4.6,6,13,0,19,2,25,1,1,2
7690,8,2018-10-13,hawaii,@,Brigham Young,L (23-49),22,38,57.9,248,2,28,63,2.3,1,66,311,4.7,13,4,1,18,4,25,1,1,2
7691,9,2018-10-20,hawaii,,Nevada,L (22-40),19,38,50.0,259,3,35,112,3.2,0,73,371,5.1,10,5,1,16,7,73,0,0,0
7692,10,2018-10-27,hawaii,@,Fresno State,L (20-50),20,35,57.1,286,2,26,88,3.4,0,61,374,6.1,12,6,1,19,3,14,1,1,2
7693,11,2018-11-03,hawaii,,Utah State,L (17-56),19,48,39.6,347,2,20,43,2.2,0,68,390,5.7,13,1,4,18,10,75,0,2,2
7694,12,2018-11-17,hawaii,,Nevada-Las Vegas,W (35-28),18,36,50.0,328,3,31,83,2.7,1,67,411,6.1,11,6,1,18,3,15,0,2,2
7695,,12 Games,hawaii,,,,274,465,58.9,3724,38,360,1416,3.9,10,825,5140,6.2,157,84,22,263,65,547,7,9,16
7696,1,2014-08-30,san-diego-state,,Northern Arizona,W (38-7),18,29,62.1,205,1,37,194,5.2,3,66,399,6.0,11,11,3,25,5,29,0,1,1
7697,2,2014-09-06,san-diego-state,@,North Carolina,L (27-31),23,39,59.0,341,1,35,168,4.8,2,74,509,6.9,13,7,3,23,9,65,0,3,3
7698,3,2014-09-20,san-diego-state,@,Oregon State,L (7-28),14,26,53.8,106,0,23,109,4.7,1,49,215,4.4,6,5,0,11,9,65,0,2,2
7699,4,2014-09-27,san-diego-state,,Nevada-Las Vegas,W (34-17),16,28,57.1,209,0,43,257,6.0,4,71,466,6.6,10,10,5,25,6,66,0,0,0
7700,5,2014-10-03,san-diego-state,@,Fresno State,L (13-24),9,24,37.5,84,1,45,186,4.1,0,69,270,3.9,6,11,0,17,7,64,1,2,3
7701,6,2014-10-10,san-diego-state,@,New Mexico,W (24-14),5,17,29.4,73,0,46,397,8.6,3,63,470,7.5,3,14,2,19,10,102,2,2,4
7702,7,2014-10-18,san-diego-state,,Hawaii,W (20-10),13,24,54.2,174,1,47,283,6.0,1,71,457,6.4,4,15,0,19,4,44,1,0,1
7703,8,2014-11-01,san-diego-state,@,Nevada,L (14-30),21,36,58.3,189,1,29,135,4.7,1,65,324,5.0,9,8,0,17,4,55,2,1,3
7704,9,2014-11-08,san-diego-state,,Idaho,W (35-21),14,22,63.6,249,3,39,156,4.0,2,61,405,6.6,11,6,1,18,4,51,0,0,0
7705,10,2014-11-15,san-diego-state,@,Boise State,L (29-38),18,30,60.0,188,1,36,169,4.7,2,66,357,5.4,7,7,2,16,8,75,0,1,1
7706,11,2014-11-21,san-diego-state,,Air Force,W (30-14),17,31,54.8,326,1,44,176,4.0,1,75,502,6.7,15,8,0,23,5,39,0,1,1
7707,12,2014-11-29,san-diego-state,,San Jose State,W (38-7),4,16,25.0,34,0,60,393,6.6,5,76,427,5.6,3,17,1,21,1,5,0,0,0
7708,13,2014-12-23,san-diego-state,N,Navy*,L (16-17),11,27,40.7,141,0,33,186,5.6,1,60,327,5.5,7,10,1,18,5,34,1,2,3
7709,,13 Games,san-diego-state,,,,183,349,52.4,2319,10,517,2809,5.4,26,866,5128,5.9,105,129,18,252,77,694,7,15,22
7710,1,2015-09-05,san-diego-state,,San Diego,W (37-3),11,23,47.8,139,0,36,166,4.6,1,59,305,5.2,5,10,0,15,8,58,0,1,1
7711,2,2015-09-12,san-diego-state,@,California,L (7-35),14,32,43.8,173,1,43,152,3.5,0,75,325,4.3,9,7,0,16,12,136,0,2,2
7712,3,2015-09-19,san-diego-state,,South Alabama,L (27-34),13,27,48.1,165,2,38,140,3.7,1,65,305,4.7,7,6,1,14,4,35,1,0,1
7713,4,2015-09-26,san-diego-state,@,Penn State,L (21-37),10,29,34.5,141,1,34,101,3.0,1,63,242,3.8,7,5,1,13,4,32,3,0,3
7714,5,2015-10-03,san-diego-state,,Fresno State,W (21-7),5,12,41.7,104,2,60,305,5.1,1,72,409,5.7,2,16,1,19,5,50,1,0,1
7715,6,2015-10-10,san-diego-state,@,Hawaii,W (28-14),11,15,73.3,184,1,57,218,3.8,3,72,402,5.6,8,8,3,19,11,70,1,0,1
7716,7,2015-10-17,san-diego-state,@,San Jose State,W (30-7),10,14,71.4,144,1,48,233,4.9,2,62,377,6.1,6,15,2,23,9,76,0,0,0
7717,8,2015-10-23,san-diego-state,,Utah State,W (48-14),6,10,60.0,93,1,61,336,5.5,5,71,429,6.0,4,12,3,19,6,60,0,0,0
7718,9,2015-10-31,san-diego-state,@,Colorado State,W (41-17),11,14,78.6,180,1,47,276,5.9,3,61,456,7.5,9,9,3,21,5,61,0,0,0
7719,10,2015-11-14,san-diego-state,,Wyoming,W (38-3),12,19,63.2,138,3,53,293,5.5,2,72,431,6.0,4,17,4,25,3,40,2,0,2
7720,11,2015-11-21,san-diego-state,@,Nevada-Las Vegas,W (52-14),11,18,61.1,107,1,48,286,6.0,5,66,393,6.0,8,11,1,20,6,70,0,0,0
7721,12,2015-11-28,san-diego-state,,Nevada,W (31-14),9,12,75.0,88,0,53,320,6.0,4,65,408,6.3,3,13,1,17,7,55,0,0,0
7722,13,2015-12-05,san-diego-state,,Air Force,W (27-24),9,14,64.3,203,1,46,233,5.1,2,60,436,7.3,6,11,0,17,5,39,1,0,1
7723,14,2015-12-24,san-diego-state,N,Cincinnati*,W (42-7),9,12,75.0,129,2,52,207,4.0,2,64,336,5.3,7,10,5,22,4,31,0,0,0
7724,,14 Games,san-diego-state,,,,141,251,56.2,1988,17,676,3266,4.8,32,927,5254,5.7,85,150,25,260,89,813,9,3,12
7725,1,2016-09-03,san-diego-state,,New Hampshire,W (31-0),17,26,65.4,291,2,41,170,4.1,2,67,461,6.9,11,7,1,19,9,70,0,0,0
7726,2,2016-09-10,san-diego-state,,California,W (45-40),14,23,60.9,129,1,47,334,7.1,3,70,463,6.6,8,13,1,22,14,105,1,1,2
7727,3,2016-09-17,san-diego-state,@,Northern Illinois,W (42-28),11,19,57.9,126,3,45,278,6.2,3,64,404,6.3,6,11,5,22,11,107,0,1,1
7728,4,2016-10-01,san-diego-state,@,South Alabama,L (24-42),13,22,59.1,159,1,41,157,3.8,2,63,316,5.0,8,12,0,20,10,85,2,0,2
7729,5,2016-10-08,san-diego-state,,Nevada-Las Vegas,W (26-7),15,20,75.0,215,1,54,245,4.5,2,74,460,6.2,8,14,0,22,7,75,1,0,1
7730,6,2016-10-14,san-diego-state,@,Fresno State,W (17-3),7,12,58.3,72,0,61,292,4.8,2,73,364,5.0,5,20,0,25,6,65,0,0,0
7731,7,2016-10-21,san-diego-state,,San Jose State,W (42-3),13,18,72.2,167,1,44,293,6.7,5,62,460,7.4,7,12,3,22,5,37,0,1,1
7732,8,2016-10-28,san-diego-state,@,Utah State,W (40-13),4,10,40.0,14,1,57,400,7.0,2,67,414,6.2,0,18,2,20,4,40,0,0,0
7733,9,2016-11-05,san-diego-state,,Hawaii,W (55-0),8,16,50.0,97,3,42,296,7.0,2,58,393,6.8,4,14,1,19,3,20,0,1,1
7734,10,2016-11-12,san-diego-state,@,Nevada,W (46-16),11,17,64.7,146,2,44,474,10.8,4,61,620,10.2,9,16,0,25,6,49,1,0,1
7735,11,2016-11-19,san-diego-state,@,Wyoming,L (33-34),15,27,55.6,211,2,31,178,5.7,0,58,389,6.7,9,7,1,17,7,53,1,0,1
7736,12,2016-11-26,san-diego-state,,Colorado State,L (31-63),11,19,57.9,183,2,38,195,5.1,2,57,378,6.6,9,4,3,16,6,50,1,1,2
7737,13,2016-12-03,san-diego-state,@,Wyoming,W (27-24),6,13,46.2,85,0,53,242,4.6,3,66,327,5.0,4,11,1,16,7,62,2,1,3
7738,14,2016-12-17,san-diego-state,N,Houston*,W (34-10),10,14,71.4,128,1,37,127,3.4,2,51,255,5.0,6,6,1,13,3,25,0,0,0
7739,,14 Games,san-diego-state,,,,155,256,60.5,2023,20,635,3681,5.8,34,891,5704,6.4,94,165,19,278,98,843,9,6,15
7740,1,2017-09-02,san-diego-state,,California-Davis,W (38-17),17,23,73.9,237,2,52,276,5.3,3,75,513,6.8,9,15,3,27,10,87,1,1,2
7741,2,2017-09-09,san-diego-state,@,Arizona State,W (30-20),9,18,50.0,73,1,43,279,6.5,1,61,352,5.8,3,10,1,14,12,95,0,0,0
7742,3,2017-09-16,san-diego-state,,Stanford,W (20-17),21,29,72.4,187,1,48,172,3.6,1,77,359,4.7,11,9,1,21,7,81,0,0,0
7743,4,2017-09-23,san-diego-state,@,Air Force,W (28-24),10,16,62.5,180,1,41,187,4.6,3,57,367,6.4,8,7,4,19,0,0,1,0,1
7744,5,2017-09-30,san-diego-state,,Northern Illinois,W (34-28),10,20,50.0,136,2,36,127,3.5,0,56,263,4.7,6,3,1,10,10,126,0,0,0
7745,6,2017-10-07,san-diego-state,@,Nevada-Las Vegas,W (41-10),14,24,58.3,172,0,46,302,6.6,5,70,474,6.8,10,15,2,27,4,19,1,0,1
7746,7,2017-10-14,san-diego-state,,Boise State,L (14-31),12,27,44.4,240,1,39,83,2.1,1,66,323,4.9,8,6,2,16,3,24,1,0,1
7747,8,2017-10-21,san-diego-state,,Fresno State,L (3-27),11,23,47.8,90,0,39,165,4.2,0,62,255,4.1,5,8,1,14,5,40,1,0,1
7748,9,2017-10-28,san-diego-state,@,Hawaii,W (28-7),5,11,45.5,83,1,53,334,6.3,3,64,417,6.5,4,14,3,21,8,90,0,1,1
7749,10,2017-11-04,san-diego-state,@,San Jose State,W (52-7),6,7,85.7,94,1,71,554,7.8,6,78,648,8.3,6,24,1,31,4,25,1,0,1
7750,11,2017-11-18,san-diego-state,,Nevada,W (42-23),15,23,65.2,205,1,48,289,6.0,3,71,494,7.0,11,13,1,25,7,75,1,0,1
7751,12,2017-11-24,san-diego-state,,New Mexico,W (35-10),14,21,66.7,198,2,37,265,7.2,3,58,463,8.0,8,9,2,19,5,35,1,1,2
7752,13,2017-12-23,san-diego-state,N,Army*,L (35-42),6,10,60.0,25,0,21,255,12.1,4,31,280,9.0,3,7,1,11,10,82,1,1,2
7753,,13 Games,san-diego-state,,,,150,252,59.5,1920,13,574,3288,5.7,33,826,5208,6.3,92,140,23,255,85,779,9,4,13
7754,1,2018-08-31,san-diego-state,@,Stanford,L (10-31),10,15,66.7,113,0,37,150,4.1,1,52,263,5.1,5,6,0,11,11,125,1,0,1
7755,2,2018-09-08,san-diego-state,,Sacramento State,W (28-14),17,28,60.7,271,0,45,158,3.5,3,73,429,5.9,15,8,2,25,8,53,0,2,2
7756,3,2018-09-15,san-diego-state,,Arizona State,W (28-21),12,24,50.0,129,1,58,311,5.4,2,82,440,5.4,7,18,2,27,9,85,1,0,1
7757,4,2018-09-22,san-diego-state,,Eastern Michigan,W (23-20),12,22,54.5,176,2,37,174,4.7,0,59,350,5.9,8,6,1,15,5,56,0,1,1
7758,5,2018-10-06,san-diego-state,@,Boise State,W (19-13),8,15,53.3,113,0,44,154,3.5,2,59,267,4.5,4,4,1,9,8,55,2,0,2
7759,6,2018-10-12,san-diego-state,,Air Force,W (21-17),9,25,36.0,213,1,34,84,2.5,1,59,297,5.0,8,5,0,13,8,55,0,1,1
7760,7,2018-10-20,san-diego-state,,San Jose State,W (16-13),7,11,63.6,86,0,47,207,4.4,1,58,293,5.1,4,10,2,16,8,67,1,0,1
7761,8,2018-10-27,san-diego-state,@,Nevada,L (24-28),20,41,48.8,283,3,36,173,4.8,0,77,456,5.9,14,7,3,24,8,68,2,0,2
7762,9,2018-11-03,san-diego-state,@,New Mexico,W (31-23),17,25,68.0,240,1,40,161,4.0,3,65,401,6.2,10,6,1,17,9,80,3,0,3
7763,10,2018-11-10,san-diego-state,,Nevada-Las Vegas,L (24-27),22,36,61.1,279,2,34,89,2.6,1,70,368,5.3,10,10,1,21,4,45,0,2,2
7764,11,2018-11-17,san-diego-state,@,Fresno State,L (14-23),8,21,38.1,218,2,27,64,2.4,0,48,282,5.9,5,2,1,8,6,41,0,0,0
7765,,11 Games,san-diego-state,,,,142,263,54.0,2121,12,439,1725,3.9,14,702,3846,5.5,90,82,14,186,84,730,10,6,16
7766,1,2016-10-22,tennessee-state,@,Vanderbilt,L (17-35),19,30,63.3,285,2,23,125,5.4,0,53,410,7.7,10,7,2,19,9,63,1,1,2
7767,1,2017-08-31,tennessee-state,@,Georgia State,W (17-10),12,25,48.0,145,0,42,238,5.7,2,67,383,5.7,8,11,2,21,12,101,0,0,0
7768,1,2018-09-29,tennessee-state,@,Vanderbilt,L (27-31),22,31,71.0,269,3,35,104,3.0,1,66,373,5.7,13,7,0,20,8,44,0,0,0
7769,1,2016-09-10,indiana-state,@,Minnesota,L (28-58),21,37,56.8,247,4,33,109,3.3,0,70,356,5.1,11,7,2,20,4,30,1,0,1
7770,1,2017-09-09,indiana-state,@,Tennessee,L (7-42),9,19,47.4,93,1,38,122,3.2,0,57,215,3.8,6,6,1,13,5,45,0,0,0
7771,1,2018-09-08,indiana-state,@,Louisville,L (7-31),3,12,25.0,37,0,50,174,3.5,1,62,211,3.4,2,8,2,12,6,45,0,0,0
7772,1,2016-11-19,chattanooga,@,Alabama,L (3-31),17,24,70.8,114,0,30,70,2.3,0,54,184,3.4,7,3,0,10,2,10,2,0,2
7773,1,2017-09-09,chattanooga,@,Louisiana State,L (10-45),15,32,46.9,174,0,27,68,2.5,1,59,242,4.1,8,3,1,12,4,10,0,2,2
7774,1,2018-11-17,chattanooga,@,South Carolina,L (9-49),18,37,48.6,256,1,24,78,3.3,0,61,334,5.5,9,4,4,17,6,49,1,1,2
7775,1,2016-09-03,southern-illinois,@,Florida Atlantic,L (30-38),37,52,71.2,387,2,34,143,4.2,2,86,530,6.2,19,7,0,26,5,50,1,0,1
7776,1,2017-09-23,southern-illinois,@,Memphis,L (31-44),30,49,61.2,290,4,37,103,2.8,0,86,393,4.6,15,5,3,23,7,56,0,1,1
7777,1,2018-09-08,southern-illinois,@,Mississippi,L (41-76),30,48,62.5,388,4,45,241,5.4,1,93,629,6.8,15,11,3,29,8,48,1,2,3
7778,1,2014-08-30,marshall,@,Miami (OH),W (42-27),20,32,62.5,261,3,36,171,4.8,3,68,432,6.4,13,4,3,20,9,98,1,0,1
7779,2,2014-09-06,marshall,,Rhode Island,W (48-7),18,35,51.4,292,2,46,432,9.4,4,81,724,8.9,11,18,0,29,8,64,3,0,3
7780,3,2014-09-13,marshall,,Ohio,W (44-14),20,33,60.6,448,4,46,257,5.6,1,79,705,8.9,14,16,1,31,7,60,0,1,1
7781,4,2014-09-20,marshall,@,Akron,W (48-17),20,38,52.6,242,1,38,284,7.5,5,76,526,6.9,11,13,4,28,20,188,0,1,1
7782,5,2014-10-04,marshall,@,Old Dominion,W (56-14),21,27,77.8,237,2,50,354,7.1,5,77,591,7.7,13,15,0,28,6,54,1,2,3
7783,6,2014-10-11,marshall,,Middle Tennessee State,W (49-24),17,33,51.5,337,3,52,252,4.8,4,85,589,6.9,12,12,4,28,8,101,1,1,2
7784,7,2014-10-18,marshall,@,Florida International,W (45-13),15,27,55.6,214,4,26,243,9.3,1,53,457,8.6,10,6,2,18,9,65,0,1,1
7785,8,2014-10-25,marshall,,Florida Atlantic,W (35-16),13,24,54.2,218,1,35,328,9.4,4,59,546,9.3,9,9,2,20,6,60,0,0,0
7786,9,2014-11-08,marshall,@,Southern Mississippi,W (63-17),13,19,68.4,186,2,38,335,8.8,7,57,521,9.1,10,13,2,25,7,80,0,0,0
7787,10,2014-11-15,marshall,,Rice,W (41-14),23,37,62.2,297,4,44,284,6.5,1,81,581,7.2,17,13,0,30,7,70,1,1,2
7788,11,2014-11-22,marshall,@,Alabama-Birmingham,W (23-18),20,39,51.3,284,2,39,231,5.9,0,78,515,6.6,13,9,2,24,11,90,1,1,2
7789,12,2014-11-28,marshall,,Western Kentucky,L (66-67),29,46,63.0,417,7,36,291,8.1,2,82,708,8.6,19,17,1,37,6,59,0,4,4
7790,13,2014-12-06,marshall,,Louisiana Tech,W (26-23),25,46,54.3,308,2,35,121,3.5,0,81,429,5.3,16,4,0,20,9,75,3,1,4
7791,14,2014-12-23,marshall,N,Northern Illinois*,W (52-23),25,37,67.6,281,3,38,224,5.9,3,75,505,6.7,15,12,1,28,6,60,0,0,0
7792,,14 Games,marshall,,,,279,473,59.0,4022,40,559,3807,6.8,40,1032,7829,7.6,183,161,22,366,119,1124,11,13,24
7793,1,2015-09-06,marshall,,Purdue,W (41-31),23,36,63.9,234,2,29,163,5.6,1,65,397,6.1,11,5,4,20,6,57,2,1,3
7794,2,2015-09-12,marshall,@,Ohio,L (10-21),16,33,48.5,106,0,25,157,6.3,1,58,263,4.5,5,4,1,10,16,150,2,2,4
7795,3,2015-09-19,marshall,,Norfolk State,W (45-7),25,34,73.5,279,4,43,216,5.0,2,77,495,6.4,15,14,0,29,5,60,1,1,2
7796,4,2015-09-26,marshall,@,Kent State,W (36-29),14,36,38.9,151,2,44,126,2.9,2,80,277,3.5,9,5,3,17,4,45,1,2,3
7797,5,2015-10-03,marshall,,Old Dominion,W (27-7),21,35,60.0,212,2,40,112,2.8,1,75,324,4.3,9,7,1,17,7,77,2,0,2
7798,6,2015-10-09,marshall,,Southern Mississippi,W (31-10),11,21,52.4,163,2,35,114,3.3,1,56,277,4.9,6,7,1,14,8,96,0,1,1
7799,7,2015-10-17,marshall,@,Florida Atlantic,W (33-17),17,28,60.7,174,1,47,326,6.9,3,75,500,6.7,11,13,2,26,3,15,0,1,1
7800,8,2015-10-24,marshall,,North Texas,W (30-13),19,34,55.9,189,1,43,213,5.0,2,77,402,5.2,7,11,3,21,4,50,0,0,0
7801,9,2015-10-31,marshall,@,UNC Charlotte,W (34-10),35,53,66.0,494,2,39,136,3.5,2,92,630,6.8,21,8,2,31,14,100,0,0,0
7802,10,2015-11-07,marshall,@,Middle Tennessee State,L (24-27),35,58,60.3,376,3,45,139,3.1,0,103,515,5.0,18,9,3,30,11,86,0,1,1
7803,11,2015-11-14,marshall,,Florida International,W (52-0),17,26,65.4,174,3,39,289,7.4,3,65,463,7.1,8,16,2,26,3,14,1,1,2
7804,12,2015-11-27,marshall,@,Western Kentucky,L (28-49),20,41,48.8,242,2,25,31,1.2,1,66,273,4.1,11,3,2,16,6,65,2,2,4
7805,13,2015-12-26,marshall,N,Connecticut*,W (16-10),23,36,63.9,218,1,41,171,4.2,0,77,389,5.1,13,10,1,24,4,45,0,1,1
7806,,13 Games,marshall,,,,276,471,58.6,3012,25,495,2193,4.4,19,966,5205,5.4,144,112,25,281,91,860,11,13,24
7807,1,2016-09-10,marshall,,Morgan State,W (62-0),14,22,63.6,313,6,40,217,5.4,1,62,530,8.5,10,10,1,21,8,70,1,0,1
7808,2,2016-09-17,marshall,,Akron,L (38-65),33,59,55.9,446,4,38,114,3.0,1,97,560,5.8,17,8,6,31,17,180,1,3,4
7809,3,2016-09-24,marshall,,Louisville,L (28-59),9,21,42.9,59,2,43,148,3.4,1,64,207,3.2,2,10,4,16,9,95,1,1,2
7810,4,2016-10-01,marshall,@,Pittsburgh,L (27-43),20,32,62.5,240,2,30,104,3.5,2,62,344,5.5,7,9,2,18,5,67,0,1,1
7811,5,2016-10-08,marshall,@,North Texas,L (21-38),20,42,47.6,258,1,28,13,0.5,1,70,271,3.9,12,2,2,16,6,70,0,1,1
7812,6,2016-10-15,marshall,,Florida Atlantic,W (27-21),27,39,69.2,330,1,42,106,2.5,2,81,436,5.4,16,6,3,25,4,40,0,1,1
7813,7,2016-10-22,marshall,,UNC Charlotte,L (24-27),32,46,69.6,262,2,24,88,3.7,1,70,350,5.0,13,5,4,22,12,115,1,1,2
7814,8,2016-10-29,marshall,@,Southern Mississippi,L (14-24),20,34,58.8,166,1,25,60,2.4,1,59,226,3.8,8,2,1,11,5,65,0,0,0
7815,9,2016-11-05,marshall,@,Old Dominion,L (14-38),20,29,69.0,138,2,20,76,3.8,0,49,214,4.4,5,5,0,10,5,39,0,0,0
7816,10,2016-11-12,marshall,,Middle Tennessee State,W (42-17),21,37,56.8,246,4,41,207,5.0,2,78,453,5.8,13,13,3,29,3,35,0,0,0
7817,11,2016-11-19,marshall,@,Florida International,L (14-31),29,42,69.0,301,2,26,78,3.0,0,68,379,5.6,18,5,1,24,5,55,0,2,2
7818,12,2016-11-26,marshall,,Western Kentucky,L (6-60),19,35,54.3,143,1,39,87,2.2,0,74,230,3.1,4,10,4,18,11,90,0,2,2
7819,,12 Games,marshall,,,,264,438,60.3,2902,28,396,1298,3.3,12,834,4200,5.0,125,85,31,241,90,921,4,12,16
7820,1,2017-09-02,marshall,,Miami (OH),W (31-26),20,30,66.7,208,1,25,59,2.4,0,55,267,4.9,8,5,2,15,6,43,1,1,2
7821,2,2017-09-09,marshall,@,North Carolina State,L (20-37),26,43,60.5,350,2,25,101,4.0,0,68,451,6.6,13,5,0,18,9,86,1,1,2
7822,3,2017-09-16,marshall,,Kent State,W (21-0),23,43,53.5,223,1,33,158,4.8,2,76,381,5.0,11,10,2,23,8,75,0,1,1
7823,4,2017-09-30,marshall,@,Cincinnati,W (38-21),21,34,61.8,233,4,44,133,3.0,1,78,366,4.7,12,5,5,22,6,85,1,0,1
7824,5,2017-10-07,marshall,@,UNC Charlotte,W (14-3),19,28,67.9,192,2,42,212,5.0,0,70,404,5.8,11,10,2,23,5,30,2,0,2
7825,6,2017-10-14,marshall,,Old Dominion,W (35-3),12,23,52.2,176,3,40,195,4.9,1,63,371,5.9,7,8,3,18,3,25,0,0,0
7826,7,2017-10-20,marshall,@,Middle Tennessee State,W (38-10),16,24,66.7,168,0,43,202,4.7,4,67,370,5.5,9,10,2,21,7,63,0,0,0
7827,8,2017-10-28,marshall,,Florida International,L (30-41),33,52,63.5,363,3,29,142,4.9,1,81,505,6.2,19,8,2,29,3,35,1,2,3
7828,9,2017-11-03,marshall,@,Florida Atlantic,L (25-30),20,39,51.3,253,2,41,128,3.1,1,80,381,4.8,11,6,4,21,7,37,0,4,4
7829,10,2017-11-11,marshall,,Western Kentucky,W (30-23),17,28,60.7,190,0,49,144,2.9,2,77,334,4.3,10,11,1,22,7,69,0,1,1
7830,11,2017-11-18,marshall,@,Texas-San Antonio,L (7-9),16,23,69.6,189,1,23,40,1.7,0,46,229,5.0,9,2,1,12,7,70,1,1,2
7831,12,2017-11-25,marshall,,Southern Mississippi,L (27-28),26,44,59.1,308,4,26,74,2.8,0,70,382,5.5,12,6,5,23,6,52,2,1,3
7832,13,2017-12-16,marshall,N,Colorado State*,W (31-28),17,32,53.1,262,2,33,239,7.2,2,65,501,7.7,10,8,0,18,11,107,0,2,2
7833,,13 Games,marshall,,,,266,443,60.0,3115,25,453,1827,4.0,14,896,4942,5.5,142,94,29,265,85,777,9,14,23
7834,1,2018-09-01,marshall,@,Miami (OH),W (35-28),24,37,64.9,272,2,38,171,4.5,3,75,443,5.9,11,11,2,24,7,62,0,0,0
7835,2,2018-09-08,marshall,,Eastern Kentucky,W (32-16),23,39,59.0,278,3,28,89,3.2,1,67,367,5.5,10,6,1,17,8,70,3,1,4
7836,3,2018-09-22,marshall,,North Carolina State,L (20-37),22,43,51.2,270,1,22,54,2.5,0,65,324,5.0,11,3,1,15,4,20,1,2,3
7837,4,2018-09-29,marshall,@,Western Kentucky,W (20-17),18,39,46.2,288,2,33,113,3.4,0,72,401,5.6,11,6,0,17,6,70,1,3,4
7838,5,2018-10-05,marshall,,Middle Tennessee State,L (24-34),17,35,48.6,173,2,53,209,3.9,1,88,382,4.3,9,14,5,28,6,59,2,1,3
7839,6,2018-10-13,marshall,@,Old Dominion,W (42-20),18,29,62.1,182,1,45,319,7.1,5,74,501,6.8,9,13,2,24,8,101,0,1,1
7840,7,2018-10-20,marshall,,Florida Atlantic,W (31-7),13,24,54.2,102,2,48,233,4.9,2,72,335,4.7,4,14,0,18,5,55,0,0,0
7841,8,2018-11-03,marshall,@,Southern Mississippi,L (24-26),17,38,44.7,218,1,22,31,1.4,1,60,249,4.2,9,4,2,15,7,79,3,2,5
7842,9,2018-11-10,marshall,,UNC Charlotte,W (30-13),15,26,57.7,178,1,38,147,3.9,2,64,325,5.1,8,8,0,16,3,20,1,0,1
7843,10,2018-11-17,marshall,,Texas-San Antonio,W (23-0),19,36,52.8,387,2,37,118,3.2,0,73,505,6.9,14,6,2,22,6,49,0,0,0
7844,,10 Games,marshall,,,,186,346,53.8,2348,17,364,1484,4.1,15,710,3832,5.4,96,85,15,196,60,585,11,10,21
7845,1,2014-08-29,houston,,Texas-San Antonio,L (7-27),25,50,50.0,234,0,23,-26,-1.1,1,73,208,2.8,10,4,4,18,9,47,2,4,6
7846,2,2014-09-06,houston,,Grambling State,W (47-0),15,26,57.7,202,1,40,275,6.9,3,66,477,7.2,8,8,4,20,5,30,2,0,2
7847,3,2014-09-11,houston,@,Brigham Young,L (25-33),31,53,58.5,315,3,13,10,0.8,0,66,325,4.9,14,1,3,18,8,83,0,0,0
7848,4,2014-09-20,houston,,Nevada-Las Vegas,W (47-14),12,29,41.4,135,2,52,399,7.7,4,81,534,6.6,6,19,5,30,9,110,0,2,2
7849,5,2014-10-02,houston,,Central Florida,L (12-17),22,43,51.2,214,0,33,117,3.5,0,76,331,4.4,7,9,4,20,11,99,1,2,3
7850,6,2014-10-11,houston,@,Memphis,W (28-24),17,28,60.7,188,1,40,166,4.2,3,68,354,5.2,8,6,1,15,3,32,2,1,3
7851,7,2014-10-17,houston,,Temple,W (31-10),29,33,87.9,268,2,49,171,3.5,1,82,439,5.4,10,11,2,23,10,102,0,0,0
7852,8,2014-11-01,houston,@,South Florida,W (27-3),15,19,78.9,89,1,47,217,4.6,3,66,306,4.6,5,14,2,21,1,5,0,0,0
7853,9,2014-11-08,houston,,Tulane,L (24-31),30,49,61.2,336,2,32,90,2.8,0,81,426,5.3,13,8,4,25,6,51,0,4,4
7854,10,2014-11-22,houston,,Tulsa,W (38-28),16,21,76.2,227,1,43,244,5.7,4,64,471,7.4,9,12,0,21,5,47,0,0,0
7855,11,2014-11-28,houston,@,Southern Methodist,W (35-9),18,29,62.1,151,0,48,282,5.9,5,77,433,5.6,11,12,2,25,4,28,0,1,1
7856,12,2014-12-06,houston,N,Cincinnati,L (31-38),27,45,60.0,360,2,35,234,6.7,2,80,594,7.4,12,14,1,27,4,37,0,1,1
7857,13,2015-01-02,houston,N,Pittsburgh*,W (35-34),15,25,60.0,274,3,40,212,5.3,2,65,486,7.5,10,12,1,23,9,100,0,0,0
7858,,13 Games,houston,,,,272,450,60.4,2993,18,495,2391,4.8,28,945,5384,5.7,123,130,33,286,84,771,7,15,22
7859,1,2015-09-05,houston,,Tennessee Tech,W (52-24),27,38,71.1,355,1,44,272,6.2,6,82,627,7.6,13,14,0,27,9,59,1,0,1
7860,2,2015-09-12,houston,@,Louisville,W (34-31),23,35,65.7,236,3,57,226,4.0,0,92,462,5.0,11,12,2,25,7,78,0,1,1
7861,3,2015-09-26,houston,,Texas State,W (59-14),18,24,75.0,323,4,54,366,6.8,3,78,689,8.8,10,19,0,29,10,69,0,0,0
7862,4,2015-10-03,houston,@,Tulsa,W (38-24),22,38,57.9,273,0,56,365,6.5,5,94,638,6.8,12,13,3,28,3,44,1,0,1
7863,5,2015-10-08,houston,,Southern Methodist,W (49-28),16,18,88.9,243,0,48,214,4.5,7,66,457,6.9,9,13,1,23,6,55,1,0,1
7864,6,2015-10-16,houston,@,Tulane,W (42-7),17,25,68.0,222,1,47,239,5.1,4,72,461,6.4,8,12,4,24,10,99,0,1,1
7865,7,2015-10-24,houston,@,Central Florida,W (59-10),20,28,71.4,234,2,48,366,7.6,5,76,600,7.9,10,17,3,30,7,87,0,0,0
7866,8,2015-10-31,houston,,Vanderbilt,W (34-0),15,23,65.2,221,1,51,150,2.9,2,74,371,5.0,11,6,2,19,6,55,2,0,2
7867,9,2015-11-07,houston,,Cincinnati,W (33-30),16,24,66.7,161,2,63,266,4.2,1,87,427,4.9,10,8,6,24,4,40,0,2,2
7868,10,2015-11-14,houston,,Memphis,W (35-34),26,44,59.1,296,1,31,96,3.1,4,75,392,5.2,14,5,1,20,4,40,0,0,0
7869,11,2015-11-21,houston,@,Connecticut,L (17-20),17,31,54.8,208,1,33,110,3.3,0,64,318,5.0,8,4,1,13,7,69,2,2,4
7870,12,2015-11-27,houston,,Navy,W (52-31),27,36,75.0,337,4,44,218,5.0,3,80,555,6.9,14,13,0,27,3,29,0,0,0
7871,13,2015-12-05,houston,,Temple,W (24-13),12,22,54.5,106,0,40,233,5.8,3,62,339,5.5,5,11,0,16,5,40,0,0,0
7872,14,2015-12-31,houston,N,Florida State*,W (38-24),28,46,60.9,261,2,53,187,3.5,3,99,448,4.5,14,10,3,27,4,30,0,1,1
7873,,14 Games,houston,,,,284,432,65.7,3476,22,669,3308,4.9,46,1101,6784,6.2,149,157,26,332,85,794,7,7,14
7874,1,2016-09-03,houston,N,Oklahoma,W (33-23),23,40,57.5,321,2,40,89,2.2,0,80,410,5.1,16,5,4,25,7,75,1,0,1
7875,2,2016-09-10,houston,,Lamar,W (42-0),15,26,57.7,130,0,71,381,5.4,6,97,511,5.3,7,17,1,25,2,15,0,1,1
7876,3,2016-09-15,houston,@,Cincinnati,W (40-16),24,36,66.7,326,1,57,180,3.2,2,93,506,5.4,14,14,0,28,4,45,1,2,3
7877,4,2016-09-24,houston,@,Texas State,W (64-3),25,32,78.1,320,3,50,243,4.9,5,82,563,6.9,14,14,4,32,0,0,0,0,0
7878,5,2016-09-29,houston,,Connecticut,W (42-14),40,49,81.6,426,3,30,114,3.8,3,79,540,6.8,20,6,1,27,2,20,0,0,0
7879,6,2016-10-08,houston,@,Navy,L (40-46),32,50,64.0,359,3,33,125,3.8,2,83,484,5.8,20,8,0,28,4,30,1,2,3
7880,7,2016-10-15,houston,,Tulsa,W (38-31),26,34,76.5,254,0,55,268,4.9,4,89,522,5.9,15,15,0,30,10,104,2,1,3
7881,8,2016-10-22,houston,@,Southern Methodist,L (16-38),21,33,63.6,241,2,35,62,1.8,0,68,303,4.5,8,5,0,13,4,55,2,0,2
7882,9,2016-10-29,houston,,Central Florida,W (31-24),26,37,70.3,240,1,49,158,3.2,3,86,398,4.6,12,10,0,22,6,71,1,3,4
7883,10,2016-11-12,houston,,Tulane,W (30-18),21,37,56.8,221,2,35,66,1.9,1,72,287,4.0,8,5,1,14,7,55,1,1,2
7884,11,2016-11-17,houston,,Louisville,W (36-10),27,46,58.7,298,3,33,64,1.9,1,79,362,4.6,15,5,1,21,1,5,0,0,0
7885,12,2016-11-25,houston,@,Memphis,L (44-48),47,69,68.1,487,4,32,137,4.3,1,101,624,6.2,20,10,3,33,9,69,1,1,2
7886,13,2016-12-17,houston,N,San Diego State*,L (10-34),25,34,73.5,229,0,41,25,0.6,1,75,254,3.4,9,7,0,16,2,10,0,4,4
7887,,13 Games,houston,,,,352,523,67.3,3852,24,561,1912,3.4,29,1084,5764,5.3,178,121,15,314,58,554,10,15,25
7888,1,2017-09-09,houston,@,Arizona,W (19-16),25,32,78.1,225,1,37,158,4.3,1,69,383,5.6,11,6,1,18,10,110,0,2,2
7889,2,2017-09-16,houston,,Rice,W (38-3),34,38,89.5,354,2,37,130,3.5,3,75,484,6.5,16,6,0,22,2,10,0,0,0
7890,3,2017-09-23,houston,,Texas Tech,L (24-27),32,52,61.5,317,2,31,110,3.5,1,83,427,5.1,14,8,3,25,6,50,3,2,5
7891,4,2017-09-30,houston,@,Temple,W (20-13),25,36,69.4,226,1,31,162,5.2,1,67,388,5.8,10,9,4,23,12,108,0,1,1
7892,5,2017-10-07,houston,,Southern Methodist,W (35-22),20,28,71.4,198,3,40,265,6.6,2,68,463,6.8,10,14,3,27,4,48,0,2,2
7893,6,2017-10-14,houston,@,Tulsa,L (17-45),25,41,61.0,258,0,47,146,3.1,2,88,404,4.6,13,11,1,25,6,36,1,2,3
7894,7,2017-10-19,houston,,Memphis,L (38-42),29,41,70.7,315,1,54,239,4.4,4,95,554,5.8,16,9,0,25,8,72,2,1,3
7895,8,2017-10-28,houston,@,South Florida,W (28-24),14,25,56.0,142,1,48,255,5.3,3,73,397,5.4,5,11,0,16,5,45,1,0,1
7896,9,2017-11-04,houston,,East Carolina,W (52-27),15,22,68.2,330,3,26,142,5.5,3,48,472,9.8,8,7,1,16,4,34,0,0,0
7897,10,2017-11-18,houston,@,Tulane,L (17-20),18,26,69.2,225,0,33,220,6.7,2,59,445,7.5,13,8,1,22,5,46,1,1,2
7898,11,2017-11-24,houston,,Navy,W (24-14),21,27,77.8,277,1,32,103,3.2,2,59,380,6.4,10,5,1,16,4,43,2,0,2
7899,12,2017-12-24,houston,N,Fresno State*,L (27-33),23,43,53.5,269,1,30,72,2.4,1,73,341,4.7,13,3,1,17,6,44,1,1,2
7900,,12 Games,houston,,,,281,411,68.4,3136,16,446,2002,4.5,25,857,5138,6.0,139,97,16,252,72,646,11,12,23
7901,1,2018-09-01,houston,@,Rice,W (45-27),18,25,72.0,320,3,37,251,6.8,3,62,571,9.2,11,10,2,23,5,38,2,0,2
7902,2,2018-09-08,houston,,Arizona,W (45-18),19,40,47.5,254,4,40,297,7.4,2,80,551,6.9,11,14,3,28,7,56,0,0,0
7903,3,2018-09-15,houston,@,Texas Tech,L (49-63),31,52,59.6,462,5,40,173,4.3,2,92,635,6.9,18,8,2,28,9,68,0,0,0
7904,4,2018-09-22,houston,,Texas Southern,W (70-14),33,49,67.3,386,5,41,285,7.0,5,90,671,7.5,18,17,1,36,2,10,0,1,1
7905,5,2018-10-04,houston,,Tulsa,W (41-26),19,27,70.4,165,3,39,314,8.1,2,66,479,7.3,8,11,2,21,8,55,1,2,3
7906,6,2018-10-13,houston,@,East Carolina,W (42-20),16,28,57.1,249,3,43,157,3.7,2,71,406,5.7,8,8,2,18,12,115,0,0,0
7907,7,2018-10-20,houston,@,Navy,W (49-36),25,39,64.1,413,3,25,157,6.3,3,64,570,8.9,18,11,0,29,3,20,1,1,2
7908,8,2018-10-27,houston,,South Florida,W (57-36),28,40,70.0,419,5,49,263,5.4,3,89,682,7.7,16,16,3,35,5,50,0,2,2
7909,9,2018-11-03,houston,@,Southern Methodist,L (31-45),11,22,50.0,175,2,47,190,4.0,1,69,365,5.3,6,9,0,15,6,50,2,0,2
7910,10,2018-11-10,houston,,Temple,L (49-59),28,47,59.6,322,5,44,205,4.7,2,91,527,5.8,14,11,6,31,12,90,2,1,3
7911,11,2018-11-15,houston,,Tulane,W (48-17),17,30,56.7,190,3,48,298,6.2,3,78,488,6.3,9,13,2,24,6,54,0,1,1
7912,,11 Games,houston,,,,245,399,61.4,3355,41,453,2590,5.7,28,852,5945,7.0,137,128,23,288,75,606,8,8,16
7913,1,2014-08-30,eastern-michigan,,Morgan State,W (31-28),18,30,60.0,99,0,56,292,5.2,3,86,391,4.5,8,20,2,30,4,30,0,0,0
7914,2,2014-09-06,eastern-michigan,@,Florida,L (0-65),9,21,42.9,45,0,34,80,2.4,0,55,125,2.3,2,3,2,7,4,40,4,1,5
7915,3,2014-09-13,eastern-michigan,@,Old Dominion,L (3-17),12,24,50.0,72,0,48,143,3.0,0,72,215,3.0,4,10,0,14,5,47,2,0,2
7916,4,2014-09-20,eastern-michigan,@,Michigan State,L (14-73),10,29,34.5,115,2,19,20,1.1,0,48,135,2.8,3,2,0,5,4,38,5,1,6
7917,5,2014-10-04,eastern-michigan,@,Akron,L (6-31),17,30,56.7,185,1,37,94,2.5,0,67,279,4.2,8,8,2,18,7,60,2,2,4
7918,6,2014-10-11,eastern-michigan,,Buffalo,W (37-27),10,18,55.6,147,1,49,337,6.9,4,67,484,7.2,7,11,0,18,7,62,1,0,1
7919,7,2014-10-18,eastern-michigan,N,Massachusetts,L (14-36),10,21,47.6,147,2,32,133,4.2,0,53,280,5.3,5,6,0,11,10,92,0,1,1
7920,8,2014-10-25,eastern-michigan,,Northern Illinois,L (17-28),16,34,47.1,124,0,48,257,5.4,2,82,381,4.6,8,15,2,25,8,80,0,1,1
7921,9,2014-11-01,eastern-michigan,,Central Michigan,L (7-38),7,19,36.8,76,1,29,21,0.7,0,48,97,2.0,2,2,1,5,4,19,1,1,2
7922,10,2014-11-15,eastern-michigan,@,Western Michigan,L (7-51),14,22,63.6,283,1,37,87,2.4,0,59,370,6.3,10,4,0,14,8,70,1,2,3
7923,11,2014-11-22,eastern-michigan,@,Ball State,L (30-45),36,49,73.5,409,3,36,94,2.6,0,85,503,5.9,16,13,1,30,6,46,3,0,3
7924,12,2014-11-28,eastern-michigan,,Toledo,L (16-52),8,23,34.8,119,2,34,96,2.8,0,57,215,3.8,6,4,2,12,2,14,0,2,2
7925,,12 Games,eastern-michigan,,,,167,320,52.2,1821,13,459,1654,3.6,9,779,3475,4.5,79,98,12,189,69,598,19,11,30
7926,1,2015-09-05,eastern-michigan,,Old Dominion,L (34-38),22,36,61.1,192,2,47,252,5.4,2,83,444,5.3,11,13,3,27,7,78,1,2,3
7927,2,2015-09-12,eastern-michigan,@,Wyoming,W (48-29),18,25,72.0,330,3,37,176,4.8,3,62,506,8.2,12,8,1,21,4,45,0,0,0
7928,3,2015-09-19,eastern-michigan,,Ball State,L (17-28),19,39,48.7,196,0,22,123,5.6,2,61,319,5.2,8,4,0,12,4,45,0,2,2
7929,4,2015-09-26,eastern-michigan,,Army,L (36-58),27,39,69.2,280,2,25,193,7.7,3,64,473,7.4,16,7,1,24,10,77,1,1,2
7930,5,2015-10-03,eastern-michigan,@,Louisiana State,L (22-44),17,24,70.8,161,1,33,94,2.8,2,57,255,4.5,8,7,1,16,7,70,0,3,3
7931,6,2015-10-10,eastern-michigan,,Akron,L (21-47),24,35,68.6,252,3,31,161,5.2,0,66,413,6.3,9,9,2,20,9,90,2,1,3
7932,7,2015-10-17,eastern-michigan,@,Toledo,L (20-63),23,37,62.2,176,0,48,282,5.9,2,85,458,5.4,8,14,1,23,6,45,1,1,2
7933,8,2015-10-24,eastern-michigan,@,Northern Illinois,L (21-49),26,43,60.5,219,0,44,157,3.6,3,87,376,4.3,11,14,1,26,7,75,0,1,1
7934,9,2015-10-29,eastern-michigan,,Western Michigan,L (28-58),18,30,60.0,263,3,39,226,5.8,1,69,489,7.1,13,12,1,26,3,20,2,2,4
7935,10,2015-11-07,eastern-michigan,@,Miami (OH),L (13-28),7,20,35.0,89,0,39,103,2.6,1,59,192,3.3,5,5,0,10,9,54,1,1,2
7936,11,2015-11-14,eastern-michigan,,Massachusetts,L (17-28),27,43,62.8,256,2,26,59,2.3,0,69,315,4.6,16,4,3,23,6,47,1,0,1
7937,12,2015-11-27,eastern-michigan,@,Central Michigan,L (28-35),19,36,52.8,217,2,32,113,3.5,1,68,330,4.9,7,5,2,14,9,55,2,0,2
7938,,12 Games,eastern-michigan,,,,247,407,60.7,2631,18,423,1939,4.6,20,830,4570,5.5,124,102,16,242,81,701,11,14,25
7939,1,2016-09-02,eastern-michigan,,Mississippi Valley State,W (61-14),17,24,70.8,198,3,44,281,6.4,5,68,479,7.0,9,14,1,24,6,68,0,1,1
7940,2,2016-09-10,eastern-michigan,@,Missouri,L (21-61),23,45,51.1,287,1,46,141,3.1,2,91,428,4.7,12,7,2,21,8,61,0,2,2
7941,3,2016-09-17,eastern-michigan,@,UNC Charlotte,W (37-19),24,31,77.4,285,2,30,72,2.4,1,61,357,5.9,13,4,0,17,7,90,0,1,1
7942,4,2016-09-23,eastern-michigan,,Wyoming,W (27-24),17,34,50.0,261,1,47,239,5.1,2,81,500,6.2,10,13,1,24,5,55,0,4,4
7943,5,2016-10-01,eastern-michigan,@,Bowling Green State,W (28-25),21,30,70.0,262,3,45,212,4.7,1,75,474,6.3,8,13,3,24,5,56,1,1,2
7944,6,2016-10-08,eastern-michigan,,Toledo,L (20-35),20,38,52.6,255,1,20,62,3.1,1,58,317,5.5,11,4,1,16,5,51,1,1,2
7945,7,2016-10-15,eastern-michigan,@,Ohio,W (27-20),29,39,74.4,347,3,32,88,2.8,0,71,435,6.1,12,8,0,20,5,55,1,0,1
7946,8,2016-10-22,eastern-michigan,@,Western Michigan,L (31-45),29,45,64.4,319,1,30,142,4.7,3,75,461,6.1,17,5,1,23,7,50,1,1,2
7947,9,2016-10-29,eastern-michigan,,Miami (OH),L (15-28),23,39,59.0,328,2,23,33,1.4,0,62,361,5.8,13,3,0,16,7,67,0,1,1
7948,10,2016-11-08,eastern-michigan,@,Ball State,W (48-41),37,72,51.4,468,3,37,154,4.2,3,109,622,5.7,23,10,2,35,4,30,2,1,3
7949,11,2016-11-16,eastern-michigan,,Northern Illinois,L (24-31),17,38,44.7,184,1,56,291,5.2,2,94,475,5.1,9,18,5,32,7,68,0,2,2
7950,12,2016-11-22,eastern-michigan,,Central Michigan,W (26-21),26,37,70.3,355,2,32,183,5.7,1,69,538,7.8,14,8,1,23,7,75,0,1,1
7951,13,2016-12-23,eastern-michigan,N,Old Dominion*,L (20-24),26,47,55.3,300,2,38,170,4.5,0,85,470,5.5,16,8,4,28,3,15,0,1,1
7952,,13 Games,eastern-michigan,,,,309,519,59.5,3849,25,480,2068,4.3,21,999,5917,5.9,167,115,21,303,76,741,6,17,23
7953,1,2017-09-01,eastern-michigan,,UNC Charlotte,W (24-7),22,31,71.0,267,0,41,126,3.1,2,72,393,5.5,10,8,1,19,10,70,1,1,2
7954,2,2017-09-09,eastern-michigan,@,Rutgers,W (16-13),19,37,51.4,260,1,35,114,3.3,0,72,374,5.2,13,4,2,19,9,93,1,0,1
7955,3,2017-09-23,eastern-michigan,,Ohio,L (20-27),29,49,59.2,305,1,27,45,1.7,1,76,350,4.6,12,3,0,15,8,85,0,1,1
7956,4,2017-09-30,eastern-michigan,@,Kentucky,L (20-24),27,47,57.4,299,2,27,13,0.5,1,74,312,4.2,17,2,1,20,5,50,1,2,3
7957,5,2017-10-07,eastern-michigan,@,Toledo,L (15-20),24,40,60.0,253,2,23,73,3.2,0,63,326,5.2,13,6,2,21,7,86,0,2,2
7958,6,2017-10-14,eastern-michigan,@,Army,L (27-28),19,27,70.4,229,4,26,135,5.2,0,53,364,6.9,13,7,1,21,6,34,0,1,1
7959,7,2017-10-21,eastern-michigan,,Western Michigan,L (17-20),28,44,63.6,308,1,38,153,4.0,1,82,461,5.6,14,10,3,27,8,65,2,1,3
7960,8,2017-10-26,eastern-michigan,@,Northern Illinois,L (27-30),23,45,51.1,307,2,33,96,2.9,0,78,403,5.2,11,2,2,15,6,69,0,0,0
7961,9,2017-11-02,eastern-michigan,,Ball State,W (56-14),15,22,68.2,263,3,40,225,5.6,4,62,488,7.9,12,10,2,24,3,30,1,0,1
7962,10,2017-11-08,eastern-michigan,@,Central Michigan,L (30-42),23,39,59.0,204,2,36,124,3.4,1,75,328,4.4,9,10,3,22,4,25,0,5,5
7963,11,2017-11-15,eastern-michigan,@,Miami (OH),W (27-24),15,27,55.6,269,2,40,196,4.9,1,67,465,6.9,9,7,2,18,4,28,1,1,2
7964,12,2017-11-21,eastern-michigan,,Bowling Green State,W (34-31),13,27,48.1,124,1,53,266,5.0,3,80,390,4.9,7,15,0,22,4,55,0,1,1
7965,,12 Games,eastern-michigan,,,,257,435,59.1,3088,21,419,1566,3.7,14,854,4654,5.4,140,84,19,243,74,690,7,15,22
7966,1,2018-08-31,eastern-michigan,,Monmouth,W (51-17),22,27,81.5,302,5,39,171,4.4,2,66,473,7.2,15,9,3,27,7,65,0,0,0
7967,2,2018-09-08,eastern-michigan,@,Purdue,W (20-19),22,34,64.7,347,1,31,69,2.2,1,65,416,6.4,13,3,3,19,10,71,0,1,1
7968,3,2018-09-15,eastern-michigan,@,Buffalo,L (28-35),25,38,65.8,348,2,43,142,3.3,2,81,490,6.0,12,8,2,22,11,98,1,0,1
7969,4,2018-09-22,eastern-michigan,@,San Diego State,L (20-23),17,27,63.0,236,1,39,119,3.1,1,66,355,5.4,7,6,1,14,6,45,1,1,2
7970,5,2018-09-29,eastern-michigan,,Northern Illinois,L (23-26),17,41,41.5,180,1,33,62,1.9,1,74,242,3.3,9,5,2,16,11,85,1,0,1
7971,6,2018-10-06,eastern-michigan,@,Western Michigan,L (24-27),18,31,58.1,206,2,48,178,3.7,1,79,384,4.9,11,10,2,23,4,31,1,0,1
7972,7,2018-10-13,eastern-michigan,,Toledo,W (28-26),17,23,73.9,183,0,38,229,6.0,4,61,412,6.8,8,10,0,18,11,138,0,0,0
7973,8,2018-10-20,eastern-michigan,@,Ball State,W (42-20),22,28,78.6,257,3,49,163,3.3,3,77,420,5.5,11,10,2,23,5,65,1,0,1
7974,9,2018-10-27,eastern-michigan,,Army,L (22-37),19,29,65.5,201,2,11,34,3.1,1,40,235,5.9,7,1,2,10,8,75,1,0,1
7975,10,2018-11-03,eastern-michigan,,Central Michigan,W (17-7),21,33,63.6,212,1,43,137,3.2,1,76,349,4.6,10,7,1,18,8,81,2,1,3
7976,11,2018-11-10,eastern-michigan,,Akron,W (27-7),16,24,66.7,132,0,50,261,5.2,2,74,393,5.3,7,12,1,20,7,65,1,0,1
7977,,11 Games,eastern-michigan,,,,216,335,64.5,2604,18,424,1565,3.7,19,759,4169,5.5,110,81,19,210,88,819,9,3,12
7978,1,2016-09-10,lamar,@,Houston,L (0-42),7,13,53.8,58,0,28,15,0.5,0,41,73,1.8,2,2,0,4,6,43,1,0,1
7979,1,2017-09-02,lamar,@,North Texas,L (14-59),20,41,48.8,180,2,33,86,2.6,0,74,266,3.6,9,6,1,15,3,15,1,1,2
7980,1,2018-09-08,lamar,@,Texas Tech,L (0-77),10,32,31.3,80,0,42,102,2.4,0,74,182,2.5,3,8,2,13,4,15,1,3,4
7981,1,2014-08-30,buffalo,,Duquesne,W (38-28),25,36,69.4,298,3,49,174,3.6,2,85,472,5.6,14,10,2,26,3,31,1,1,2
7982,2,2014-09-06,buffalo,@,Army,L (39-47),34,50,68.0,396,5,29,153,5.3,0,79,549,6.9,21,8,4,33,7,59,0,3,3
7983,3,2014-09-12,buffalo,,Baylor,L (21-63),18,31,58.1,255,2,39,139,3.6,1,70,394,5.6,8,5,2,15,8,59,1,0,1
7984,4,2014-09-20,buffalo,,Norfolk State,W (36-7),15,29,51.7,262,4,44,169,3.8,1,73,431,5.9,10,9,3,22,4,55,0,0,0
7985,5,2014-09-27,buffalo,,Miami (OH),W (35-27),29,39,74.4,302,2,49,273,5.6,3,88,575,6.5,14,14,1,29,5,58,0,0,0
7986,6,2014-10-04,buffalo,@,Bowling Green State,L (35-36),16,24,66.7,134,1,47,234,5.0,4,71,368,5.2,9,11,3,23,6,70,0,1,1
7987,7,2014-10-11,buffalo,@,Eastern Michigan,L (27-37),27,45,60.0,383,3,36,154,4.3,0,81,537,6.6,12,7,3,22,7,60,1,2,3
7988,8,2014-10-25,buffalo,,Central Michigan,L (14-20),21,37,56.8,233,2,22,38,1.7,0,59,271,4.6,10,3,2,15,3,40,0,2,2
7989,9,2014-11-05,buffalo,@,Ohio,L (14-37),12,25,48.0,106,1,25,28,1.1,0,50,134,2.7,5,2,0,7,3,21,2,2,4
7990,10,2014-11-11,buffalo,,Akron,W (55-24),17,23,73.9,226,5,54,310,5.7,3,77,536,7.0,9,16,4,29,7,75,1,1,2
7991,11,2014-11-28,buffalo,@,Massachusetts,W (41-21),20,27,74.1,255,4,49,293,6.0,2,76,548,7.2,10,12,1,23,5,55,0,0,0
7992,,11 Games,buffalo,,,,234,366,63.9,2850,32,443,1965,4.4,16,809,4815,6.0,122,97,25,244,58,583,6,12,18
7993,1,2015-09-05,buffalo,,Albany,W (51-14),22,29,75.9,255,2,43,212,4.9,4,72,467,6.5,11,10,3,24,7,56,0,0,0
7994,2,2015-09-12,buffalo,@,Penn State,L (14-27),24,35,68.6,205,2,33,69,2.1,0,68,274,4.0,10,4,1,15,14,107,0,1,1
7995,3,2015-09-19,buffalo,@,Florida Atlantic,W (33-15),10,20,50.0,105,0,45,185,4.1,1,65,290,4.5,5,8,0,13,8,75,0,1,1
7996,4,2015-09-26,buffalo,,Nevada,L (21-24),28,46,60.9,338,2,35,149,4.3,0,81,487,6.0,15,7,1,23,9,90,1,2,3
7997,5,2015-10-03,buffalo,,Bowling Green State,L (22-28),35,59,59.3,348,1,37,152,4.1,1,96,500,5.2,21,11,2,34,8,85,0,1,1
7998,6,2015-10-17,buffalo,@,Central Michigan,L (14-51),14,28,50.0,149,1,29,92,3.2,0,57,241,4.2,7,5,1,13,5,63,2,2,4
7999,7,2015-10-24,buffalo,,Ohio,W (41-17),21,32,65.6,212,0,34,161,4.7,3,66,373,5.7,10,8,1,19,8,65,0,0,0
8000,8,2015-10-29,buffalo,@,Miami (OH),W (29-24),22,29,75.9,289,2,40,144,3.6,2,69,433,6.3,11,6,1,18,6,65,0,1,1
8001,9,2015-11-05,buffalo,@,Kent State,W (18-17),25,39,64.1,190,2,35,116,3.3,1,74,306,4.1,10,8,2,20,3,26,0,1,1
8002,10,2015-11-11,buffalo,,Northern Illinois,L (30-41),31,47,66.0,354,2,23,78,3.4,1,70,432,6.2,15,5,3,23,5,26,0,3,3
8003,11,2015-11-21,buffalo,@,Akron,L (21-42),32,51,62.7,262,1,28,130,4.6,2,79,392,5.0,16,5,2,23,6,64,1,2,3
8004,12,2015-11-27,buffalo,,Massachusetts,L (26-31),19,40,47.5,287,1,43,160,3.7,2,83,447,5.4,11,9,1,21,5,46,0,2,2
8005,,12 Games,buffalo,,,,283,455,62.2,2994,16,425,1648,3.9,17,880,4642,5.3,142,86,18,246,84,768,4,16,20
8006,1,2016-09-02,buffalo,,Albany,L (16-22),17,34,50.0,177,1,48,226,4.7,0,82,403,4.9,10,11,2,23,9,83,1,3,4
8007,2,2016-09-17,buffalo,@,Nevada,L (14-38),7,23,30.4,130,1,35,231,6.6,1,58,361,6.2,4,13,0,17,4,24,0,0,0
8008,3,2016-09-24,buffalo,,Army,W (23-20),20,31,64.5,178,1,33,87,2.6,2,64,265,4.1,7,5,1,13,5,35,0,1,1
8009,4,2016-10-01,buffalo,@,Boston College,L (3-35),10,23,43.5,41,0,19,26,1.4,0,42,67,1.6,3,1,1,5,5,39,1,0,1
8010,5,2016-10-08,buffalo,,Kent State,L (20-44),21,40,52.5,256,1,37,116,3.1,1,77,372,4.8,11,8,1,20,2,18,1,0,1
8011,6,2016-10-15,buffalo,,Ball State,L (21-31),28,46,60.9,306,3,37,153,4.1,0,83,459,5.5,16,7,1,24,6,49,0,0,0
8012,7,2016-10-22,buffalo,@,Northern Illinois,L (7-44),25,41,61.0,203,0,29,135,4.7,1,70,338,4.8,12,7,1,20,6,53,0,4,4
8013,8,2016-10-27,buffalo,,Akron,W (41-20),7,21,33.3,140,1,42,378,9.0,4,63,518,8.2,4,15,0,19,6,66,0,1,1
8014,9,2016-11-03,buffalo,@,Ohio,L (10-34),24,40,60.0,308,1,38,105,2.8,0,78,413,5.3,12,6,1,19,8,66,1,1,2
8015,10,2016-11-12,buffalo,,Miami (OH),L (24-35),21,40,52.5,193,0,46,187,4.1,2,86,380,4.4,12,12,3,27,5,36,1,1,2
8016,11,2016-11-19,buffalo,@,Western Michigan,L (0-38),12,22,54.5,140,0,30,128,4.3,0,52,268,5.2,6,6,1,13,4,32,1,0,1
8017,12,2016-11-25,buffalo,@,Bowling Green State,L (19-27),20,36,55.6,334,2,32,67,2.1,1,68,401,5.9,15,5,0,20,3,16,2,0,2
8018,,12 Games,buffalo,,,,212,397,53.4,2406,11,426,1839,4.3,12,823,4245,5.2,112,96,12,220,63,517,8,11,19
8019,1,2017-08-31,buffalo,@,Minnesota,L (7-17),22,42,52.4,211,1,22,51,2.3,0,64,262,4.1,10,2,1,13,4,35,0,1,1
8020,2,2017-09-09,buffalo,@,Army,L (17-21),9,16,56.3,193,1,23,119,5.2,1,39,312,8.0,8,3,0,11,3,25,2,0,2
8021,3,2017-09-16,buffalo,,Colgate,W (33-10),9,16,56.3,184,1,58,302,5.2,3,74,486,6.6,7,17,2,26,7,70,0,0,0
8022,4,2017-09-23,buffalo,,Florida Atlantic,W (34-31),18,27,66.7,254,1,57,204,3.6,3,84,458,5.5,15,9,4,28,7,52,0,0,0
8023,5,2017-09-30,buffalo,@,Kent State,W (27-13),11,18,61.1,142,1,44,235,5.3,3,62,377,6.1,6,7,5,18,6,56,0,1,1
8024,6,2017-10-07,buffalo,,Western Michigan,L (68-71),35,61,57.4,597,7,33,86,2.6,2,94,683,7.3,19,6,5,30,8,64,2,0,2
8025,7,2017-10-14,buffalo,,Northern Illinois,L (13-14),21,34,61.8,344,1,27,39,1.4,0,61,383,6.3,11,2,2,15,8,77,0,1,1
8026,8,2017-10-21,buffalo,@,Miami (OH),L (14-24),17,41,41.5,202,2,25,69,2.8,0,66,271,4.1,10,2,2,14,5,50,1,1,2
8027,9,2017-10-28,buffalo,@,Akron,L (20-21),34,50,68.0,313,0,34,141,4.1,2,84,454,5.4,17,9,2,28,4,31,0,1,1
8028,10,2017-11-07,buffalo,,Bowling Green State,W (38-28),23,37,62.2,406,3,40,176,4.4,2,77,582,7.6,16,8,2,26,6,51,2,0,2
8029,11,2017-11-16,buffalo,@,Ball State,W (40-24),16,28,57.1,350,4,39,215,5.5,1,67,565,8.4,14,11,1,26,5,47,0,1,1
8030,12,2017-11-24,buffalo,,Ohio,W (31-24),19,30,63.3,294,2,26,56,2.2,1,56,350,6.3,12,3,1,16,4,39,0,0,0
8031,,12 Games,buffalo,,,,234,400,58.5,3490,24,428,1693,4.0,18,828,5183,6.3,145,79,27,251,67,597,7,6,13
8032,1,2018-09-01,buffalo,,Delaware State,W (48-10),19,29,65.5,200,6,37,154,4.2,1,66,354,5.4,9,9,3,21,5,42,0,0,0
8033,2,2018-09-08,buffalo,@,Temple,W (36-29),26,45,57.8,275,3,41,152,3.7,2,86,427,5.0,17,7,3,27,4,29,0,1,1
8034,3,2018-09-15,buffalo,,Eastern Michigan,W (35-28),21,26,80.8,325,3,41,164,4.0,2,67,489,7.3,10,6,2,18,7,47,1,0,1
8035,4,2018-09-22,buffalo,@,Rutgers,W (42-13),14,28,50.0,263,3,36,182,5.1,3,64,445,7.0,10,5,4,19,3,25,0,2,2
8036,5,2018-09-29,buffalo,,Army,L (13-42),10,24,41.7,152,1,31,103,3.3,1,55,255,4.6,5,5,4,14,7,78,0,0,0
8037,6,2018-10-06,buffalo,@,Central Michigan,W (34-24),10,20,50.0,127,1,48,295,6.1,3,68,422,6.2,8,12,1,21,4,38,0,1,1
8038,7,2018-10-13,buffalo,,Akron,W (24-6),16,30,53.3,212,1,46,223,4.8,2,76,435,5.7,9,10,1,20,5,45,0,1,1
8039,8,2018-10-20,buffalo,@,Toledo,W (31-17),25,46,54.3,326,2,50,137,2.7,2,96,463,4.8,14,10,8,32,5,44,0,3,3
8040,9,2018-10-30,buffalo,,Miami (OH),W (51-42),20,35,57.1,358,3,37,149,4.0,4,72,507,7.0,11,10,5,26,11,100,0,0,0
8041,10,2018-11-06,buffalo,,Kent State,W (48-14),9,21,42.9,120,1,57,358,6.3,6,78,478,6.1,6,15,1,22,3,20,1,0,1
8042,11,2018-11-14,buffalo,@,Ohio,L (17-52),10,23,43.5,120,0,22,157,7.1,2,45,277,6.2,4,7,2,13,3,20,2,3,5
8043,,11 Games,buffalo,,,,180,327,55.0,2478,24,446,2074,4.7,28,773,4552,5.9,103,96,34,233,57,488,4,11,15
8044,1,2014-08-28,san-jose-state,,North Dakota,W (42-10),23,26,88.5,256,3,40,150,3.8,2,66,406,6.2,11,10,2,23,4,40,0,0,0
8045,2,2014-09-06,san-jose-state,@,Auburn,L (13-59),19,32,59.4,254,1,45,65,1.4,0,77,319,4.1,10,8,2,20,7,66,0,3,3
8046,3,2014-09-20,san-jose-state,@,Minnesota,L (7-24),16,33,48.5,186,1,32,68,2.1,0,65,254,3.9,8,6,3,17,0,0,3,2,5
8047,4,2014-09-27,san-jose-state,,Nevada,L (10-21),32,46,69.6,276,0,37,170,4.6,1,83,446,5.4,13,10,1,24,9,95,1,2,3
8048,5,2014-10-04,san-jose-state,,Nevada-Las Vegas,W (33-10),20,30,66.7,265,1,56,277,4.9,2,86,542,6.3,11,12,0,23,4,45,1,0,1
8049,6,2014-10-18,san-jose-state,@,Wyoming,W (27-20),33,45,73.3,322,2,41,149,3.6,1,86,471,5.5,18,10,3,31,5,40,2,0,2
8050,7,2014-10-25,san-jose-state,@,Navy,L (31-41),33,46,71.7,322,3,25,100,4.0,1,71,422,5.9,20,6,0,26,2,20,0,1,1
8051,8,2014-11-01,san-jose-state,,Colorado State,L (31-38),26,51,51.0,308,2,32,185,5.8,2,83,493,5.9,15,8,1,24,1,5,1,2,3
8052,9,2014-11-08,san-jose-state,@,Fresno State,L (24-38),26,44,59.1,350,2,23,86,3.7,1,67,436,6.5,12,4,0,16,7,30,1,2,3
8053,10,2014-11-15,san-jose-state,,Hawaii,L (0-13),25,45,55.6,305,0,41,157,3.8,0,86,462,5.4,15,9,0,24,3,20,2,1,3
8054,11,2014-11-21,san-jose-state,@,Utah State,L (7-41),13,21,61.9,61,0,51,191,3.7,1,72,252,3.5,3,9,2,14,7,43,0,0,0
8055,12,2014-11-29,san-jose-state,@,San Diego State,L (7-38),17,30,56.7,133,1,31,98,3.2,0,61,231,3.8,7,5,0,12,3,35,1,1,2
8056,,12 Games,san-jose-state,,,,283,449,63.0,3038,16,454,1696,3.7,11,903,4734,5.2,143,97,14,254,52,439,12,14,26
8057,1,2015-09-03,san-jose-state,,New Hampshire,W (43-13),30,35,85.7,422,1,53,285,5.4,5,88,707,8.0,18,16,0,34,5,43,0,0,0
8058,2,2015-09-12,san-jose-state,@,Air Force,L (16-37),18,33,54.5,140,1,20,150,7.5,1,53,290,5.5,0,0,0,13,8,51,0,2,2
8059,3,2015-09-19,san-jose-state,@,Oregon State,L (21-35),20,33,60.6,149,1,36,104,2.9,2,69,253,3.7,6,8,0,14,2,20,0,2,2
8060,4,2015-09-26,san-jose-state,,Fresno State,W (49-23),20,23,87.0,252,3,58,291,5.0,3,81,543,6.7,10,21,2,33,4,30,1,0,1
8061,5,2015-10-03,san-jose-state,@,Auburn,L (21-35),21,33,63.6,224,1,38,182,4.8,2,71,406,5.7,12,9,1,22,2,15,2,2,4
8062,6,2015-10-10,san-jose-state,@,Nevada-Las Vegas,W (33-27),30,48,62.5,329,2,24,115,4.8,2,72,444,6.2,17,4,1,22,3,22,1,1,2
8063,7,2015-10-17,san-jose-state,,San Diego State,L (7-30),14,24,58.3,113,0,35,35,1.0,1,59,148,2.5,5,6,3,14,4,29,0,2,2
8064,8,2015-10-24,san-jose-state,,New Mexico,W (31-21),16,20,80.0,181,2,57,317,5.6,2,77,498,6.5,8,15,2,25,5,50,0,0,0
8065,9,2015-11-06,san-jose-state,,Brigham Young,L (16-17),18,26,69.2,147,0,38,122,3.2,1,64,269,4.2,9,6,3,18,2,10,1,0,1
8066,10,2015-11-14,san-jose-state,@,Nevada,L (34-37),15,23,65.2,186,3,45,247,5.5,0,68,433,6.4,10,11,0,21,4,40,0,0,0
8067,11,2015-11-21,san-jose-state,@,Hawaii,W (42-23),24,33,72.7,314,3,40,195,4.9,3,73,509,7.0,14,8,1,23,7,50,0,0,0
8068,12,2015-11-27,san-jose-state,,Boise State,L (23-40),28,41,68.3,336,3,33,138,4.2,0,74,474,6.4,16,7,1,24,6,56,0,2,2
8069,13,2015-12-19,san-jose-state,N,Georgia State*,W (27-16),10,19,52.6,89,1,54,197,3.6,1,73,286,3.9,6,12,2,20,5,48,0,1,1
8070,,13 Games,san-jose-state,,,,264,391,67.5,2882,21,531,2378,4.5,23,922,5260,5.7,131,123,16,283,57,464,5,12,17
8071,1,2016-09-03,san-jose-state,@,Tulsa,L (10-45),16,29,55.2,234,1,32,53,1.7,0,61,287,4.7,10,2,1,13,4,30,2,1,3
8072,2,2016-09-10,san-jose-state,,Portland State,W (66-35),14,21,66.7,233,3,57,409,7.2,6,78,642,8.2,8,16,4,28,6,60,0,0,0
8073,3,2016-09-17,san-jose-state,,Utah,L (17-34),21,39,53.8,249,2,32,56,1.8,0,71,305,4.3,10,6,2,18,2,10,1,2,3
8074,4,2016-09-24,san-jose-state,@,Iowa State,L (10-44),13,27,48.1,155,1,47,177,3.8,0,74,332,4.5,9,14,1,24,4,30,0,4,4
8075,5,2016-10-01,san-jose-state,@,New Mexico,L (41-48),16,30,53.3,314,3,26,129,5.0,3,56,443,7.9,12,3,5,20,2,25,0,1,1
8076,6,2016-10-08,san-jose-state,,Hawaii,L (17-34),18,33,54.5,175,1,40,164,4.1,0,73,339,4.6,5,10,1,16,4,25,0,3,3
8077,7,2016-10-15,san-jose-state,,Nevada,W (14-10),11,17,64.7,142,0,54,137,2.5,2,71,279,3.9,8,11,1,20,4,43,0,0,0
8078,8,2016-10-21,san-jose-state,@,San Diego State,L (3-42),18,37,48.6,142,0,28,67,2.4,0,65,209,3.2,10,3,1,14,7,69,0,0,0
8079,9,2016-10-29,san-jose-state,,Nevada-Las Vegas,W (30-24),24,40,60.0,292,2,42,132,3.1,1,82,424,5.2,14,9,1,24,4,50,0,0,0
8080,10,2016-11-04,san-jose-state,@,Boise State,L (31-45),23,35,65.7,278,2,31,209,6.7,1,66,487,7.4,15,12,0,27,5,44,0,1,1
8081,11,2016-11-19,san-jose-state,,Air Force,L (38-41),25,37,67.6,340,2,41,117,2.9,3,78,457,5.9,16,9,3,28,7,41,1,2,3
8082,12,2016-11-26,san-jose-state,@,Fresno State,W (16-14),15,25,60.0,111,1,48,211,4.4,0,73,322,4.4,6,14,0,20,3,12,1,1,2
8083,,12 Games,san-jose-state,,,,214,370,57.8,2665,18,478,1861,3.9,16,848,4526,5.3,123,109,20,252,52,439,5,15,20
8084,1,2017-08-26,san-jose-state,,South Florida,L (22-42),25,50,50.0,278,3,38,109,2.9,0,88,387,4.4,11,5,2,18,9,64,0,3,3
8085,2,2017-09-02,san-jose-state,,Cal Poly,W (34-13),15,26,57.7,211,3,52,271,5.2,1,78,482,6.2,8,15,0,23,7,57,2,0,2
8086,3,2017-09-09,san-jose-state,@,Texas,L (0-56),15,29,51.7,129,0,23,42,1.8,0,52,171,3.3,4,3,1,8,7,49,1,1,2
8087,4,2017-09-16,san-jose-state,@,Utah,L (16-54),17,35,48.6,233,1,37,30,0.8,0,72,263,3.7,11,4,1,16,6,58,3,2,5
8088,5,2017-09-23,san-jose-state,,Utah State,L (10-61),8,22,36.4,54,0,37,108,2.9,0,59,162,2.7,2,8,0,10,9,52,4,1,5
8089,6,2017-09-30,san-jose-state,@,Nevada-Las Vegas,L (13-41),30,49,61.2,315,1,33,147,4.5,0,82,462,5.6,20,7,3,30,7,60,1,2,3
8090,7,2017-10-07,san-jose-state,,Fresno State,L (10-27),15,26,57.7,97,1,33,108,3.3,0,59,205,3.5,4,7,1,12,9,78,2,2,4
8091,8,2017-10-14,san-jose-state,@,Hawaii,L (26-37),21,33,63.6,381,2,37,123,3.3,0,70,504,7.2,12,7,4,23,11,104,1,1,2
8092,9,2017-10-28,san-jose-state,@,Brigham Young,L (20-41),25,39,64.1,198,2,41,140,3.4,0,80,338,4.2,12,9,2,23,2,10,4,1,5
8093,10,2017-11-04,san-jose-state,,San Diego State,L (7-52),12,22,54.5,167,1,21,33,1.6,0,43,200,4.7,5,3,0,8,4,30,1,2,3
8094,11,2017-11-11,san-jose-state,@,Nevada,L (14-59),11,22,50.0,129,1,55,173,3.1,1,77,302,3.9,7,13,3,23,6,67,2,3,5
8095,12,2017-11-18,san-jose-state,@,Colorado State,L (14-42),17,33,51.5,208,0,33,131,4.0,2,66,339,5.1,8,6,2,16,2,10,0,1,1
8096,13,2017-11-25,san-jose-state,,Wyoming,W (20-17),15,29,51.7,174,0,43,146,3.4,2,72,320,4.4,6,7,1,14,5,55,1,1,2
8097,,13 Games,san-jose-state,,,,226,415,54.5,2574,15,483,1561,3.2,6,898,4135,4.6,110,94,20,224,84,694,22,20,42
8098,1,2018-08-30,san-jose-state,,California-Davis,L (38-44),28,52,53.8,365,3,38,141,3.7,2,90,506,5.6,17,8,2,27,12,125,1,2,3
8099,2,2018-09-08,san-jose-state,@,Washington State,L (0-31),14,28,50.0,100,0,23,9,0.4,0,51,109,2.1,5,2,1,8,9,56,0,1,1
8100,3,2018-09-15,san-jose-state,@,Oregon,L (22-35),20,41,48.8,267,1,28,29,1.0,1,69,296,4.3,12,1,3,16,3,25,0,2,2
8101,4,2018-09-29,san-jose-state,,Hawaii,L (41-44),28,49,57.1,451,3,37,39,1.1,2,86,490,5.7,17,5,2,24,10,75,0,0,0
8102,5,2018-10-06,san-jose-state,,Colorado State,L (30-42),18,43,41.9,237,3,34,48,1.4,1,77,285,3.7,8,6,2,16,6,45,0,2,2
8103,6,2018-10-13,san-jose-state,N,Army,L (3-52),13,18,72.2,135,0,30,36,1.2,0,48,171,3.6,7,3,0,10,7,55,4,0,4
8104,7,2018-10-20,san-jose-state,@,San Diego State,L (13-16),27,37,73.0,233,0,34,62,1.8,1,71,295,4.2,13,3,2,18,6,52,0,1,1
8105,8,2018-10-27,san-jose-state,,Nevada-Las Vegas,W (50-37),26,37,70.3,349,4,40,157,3.9,1,77,506,6.6,18,7,0,25,4,36,0,1,1
8106,9,2018-11-03,san-jose-state,@,Wyoming,L (9-24),19,32,59.4,173,1,24,71,3.0,0,56,244,4.4,9,5,1,15,6,45,0,0,0
8107,10,2018-11-10,san-jose-state,@,Utah State,L (24-62),22,42,52.4,344,2,20,56,2.8,0,62,400,6.5,12,1,1,14,9,80,1,2,3
8108,11,2018-11-17,san-jose-state,,Nevada,L (12-21),18,27,66.7,170,2,26,30,1.2,0,53,200,3.8,10,1,0,11,5,21,0,1,1
8109,,11 Games,san-jose-state,,,,233,406,57.4,2824,19,334,678,2.0,8,740,3502,4.7,128,42,14,184,77,615,6,12,18
8110,1,2014-08-29,colorado-state,N,Colorado,W (31-17),13,23,56.5,134,1,45,266,5.9,3,68,400,5.9,10,14,3,27,6,63,1,0,1
8111,2,2014-09-06,colorado-state,@,Boise State,L (24-37),31,58,53.4,434,3,23,28,1.2,0,81,462,5.7,20,2,1,23,2,20,1,2,3
8112,3,2014-09-13,colorado-state,,California-Davis,W (49-21),25,34,73.5,452,4,33,224,6.8,3,67,676,10.1,17,11,0,28,3,31,0,0,0
8113,4,2014-09-27,colorado-state,@,Boston College,W (24-21),27,41,65.9,268,2,24,162,6.8,1,65,430,6.6,18,6,1,25,7,69,0,2,2
8114,5,2014-10-04,colorado-state,,Tulsa,W (42-17),16,26,61.5,298,4,31,234,7.5,2,57,532,9.3,6,10,1,17,7,74,1,1,2
8115,6,2014-10-11,colorado-state,@,Nevada,W (31-24),26,36,72.2,326,3,34,119,3.5,1,70,445,6.4,15,6,0,21,2,25,1,0,1
8116,7,2014-10-18,colorado-state,,Utah State,W (16-13),20,32,62.5,243,0,39,75,1.9,1,71,318,4.5,8,7,4,19,11,116,0,0,0
8117,8,2014-10-25,colorado-state,,Wyoming,W (45-31),20,24,83.3,411,5,30,147,4.9,1,54,558,10.3,17,6,1,24,9,87,0,0,0
8118,9,2014-11-01,colorado-state,@,San Jose State,W (38-31),22,28,78.6,290,1,37,113,3.1,4,65,403,6.2,12,8,0,20,2,17,2,0,2
8119,10,2014-11-08,colorado-state,,Hawaii,W (49-22),16,28,57.1,287,4,43,293,6.8,3,71,580,8.2,11,14,1,26,7,46,1,0,1
8120,11,2014-11-22,colorado-state,,New Mexico,W (58-20),26,36,72.2,406,3,45,292,6.5,5,81,698,8.6,18,11,3,32,7,76,2,0,2
8121,12,2014-11-28,colorado-state,@,Air Force,L (24-27),23,46,50.0,366,3,32,106,3.3,0,78,472,6.1,15,8,1,24,2,14,0,1,1
8122,13,2014-12-20,colorado-state,N,Utah*,L (10-45),21,35,60.0,266,1,19,12,0.6,0,54,278,5.1,9,2,2,13,7,73,1,1,2
8123,,13 Games,colorado-state,,,,286,447,64.0,4181,34,435,2071,4.8,24,882,6252,7.1,176,105,18,299,72,711,10,7,17
8124,1,2015-09-05,colorado-state,,Savannah State,W (65-13),27,36,75.0,381,6,33,217,6.6,2,69,598,8.7,20,11,2,33,6,62,4,1,5
8125,2,2015-09-12,colorado-state,,Minnesota,L (20-23),16,32,50.0,142,1,41,172,4.2,1,73,314,4.3,5,8,1,14,10,86,2,2,4
8126,3,2015-09-19,colorado-state,N,Colorado,L (24-27),25,39,64.1,282,1,49,218,4.4,2,88,500,5.7,16,9,2,27,8,65,0,2,2
8127,4,2015-09-26,colorado-state,@,Texas-San Antonio,W (33-31),16,30,53.3,267,3,46,171,3.7,1,76,438,5.8,12,11,2,25,9,71,0,0,0
8128,5,2015-10-03,colorado-state,@,Utah State,L (18-33),21,46,45.7,252,1,31,109,3.5,1,77,361,4.7,12,9,3,24,12,110,2,1,3
8129,6,2015-10-10,colorado-state,,Boise State,L (10-41),14,30,46.7,151,1,37,105,2.8,0,67,256,3.8,6,7,1,14,9,93,1,2,3
8130,7,2015-10-17,colorado-state,,Air Force,W (38-23),23,30,76.7,296,3,37,160,4.3,2,67,456,6.8,14,7,1,22,9,87,0,1,1
8131,8,2015-10-31,colorado-state,,San Diego State,L (17-41),17,28,60.7,205,2,33,163,4.9,0,61,368,6.0,10,8,4,22,7,78,1,3,4
8132,9,2015-11-07,colorado-state,@,Wyoming,W (26-7),11,15,73.3,120,0,55,228,4.1,3,70,348,5.0,6,14,3,23,10,101,0,1,1
8133,10,2015-11-14,colorado-state,,Nevada-Las Vegas,W (49-35),13,19,68.4,209,4,46,325,7.1,3,65,534,8.2,7,15,2,24,3,35,1,1,2
8134,11,2015-11-21,colorado-state,@,New Mexico,W (28-21),16,23,69.6,264,1,45,221,4.9,2,68,485,7.1,12,13,1,26,4,29,0,0,0
8135,12,2015-11-28,colorado-state,@,Fresno State,W (34-31),11,21,52.4,85,1,40,261,6.5,1,61,346,5.7,4,14,0,18,4,45,0,1,1
8136,13,2015-12-29,colorado-state,N,Nevada*,L (23-28),22,42,52.4,310,0,42,222,5.3,2,84,532,6.3,17,12,1,30,7,65,1,0,1
8137,,13 Games,colorado-state,,,,232,391,59.3,2964,24,535,2572,4.8,20,926,5536,6.0,141,138,23,302,98,927,12,15,27
8138,1,2016-09-02,colorado-state,N,Colorado,L (7-44),12,29,41.4,63,1,35,162,4.6,0,64,225,3.5,5,7,0,12,2,15,2,2,4
8139,2,2016-09-10,colorado-state,,Texas-San Antonio,W (23-14),8,23,34.8,108,0,47,220,4.7,2,70,328,4.7,6,11,2,19,7,70,0,0,0
8140,3,2016-09-17,colorado-state,,Northern Colorado,W (47-21),22,28,78.6,324,4,43,245,5.7,2,71,569,8.0,13,12,4,29,8,80,1,0,1
8141,4,2016-09-24,colorado-state,@,Minnesota,L (24-31),16,31,51.6,211,1,48,158,3.3,2,79,369,4.7,9,12,3,24,3,25,1,1,2
8142,5,2016-10-01,colorado-state,,Wyoming,L (17-38),23,42,54.8,370,1,33,111,3.4,1,75,481,6.4,15,5,0,20,6,37,1,1,2
8143,6,2016-10-08,colorado-state,,Utah State,W (31-24),17,32,53.1,240,2,47,224,4.8,2,79,464,5.9,9,12,1,22,8,79,0,0,0
8144,7,2016-10-15,colorado-state,@,Boise State,L (23-28),17,31,54.8,189,2,36,184,5.1,1,67,373,5.6,6,13,0,19,6,30,0,0,0
8145,8,2016-10-22,colorado-state,@,Nevada-Las Vegas,W (42-23),21,28,75.0,237,2,50,230,4.6,4,78,467,6.0,11,15,0,26,4,21,1,0,1
8146,9,2016-11-05,colorado-state,,Fresno State,W (37-0),18,25,72.0,237,2,48,257,5.4,3,73,494,6.8,13,13,2,28,7,80,0,0,0
8147,10,2016-11-12,colorado-state,@,Air Force,L (46-49),22,29,75.9,374,2,35,185,5.3,3,64,559,8.7,12,9,1,22,3,35,1,1,2
8148,11,2016-11-19,colorado-state,,New Mexico,W (49-31),9,10,90.0,164,2,42,412,9.8,5,52,576,11.1,7,15,1,23,8,70,0,0,0
8149,12,2016-11-26,colorado-state,@,San Diego State,W (63-31),11,16,68.8,216,5,46,291,6.3,3,62,507,8.2,10,13,0,23,6,65,0,0,0
8150,13,2016-12-22,colorado-state,N,Idaho*,L (50-61),21,36,58.3,445,5,30,155,5.2,2,66,600,9.1,14,7,4,25,10,92,1,2,3
8151,,13 Games,colorado-state,,,,217,360,60.3,3178,29,540,2834,5.2,30,900,6012,6.7,130,144,18,292,78,699,8,7,15
8152,1,2017-08-26,colorado-state,,Oregon State,W (58-27),26,39,66.7,334,3,43,191,4.4,3,82,525,6.4,14,16,1,31,8,40,1,1,2
8153,2,2017-09-01,colorado-state,N,Colorado,L (3-17),24,47,51.1,309,0,33,88,2.7,0,80,397,5.0,15,7,1,23,10,120,1,2,3
8154,3,2017-09-09,colorado-state,,Abilene Christian,W (38-10),25,40,62.5,342,3,38,273,7.2,2,78,615,7.9,15,12,3,30,8,88,1,1,2
8155,4,2017-09-16,colorado-state,@,Alabama,L (23-41),21,38,55.3,247,2,40,144,3.6,1,78,391,5.0,11,8,3,22,3,14,0,2,2
8156,5,2017-09-30,colorado-state,@,Hawaii,W (51-21),18,22,81.8,351,4,37,259,7.0,3,59,610,10.3,13,11,1,25,3,25,0,0,0
8157,6,2017-10-07,colorado-state,@,Utah State,W (27-14),22,31,71.0,293,2,52,216,4.2,1,83,509,6.1,16,10,3,29,8,85,0,0,0
8158,7,2017-10-14,colorado-state,,Nevada,W (44-42),26,37,70.3,384,4,34,224,6.6,2,71,608,8.6,15,8,0,23,11,98,1,0,1
8159,8,2017-10-20,colorado-state,@,New Mexico,W (27-24),17,33,51.5,231,2,35,180,5.1,1,68,411,6.0,13,8,2,23,8,88,0,0,0
8160,9,2017-10-28,colorado-state,,Air Force,L (28-45),17,31,54.8,269,2,23,166,7.2,2,54,435,8.1,13,7,2,22,4,40,0,3,3
8161,10,2017-11-04,colorado-state,@,Wyoming,L (13-16),8,14,57.1,110,0,55,235,4.3,1,69,345,5.0,5,13,0,18,7,55,0,0,0
8162,11,2017-11-11,colorado-state,,Boise State,L (52-59),29,43,67.4,309,2,52,261,5.0,5,95,570,6.0,15,16,2,33,2,19,1,1,2
8163,12,2017-11-18,colorado-state,,San Jose State,W (42-14),26,32,81.3,305,3,45,301,6.7,3,77,606,7.9,14,12,0,26,6,54,1,0,1
8164,13,2017-12-16,colorado-state,N,Marshall*,L (28-31),25,52,48.1,320,2,31,70,2.3,2,83,390,4.7,15,6,5,26,3,15,0,0,0
8165,,13 Games,colorado-state,,,,284,459,61.9,3804,29,518,2608,5.0,26,977,6412,6.6,174,134,23,331,81,741,6,10,16
8166,1,2018-08-25,colorado-state,,Hawaii,L (34-43),34,50,68.0,537,5,25,116,4.6,0,75,653,8.7,22,5,2,29,12,120,0,1,1
8167,2,2018-08-31,colorado-state,N,Colorado,L (13-45),19,37,51.4,181,1,39,103,2.6,0,76,284,3.7,10,8,2,20,5,35,0,1,1
8168,3,2018-09-08,colorado-state,,Arkansas,W (34-27),32,50,64.0,389,2,23,40,1.7,1,73,429,5.9,14,5,2,21,6,54,1,1,2
8169,4,2018-09-15,colorado-state,@,Florida,L (10-48),23,41,56.1,240,1,41,73,1.8,0,82,313,3.8,11,8,3,22,6,33,3,0,3
8170,5,2018-09-22,colorado-state,,Illinois State,L (19-35),24,44,54.5,257,3,31,134,4.3,0,75,391,5.2,12,10,3,25,9,79,0,2,2
8171,6,2018-10-06,colorado-state,@,San Jose State,W (42-30),15,29,51.7,172,4,45,219,4.9,1,74,391,5.3,8,11,2,21,8,61,0,2,2
8172,7,2018-10-13,colorado-state,,New Mexico,W (20-18),24,42,57.1,311,1,41,112,2.7,1,83,423,5.1,12,10,2,24,10,65,0,0,0
8173,8,2018-10-19,colorado-state,@,Boise State,L (28-56),31,44,70.5,373,3,25,116,4.6,1,69,489,7.1,16,9,2,27,7,60,1,2,3
8174,9,2018-10-26,colorado-state,,Wyoming,L (21-34),34,54,63.0,333,0,20,20,1.0,3,74,353,4.8,19,3,1,23,3,26,1,2,3
8175,10,2018-11-10,colorado-state,@,Nevada,L (10-49),23,40,57.5,186,1,33,74,2.2,0,73,260,3.6,9,3,1,13,9,73,0,1,1
8176,11,2018-11-17,colorado-state,,Utah State,L (24-29),25,38,65.8,307,2,44,199,4.5,1,82,506,6.2,17,8,4,29,11,108,0,2,2
8177,,11 Games,colorado-state,,,,284,469,60.6,3286,23,367,1206,3.3,8,836,4492,5.4,150,80,24,254,86,714,6,14,20
8178,1,2018-09-15,lehigh,@,Navy,L (21-51),22,40,55.0,174,1,25,162,6.5,2,65,336,5.2,9,6,1,16,3,25,2,3,5
8179,1,2014-08-30,oregon,,South Dakota,W (62-13),25,32,78.1,380,4,38,293,7.7,4,70,673,9.6,16,16,0,32,9,64,1,0,1
8180,2,2014-09-06,oregon,,Michigan State,W (46-27),17,28,60.7,318,3,40,173,4.3,3,68,491,7.2,10,7,2,19,9,70,0,0,0
8181,3,2014-09-13,oregon,,Wyoming,W (48-14),25,31,80.6,293,2,37,263,7.1,5,68,556,8.2,15,15,2,32,4,30,0,0,0
8182,4,2014-09-20,oregon,@,Washington State,W (38-31),21,25,84.0,329,5,42,172,4.1,0,67,501,7.5,10,10,2,22,10,86,0,0,0
8183,5,2014-10-02,oregon,,Arizona,L (24-31),21,33,63.6,302,3,41,144,3.5,0,74,446,6.0,18,4,3,25,10,79,2,0,2
8184,6,2014-10-11,oregon,@,UCLA,W (42-30),17,27,63.0,210,2,41,258,6.3,4,68,468,6.9,9,14,3,26,4,37,0,0,0
8185,7,2014-10-18,oregon,,Washington,W (45-20),24,33,72.7,336,2,50,218,4.4,4,83,554,6.7,15,13,1,29,7,90,0,0,0
8186,8,2014-10-24,oregon,@,California,W (59-41),18,30,60.0,326,5,46,264,5.7,2,76,590,7.8,12,13,2,27,10,106,1,1,2
8187,9,2014-11-01,oregon,,Stanford,W (45-16),19,31,61.3,258,2,46,267,5.8,4,77,525,6.8,13,15,2,30,7,60,0,1,1
8188,10,2014-11-08,oregon,@,Utah,W (51-27),17,29,58.6,239,3,50,269,5.4,2,79,508,6.4,10,15,2,27,8,73,1,0,1
8189,11,2014-11-22,oregon,,Colorado,W (44-10),26,36,72.2,332,3,41,265,6.5,3,77,597,7.8,18,11,1,30,8,98,0,0,0
8190,12,2014-11-29,oregon,@,Oregon State,W (47-19),19,25,76.0,367,4,40,198,5.0,2,65,565,8.7,12,13,1,26,8,77,1,0,1
8191,13,2014-12-05,oregon,N,Arizona,W (51-13),27,40,67.5,326,2,54,301,5.6,4,94,627,6.7,15,13,3,31,13,84,0,0,0
8192,14,2015-01-01,oregon,N,Florida State*,W (59-20),26,36,72.2,338,2,45,301,6.7,5,81,639,7.9,12,17,1,30,6,50,1,1,2
8193,15,2015-01-12,oregon,N,Ohio State*,L (20-42),24,38,63.2,333,2,33,132,4.0,0,71,465,6.5,13,7,0,20,10,76,0,1,1
8194,,15 Games,oregon,,,,326,474,68.8,4687,44,644,3518,5.5,42,1118,8205,7.3,198,183,25,406,123,1080,7,4,11
8195,1,2015-09-05,oregon,,Eastern Washington,W (61-42),19,25,76.0,246,2,57,485,8.5,6,82,731,8.9,11,21,2,34,8,70,1,0,1
8196,2,2015-09-12,oregon,@,Michigan State,L (28-31),22,39,56.4,309,1,43,123,2.9,2,82,432,5.3,17,7,2,26,9,56,0,2,2
8197,3,2015-09-19,oregon,,Georgia State,W (61-28),23,31,74.2,228,2,53,311,5.9,3,84,539,6.4,10,18,1,29,7,62,1,0,1
8198,4,2015-09-26,oregon,,Utah,L (20-62),14,30,46.7,178,2,40,222,5.6,1,70,400,5.7,9,10,1,20,10,90,1,2,3
8199,5,2015-10-03,oregon,@,Colorado,W (41-24),13,21,61.9,176,2,60,361,6.0,3,81,537,6.6,6,19,2,27,4,45,0,1,1
8200,6,2015-10-10,oregon,,Washington State,L (38-45),13,24,54.2,123,2,50,410,8.2,3,74,533,7.2,5,13,0,18,5,44,1,1,2
8201,7,2015-10-17,oregon,@,Washington,W (26-20),14,25,56.0,272,2,51,170,3.3,1,76,442,5.8,9,9,3,21,9,82,0,0,0
8202,8,2015-10-29,oregon,@,Arizona State,W (61-55),23,41,56.1,315,4,28,186,6.6,3,69,501,7.3,9,7,3,19,6,50,0,1,1
8203,9,2015-11-07,oregon,,California,W (44-28),17,29,58.6,300,4,63,477,7.6,1,92,777,8.4,11,23,2,36,10,90,0,2,2
8204,10,2015-11-14,oregon,@,Stanford,W (38-36),10,12,83.3,205,2,36,231,6.4,3,48,436,9.1,8,9,1,18,4,45,1,0,1
8205,11,2015-11-21,oregon,,Southern California,W (48-28),20,25,80.0,407,6,38,171,4.5,0,63,578,9.2,15,11,2,28,4,42,0,1,1
8206,12,2015-11-27,oregon,,Oregon State,W (52-42),28,38,73.7,366,3,51,308,6.0,4,89,674,7.6,16,17,4,37,9,93,1,0,1
8207,13,2016-01-02,oregon,N,Texas Christian*,L (41-47),20,35,57.1,233,1,48,186,3.9,4,83,419,5.0,11,9,1,21,5,24,1,0,1
8208,,13 Games,oregon,,,,236,375,62.9,3358,33,618,3641,5.9,34,993,6999,7.0,137,173,24,334,90,793,7,10,17
8209,1,2016-09-03,oregon,,California-Davis,W (53-28),21,30,70.0,271,3,37,251,6.8,4,67,522,7.8,12,8,1,21,8,71,2,0,2
8210,2,2016-09-10,oregon,,Virginia,W (44-26),21,31,67.7,331,3,45,301,6.7,3,76,632,8.3,11,10,4,25,12,117,0,0,0
8211,3,2016-09-17,oregon,@,Nebraska,L (32-35),14,23,60.9,146,0,47,336,7.1,5,70,482,6.9,5,14,1,20,13,126,0,0,0
8212,4,2016-09-24,oregon,,Colorado,L (38-41),22,33,66.7,293,2,45,215,4.8,3,78,508,6.5,14,8,2,24,8,75,0,1,1
8213,5,2016-10-01,oregon,@,Washington State,L (33-51),17,27,63.0,202,0,37,214,5.8,4,64,416,6.5,8,12,0,20,4,42,1,1,2
8214,6,2016-10-08,oregon,,Washington,L (21-70),21,34,61.8,179,2,43,230,5.3,1,77,409,5.3,9,11,2,22,5,40,1,1,2
8215,7,2016-10-21,oregon,@,California,L (49-52),22,40,55.0,258,6,45,192,4.3,1,85,450,5.3,13,9,5,27,14,134,0,1,1
8216,8,2016-10-29,oregon,,Arizona State,W (54-35),31,42,73.8,489,4,46,245,5.3,2,88,734,8.3,16,14,0,30,9,73,1,0,1
8217,9,2016-11-05,oregon,@,Southern California,L (20-45),20,37,54.1,203,1,30,85,2.8,2,67,288,4.3,9,7,3,19,7,43,0,0,0
8218,10,2016-11-12,oregon,,Stanford,L (27-52),21,30,70.0,274,2,45,226,5.0,2,75,500,6.7,11,10,3,24,8,77,2,2,4
8219,11,2016-11-19,oregon,@,Utah,W (30-28),30,43,69.8,324,3,43,251,5.8,1,86,575,6.7,17,10,0,27,5,37,1,0,1
8220,12,2016-11-26,oregon,@,Oregon State,L (24-34),17,29,58.6,213,2,30,171,5.7,1,59,384,6.5,9,9,3,21,6,75,1,0,1
8221,,12 Games,oregon,,,,257,399,64.4,3183,28,493,2717,5.5,29,892,5900,6.6,134,122,24,280,99,910,9,6,15
8222,1,2017-09-02,oregon,,Southern Utah,W (77-21),23,27,85.2,355,1,52,348,6.7,9,79,703,8.9,14,20,3,37,12,115,2,0,2
8223,2,2017-09-09,oregon,,Nebraska,W (42-35),25,33,75.8,365,3,44,201,4.6,3,77,566,7.4,10,11,1,22,12,103,1,1,2
8224,3,2017-09-16,oregon,@,Wyoming,W (49-13),18,30,60.0,251,1,65,307,4.7,6,95,558,5.9,12,18,2,32,4,40,2,1,3
8225,4,2017-09-23,oregon,@,Arizona State,L (35-37),19,35,54.3,281,3,30,120,4.0,2,65,401,6.2,11,5,4,20,14,99,1,0,1
8226,5,2017-09-30,oregon,,California,W (45-24),17,22,77.3,131,1,56,328,5.9,5,78,459,5.9,6,15,3,24,10,110,0,1,1
8227,6,2017-10-07,oregon,,Washington State,L (10-33),15,27,55.6,145,1,45,132,2.9,0,72,277,3.8,5,6,2,13,10,95,1,2,3
8228,7,2017-10-14,oregon,@,Stanford,L (7-49),5,13,38.5,33,0,43,276,6.4,1,56,309,5.5,3,9,0,12,9,101,1,2,3
8229,8,2017-10-21,oregon,@,UCLA,L (14-31),8,15,53.3,74,0,62,246,4.0,2,77,320,4.2,5,14,5,24,3,15,1,1,2
8230,9,2017-10-28,oregon,,Utah,W (41-20),10,13,76.9,69,2,49,347,7.1,2,62,416,6.7,3,15,1,19,8,60,1,0,1
8231,10,2017-11-04,oregon,@,Washington,L (3-38),7,13,53.8,31,0,55,247,4.5,0,68,278,4.1,0,16,0,16,5,50,1,1,2
8232,11,2017-11-18,oregon,,Arizona,W (48-28),14,21,66.7,235,1,50,353,7.1,5,71,588,8.3,9,13,2,24,12,117,0,1,1
8233,12,2017-11-25,oregon,,Oregon State,W (69-10),16,26,61.5,266,3,49,311,6.3,5,75,577,7.7,8,17,3,28,12,138,0,0,0
8234,13,2017-12-16,oregon,N,Boise State*,L (28-38),26,36,72.2,233,2,28,47,1.7,0,64,280,4.4,10,3,1,14,10,95,2,2,4
8235,,13 Games,oregon,,,,203,311,65.3,2469,18,628,3263,5.2,40,939,5732,6.1,96,162,27,285,121,1138,13,12,25
8236,1,2018-09-01,oregon,,Bowling Green State,W (58-24),11,26,42.3,292,5,42,212,5.0,2,68,504,7.4,8,11,4,23,3,35,1,2,3
8237,2,2018-09-08,oregon,,Portland State,W (62-14),23,29,79.3,266,4,47,296,6.3,5,76,562,7.4,14,17,1,32,5,55,0,0,0
8238,3,2018-09-15,oregon,,San Jose State,W (35-22),16,36,44.4,309,3,49,134,2.7,2,85,443,5.2,12,7,1,20,6,59,0,2,2
8239,4,2018-09-22,oregon,,Stanford,L (31-38),26,33,78.8,346,1,49,178,3.6,3,82,524,6.4,15,10,2,27,4,32,1,1,2
8240,5,2018-09-29,oregon,@,California,W (42-24),16,22,72.7,225,2,42,260,6.2,2,64,485,7.6,9,11,1,21,7,72,1,0,1
8241,6,2018-10-13,oregon,,Washington,W (30-27),18,32,56.3,202,2,49,177,3.6,2,81,379,4.7,11,11,2,24,7,70,1,0,1
8242,7,2018-10-20,oregon,@,Washington State,L (20-34),25,44,56.8,270,1,23,65,2.8,1,67,335,5.0,13,5,3,21,6,44,0,0,0
8243,8,2018-10-27,oregon,@,Arizona,L (15-44),24,48,50.0,186,2,23,84,3.7,0,71,270,3.8,12,4,2,18,6,53,2,1,3
8244,9,2018-11-03,oregon,,UCLA,W (42-21),19,33,57.6,292,2,42,200,4.8,3,75,492,6.6,11,8,1,20,1,15,0,0,0
8245,10,2018-11-10,oregon,@,Utah,L (25-32),20,33,60.6,288,3,32,117,3.7,0,65,405,6.2,11,5,1,17,7,63,1,0,1
8246,11,2018-11-17,oregon,,Arizona State,W (31-29),19,34,55.9,262,2,39,199,5.1,2,73,461,6.3,10,10,1,21,6,55,2,2,4
8247,,11 Games,oregon,,,,217,370,58.6,2938,27,437,1922,4.4,22,807,4860,6.0,126,99,19,244,58,553,9,8,17
8248,1,2014-08-30,oregon-state,,Portland State,W (29-14),26,45,57.8,328,1,37,177,4.8,1,82,505,6.2,16,8,1,25,13,119,1,0,1
8249,2,2014-09-06,oregon-state,@,Hawaii,W (38-30),26,37,70.3,300,3,36,164,4.6,2,73,464,6.4,10,7,5,22,13,99,1,1,2
8250,3,2014-09-20,oregon-state,,San Diego State,W (28-7),24,31,77.4,275,0,36,97,2.7,4,67,372,5.6,12,8,5,25,7,52,1,1,2
8251,4,2014-09-27,oregon-state,@,Southern California,L (10-35),15,35,42.9,123,0,21,58,2.8,0,56,181,3.2,4,6,7,17,13,108,0,2,2
8252,5,2014-10-04,oregon-state,@,Colorado,W (36-31),27,37,73.0,278,1,32,167,5.2,3,69,445,6.4,13,7,2,22,5,42,0,0,0
8253,6,2014-10-16,oregon-state,,Utah,L (23-29),21,37,56.8,272,2,46,118,2.6,0,83,390,4.7,9,9,3,21,9,75,1,1,2
8254,7,2014-10-25,oregon-state,@,Stanford,L (14-38),18,38,47.4,209,0,29,12,0.4,2,67,221,3.3,9,3,0,12,8,67,0,0,0
8255,8,2014-11-01,oregon-state,,California,L (31-45),30,45,66.7,320,2,23,148,6.4,2,68,468,6.9,17,6,2,25,8,90,0,1,1
8256,9,2014-11-08,oregon-state,,Washington State,L (32-39),31,41,75.6,419,1,24,37,1.5,2,65,456,7.0,15,6,2,23,10,100,0,0,0
8257,10,2014-11-15,oregon-state,,Arizona State,W (35-27),19,33,57.6,251,2,37,247,6.7,2,70,498,7.1,9,8,2,19,9,76,1,1,2
8258,11,2014-11-22,oregon-state,@,Washington,L (13-37),30,46,65.2,314,2,23,47,2.0,0,69,361,5.2,12,3,2,17,5,55,0,1,1
8259,12,2014-11-29,oregon-state,,Oregon,L (19-47),23,47,48.9,216,1,32,146,4.6,1,79,362,4.6,12,7,2,21,7,75,1,0,1
8260,,12 Games,oregon-state,,,,290,472,61.4,3305,15,376,1418,3.8,19,848,4723,5.6,138,78,33,249,107,958,6,8,14
8261,1,2015-09-04,oregon-state,,Weber State,W (26-7),12,22,54.5,110,2,56,281,5.0,0,78,391,5.0,5,13,4,22,7,67,0,1,1
8262,2,2015-09-12,oregon-state,@,Michigan,L (7-35),9,20,45.0,79,1,33,59,1.8,0,53,138,2.6,5,4,3,12,8,62,1,0,1
8263,3,2015-09-19,oregon-state,,San Jose State,W (35-21),13,25,52.0,135,1,46,303,6.6,3,71,438,6.2,9,14,1,24,4,35,1,1,2
8264,4,2015-09-25,oregon-state,,Stanford,L (24-42),20,36,55.6,275,1,36,111,3.1,2,72,386,5.4,13,7,0,20,6,65,1,0,1
8265,5,2015-10-10,oregon-state,@,Arizona,L (7-44),12,35,34.3,98,0,31,151,4.9,1,66,249,3.8,5,8,2,15,5,59,0,1,1
8266,6,2015-10-17,oregon-state,@,Washington State,L (31-52),17,30,56.7,176,1,45,218,4.8,2,75,394,5.3,10,11,0,21,11,86,0,2,2
8267,7,2015-10-24,oregon-state,,Colorado,L (13-17),13,32,40.6,199,0,41,202,4.9,1,73,401,5.5,7,9,1,17,8,65,0,1,1
8268,8,2015-10-31,oregon-state,@,Utah,L (12-27),19,35,54.3,204,1,30,108,3.6,0,65,312,4.8,9,5,2,16,5,40,0,0,0
8269,9,2015-11-07,oregon-state,,UCLA,L (0-41),10,24,41.7,131,0,33,115,3.5,0,57,246,4.3,4,6,2,12,5,45,1,3,4
8270,10,2015-11-14,oregon-state,@,California,L (24-54),15,36,41.7,194,2,34,204,6.0,1,70,398,5.7,10,8,3,21,7,70,0,0,0
8271,11,2015-11-21,oregon-state,,Washington,L (7-52),8,23,34.8,109,1,23,148,6.4,0,46,257,5.6,4,3,1,8,3,30,1,1,2
8272,12,2015-11-27,oregon-state,@,Oregon,L (42-52),13,25,52.0,199,0,38,228,6.0,5,63,427,6.8,8,12,3,23,7,80,0,1,1
8273,,12 Games,oregon-state,,,,161,343,46.9,1909,10,446,2128,4.8,15,789,4037,5.1,89,100,22,211,76,704,5,11,16
8274,1,2016-09-01,oregon-state,@,Minnesota,L (23-30),25,40,62.5,228,3,34,89,2.6,0,74,317,4.3,11,4,3,18,4,55,2,0,2
8275,2,2016-09-17,oregon-state,,Idaho State,W (37-7),15,30,50.0,172,0,41,246,6.0,3,71,418,5.9,7,8,2,17,9,95,0,1,1
8276,3,2016-09-24,oregon-state,,Boise State,L (24-38),22,34,64.7,191,0,35,96,2.7,2,69,287,4.2,8,7,2,17,7,50,1,0,1
8277,4,2016-10-01,oregon-state,@,Colorado,L (6-47),13,32,40.6,100,0,34,126,3.7,0,66,226,3.4,6,7,1,14,5,31,0,2,2
8278,5,2016-10-08,oregon-state,,California,W (47-44),13,24,54.2,85,0,50,474,9.5,6,74,559,7.6,6,19,2,27,10,81,0,2,2
8279,6,2016-10-15,oregon-state,,Utah,L (14-19),9,30,30.0,100,1,35,197,5.6,1,65,297,4.6,4,10,1,15,9,65,1,1,2
8280,7,2016-10-22,oregon-state,@,Washington,L (17-41),12,27,44.4,148,0,30,177,5.9,2,57,325,5.7,8,6,1,15,6,40,0,2,2
8281,8,2016-10-29,oregon-state,,Washington State,L (31-35),23,39,59.0,327,2,28,171,6.1,2,67,498,7.4,12,6,2,20,13,110,0,0,0
8282,9,2016-11-05,oregon-state,@,Stanford,L (15-26),10,24,41.7,137,1,22,129,5.9,1,46,266,5.8,3,3,2,8,9,102,0,2,2
8283,10,2016-11-12,oregon-state,@,UCLA,L (24-38),22,34,64.7,232,0,34,75,2.2,2,68,307,4.5,9,5,2,16,12,119,2,1,3
8284,11,2016-11-19,oregon-state,,Arizona,W (42-17),16,19,84.2,265,5,46,210,4.6,1,65,475,7.3,11,14,1,26,5,49,1,0,1
8285,12,2016-11-26,oregon-state,,Oregon,W (34-24),13,20,65.0,101,1,51,316,6.2,4,71,417,5.9,5,20,0,25,7,65,1,0,1
8286,,12 Games,oregon-state,,,,193,353,54.7,2086,13,440,2306,5.2,24,793,4392,5.5,90,109,19,218,96,862,8,11,19
8287,1,2017-08-26,oregon-state,@,Colorado State,L (27-58),27,47,57.4,304,2,29,152,5.2,1,76,456,6.0,17,6,0,23,3,21,2,3,5
8288,2,2017-09-02,oregon-state,,Portland State,W (35-32),18,25,72.0,235,1,32,154,4.8,3,57,389,6.8,11,5,2,18,5,52,1,1,2
8289,3,2017-09-09,oregon-state,,Minnesota,L (14-48),17,29,58.6,145,1,26,80,3.1,1,55,225,4.1,6,6,2,14,7,91,3,0,3
8290,4,2017-09-16,oregon-state,@,Washington State,L (23-52),24,37,64.9,199,1,33,155,4.7,2,70,354,5.1,9,10,2,21,8,80,2,0,2
8291,5,2017-09-30,oregon-state,,Washington,L (7-42),11,22,50.0,74,0,28,110,3.9,1,50,184,3.7,2,6,0,8,8,86,2,0,2
8292,6,2017-10-07,oregon-state,@,Southern California,L (10-38),16,29,55.2,197,0,36,122,3.4,1,65,319,4.9,7,8,1,16,7,69,2,1,3
8293,7,2017-10-14,oregon-state,,Colorado,L (33-36),20,37,54.1,289,0,46,280,6.1,3,83,569,6.9,14,16,0,30,9,79,0,1,1
8294,8,2017-10-26,oregon-state,,Stanford,L (14-15),13,22,59.1,126,0,41,138,3.4,2,63,264,4.2,7,9,4,20,6,47,2,1,3
8295,9,2017-11-04,oregon-state,@,California,L (23-37),14,26,53.8,195,1,31,104,3.4,1,57,299,5.2,6,10,2,18,9,99,0,0,0
8296,10,2017-11-11,oregon-state,@,Arizona,L (28-49),16,28,57.1,209,4,40,151,3.8,0,68,360,5.3,10,10,2,22,5,39,0,1,1
8297,11,2017-11-18,oregon-state,,Arizona State,L (24-40),26,37,70.3,269,0,33,106,3.2,3,70,375,5.4,14,4,5,23,8,67,1,2,3
8298,12,2017-11-25,oregon-state,@,Oregon,L (10-69),12,23,52.2,113,1,36,98,2.7,0,59,211,3.6,3,5,7,15,9,86,1,2,3
8299,,12 Games,oregon-state,,,,214,362,59.1,2355,11,411,1650,4.0,18,773,4005,5.2,106,95,27,228,84,816,16,12,28
8300,1,2018-09-01,oregon-state,@,Ohio State,L (31-77),14,24,58.3,196,2,39,196,5.0,2,63,392,6.2,7,6,2,15,5,49,2,0,2
8301,2,2018-09-08,oregon-state,,Southern Utah,W (48-25),19,31,61.3,289,1,45,360,8.0,5,76,649,8.5,13,14,0,27,5,70,1,0,1
8302,3,2018-09-15,oregon-state,@,Nevada,L (35-37),35,56,62.5,459,2,40,81,2.0,3,96,540,5.6,17,9,2,28,7,60,1,2,3
8303,4,2018-09-22,oregon-state,,Arizona,L (14-35),18,26,69.2,141,2,44,97,2.2,0,70,238,3.4,7,9,2,18,5,50,0,0,0
8304,5,2018-09-29,oregon-state,@,Arizona State,L (24-52),14,24,58.3,145,1,53,261,4.9,2,77,406,5.3,7,17,0,24,5,50,1,0,1
8305,6,2018-10-06,oregon-state,,Washington State,L (37-56),18,26,69.2,221,0,50,276,5.5,5,76,497,6.5,10,11,1,22,11,104,1,0,1
8306,7,2018-10-20,oregon-state,,California,L (7-49),17,33,51.5,146,0,41,95,2.3,1,74,241,3.3,7,8,3,18,5,43,0,2,2
8307,8,2018-10-27,oregon-state,@,Colorado,W (41-34),34,54,63.0,345,3,45,114,2.5,2,99,459,4.6,20,5,3,28,7,62,0,1,1
8308,9,2018-11-03,oregon-state,,Southern California,L (21-38),31,46,67.4,301,1,32,31,1.0,2,78,332,4.3,17,5,2,24,4,28,0,0,0
8309,10,2018-11-10,oregon-state,@,Stanford,L (17-48),17,35,48.6,236,2,33,168,5.1,0,68,404,5.9,8,9,1,18,6,34,0,1,1
8310,11,2018-11-17,oregon-state,@,Washington,L (23-42),21,36,58.3,229,1,35,134,3.8,1,71,363,5.1,12,8,0,20,3,25,2,0,2
8311,,11 Games,oregon-state,,,,238,391,60.9,2708,15,457,1813,4.0,23,848,4521,5.3,125,101,16,242,63,575,8,6,14
8312,1,2017-09-09,montana,@,Washington,L (7-63),19,31,61.3,132,0,33,31,0.9,0,64,163,2.5,4,4,2,10,4,35,2,2,4
8313,1,2014-08-29,arizona,,Nevada-Las Vegas,W (58-13),26,46,56.5,434,4,48,353,7.4,3,94,787,8.4,17,13,2,32,7,63,0,0,0
8314,2,2014-09-04,arizona,@,Texas-San Antonio,W (26-23),17,32,53.1,231,1,44,223,5.1,1,76,454,6.0,8,11,3,22,8,73,0,0,0
8315,3,2014-09-13,arizona,,Nevada,W (35-28),22,26,84.6,278,3,38,229,6.0,2,64,507,7.9,13,10,3,26,7,47,0,1,1
8316,4,2014-09-20,arizona,,California,W (49-45),47,74,63.5,520,5,32,107,3.3,1,106,627,5.9,24,8,4,36,6,65,0,2,2
8317,5,2014-10-02,arizona,@,Oregon,W (31-24),20,31,64.5,287,1,55,208,3.8,3,86,495,5.8,13,11,5,29,9,78,1,1,2
8318,6,2014-10-11,arizona,,Southern California,L (26-28),43,72,59.7,395,1,30,78,2.6,2,102,473,4.6,23,6,5,34,4,35,1,0,1
8319,7,2014-10-25,arizona,@,Washington State,W (59-37),26,38,68.4,294,5,36,157,4.4,1,74,451,6.1,12,8,5,25,8,89,1,0,1
8320,8,2014-11-01,arizona,@,UCLA,L (7-17),18,48,37.5,175,1,31,80,2.6,0,79,255,3.2,10,5,4,19,4,40,0,1,1
8321,9,2014-11-08,arizona,,Colorado,W (38-20),21,38,55.3,211,4,47,288,6.1,0,85,499,5.9,11,11,6,28,8,75,0,0,0
8322,10,2014-11-15,arizona,,Washington,W (27-26),17,40,42.5,242,0,40,133,3.3,3,80,375,4.7,10,8,4,22,2,14,1,2,3
8323,11,2014-11-22,arizona,@,Utah,W (42-10),11,22,50.0,222,0,47,298,6.3,4,69,520,7.5,9,12,0,21,6,57,1,0,1
8324,12,2014-11-28,arizona,,Arizona State,W (42-35),15,21,71.4,208,2,37,125,3.4,3,58,333,5.7,6,7,0,13,9,123,2,0,2
8325,13,2014-12-05,arizona,N,Oregon,L (13-51),9,26,34.6,113,1,35,111,3.2,1,61,224,3.7,3,7,0,10,8,67,1,1,2
8326,14,2014-12-31,arizona,N,Boise State*,L (30-38),28,50,56.0,335,1,56,157,2.8,2,106,492,4.6,17,11,1,29,6,55,0,2,2
8327,,14 Games,arizona,,,,320,564,56.7,3945,29,576,2547,4.4,26,1140,6492,5.7,176,128,42,346,92,881,8,10,18
8328,1,2015-09-03,arizona,,Texas-San Antonio,W (42-32),22,36,61.1,229,4,38,163,4.3,0,74,392,5.3,12,8,5,25,8,76,1,0,1
8329,2,2015-09-12,arizona,@,Nevada,W (44-20),25,34,73.5,269,2,43,301,7.0,4,77,570,7.4,10,10,4,24,3,30,1,0,1
8330,3,2015-09-19,arizona,,Northern Arizona,W (77-13),26,39,66.7,293,4,41,499,12.2,7,80,792,9.9,15,19,2,36,4,50,0,0,0
8331,4,2015-09-26,arizona,,UCLA,L (30-56),10,28,35.7,115,2,59,353,6.0,2,87,468,5.4,5,23,4,32,5,40,2,1,3
8332,5,2015-10-03,arizona,@,Stanford,L (17-55),17,33,51.5,196,1,34,118,3.5,1,67,314,4.7,9,7,0,16,7,55,0,0,0
8333,6,2015-10-10,arizona,,Oregon State,W (44-7),17,30,56.7,276,0,58,368,6.3,5,88,644,7.3,10,15,2,27,7,56,0,0,0
8334,7,2015-10-17,arizona,@,Colorado,W (38-31),25,40,62.5,325,2,44,291,6.6,3,84,616,7.3,14,12,0,26,3,25,2,0,2
8335,8,2015-10-24,arizona,,Washington State,L (42-45),24,37,64.9,307,2,32,176,5.5,3,69,483,7.0,13,8,3,24,5,40,1,0,1
8336,9,2015-10-31,arizona,@,Washington,L (3-49),25,42,59.5,203,0,44,127,2.9,0,86,330,3.8,9,10,3,22,4,22,1,3,4
8337,10,2015-11-07,arizona,@,Southern California,L (30-38),31,47,66.0,352,3,32,60,1.9,0,79,412,5.2,16,5,3,24,9,80,0,1,1
8338,11,2015-11-14,arizona,,Utah,W (37-30),18,32,56.3,302,3,34,158,4.6,1,66,460,7.0,11,9,4,24,8,71,0,2,2
8339,12,2015-11-21,arizona,@,Arizona State,L (37-52),20,43,46.5,340,2,34,109,3.2,1,77,449,5.8,13,5,1,19,7,58,1,2,3
8340,13,2015-12-19,arizona,N,New Mexico*,W (45-37),13,24,54.2,329,2,32,174,5.4,4,56,503,9.0,10,7,2,19,4,30,1,1,2
8341,,13 Games,arizona,,,,273,465,58.7,3536,27,525,2897,5.5,31,990,6433,6.5,147,138,33,318,74,633,10,10,20
8342,1,2016-09-03,arizona,N,Brigham Young,L (16-18),20,30,66.7,213,0,26,115,4.4,2,56,328,5.9,9,6,2,17,4,20,0,2,2
8343,2,2016-09-10,arizona,,Grambling State,W (31-21),15,30,50.0,223,1,47,222,4.7,3,77,445,5.8,8,11,2,21,7,65,0,0,0
8344,3,2016-09-17,arizona,,Hawaii,W (47-28),16,21,76.2,235,1,49,347,7.1,5,70,582,8.3,8,19,1,28,11,105,0,0,0
8345,4,2016-09-24,arizona,,Washington,L (28-35),19,31,61.3,167,1,43,308,7.2,3,74,475,6.4,8,12,3,23,2,30,2,1,3
8346,5,2016-10-01,arizona,@,UCLA,L (24-45),13,31,41.9,145,3,49,242,4.9,0,80,387,4.8,7,11,4,22,5,40,0,0,0
8347,6,2016-10-08,arizona,@,Utah,L (23-36),16,29,55.2,348,2,37,127,3.4,1,66,475,7.2,11,8,2,21,7,65,0,3,3
8348,7,2016-10-15,arizona,,Southern California,L (14-48),11,26,42.3,142,1,44,201,4.6,1,70,343,4.9,7,8,5,20,4,35,2,2,4
8349,8,2016-10-29,arizona,,Stanford,L (10-34),5,20,25.0,116,1,44,170,3.9,0,64,286,4.5,4,9,2,15,5,55,2,1,3
8350,9,2016-11-05,arizona,@,Washington State,L (7-69),11,23,47.8,128,1,30,158,5.3,0,53,286,5.4,4,7,3,14,7,85,1,2,3
8351,10,2016-11-12,arizona,,Colorado,L (24-49),12,26,46.2,155,0,52,257,4.9,3,78,412,5.3,7,12,4,23,13,138,1,0,1
8352,11,2016-11-19,arizona,@,Oregon State,L (17-42),16,31,51.6,188,1,40,162,4.1,1,71,350,4.9,11,10,2,23,3,29,0,1,1
8353,12,2016-11-25,arizona,,Arizona State,W (56-35),3,8,37.5,77,1,48,511,10.6,7,56,588,10.5,1,16,2,19,8,101,1,0,1
8354,,12 Games,arizona,,,,157,306,51.3,2137,13,509,2820,5.5,26,815,4957,6.1,85,129,32,246,76,768,9,12,21
8355,1,2017-09-02,arizona,,Northern Arizona,W (62-24),7,14,50.0,89,1,47,506,10.8,7,61,595,9.8,2,17,4,23,9,81,0,0,0
8356,2,2017-09-09,arizona,,Houston,L (16-19),22,37,59.5,219,0,39,152,3.9,1,76,371,4.9,10,8,3,21,4,35,1,1,2
8357,3,2017-09-15,arizona,@,Texas-El Paso,W (63-16),20,23,87.0,175,3,64,328,5.1,5,87,503,5.8,11,17,1,29,3,20,1,0,1
8358,4,2017-09-22,arizona,,Utah,L (24-30),24,42,57.1,248,1,42,200,4.8,2,84,448,5.3,9,10,5,24,4,60,2,3,5
8359,5,2017-10-07,arizona,@,Colorado,W (45-42),12,14,85.7,154,1,40,416,10.4,5,54,570,10.6,6,15,4,25,2,10,1,0,1
8360,6,2017-10-14,arizona,,UCLA,W (47-30),9,13,69.2,148,1,61,457,7.5,4,74,605,8.2,5,18,4,27,11,113,0,0,0
8361,7,2017-10-21,arizona,@,California,W (45-44),10,15,66.7,166,2,46,345,7.5,4,61,511,8.4,7,15,2,24,8,88,0,1,1
8362,8,2017-10-28,arizona,,Washington State,W (58-37),10,17,58.8,275,2,34,310,9.1,4,51,585,11.5,8,5,0,13,2,20,2,1,3
8363,9,2017-11-04,arizona,@,Southern California,L (35-49),14,31,45.2,146,2,43,234,5.4,2,74,380,5.1,8,13,4,25,3,32,1,2,3
8364,10,2017-11-11,arizona,,Oregon State,W (49-28),5,7,71.4,68,0,55,534,9.7,7,62,602,9.7,4,21,1,26,5,70,0,1,1
8365,11,2017-11-18,arizona,@,Oregon,L (28-48),18,35,51.4,159,1,45,171,3.8,3,80,330,4.1,8,13,6,27,8,94,0,2,2
8366,12,2017-11-25,arizona,@,Arizona State,L (30-42),15,21,71.4,194,0,51,245,4.8,4,72,439,6.1,7,13,4,23,4,45,0,1,1
8367,13,2017-12-27,arizona,N,Purdue*,L (35-38),17,26,65.4,302,5,43,128,3.0,0,69,430,6.2,12,5,2,19,6,47,1,1,2
8368,,13 Games,arizona,,,,183,295,62.0,2343,19,610,4026,6.6,48,905,6369,7.0,97,170,40,306,69,715,9,13,22
8369,1,2018-09-01,arizona,,Brigham Young,L (23-28),17,34,50.0,197,1,35,129,3.7,2,69,326,4.7,11,7,4,22,4,26,0,0,0
8370,2,2018-09-08,arizona,@,Houston,L (18-45),28,50,56.0,381,0,50,150,3.0,2,100,531,5.3,19,9,3,31,8,85,0,2,2
8371,3,2018-09-15,arizona,,Southern Utah,W (62-31),15,22,68.2,358,5,38,268,7.1,2,60,626,10.4,11,12,3,26,10,98,1,0,1
8372,4,2018-09-22,arizona,@,Oregon State,W (35-14),9,17,52.9,152,2,51,442,8.7,3,68,594,8.7,8,21,0,29,7,55,1,0,1
8373,5,2018-09-29,arizona,,Southern California,L (20-24),16,33,48.5,232,2,37,98,2.6,1,70,330,4.7,10,4,6,20,8,80,0,1,1
8374,6,2018-10-06,arizona,,California,W (24-17),15,25,60.0,141,1,34,124,3.6,0,59,265,4.5,5,7,1,13,10,72,1,1,2
8375,7,2018-10-12,arizona,@,Utah,L (10-42),24,46,52.2,246,1,31,72,2.3,0,77,318,4.1,10,4,5,19,5,56,0,0,0
8376,8,2018-10-20,arizona,@,UCLA,L (30-31),15,34,44.1,231,2,38,289,7.6,1,72,520,7.2,11,7,4,22,6,64,1,2,3
8377,9,2018-10-27,arizona,,Oregon,W (44-15),19,33,57.6,189,3,51,276,5.4,2,84,465,5.5,10,13,4,27,11,106,0,1,1
8378,10,2018-11-02,arizona,,Colorado,W (42-34),17,22,77.3,350,5,47,216,4.6,0,69,566,8.2,12,12,3,27,12,129,1,1,2
8379,11,2018-11-17,arizona,@,Washington State,L (28-69),20,34,58.8,304,4,37,127,3.4,0,71,431,6.1,12,7,2,21,7,75,3,1,4
8380,,11 Games,arizona,,,,195,350,55.7,2781,26,449,2191,4.9,13,799,4972,6.2,119,103,35,257,88,846,8,9,17
8381,1,2014-08-28,washington-state,N,Rutgers,L (38-41),40,56,71.4,532,5,14,6,0.4,0,70,538,7.7,18,1,3,22,9,77,1,1,2
8382,2,2014-09-05,washington-state,@,Nevada,L (13-24),38,57,66.7,389,1,18,38,2.1,0,75,427,5.7,20,2,3,25,10,72,0,2,2
8383,3,2014-09-13,washington-state,,Portland State,W (59-21),43,64,67.2,630,7,23,76,3.3,1,87,706,8.1,27,5,1,33,7,70,0,2,2
8384,4,2014-09-20,washington-state,,Oregon,L (31-38),43,63,68.3,436,4,17,63,3.7,0,80,499,6.2,21,4,4,29,5,54,2,0,2
8385,5,2014-09-27,washington-state,@,Utah,W (28-27),39,61,63.9,417,4,25,78,3.1,0,86,495,5.8,19,6,2,27,4,40,1,2,3
8386,6,2014-10-04,washington-state,,California,L (59-60),49,70,70.0,734,6,25,78,3.1,2,95,812,8.5,26,4,3,33,12,121,0,0,0
8387,7,2014-10-10,washington-state,@,Stanford,L (17-34),42,69,60.9,292,2,11,-26,-2.4,0,80,266,3.3,12,4,2,18,10,75,0,1,1
8388,8,2014-10-25,washington-state,,Arizona,L (37-59),56,79,70.9,489,4,20,54,2.7,1,99,543,5.5,25,4,4,33,11,85,0,2,2
8389,9,2014-11-01,washington-state,,Southern California,L (17-44),44,66,66.7,386,2,26,34,1.3,0,92,420,4.6,14,7,2,23,5,48,1,2,3
8390,10,2014-11-08,washington-state,@,Oregon State,W (39-32),44,61,72.1,471,5,22,35,1.6,0,83,506,6.1,26,4,3,33,5,51,0,0,0
8391,11,2014-11-22,washington-state,@,Arizona State,L (31-52),45,76,59.2,601,3,24,21,0.9,1,100,622,6.2,27,2,1,30,7,49,1,4,5
8392,12,2014-11-29,washington-state,,Washington,L (13-31),27,49,55.1,355,2,18,21,1.2,0,67,376,5.6,16,2,2,20,9,70,1,2,3
8393,,12 Games,washington-state,,,,510,771,66.1,5732,45,243,478,2.0,5,1014,6210,6.1,251,45,30,326,94,812,7,18,25
8394,1,2015-09-05,washington-state,,Portland State,L (17-24),28,45,62.2,307,2,30,104,3.5,0,75,411,5.5,13,7,1,21,5,32,1,1,2
8395,2,2015-09-12,washington-state,@,Rutgers,W (37-34),47,66,71.2,478,4,16,81,5.1,0,82,559,6.8,21,6,1,28,5,50,0,0,0
8396,3,2015-09-19,washington-state,,Wyoming,W (31-14),37,45,82.2,303,2,20,75,3.8,2,65,378,5.8,14,4,1,19,5,43,0,1,1
8397,4,2015-10-03,washington-state,@,California,L (28-34),35,49,71.4,389,2,25,14,0.6,2,74,403,5.4,16,4,0,20,2,13,3,1,4
8398,5,2015-10-10,washington-state,@,Oregon,W (45-38),50,75,66.7,505,5,30,136,4.5,1,105,641,6.1,22,8,1,31,7,45,2,0,2
8399,6,2015-10-17,washington-state,,Oregon State,W (52-31),40,52,76.9,409,6,22,111,5.0,0,74,520,7.0,22,10,0,32,6,60,1,2,3
8400,7,2015-10-24,washington-state,@,Arizona,W (45-42),47,62,75.8,514,5,31,117,3.8,1,93,631,6.8,23,9,2,34,9,51,0,0,0
8401,8,2015-10-31,washington-state,,Stanford,L (28-30),35,63,55.6,354,2,23,88,3.8,0,86,442,5.1,19,5,2,26,4,30,0,2,2
8402,9,2015-11-07,washington-state,,Arizona State,W (38-24),36,55,65.5,497,5,17,15,0.9,0,72,512,7.1,18,3,0,21,2,20,0,1,1
8403,10,2015-11-14,washington-state,@,UCLA,W (31-27),40,58,69.0,388,3,22,38,1.7,1,80,426,5.3,18,5,3,26,9,45,0,1,1
8404,11,2015-11-21,washington-state,,Colorado,W (27-3),40,57,70.2,332,2,21,149,7.1,1,78,481,6.2,21,7,2,30,6,40,0,1,1
8405,12,2015-11-27,washington-state,@,Washington,L (10-45),36,58,62.1,288,1,12,31,2.6,0,70,319,4.6,16,1,2,19,4,28,5,2,7
8406,13,2015-12-26,washington-state,N,Miami (FL)*,W (20-14),29,53,54.7,295,2,25,87,3.5,0,78,382,4.9,12,7,4,23,5,63,1,0,1
8407,,13 Games,washington-state,,,,500,738,67.8,5059,41,294,1046,3.6,8,1032,6105,5.9,235,76,19,330,69,520,13,12,25
8408,1,2016-09-03,washington-state,,Eastern Washington,L (42-45),41,52,78.8,418,4,25,97,3.9,2,77,515,6.7,23,5,4,32,12,101,0,1,1
8409,2,2016-09-10,washington-state,@,Boise State,L (28-31),55,71,77.5,480,4,20,40,2.0,0,91,520,5.7,21,4,1,26,10,79,0,1,1
8410,3,2016-09-17,washington-state,,Idaho,W (56-6),27,44,61.4,281,3,35,228,6.5,3,79,509,6.4,12,12,2,26,11,108,0,1,1
8411,4,2016-10-01,washington-state,,Oregon,W (51-33),36,48,75.0,371,1,40,280,7.0,6,88,651,7.4,23,12,1,36,5,37,0,0,0
8412,5,2016-10-08,washington-state,@,Stanford,W (42-16),30,41,73.2,357,4,30,101,3.4,2,71,458,6.5,15,5,1,21,10,81,0,2,2
8413,6,2016-10-15,washington-state,,UCLA,W (27-21),28,48,58.3,261,0,35,95,2.7,3,83,356,4.3,15,6,4,25,8,60,1,1,2
8414,7,2016-10-22,washington-state,@,Arizona State,W (37-32),42,53,79.2,398,3,17,-38,-2.2,1,70,360,5.1,21,1,2,24,3,25,0,0,0
8415,8,2016-10-29,washington-state,@,Oregon State,W (35-31),33,46,71.7,415,5,26,137,5.3,0,72,552,7.7,17,7,3,27,6,65,2,0,2
8416,9,2016-11-05,washington-state,,Arizona,W (69-7),47,52,90.4,474,6,32,140,4.4,3,84,614,7.3,22,7,5,34,9,85,0,0,0
8417,10,2016-11-12,washington-state,,California,W (56-21),39,55,70.9,400,5,31,254,8.2,2,86,654,7.6,18,13,3,34,12,120,0,1,1
8418,11,2016-11-19,washington-state,@,Colorado,L (24-38),26,53,49.1,325,3,22,137,6.2,0,75,462,6.2,14,5,2,21,5,35,1,1,2
8419,12,2016-11-25,washington-state,,Washington,L (17-45),33,50,66.0,269,1,24,65,2.7,1,74,334,4.5,13,3,2,18,5,44,1,3,4
8420,13,2016-12-27,washington-state,N,Minnesota*,L (12-17),30,51,58.8,264,1,23,39,1.7,0,74,303,4.1,11,4,1,16,7,56,0,1,1
8421,,13 Games,washington-state,,,,467,664,70.3,4713,40,360,1575,4.4,23,1024,6288,6.1,225,84,31,340,103,896,5,12,17
8422,1,2017-09-02,washington-state,,Montana State,W (31-0),40,48,83.3,361,3,25,150,6.0,1,73,511,7.0,18,9,0,27,4,32,1,0,1
8423,2,2017-09-09,washington-state,,Boise State,W (47-44),49,67,73.1,433,3,27,22,0.8,1,94,455,4.8,22,3,0,25,5,55,1,2,3
8424,3,2017-09-16,washington-state,,Oregon State,W (52-23),42,58,72.4,431,6,16,60,3.8,0,74,491,6.6,23,2,2,27,7,50,0,0,0
8425,4,2017-09-23,washington-state,,Nevada,W (45-7),38,50,76.0,505,5,34,55,1.6,1,84,560,6.7,20,8,3,31,5,55,1,1,2
8426,5,2017-09-29,washington-state,,Southern California,W (30-27),34,51,66.7,340,2,30,122,4.1,1,81,462,5.7,13,7,3,23,6,59,0,1,1
8427,6,2017-10-07,washington-state,@,Oregon,W (33-10),24,42,57.1,282,3,25,87,3.5,0,67,369,5.5,10,4,6,19,6,74,2,0,2
8428,7,2017-10-13,washington-state,@,California,L (3-37),32,48,66.7,314,0,26,23,0.9,0,74,337,4.6,10,3,1,16,5,50,2,5,7
8429,8,2017-10-21,washington-state,,Colorado,W (28-0),20,43,46.5,212,3,35,194,5.5,1,78,406,5.2,10,10,1,21,6,70,2,0,2
8430,9,2017-10-28,washington-state,@,Arizona,L (37-58),58,84,69.0,602,3,17,44,2.6,2,101,646,6.4,28,3,1,32,7,50,0,4,4
8431,10,2017-11-04,washington-state,,Stanford,W (24-21),34,48,70.8,337,3,29,93,3.2,0,77,430,5.6,17,7,1,25,4,25,0,1,1
8432,11,2017-11-11,washington-state,@,Utah,W (33-25),40,69,58.0,311,3,17,27,1.6,0,86,338,3.9,15,3,2,20,10,66,0,2,2
8433,12,2017-11-25,washington-state,@,Washington,L (14-41),37,55,67.3,369,1,14,-24,-1.7,1,69,345,5.0,18,1,0,19,4,34,1,3,4
8434,13,2017-12-28,washington-state,N,Michigan State*,L (17-42),39,50,78.0,272,2,8,24,3.0,0,58,296,5.1,13,2,2,17,4,46,1,1,2
8435,,13 Games,washington-state,,,,487,713,68.3,4769,37,303,877,2.9,8,1016,5646,5.6,217,62,22,302,73,666,11,20,31
8436,1,2018-09-01,washington-state,@,Wyoming,W (41-19),38,57,66.7,319,3,21,75,3.6,2,78,394,5.1,15,5,4,24,10,75,1,1,2
8437,2,2018-09-08,washington-state,,San Jose State,W (31-0),35,54,64.8,420,3,31,124,4.0,1,85,544,6.4,14,7,2,27,8,60,0,3,3
8438,3,2018-09-15,washington-state,,Eastern Washington,W (59-24),51,65,78.5,524,3,15,41,2.7,4,80,565,7.1,32,1,2,35,7,87,0,0,0
8439,4,2018-09-21,washington-state,@,Southern California,L (36-39),37,52,71.2,344,3,24,91,3.8,2,76,435,5.7,19,4,1,24,11,118,0,0,0
8440,5,2018-09-29,washington-state,,Utah,W (28-24),31,56,55.4,445,3,10,13,1.3,1,66,458,6.9,16,1,4,21,9,104,0,1,1
8441,6,2018-10-06,washington-state,@,Oregon State,W (56-37),30,40,75.0,430,5,22,100,4.5,2,62,530,8.5,18,6,0,24,5,46,1,0,1
8442,7,2018-10-20,washington-state,,Oregon,W (34-20),39,51,76.5,323,4,24,77,3.2,1,75,400,5.3,19,5,1,25,5,55,0,2,2
8443,8,2018-10-27,washington-state,@,Stanford,W (41-38),40,50,80.0,438,3,19,59,3.1,2,69,497,7.2,19,4,1,24,9,89,0,0,0
8444,9,2018-11-03,washington-state,,California,W (19-13),35,51,68.6,334,1,15,79,5.3,1,66,413,6.3,19,4,0,23,7,80,1,1,2
8445,10,2018-11-10,washington-state,@,Colorado,W (31-7),37,61,60.7,346,2,33,131,4.0,2,94,477,5.1,17,7,2,26,2,10,0,0,0
8446,11,2018-11-17,washington-state,,Arizona,W (69-28),44,56,78.6,482,7,23,123,5.3,2,79,605,7.7,20,6,5,31,3,35,0,0,0
8447,,11 Games,washington-state,,,,417,593,70.3,4405,37,237,913,3.9,20,830,5318,6.4,208,50,22,284,76,759,3,8,11
8448,1,2014-08-30,oklahoma-state,N,Florida State,L (31-37),15,28,53.6,203,1,42,161,3.8,3,70,364,5.2,9,9,4,22,7,70,1,1,2
8449,2,2014-09-06,oklahoma-state,,Missouri State,W (40-23),21,35,60.0,274,2,35,206,5.9,2,70,480,6.9,10,10,2,22,5,45,0,0,0
8450,3,2014-09-13,oklahoma-state,,Texas-San Antonio,W (43-13),16,30,53.3,315,2,49,162,3.3,2,79,477,6.0,12,8,4,24,5,45,0,0,0
8451,4,2014-09-25,oklahoma-state,,Texas Tech,W (45-35),17,31,54.8,370,4,42,158,3.8,2,73,528,7.2,12,7,3,22,10,129,0,2,2
8452,5,2014-10-04,oklahoma-state,,Iowa State,W (37-20),26,41,63.4,271,1,42,129,3.1,2,83,400,4.8,12,10,3,25,7,40,0,2,2
8453,6,2014-10-11,oklahoma-state,@,Kansas,W (27-20),17,31,54.8,161,1,37,114,3.1,1,68,275,4.0,7,5,3,15,7,44,1,1,2
8454,7,2014-10-18,oklahoma-state,@,Texas Christian,L (9-42),10,25,40.0,132,0,39,126,3.2,0,64,258,4.0,5,7,0,12,4,23,0,2,2
8455,8,2014-10-25,oklahoma-state,,West Virginia,L (10-34),21,41,51.2,242,1,39,194,5.0,0,80,436,5.5,15,7,1,23,4,30,0,2,2
8456,9,2014-11-01,oklahoma-state,@,Kansas State,L (14-48),12,23,52.2,148,0,40,112,2.8,1,63,260,4.1,7,8,0,15,5,54,1,2,3
8457,10,2014-11-15,oklahoma-state,,Texas,L (7-28),17,29,58.6,158,1,23,34,1.5,0,52,192,3.7,7,2,0,9,5,70,1,1,2
8458,11,2014-11-22,oklahoma-state,@,Baylor,L (28-49),13,25,52.0,281,2,43,116,2.7,2,68,397,5.8,8,6,3,17,4,45,0,2,2
8459,12,2014-12-06,oklahoma-state,@,Oklahoma,W (38-35),19,35,54.3,273,2,26,112,4.3,2,61,385,6.3,11,6,1,18,9,55,0,1,1
8460,13,2015-01-02,oklahoma-state,N,Washington*,W (30-22),18,27,66.7,321,2,49,152,3.1,1,76,473,6.2,13,7,2,22,7,50,1,1,2
8461,,13 Games,oklahoma-state,,,,222,401,55.4,3149,19,506,1776,3.5,18,907,4925,5.4,128,92,26,246,79,700,5,17,22
8462,1,2015-09-03,oklahoma-state,@,Central Michigan,W (24-13),22,32,68.8,266,1,35,153,4.4,2,67,419,6.3,13,6,0,19,4,35,0,0,0
8463,2,2015-09-12,oklahoma-state,,Central Arkansas,W (32-8),25,39,64.1,414,3,35,164,4.7,1,74,578,7.8,13,12,0,25,8,65,0,1,1
8464,3,2015-09-19,oklahoma-state,,Texas-San Antonio,W (69-14),19,26,73.1,312,3,40,217,5.4,3,66,529,8.0,11,11,0,22,5,45,1,0,1
8465,4,2015-09-26,oklahoma-state,@,Texas,W (30-27),24,36,66.7,292,2,46,103,2.2,1,82,395,4.8,17,4,6,27,7,40,1,2,3
8466,5,2015-10-03,oklahoma-state,,Kansas State,W (36-34),35,56,62.5,441,4,27,49,1.8,1,83,490,5.9,23,2,1,26,8,95,1,1,2
8467,6,2015-10-10,oklahoma-state,@,West Virginia,W (33-26),22,43,51.2,228,1,38,134,3.5,2,81,362,4.5,11,5,4,20,7,55,0,3,3
8468,7,2015-10-24,oklahoma-state,,Kansas,W (58-10),27,36,75.0,381,3,47,202,4.3,4,83,583,7.0,15,15,3,33,2,25,0,0,0
8469,8,2015-10-31,oklahoma-state,@,Texas Tech,W (70-53),27,43,62.8,478,5,36,184,5.1,3,79,662,8.4,20,8,1,29,7,65,0,1,1
8470,9,2015-11-07,oklahoma-state,,Texas Christian,W (49-29),18,27,66.7,375,5,26,81,3.1,1,53,456,8.6,13,1,2,16,7,67,0,0,0
8471,10,2015-11-14,oklahoma-state,@,Iowa State,W (35-31),26,38,68.4,343,2,48,154,3.2,3,86,497,5.8,17,11,0,28,6,48,1,0,1
8472,11,2015-11-21,oklahoma-state,,Baylor,L (35-45),28,51,54.9,433,4,23,8,0.3,1,74,441,6.0,15,3,1,19,4,25,0,0,0
8473,12,2015-11-28,oklahoma-state,,Oklahoma,L (23-58),25,45,55.6,325,2,29,132,4.6,0,74,457,6.2,15,5,2,22,2,10,0,2,2
8474,13,2016-01-01,oklahoma-state,N,Mississippi*,L (20-48),27,45,60.0,303,0,30,63,2.1,2,75,366,4.9,14,5,1,20,7,77,1,0,1
8475,,13 Games,oklahoma-state,,,,325,517,62.9,4591,35,460,1644,3.6,24,977,6235,6.4,197,88,21,306,74,652,5,10,15
8476,1,2016-09-03,oklahoma-state,,Southeastern Louisiana,W (61-7),25,35,71.4,253,2,38,144,3.8,4,73,397,5.4,14,9,0,23,5,55,1,0,1
8477,2,2016-09-10,oklahoma-state,,Central Michigan,L (27-30),28,44,63.6,288,3,26,50,1.9,0,70,338,4.8,17,3,3,23,4,40,0,1,1
8478,3,2016-09-17,oklahoma-state,,Pittsburgh,W (45-38),26,46,56.5,540,2,32,100,3.1,4,78,640,8.2,17,5,3,25,8,55,2,0,2
8479,4,2016-09-24,oklahoma-state,@,Baylor,L (24-35),27,46,58.7,279,0,55,213,3.9,3,101,492,4.9,15,12,3,30,4,32,3,1,4
8480,5,2016-10-01,oklahoma-state,,Texas,W (49-31),19,28,67.9,392,3,43,163,3.8,3,71,555,7.8,13,8,1,22,7,70,0,0,0
8481,6,2016-10-08,oklahoma-state,,Iowa State,W (38-31),26,44,59.1,351,4,33,108,3.3,1,77,459,6.0,13,7,0,20,5,63,0,0,0
8482,7,2016-10-22,oklahoma-state,@,Kansas,W (44-20),18,27,66.7,252,1,46,230,5.0,4,73,482,6.6,8,15,0,23,5,45,1,0,1
8483,8,2016-10-29,oklahoma-state,,West Virginia,W (37-20),26,36,72.2,273,3,31,85,2.7,1,67,358,5.3,13,2,2,17,3,30,0,0,0
8484,9,2016-11-05,oklahoma-state,@,Kansas State,W (43-37),29,38,76.3,457,5,26,180,6.9,1,64,637,10.0,20,8,1,29,7,67,1,2,3
8485,10,2016-11-12,oklahoma-state,,Texas Tech,W (45-44),20,28,71.4,395,2,38,210,5.5,4,66,605,9.2,16,11,0,27,7,80,1,0,1
8486,11,2016-11-19,oklahoma-state,@,Texas Christian,W (31-6),17,35,48.6,207,1,45,334,7.4,3,80,541,6.8,7,18,3,28,6,42,1,0,1
8487,12,2016-12-03,oklahoma-state,@,Oklahoma,L (20-38),11,25,44.0,186,0,37,217,5.9,2,62,403,6.5,6,10,1,17,3,22,0,0,0
8488,13,2016-12-29,oklahoma-state,N,Colorado*,W (38-8),23,33,69.7,338,3,41,189,4.6,2,74,527,7.1,15,8,1,24,5,42,0,0,0
8489,,13 Games,oklahoma-state,,,,295,465,63.4,4211,29,491,2223,4.5,32,956,6434,6.7,174,116,18,308,69,643,10,4,14
8490,1,2017-08-31,oklahoma-state,,Tulsa,W (59-24),21,26,80.8,308,3,37,332,9.0,4,63,640,10.2,8,15,2,25,5,51,2,0,2
8491,2,2017-09-08,oklahoma-state,@,South Alabama,W (44-7),26,41,63.4,342,3,37,163,4.4,1,78,505,6.5,19,8,2,29,4,25,0,0,0
8492,3,2017-09-16,oklahoma-state,@,Pittsburgh,W (59-21),26,37,70.3,572,5,32,131,4.1,2,69,703,10.2,19,7,1,27,4,30,1,1,2
8493,4,2017-09-23,oklahoma-state,,Texas Christian,L (31-44),22,42,52.4,398,2,31,101,3.3,2,73,499,6.8,17,8,1,26,8,77,1,3,4
8494,5,2017-09-30,oklahoma-state,@,Texas Tech,W (41-34),27,38,71.1,376,3,44,221,5.0,2,82,597,7.3,20,9,3,32,8,78,0,1,1
8495,6,2017-10-14,oklahoma-state,,Baylor,W (59-16),20,33,60.6,471,3,38,276,7.3,5,71,747,10.5,15,12,2,29,5,40,2,0,2
8496,7,2017-10-21,oklahoma-state,@,Texas,W (13-10),25,38,65.8,282,0,51,146,2.9,1,89,428,4.8,12,10,4,26,2,20,1,0,1
8497,8,2017-10-28,oklahoma-state,@,West Virginia,W (50-39),20,34,58.8,216,3,56,246,4.4,4,90,462,5.1,12,14,1,27,6,56,3,1,4
8498,9,2017-11-04,oklahoma-state,,Oklahoma,L (52-62),28,54,51.9,448,5,34,213,6.3,2,88,661,7.5,17,10,5,32,5,40,1,2,3
8499,10,2017-11-11,oklahoma-state,@,Iowa State,W (49-42),25,31,80.6,376,3,37,146,3.9,3,68,522,7.7,15,7,1,23,9,105,0,0,0
8500,11,2017-11-18,oklahoma-state,,Kansas State,L (40-45),32,53,60.4,425,3,31,85,2.7,2,84,510,6.1,23,4,3,30,2,20,0,2,2
8501,12,2017-11-25,oklahoma-state,,Kansas,W (58-17),32,44,72.7,494,2,42,167,4.0,5,86,661,7.7,20,7,2,29,4,30,0,0,0
8502,13,2017-12-28,oklahoma-state,N,Virginia Tech*,W (30-21),21,32,65.6,351,2,31,141,4.5,1,63,492,7.8,16,7,1,24,4,20,0,0,0
8503,,13 Games,oklahoma-state,,,,325,503,64.6,5059,37,501,2368,4.7,34,1004,7427,7.4,213,118,28,359,66,592,11,10,21
8504,1,2018-08-30,oklahoma-state,,Missouri State,W (58-17),25,37,67.6,296,5,55,436,7.9,3,92,732,8.0,15,15,3,33,7,55,1,1,2
8505,2,2018-09-08,oklahoma-state,,South Alabama,W (55-13),26,42,61.9,453,2,44,164,3.7,4,86,617,7.2,21,7,4,32,9,112,1,2,3
8506,3,2018-09-15,oklahoma-state,,Boise State,W (44-21),16,27,59.3,246,1,38,176,4.6,3,65,422,6.5,9,10,0,19,4,25,0,0,0
8507,4,2018-09-22,oklahoma-state,,Texas Tech,L (17-41),18,38,47.4,258,1,24,128,5.3,1,62,386,6.2,12,6,0,18,8,73,1,1,2
8508,5,2018-09-29,oklahoma-state,@,Kansas,W (48-28),15,20,75.0,312,4,46,256,5.6,2,66,568,8.6,10,14,1,25,8,92,0,1,1
8509,6,2018-10-06,oklahoma-state,,Iowa State,L (42-48),19,33,57.6,289,4,43,126,2.9,2,76,415,5.5,13,8,1,22,9,87,1,1,2
8510,7,2018-10-13,oklahoma-state,@,Kansas State,L (12-31),17,35,48.6,184,0,28,127,4.5,1,63,311,4.9,8,6,1,15,7,70,0,2,2
8511,8,2018-10-27,oklahoma-state,,Texas,W (38-35),23,34,67.6,321,3,51,181,3.5,2,85,502,5.9,14,10,3,27,4,52,0,0,0
8512,9,2018-11-03,oklahoma-state,@,Baylor,L (31-35),25,42,59.5,301,1,47,212,4.5,3,89,513,5.8,16,13,3,32,12,133,1,0,1
8513,10,2018-11-10,oklahoma-state,@,Oklahoma,L (47-48),34,53,64.2,501,3,33,139,4.2,4,86,640,7.4,27,9,3,39,5,31,1,0,1
8514,11,2018-11-17,oklahoma-state,,West Virginia,W (45-41),30,46,65.2,338,5,43,266,6.2,1,89,604,6.8,15,19,1,35,3,35,2,2,4
8515,,11 Games,oklahoma-state,,,,248,407,60.9,3499,29,452,2211,4.9,26,859,5710,6.6,160,117,20,297,76,765,8,10,18
8516,1,2014-08-30,texas-tech,,Central Arkansas,W (42-35),39,53,73.6,452,4,36,184,5.1,2,89,636,7.1,25,10,0,35,15,114,0,2,2
8517,2,2014-09-06,texas-tech,@,Texas-El Paso,W (30-26),17,31,54.8,278,3,28,226,8.1,1,59,504,8.5,9,9,2,20,10,90,1,0,1
8518,3,2014-09-13,texas-tech,,Arkansas,L (28-49),27,45,60.0,252,3,22,101,4.6,1,67,353,5.3,11,9,0,20,5,60,1,2,3
8519,4,2014-09-25,texas-tech,@,Oklahoma State,L (35-45),37,60,61.7,394,5,30,118,3.9,0,90,512,5.7,20,8,4,32,16,158,0,3,3
8520,5,2014-10-04,texas-tech,@,Kansas State,L (13-45),27,50,54.0,301,2,14,46,3.3,0,64,347,5.4,16,4,0,20,9,89,0,4,4
8521,6,2014-10-11,texas-tech,,West Virginia,L (34-37),28,46,60.9,348,3,38,217,5.7,1,84,565,6.7,14,7,2,23,12,115,0,1,1
8522,7,2014-10-18,texas-tech,,Kansas,W (34-21),28,44,63.6,288,3,37,219,5.9,1,81,507,6.3,12,13,1,26,4,22,1,1,2
8523,8,2014-10-25,texas-tech,@,Texas Christian,L (27-82),20,41,48.8,345,3,28,101,3.6,0,69,446,6.5,14,5,2,21,6,69,2,2,4
8524,9,2014-11-01,texas-tech,,Texas,L (13-34),28,47,59.6,225,0,32,156,4.9,1,79,381,4.8,10,5,3,18,6,70,1,1,2
8525,10,2014-11-15,texas-tech,,Oklahoma,L (30-42),27,50,54.0,393,4,24,93,3.9,0,74,486,6.6,15,5,3,23,9,85,0,0,0
8526,11,2014-11-22,texas-tech,@,Iowa State,W (34-31),23,35,65.7,328,4,40,272,6.8,1,75,600,8.0,12,14,1,27,9,73,1,1,2
8527,12,2014-11-29,texas-tech,N,Baylor,L (46-48),31,57,54.4,609,6,26,103,4.0,0,83,712,8.6,20,6,5,31,11,125,3,1,4
8528,,12 Games,texas-tech,,,,332,559,59.4,4213,40,355,1836,5.2,8,914,6049,6.6,178,95,23,296,112,1070,10,18,28
8529,1,2015-09-05,texas-tech,,Sam Houston State,W (59-45),34,57,59.6,437,4,31,174,5.6,2,88,611,6.9,18,10,1,29,10,69,0,1,1
8530,2,2015-09-12,texas-tech,,Texas-El Paso,W (69-20),23,42,54.8,445,4,30,229,7.6,5,72,674,9.4,17,11,1,29,4,38,0,0,0
8531,3,2015-09-19,texas-tech,@,Arkansas,W (35-24),27,31,87.1,315,2,27,171,6.3,3,58,486,8.4,14,9,1,24,4,31,0,2,2
8532,4,2015-09-26,texas-tech,,Texas Christian,L (52-55),25,45,55.6,392,2,39,215,5.5,5,84,607,7.2,14,12,6,32,3,32,0,0,0
8533,5,2015-10-03,texas-tech,N,Baylor,L (35-63),40,65,61.5,530,4,24,106,4.4,1,89,636,7.1,19,6,2,27,17,142,2,2,4
8534,6,2015-10-10,texas-tech,,Iowa State,W (66-31),39,56,69.6,515,6,31,261,8.4,3,87,776,8.9,21,11,1,33,7,50,0,0,0
8535,7,2015-10-17,texas-tech,@,Kansas,W (30-20),29,50,58.0,354,1,44,222,5.0,1,94,576,6.1,15,13,1,29,6,70,1,1,2
8536,8,2015-10-24,texas-tech,@,Oklahoma,L (27-63),29,45,64.4,253,1,40,172,4.3,2,85,425,5.0,11,14,3,28,7,57,0,4,4
8537,9,2015-10-31,texas-tech,,Oklahoma State,L (53-70),38,55,69.1,480,4,39,162,4.2,2,94,642,6.8,21,8,3,32,7,66,1,2,3
8538,10,2015-11-07,texas-tech,@,West Virginia,L (26-31),22,36,61.1,199,3,42,179,4.3,0,78,378,4.8,9,12,2,23,8,75,0,1,1
8539,11,2015-11-14,texas-tech,,Kansas State,W (59-44),33,43,76.7,384,3,40,274,6.9,5,83,658,7.9,16,15,1,32,7,73,1,0,1
8540,12,2015-11-26,texas-tech,@,Texas,W (48-45),22,39,56.4,372,1,51,293,5.7,5,90,665,7.4,12,16,0,28,6,70,3,1,4
8541,13,2015-12-29,texas-tech,N,Louisiana State*,L (27-56),28,56,50.0,370,4,26,29,1.1,0,82,399,4.9,16,4,2,22,6,63,0,1,1
8542,,13 Games,texas-tech,,,,389,620,62.7,5046,39,464,2487,5.4,34,1084,7533,6.9,203,141,24,368,92,836,8,15,23
8543,1,2016-09-03,texas-tech,,Stephen F. Austin,W (69-17),48,71,67.6,633,5,28,125,4.5,4,99,758,7.7,25,11,1,37,7,42,0,1,1
8544,2,2016-09-10,texas-tech,@,Arizona State,L (55-68),38,53,71.7,540,5,22,72,3.3,3,75,612,8.2,22,3,3,28,9,94,0,2,2
8545,3,2016-09-17,texas-tech,,Louisiana Tech,W (59-45),26,36,72.2,470,5,43,196,4.6,3,79,666,8.4,18,13,4,35,11,95,0,0,0
8546,4,2016-09-29,texas-tech,,Kansas,W (55-19),42,55,76.4,548,8,24,73,3.0,0,79,621,7.9,26,6,2,34,12,70,1,1,2
8547,5,2016-10-08,texas-tech,@,Kansas State,L (38-44),46,63,73.0,529,2,28,63,2.3,3,91,592,6.5,26,4,3,33,9,100,0,1,1
8548,6,2016-10-15,texas-tech,,West Virginia,L (17-48),32,50,64.0,345,2,27,34,1.3,0,77,379,4.9,12,6,3,21,10,103,0,1,1
8549,7,2016-10-22,texas-tech,,Oklahoma,L (59-66),52,88,59.1,734,5,21,120,5.7,3,109,854,7.8,32,9,1,42,11,92,1,1,2
8550,8,2016-10-29,texas-tech,@,Texas Christian,W (27-24),24,40,60.0,206,2,49,139,2.8,1,89,345,3.9,8,15,0,23,1,5,1,1,2
8551,9,2016-11-05,texas-tech,,Texas,L (37-45),36,59,61.0,367,3,41,115,2.8,1,100,482,4.8,17,9,5,31,4,14,1,1,2
8552,10,2016-11-12,texas-tech,@,Oklahoma State,L (44-45),35,52,67.3,376,3,44,142,3.2,3,96,518,5.4,20,9,5,34,3,15,1,0,1
8553,11,2016-11-19,texas-tech,@,Iowa State,L (10-66),19,39,48.7,222,1,30,84,2.8,0,69,306,4.4,11,5,1,17,2,7,1,2,3
8554,12,2016-11-25,texas-tech,N,Baylor,W (54-35),30,47,63.8,586,6,32,80,2.5,1,79,666,8.4,20,2,2,24,15,107,0,0,0
8555,,12 Games,texas-tech,,,,428,653,65.5,5556,47,389,1243,3.2,22,1042,6799,6.5,237,92,30,359,94,744,6,11,17
8556,1,2017-09-02,texas-tech,,Eastern Washington,W (56-10),31,35,88.6,449,4,40,177,4.4,3,75,626,8.3,17,12,3,32,11,120,0,0,0
8557,2,2017-09-16,texas-tech,,Arizona State,W (52-45),37,50,74.0,543,6,29,72,2.5,1,79,615,7.8,27,5,1,33,6,67,1,0,1
8558,3,2017-09-23,texas-tech,@,Houston,W (27-24),29,45,64.4,321,2,33,200,6.1,1,78,521,6.7,11,5,1,17,15,117,0,1,1
8559,4,2017-09-30,texas-tech,,Oklahoma State,L (34-41),29,46,63.0,330,1,26,54,2.1,2,72,384,5.3,15,4,6,25,8,63,0,1,1
8560,5,2017-10-07,texas-tech,@,Kansas,W (65-19),22,27,81.5,290,3,52,313,6.0,5,79,603,7.6,12,17,1,30,2,21,1,1,2
8561,6,2017-10-14,texas-tech,@,West Virginia,L (35-46),24,39,61.5,323,4,33,190,5.8,1,72,513,7.1,14,10,3,27,16,159,0,1,1
8562,7,2017-10-21,texas-tech,,Iowa State,L (13-31),31,41,75.6,207,0,41,129,3.1,2,82,336,4.1,13,11,0,24,3,30,2,1,3
8563,8,2017-10-28,texas-tech,@,Oklahoma,L (27-49),22,36,61.1,322,4,34,115,3.4,0,70,437,6.2,12,9,3,24,6,63,0,1,1
8564,9,2017-11-04,texas-tech,,Kansas State,L (35-42),34,53,64.2,405,4,31,122,3.9,1,84,527,6.3,18,7,1,26,8,79,0,1,1
8565,10,2017-11-11,texas-tech,N,Baylor,W (38-24),24,29,82.8,246,2,30,91,3.0,1,59,337,5.7,10,7,1,18,6,64,1,0,1
8566,11,2017-11-18,texas-tech,,Texas Christian,L (3-27),18,36,50.0,153,0,41,174,4.2,0,77,327,4.2,8,10,3,21,5,55,1,1,2
8567,12,2017-11-24,texas-tech,@,Texas,W (27-23),20,45,44.4,333,2,34,62,1.8,1,79,395,5.0,12,3,1,16,8,51,0,2,2
8568,13,2017-12-23,texas-tech,N,South Florida*,L (34-38),32,59,54.2,416,3,35,133,3.8,1,94,549,5.8,19,6,1,26,10,107,0,2,2
8569,,13 Games,texas-tech,,,,353,541,65.2,4338,35,459,1832,4.0,19,1000,6170,6.2,188,106,25,319,104,996,6,12,18
8570,1,2018-09-01,texas-tech,N,Mississippi,L (27-47),33,56,58.9,322,1,39,154,3.9,2,95,476,5.0,18,10,2,31,6,80,0,0,0
8571,2,2018-09-08,texas-tech,,Lamar,W (77-0),30,35,85.7,419,3,51,264,5.2,7,86,683,7.9,20,12,0,32,14,139,0,1,1
8572,3,2018-09-15,texas-tech,,Houston,W (63-49),43,59,72.9,605,5,41,99,2.4,4,100,704,7.0,25,6,5,36,9,82,1,0,1
8573,4,2018-09-22,texas-tech,@,Oklahoma State,W (41-17),35,46,76.1,397,2,46,224,4.9,3,92,621,6.8,20,11,4,35,3,20,0,2,2
8574,5,2018-09-29,texas-tech,,West Virginia,L (34-42),25,47,53.2,295,2,42,168,4.0,2,89,463,5.2,13,13,2,28,7,60,0,3,3
8575,6,2018-10-11,texas-tech,@,Texas Christian,W (17-14),15,27,55.6,202,1,43,151,3.5,1,70,353,5.0,7,9,1,17,12,89,0,1,1
8576,7,2018-10-20,texas-tech,,Kansas,W (48-16),39,49,79.6,441,3,35,112,3.2,3,84,553,6.6,21,7,2,30,7,50,2,1,3
8577,8,2018-10-27,texas-tech,@,Iowa State,L (31-40),33,57,57.9,333,1,24,30,1.3,1,81,363,4.5,20,4,0,24,10,85,0,3,3
8578,9,2018-11-03,texas-tech,,Oklahoma,L (46-51),30,44,68.2,366,4,27,107,4.0,2,71,473,6.7,15,4,4,23,7,69,0,0,0
8579,10,2018-11-10,texas-tech,,Texas,L (34-41),38,48,79.2,454,4,33,141,4.3,0,81,595,7.3,22,9,1,32,8,89,2,1,3
8580,11,2018-11-17,texas-tech,@,Kansas State,L (6-21),19,30,63.3,150,0,26,31,1.2,0,56,181,3.2,8,3,0,11,4,37,2,1,3
8581,,11 Games,texas-tech,,,,340,498,68.3,3984,26,407,1481,3.6,25,905,5465,6.0,189,88,21,299,87,800,7,13,20
8582,1,2016-09-03,fordham,@,Navy,L (16-52),26,45,57.8,302,1,36,162,4.5,0,81,464,5.7,13,9,2,24,5,35,1,0,1
8583,1,2017-09-01,fordham,@,Army,L (6-64),28,41,68.3,240,0,32,78,2.4,1,73,318,4.4,14,5,1,20,5,25,0,1,1
8584,1,2018-09-01,fordham,@,UNC Charlotte,L (10-34),22,47,46.8,296,1,16,-9,-0.6,0,63,287,4.6,11,0,1,12,6,30,0,1,1
8585,1,2014-08-30,virginia,,UCLA,L (20-28),29,45,64.4,266,2,39,120,3.1,0,84,386,4.6,12,3,2,17,4,20,1,2,3
8586,2,2014-09-06,virginia,,Richmond,W (45-13),18,23,78.3,173,2,40,157,3.9,3,63,330,5.2,8,9,0,17,6,39,1,1,2
8587,3,2014-09-13,virginia,,Louisville,W (23-21),16,30,53.3,171,1,40,114,2.9,1,70,285,4.1,8,5,0,13,7,46,1,2,3
8588,4,2014-09-20,virginia,@,Brigham Young,L (33-41),35,58,60.3,327,1,44,192,4.4,2,102,519,5.1,18,11,6,35,8,86,1,1,2
8589,5,2014-09-27,virginia,,Kent State,W (45-13),19,32,59.4,266,2,45,254,5.6,3,77,520,6.8,13,12,2,27,9,79,1,2,3
8590,6,2014-10-04,virginia,,Pittsburgh,W (24-19),10,17,58.8,121,1,43,225,5.2,1,60,346,5.8,5,11,2,18,6,65,0,1,1
8591,7,2014-10-18,virginia,@,Duke,L (13-20),22,47,46.8,325,1,31,140,4.5,0,78,465,6.0,15,7,1,23,6,60,1,0,1
8592,8,2014-10-25,virginia,,North Carolina,L (27-28),21,41,51.2,284,2,43,159,3.7,1,84,443,5.3,15,12,4,31,8,83,0,2,2
8593,9,2014-11-01,virginia,@,Georgia Tech,L (10-35),23,41,56.1,262,1,16,22,1.4,0,57,284,5.0,14,1,0,15,6,61,0,2,2
8594,10,2014-11-08,virginia,@,Florida State,L (20-34),20,35,57.1,220,3,32,37,1.2,0,67,257,3.8,11,5,1,17,6,49,2,1,3
8595,11,2014-11-22,virginia,,Miami (FL),W (30-13),17,25,68.0,146,1,43,195,4.5,2,68,341,5.0,6,11,1,18,3,30,0,1,1
8596,12,2014-11-28,virginia,@,Virginia Tech,L (20-24),18,38,47.4,276,1,35,38,1.1,0,73,314,4.3,12,1,2,15,9,75,0,1,1
8597,,12 Games,virginia,,,,248,432,57.4,2837,18,451,1653,3.7,13,883,4490,5.1,137,88,21,246,78,693,8,16,24
8598,1,2015-09-05,virginia,@,UCLA,L (16-34),21,35,60.0,238,1,34,98,2.9,0,69,336,4.9,13,3,3,19,7,45,0,1,1
8599,2,2015-09-12,virginia,,Notre Dame,L (27-34),26,38,68.4,289,2,30,127,4.2,2,68,416,6.1,16,4,2,22,9,55,1,0,1
8600,3,2015-09-19,virginia,,William & Mary,W (35-29),17,23,73.9,263,3,29,110,3.8,1,52,373,7.2,8,7,0,15,5,60,0,2,2
8601,4,2015-09-25,virginia,,Boise State,L (14-56),16,33,48.5,233,2,33,40,1.2,0,66,273,4.1,9,1,0,10,9,80,1,4,5
8602,5,2015-10-10,virginia,@,Pittsburgh,L (19-26),17,34,50.0,209,1,31,139,4.5,0,65,348,5.4,9,7,0,16,4,22,0,1,1
8603,6,2015-10-17,virginia,,Syracuse,W (44-38),24,37,64.9,234,2,44,159,3.6,3,81,393,4.9,14,10,1,25,7,78,1,1,2
8604,7,2015-10-24,virginia,@,North Carolina,L (13-26),17,30,56.7,148,1,39,205,5.3,0,69,353,5.1,10,7,6,23,10,62,1,4,5
8605,8,2015-10-31,virginia,,Georgia Tech,W (27-21),17,28,60.7,175,1,42,233,5.5,2,70,408,5.8,10,10,1,21,7,45,0,1,1
8606,9,2015-11-07,virginia,@,Miami (FL),L (21-27),29,42,69.0,280,0,32,127,4.0,1,74,407,5.5,14,8,2,24,8,80,0,1,1
8607,10,2015-11-14,virginia,@,Louisville,L (31-38),25,41,61.0,260,4,31,94,3.0,0,72,354,4.9,12,7,3,22,8,69,1,0,1
8608,11,2015-11-21,virginia,,Duke,W (42-34),25,34,73.5,359,3,39,143,3.7,3,73,502,6.9,15,8,2,25,8,105,1,1,2
8609,12,2015-11-28,virginia,,Virginia Tech,L (20-23),18,38,47.4,171,1,40,262,6.6,1,78,433,5.6,9,11,1,21,9,65,0,2,2
8610,,12 Games,virginia,,,,252,413,61.0,2859,21,424,1737,4.1,13,837,4596,5.5,139,83,21,243,91,766,6,18,24
8611,1,2016-09-03,virginia,,Richmond,L (20-37),26,34,76.5,264,3,21,38,1.8,0,55,302,5.5,12,5,2,19,0,0,3,1,4
8612,2,2016-09-10,virginia,@,Oregon,L (26-44),21,40,52.5,195,2,40,193,4.8,2,80,388,4.9,9,14,5,28,10,102,0,2,2
8613,3,2016-09-17,virginia,@,Connecticut,L (10-13),23,43,53.5,241,0,30,140,4.7,1,73,381,5.2,11,6,4,21,10,91,0,1,1
8614,4,2016-09-24,virginia,,Central Michigan,W (49-35),27,43,62.8,421,5,26,148,5.7,2,69,569,8.2,16,8,1,25,4,45,0,1,1
8615,5,2016-10-01,virginia,@,Duke,W (34-20),23,41,56.1,336,3,36,80,2.2,1,77,416,5.4,12,4,0,16,7,59,0,1,1
8616,6,2016-10-15,virginia,,Pittsburgh,L (31-45),20,45,44.4,278,1,26,86,3.3,3,71,364,5.1,11,6,2,19,10,67,0,1,1
8617,7,2016-10-22,virginia,,North Carolina,L (14-35),22,45,48.9,143,1,39,110,2.8,1,84,253,3.0,10,8,1,19,9,82,1,0,1
8618,8,2016-10-29,virginia,,Louisville,L (25-32),25,40,62.5,238,3,28,84,3.0,0,68,322,4.7,10,6,1,17,5,48,0,2,2
8619,9,2016-11-05,virginia,@,Wake Forest,L (20-27),20,40,50.0,190,2,32,105,3.3,1,72,295,4.1,11,8,2,21,3,30,1,2,3
8620,10,2016-11-12,virginia,,Miami (FL),L (14-34),19,34,55.9,207,1,33,82,2.5,1,67,289,4.3,10,4,0,14,10,110,4,0,4
8621,11,2016-11-19,virginia,@,Georgia Tech,L (17-31),27,46,58.7,220,1,42,189,4.5,1,88,409,4.6,15,10,0,25,4,30,0,3,3
8622,12,2016-11-26,virginia,@,Virginia Tech,L (10-52),13,36,36.1,139,1,31,108,3.5,0,67,247,3.7,5,7,2,14,4,31,1,2,3
8623,,12 Games,virginia,,,,266,487,54.6,2872,23,384,1363,3.5,13,871,4235,4.9,132,86,20,238,76,695,10,16,26
8624,1,2017-09-02,virginia,,William & Mary,W (28-10),27,40,67.5,262,3,32,92,2.9,1,72,354,4.9,13,6,0,19,3,15,0,0,0
8625,2,2017-09-09,virginia,,Indiana,L (17-34),39,66,59.1,259,1,25,55,2.2,1,91,314,3.5,11,7,4,22,5,26,0,0,0
8626,3,2017-09-16,virginia,,Connecticut,W (38-18),30,40,75.0,455,3,31,171,5.5,2,71,626,8.8,18,9,0,27,9,109,0,1,1
8627,4,2017-09-22,virginia,@,Boise State,W (42-23),19,29,65.5,273,3,40,167,4.2,3,69,440,6.4,13,8,0,21,3,23,0,0,0
8628,5,2017-10-07,virginia,,Duke,W (28-21),24,43,55.8,182,3,38,128,3.4,0,81,310,3.8,8,8,5,21,7,67,0,2,2
8629,6,2017-10-14,virginia,@,North Carolina,W (20-14),19,31,61.3,249,2,47,156,3.3,0,78,405,5.2,8,13,2,23,6,54,1,0,1
8630,7,2017-10-21,virginia,,Boston College,L (10-41),19,42,45.2,152,0,26,95,3.7,1,68,247,3.6,9,7,3,19,1,15,0,3,3
8631,8,2017-10-28,virginia,@,Pittsburgh,L (14-31),22,42,52.4,212,2,31,102,3.3,0,73,314,4.3,12,4,4,20,3,45,0,1,1
8632,9,2017-11-04,virginia,,Georgia Tech,W (40-36),21,43,48.8,260,3,25,97,3.9,0,68,357,5.3,11,3,1,15,4,25,1,1,2
8633,10,2017-11-11,virginia,@,Louisville,L (21-38),19,36,52.8,214,1,28,63,2.3,2,64,277,4.3,11,4,1,16,8,73,1,1,2
8634,11,2017-11-18,virginia,@,Miami (FL),L (28-44),28,37,75.7,384,4,28,55,2.0,0,65,439,6.8,13,3,2,18,6,40,2,1,3
8635,12,2017-11-24,virginia,,Virginia Tech,L (0-10),17,34,50.0,186,0,20,5,0.3,0,54,191,3.5,7,2,0,9,4,50,1,0,1
8636,13,2017-12-28,virginia,@,Navy*,L (7-49),16,36,44.4,145,0,18,30,1.7,0,54,175,3.2,7,4,0,11,4,40,2,1,3
8637,,13 Games,virginia,,,,300,519,57.8,3233,25,389,1216,3.1,10,908,4449,4.9,141,78,22,241,63,582,8,11,19
8638,1,2018-09-01,virginia,,Richmond,W (42-13),14,26,53.8,191,2,48,301,6.3,4,74,492,6.6,8,17,0,25,4,24,0,1,1
8639,2,2018-09-08,virginia,@,Indiana,L (16-20),12,25,48.0,106,2,39,188,4.8,0,64,294,4.6,6,7,2,15,5,56,1,0,1
8640,3,2018-09-15,virginia,N,Ohio,W (45-31),25,30,83.3,379,3,31,173,5.6,3,61,552,9.0,14,8,1,23,3,20,3,0,3
8641,4,2018-09-22,virginia,,Louisville,W (27-3),17,26,65.4,197,2,39,204,5.2,1,65,401,6.2,10,9,1,20,3,29,0,1,1
8642,5,2018-09-29,virginia,@,North Carolina State,L (21-35),20,35,57.1,258,2,29,93,3.2,1,64,351,5.5,10,7,3,20,6,62,0,2,2
8643,6,2018-10-13,virginia,,Miami (FL),W (16-13),12,21,57.1,92,0,41,139,3.4,1,62,231,3.7,3,12,3,18,6,60,0,3,3
8644,7,2018-10-20,virginia,@,Duke,W (28-14),21,34,61.8,198,1,44,178,4.0,2,78,376,4.8,12,8,1,21,6,55,0,0,0
8645,8,2018-10-27,virginia,,North Carolina,W (31-21),18,27,66.7,217,3,44,208,4.7,1,71,425,6.0,11,12,0,23,1,5,0,1,1
8646,9,2018-11-02,virginia,,Pittsburgh,L (13-23),17,24,70.8,205,1,26,44,1.7,0,50,249,5.0,6,6,1,13,10,80,1,0,1
8647,10,2018-11-10,virginia,,Liberty,W (45-24),14,22,63.6,168,2,39,221,5.7,3,61,389,6.4,8,15,1,24,1,10,0,1,1
8648,11,2018-11-17,virginia,@,Georgia Tech,L (27-30),22,28,78.6,273,2,33,130,3.9,1,61,403,6.6,14,10,0,24,4,35,1,0,1
8649,,11 Games,virginia,,,,192,298,64.4,2284,20,413,1879,4.5,17,711,4163,5.9,102,111,13,226,49,436,6,9,15
8650,1,2014-08-29,michigan-state,,Jacksonville State,W (45-7),18,24,75.0,354,3,50,211,4.2,3,74,565,7.6,11,11,3,25,2,13,0,0,0
8651,2,2014-09-06,michigan-state,@,Oregon,L (27-46),29,47,61.7,343,2,36,123,3.4,1,83,466,5.6,18,7,0,25,5,38,0,2,2
8652,3,2014-09-20,michigan-state,,Eastern Michigan,W (73-14),14,19,73.7,160,3,60,336,5.6,7,79,496,6.3,8,14,2,24,4,25,0,1,1
8653,4,2014-09-27,michigan-state,,Wyoming,W (56-14),16,20,80.0,195,3,52,338,6.5,5,72,533,7.4,7,18,0,25,9,84,0,0,0
8654,5,2014-10-04,michigan-state,,Nebraska,W (27-22),11,29,37.9,234,1,44,188,4.3,2,73,422,5.8,8,9,0,17,9,94,2,1,3
8655,6,2014-10-11,michigan-state,@,Purdue,W (45-31),19,37,51.4,238,3,43,294,6.8,2,80,532,6.7,13,14,1,28,4,55,0,1,1
8656,7,2014-10-18,michigan-state,@,Indiana,W (56-17),24,32,75.0,332,3,51,330,6.5,5,83,662,8.0,14,15,1,30,3,37,0,1,1
8657,8,2014-10-25,michigan-state,,Michigan,W (35-11),12,22,54.5,227,1,46,219,4.8,3,68,446,6.6,7,14,1,22,8,88,2,0,2
8658,9,2014-11-08,michigan-state,,Ohio State,L (37-49),25,45,55.6,358,2,34,178,5.2,3,79,536,6.8,18,10,1,29,11,105,0,0,0
8659,10,2014-11-15,michigan-state,@,Maryland,W (37-15),14,31,45.2,240,0,47,242,5.1,3,78,482,6.2,11,12,0,23,10,75,0,0,0
8660,11,2014-11-22,michigan-state,,Rutgers,W (45-3),17,26,65.4,278,2,44,242,5.5,4,70,520,7.4,13,12,1,26,3,35,2,0,2
8661,12,2014-11-29,michigan-state,@,Penn State,W (34-10),13,26,50.0,180,1,41,118,2.9,2,67,298,4.4,11,6,1,18,5,30,0,1,1
8662,13,2015-01-01,michigan-state,N,Baylor*,W (42-41),24,42,57.1,314,2,46,238,5.2,4,88,552,6.3,15,11,3,29,7,75,0,2,2
8663,,13 Games,michigan-state,,,,236,400,59.0,3453,26,594,3057,5.1,44,994,6510,6.5,154,153,14,321,80,754,6,9,15
8664,1,2015-09-04,michigan-state,@,Western Michigan,W (37-24),15,31,48.4,256,2,40,196,4.9,3,71,452,6.4,13,11,2,26,3,25,1,0,1
8665,2,2015-09-12,michigan-state,,Oregon,W (31-28),20,32,62.5,192,2,37,197,5.3,2,69,389,5.6,11,9,1,21,2,15,0,1,1
8666,3,2015-09-19,michigan-state,,Air Force,W (35-21),15,23,65.2,247,4,42,77,1.8,0,65,324,5.0,14,5,3,22,6,38,0,0,0
8667,4,2015-09-26,michigan-state,,Central Michigan,W (30-10),11,19,57.9,143,1,36,181,5.0,3,55,324,5.9,6,11,1,18,8,78,0,0,0
8668,5,2015-10-03,michigan-state,,Purdue,W (24-21),13,19,68.4,139,1,47,267,5.7,2,66,406,6.2,7,12,1,20,8,51,0,0,0
8669,6,2015-10-10,michigan-state,@,Rutgers,W (31-24),24,39,61.5,367,2,36,123,3.4,2,75,490,6.5,16,6,0,22,1,5,0,1,1
8670,7,2015-10-17,michigan-state,@,Michigan,W (27-23),18,39,46.2,328,1,33,58,1.8,2,72,386,5.4,13,3,4,20,5,44,0,0,0
8671,8,2015-10-24,michigan-state,,Indiana,W (52-26),30,52,57.7,398,4,44,142,3.2,3,96,540,5.6,21,10,2,33,5,56,1,0,1
8672,9,2015-11-07,michigan-state,@,Nebraska,L (38-39),24,39,61.5,348,4,34,143,4.2,1,73,491,6.7,17,5,3,25,8,76,0,1,1
8673,10,2015-11-14,michigan-state,,Maryland,W (24-7),12,32,37.5,121,1,41,141,3.4,1,73,262,3.6,7,9,0,16,7,50,1,2,3
8674,11,2015-11-21,michigan-state,@,Ohio State,W (17-14),8,16,50.0,91,1,51,203,4.0,1,67,294,4.4,3,14,0,17,4,30,2,0,2
8675,12,2015-11-28,michigan-state,,Penn State,W (55-16),19,27,70.4,248,3,38,188,4.9,3,65,436,6.7,14,10,0,24,4,19,1,0,1
8676,13,2015-12-05,michigan-state,N,Iowa,W (16-13),16,33,48.5,191,0,46,174,3.8,1,79,365,4.6,10,9,1,20,8,80,0,1,1
8677,14,2015-12-31,michigan-state,N,Alabama*,L (0-38),19,39,48.7,210,0,26,29,1.1,0,65,239,3.7,11,2,3,16,6,33,0,2,2
8678,,14 Games,michigan-state,,,,244,440,55.5,3279,26,551,2119,3.8,24,991,5398,5.4,163,116,21,300,75,600,6,8,14
8679,1,2016-09-02,michigan-state,,Furman,W (28-13),13,18,72.2,190,3,40,171,4.3,1,58,361,6.2,9,9,1,19,10,120,1,1,2
8680,2,2016-09-17,michigan-state,@,Notre Dame,W (36-28),19,26,73.1,241,2,52,260,5.0,3,78,501,6.4,12,9,1,22,3,45,0,1,1
8681,3,2016-09-24,michigan-state,,Wisconsin,L (6-30),20,43,46.5,250,0,27,75,2.8,0,70,325,4.6,15,4,2,21,5,35,1,3,4
8682,4,2016-10-01,michigan-state,@,Indiana,L (21-24),21,35,60.0,263,3,41,175,4.3,0,76,438,5.8,10,10,1,21,11,98,1,0,1
8683,5,2016-10-08,michigan-state,,Brigham Young,L (14-31),13,21,61.9,121,0,32,85,2.7,2,53,206,3.9,7,5,1,13,4,39,0,1,1
8684,6,2016-10-15,michigan-state,,Northwestern,L (40-54),27,42,64.3,424,4,23,51,2.2,0,65,475,7.3,15,3,0,18,5,34,1,1,2
8685,7,2016-10-22,michigan-state,@,Maryland,L (17-28),11,24,45.8,156,0,44,270,6.1,2,68,426,6.3,9,13,0,22,7,84,1,1,2
8686,8,2016-10-29,michigan-state,,Michigan,L (23-32),13,28,46.4,184,2,42,217,5.2,1,70,401,5.7,7,12,4,23,7,57,0,1,1
8687,9,2016-11-05,michigan-state,@,Illinois,L (27-31),29,47,61.7,315,1,43,175,4.1,1,90,490,5.4,17,11,0,28,10,89,1,0,1
8688,10,2016-11-12,michigan-state,,Rutgers,W (49-0),12,19,63.2,163,3,50,277,5.5,3,69,440,6.4,6,13,1,20,5,40,0,0,0
8689,11,2016-11-19,michigan-state,,Ohio State,L (16-17),8,21,38.1,127,1,35,207,5.9,1,56,334,6.0,4,9,0,13,6,60,0,2,2
8690,12,2016-11-26,michigan-state,@,Penn State,L (12-45),25,46,54.3,234,0,42,109,2.6,0,88,343,3.9,14,11,1,26,4,23,1,0,1
8691,,12 Games,michigan-state,,,,211,370,57.0,2668,19,471,2072,4.4,14,841,4740,5.6,125,109,12,246,77,724,7,11,18
8692,1,2017-09-02,michigan-state,,Bowling Green State,W (35-10),22,36,61.1,250,3,46,215,4.7,1,82,465,5.7,11,13,1,25,4,25,3,0,3
8693,2,2017-09-09,michigan-state,,Western Michigan,W (28-14),13,21,61.9,161,1,49,296,6.0,3,70,457,6.5,9,12,0,21,3,30,1,1,2
8694,3,2017-09-23,michigan-state,,Notre Dame,L (18-38),32,53,60.4,345,2,32,151,4.7,0,85,496,5.8,17,6,3,26,9,97,2,1,3
8695,4,2017-09-30,michigan-state,,Iowa,W (17-10),18,28,64.3,212,2,40,88,2.2,0,68,300,4.4,12,4,3,19,9,65,0,0,0
8696,5,2017-10-07,michigan-state,@,Michigan,W (14-10),11,22,50.0,94,1,40,158,4.0,1,62,252,4.1,3,8,2,13,11,81,0,0,0
8697,6,2017-10-14,michigan-state,@,Minnesota,W (30-27),9,18,50.0,120,0,50,245,4.9,3,68,365,5.4,6,12,1,19,5,40,2,1,3
8698,7,2017-10-21,michigan-state,,Indiana,W (17-9),16,30,53.3,185,1,44,89,2.0,1,74,274,3.7,10,5,4,19,3,35,1,0,1
8699,8,2017-10-28,michigan-state,@,Northwestern,L (31-39),39,57,68.4,445,4,30,97,3.2,0,87,542,6.2,22,6,0,28,9,84,1,1,2
8700,9,2017-11-04,michigan-state,,Penn State,W (27-24),33,56,58.9,400,2,24,74,3.1,1,80,474,5.9,17,4,4,25,8,87,0,1,1
8701,10,2017-11-11,michigan-state,@,Ohio State,L (3-48),18,36,50.0,131,0,34,64,1.9,0,70,195,2.8,7,6,2,15,5,58,1,2,3
8702,11,2017-11-18,michigan-state,,Maryland,W (17-7),2,14,14.3,20,0,51,271,5.3,2,65,291,4.5,1,15,3,19,3,36,1,0,1
8703,12,2017-11-25,michigan-state,@,Rutgers,W (40-7),21,31,67.7,222,1,56,214,3.8,3,87,436,5.0,15,11,1,27,9,80,0,0,0
8704,13,2017-12-28,michigan-state,N,Washington State*,W (42-17),13,22,59.1,213,3,48,227,4.7,3,70,440,6.3,9,15,1,25,6,50,0,1,1
8705,,13 Games,michigan-state,,,,247,424,58.3,2798,20,544,2189,4.0,18,968,4987,5.2,139,117,25,281,84,768,12,8,20
8706,1,2018-08-31,michigan-state,,Utah State,W (38-31),23,33,69.7,287,2,42,165,3.9,2,75,452,6.0,11,9,3,23,9,62,1,1,2
8707,2,2018-09-08,michigan-state,@,Arizona State,L (13-16),27,39,69.2,314,1,27,63,2.3,0,66,377,5.7,17,5,1,23,9,82,0,1,1
8708,3,2018-09-22,michigan-state,@,Indiana,W (35-21),15,26,57.7,219,2,40,131,3.3,2,66,350,5.3,11,6,2,19,8,72,2,2,4
8709,4,2018-09-29,michigan-state,,Central Michigan,W (31-20),16,25,64.0,185,0,47,160,3.4,4,72,345,4.8,9,11,3,23,5,55,0,1,1
8710,5,2018-10-06,michigan-state,,Northwestern,L (19-29),31,51,60.8,329,1,24,96,4.0,1,75,425,5.7,17,4,1,22,5,49,0,1,1
8711,6,2018-10-13,michigan-state,@,Penn State,W (21-17),25,53,47.2,295,2,36,123,3.4,1,89,418,4.7,17,5,3,25,3,20,0,1,1
8712,7,2018-10-20,michigan-state,,Michigan,L (7-21),7,28,25.0,79,1,23,15,0.7,0,51,94,1.8,4,2,5,11,4,40,1,0,1
8713,8,2018-10-27,michigan-state,,Purdue,W (23-13),26,46,56.5,318,2,40,108,2.7,0,86,426,5.0,18,8,0,26,6,61,1,0,1
8714,9,2018-11-03,michigan-state,@,Maryland,W (24-3),11,22,50.0,87,0,46,269,5.8,3,68,356,5.2,5,13,1,19,4,33,0,2,2
8715,10,2018-11-10,michigan-state,,Ohio State,L (6-26),18,48,37.5,220,0,18,54,3.0,0,66,274,4.2,9,3,0,12,7,46,2,1,3
8716,11,2018-11-17,michigan-state,@,Nebraska,L (6-9),15,41,36.6,146,0,38,143,3.8,0,79,289,3.7,7,8,3,18,7,87,1,1,2
8717,,11 Games,michigan-state,,,,214,412,51.9,2479,11,381,1327,3.5,13,793,3806,4.8,125,74,22,221,67,607,8,11,19
8718,1,2014-08-30,clemson,@,Georgia,L (21-45),18,33,54.5,203,1,43,88,2.0,2,76,291,3.8,7,6,2,15,3,40,0,1,1
8719,2,2014-09-06,clemson,,South Carolina State,W (73-7),32,42,76.2,467,4,51,268,5.3,4,93,735,7.9,17,15,0,32,1,5,1,0,1
8720,3,2014-09-20,clemson,@,Florida State,L (17-23),22,33,66.7,306,0,40,101,2.5,2,73,407,5.6,12,4,1,17,3,30,1,0,1
8721,4,2014-09-27,clemson,,North Carolina,W (50-35),28,39,71.8,436,6,44,92,2.1,0,83,528,6.4,16,6,5,27,4,19,0,1,1
8722,5,2014-10-04,clemson,,North Carolina State,W (41-0),17,30,56.7,267,2,50,226,4.5,2,80,493,6.2,11,13,1,25,9,103,0,0,0
8723,6,2014-10-11,clemson,,Louisville,W (23-17),22,39,56.4,157,0,33,72,2.2,0,72,229,3.2,7,5,0,12,3,14,0,2,2
8724,7,2014-10-18,clemson,@,Boston College,W (17-13),29,46,63.0,285,0,35,113,3.2,2,81,398,4.9,16,6,0,22,4,30,0,0,0
8725,8,2014-10-25,clemson,,Syracuse,W (16-6),24,35,68.6,209,1,48,166,3.5,0,83,375,4.5,12,10,1,23,2,15,2,2,4
8726,9,2014-11-06,clemson,@,Wake Forest,W (34-20),27,42,64.3,282,3,37,145,3.9,1,79,427,5.4,11,7,2,20,8,75,1,1,2
8727,10,2014-11-15,clemson,@,Georgia Tech,L (6-28),11,21,52.4,59,0,33,131,4.0,0,54,190,3.5,3,7,0,10,3,21,0,3,3
8728,11,2014-11-22,clemson,,Georgia State,W (28-0),21,33,63.6,148,1,43,209,4.9,3,76,357,4.7,10,11,1,22,4,40,1,1,2
8729,12,2014-11-29,clemson,,South Carolina,W (35-17),15,21,71.4,266,2,40,225,5.6,3,61,491,8.0,9,10,1,20,4,44,0,1,1
8730,13,2014-12-29,clemson,N,Oklahoma*,W (40-6),26,37,70.3,319,3,42,68,1.6,1,79,387,4.9,14,5,3,22,4,20,0,0,0
8731,,13 Games,clemson,,,,292,451,64.7,3404,23,539,1904,3.5,20,990,5308,5.4,145,105,17,267,52,456,6,12,18
8732,1,2015-09-05,clemson,,Wofford,W (49-10),30,37,81.1,311,2,43,222,5.2,5,80,533,6.7,14,12,1,27,6,55,2,0,2
8733,2,2015-09-12,clemson,,Appalachian State,W (41-10),21,31,67.7,252,3,44,140,3.2,1,75,392,5.2,12,8,2,22,9,75,0,2,2
8734,3,2015-09-17,clemson,@,Louisville,W (20-17),21,30,70.0,199,2,40,202,5.1,0,70,401,5.7,10,10,0,20,6,53,0,2,2
8735,4,2015-10-03,clemson,,Notre Dame,W (24-22),11,22,50.0,97,2,42,199,4.7,1,64,296,4.6,6,8,1,15,5,44,0,1,1
8736,5,2015-10-10,clemson,,Georgia Tech,W (43-24),23,33,69.7,336,2,41,201,4.9,3,74,537,7.3,15,7,2,24,4,45,2,1,3
8737,6,2015-10-17,clemson,,Boston College,W (34-17),27,42,64.3,420,3,36,112,3.1,1,78,532,6.8,15,5,4,24,6,45,0,2,2
8738,7,2015-10-24,clemson,@,Miami (FL),W (58-0),17,25,68.0,151,1,63,416,6.6,6,88,567,6.4,10,19,4,33,4,29,1,0,1
8739,8,2015-10-31,clemson,@,North Carolina State,W (56-41),23,30,76.7,383,5,50,240,4.8,2,80,623,7.8,15,12,0,27,6,39,1,0,1
8740,9,2015-11-07,clemson,,Florida State,W (23-13),28,43,65.1,297,1,42,215,5.1,1,85,512,6.0,16,10,3,29,3,32,0,0,0
8741,10,2015-11-14,clemson,@,Syracuse,W (37-27),34,47,72.3,360,2,37,210,5.7,2,84,570,6.8,15,10,4,29,8,69,2,1,3
8742,11,2015-11-21,clemson,,Wake Forest,W (33-13),28,40,70.0,381,3,42,171,4.1,1,82,552,6.7,16,6,2,24,6,56,1,3,4
8743,12,2015-11-28,clemson,@,South Carolina,W (37-32),20,27,74.1,279,1,47,236,5.0,4,74,515,7.0,11,14,0,25,1,5,3,0,3
8744,13,2015-12-05,clemson,N,North Carolina,W (45-37),26,42,61.9,289,3,56,319,5.7,3,98,608,6.2,13,18,2,33,11,80,0,1,1
8745,14,2015-12-31,clemson,N,Oklahoma*,W (37-17),17,32,53.1,218,1,58,312,5.4,3,90,530,5.9,10,17,3,30,5,40,0,1,1
8746,15,2016-01-11,clemson,N,Alabama*,L (40-45),30,47,63.8,405,4,38,145,3.8,1,85,550,6.5,20,9,2,31,4,27,0,1,1
8747,,15 Games,clemson,,,,356,528,67.4,4378,35,679,3340,4.9,34,1207,7718,6.4,198,165,30,393,84,694,12,15,27
8748,1,2016-09-03,clemson,@,Auburn,W (19-13),19,34,55.9,248,1,44,151,3.4,1,78,399,5.1,9,7,3,19,6,55,1,1,2
8749,2,2016-09-10,clemson,,Troy,W (30-24),27,53,50.9,292,3,32,122,3.8,0,85,414,4.9,13,8,3,24,7,71,1,2,3
8750,3,2016-09-17,clemson,,South Carolina State,W (59-0),27,35,77.1,328,5,43,227,5.3,2,78,555,7.1,15,10,2,27,7,59,0,0,0
8751,4,2016-09-22,clemson,@,Georgia Tech,W (26-7),32,48,66.7,304,2,34,138,4.1,1,82,442,5.4,15,9,0,24,10,80,0,1,1
8752,5,2016-10-01,clemson,,Louisville,W (42-36),20,31,64.5,306,5,31,201,6.5,1,62,507,8.2,15,8,3,26,6,59,2,3,5
8753,6,2016-10-07,clemson,@,Boston College,W (56-10),16,26,61.5,278,4,35,230,6.6,3,61,508,8.3,11,7,3,21,4,18,1,0,1
8754,7,2016-10-15,clemson,,North Carolina State,W (24-17),39,52,75.0,378,2,38,126,3.3,1,90,504,5.6,20,7,3,30,5,40,3,1,4
8755,8,2016-10-29,clemson,@,Florida State,W (37-34),27,43,62.8,378,2,38,133,3.5,2,81,511,6.3,16,7,2,25,9,84,0,2,2
8756,9,2016-11-05,clemson,,Syracuse,W (54-0),27,40,67.5,370,4,44,195,4.4,2,84,565,6.7,16,11,1,28,3,30,0,0,0
8757,10,2016-11-12,clemson,,Pittsburgh,L (42-43),52,70,74.3,580,3,25,50,2.0,3,95,630,6.6,31,0,2,33,9,101,0,3,3
8758,11,2016-11-19,clemson,@,Wake Forest,W (35-13),23,33,69.7,202,1,42,254,6.0,4,75,456,6.1,9,11,1,21,6,33,1,0,1
8759,12,2016-11-26,clemson,,South Carolina,W (56-7),30,36,83.3,372,6,53,250,4.7,2,89,622,7.0,20,17,3,41,7,75,0,1,1
8760,13,2016-12-03,clemson,N,Virginia Tech,W (42-35),23,34,67.6,288,3,41,182,4.4,3,75,470,6.3,14,11,5,30,8,65,0,1,1
8761,14,2016-12-31,clemson,N,Ohio State,W (31-0),24,37,64.9,265,1,48,205,4.3,3,85,470,5.5,12,12,0,24,5,60,0,2,2
8762,15,2017-01-09,clemson,N,Alabama,W (35-31),36,57,63.2,420,3,42,91,2.2,2,99,511,5.2,19,8,4,31,3,35,2,0,2
8763,,15 Games,clemson,,,,422,629,67.1,5009,45,590,2555,4.3,30,1219,7564,6.2,235,133,35,404,95,865,11,17,28
8764,1,2017-09-02,clemson,,Kent State,W (56-3),25,34,73.5,312,2,42,366,8.7,6,76,678,8.9,14,15,5,34,4,45,0,1,1
8765,2,2017-09-09,clemson,,Auburn,W (14-6),20,31,64.5,185,0,36,96,2.7,2,67,281,4.2,10,6,2,18,8,60,2,0,2
8766,3,2017-09-16,clemson,@,Louisville,W (47-21),23,33,69.7,316,1,48,297,6.2,4,81,613,7.6,12,13,0,25,4,30,0,0,0
8767,4,2017-09-23,clemson,,Boston College,W (34-7),17,26,65.4,140,0,58,342,5.9,5,84,482,5.7,8,19,0,27,2,10,0,2,2
8768,5,2017-09-30,clemson,@,Virginia Tech,W (31-17),12,21,57.1,186,1,43,146,3.4,2,64,332,5.2,5,8,1,14,4,20,0,0,0
8769,6,2017-10-07,clemson,,Wake Forest,W (28-14),29,41,70.7,263,2,48,190,4.0,2,89,453,5.1,13,12,0,25,9,79,1,1,2
8770,7,2017-10-13,clemson,@,Syracuse,L (24-27),22,32,68.8,204,0,25,113,4.5,2,57,317,5.6,11,4,1,16,11,119,0,0,0
8771,8,2017-10-28,clemson,,Georgia Tech,W (24-10),22,33,66.7,207,2,45,221,4.9,1,78,428,5.5,9,12,0,21,5,45,1,0,1
8772,9,2017-11-04,clemson,@,North Carolina State,W (38-31),20,38,52.6,191,1,35,224,6.4,3,73,415,5.7,10,5,4,19,3,23,0,1,1
8773,10,2017-11-11,clemson,,Florida State,W (31-14),20,30,66.7,151,0,52,227,4.4,4,82,378,4.6,10,12,2,24,7,80,2,0,2
8774,11,2017-11-18,clemson,,Citadel,W (61-3),31,41,75.6,479,5,26,183,7.0,3,67,662,9.9,19,7,1,27,4,30,0,0,0
8775,12,2017-11-25,clemson,@,South Carolina,W (34-10),25,38,65.8,285,2,45,184,4.1,2,83,469,5.7,12,12,3,27,2,25,0,2,2
8776,13,2017-12-02,clemson,N,Miami (FL),W (38-3),25,34,73.5,254,1,41,77,1.9,4,75,331,4.4,13,5,0,18,2,13,1,0,1
8777,14,2018-01-01,clemson,N,Alabama*,L (6-24),18,37,48.6,124,0,33,64,1.9,0,70,188,2.7,8,5,0,14,4,29,0,2,2
8778,,14 Games,clemson,,,,309,469,65.9,3297,17,577,2730,4.7,40,1046,6027,5.8,154,135,19,309,69,608,7,9,16
8779,1,2018-09-01,clemson,,Furman,W (48-7),22,35,62.9,277,4,34,266,7.8,2,69,543,7.9,15,8,0,23,0,0,0,0,0
8780,2,2018-09-08,clemson,@,Texas A&M,W (28-26),17,27,63.0,298,2,32,115,3.6,2,59,413,7.0,7,6,1,14,4,49,0,0,0
8781,3,2018-09-15,clemson,,Georgia Southern,W (38-7),21,31,67.7,286,1,46,309,6.7,4,77,595,7.7,14,13,0,27,7,65,1,2,3
8782,4,2018-09-22,clemson,@,Georgia Tech,W (49-21),19,30,63.3,232,4,36,248,6.9,2,66,480,7.3,10,14,1,25,6,68,0,2,2
8783,5,2018-09-29,clemson,,Syracuse,W (27-23),17,29,58.6,176,0,53,293,5.5,3,82,469,5.7,8,19,1,28,3,16,2,1,3
8784,6,2018-10-06,clemson,@,Wake Forest,W (63-3),25,30,83.3,227,3,40,471,11.8,6,70,698,10.0,8,12,2,22,3,28,1,0,1
8785,7,2018-10-20,clemson,,North Carolina State,W (41-7),32,48,66.7,380,1,32,91,2.8,4,80,471,5.9,19,4,1,24,8,67,1,0,1
8786,8,2018-10-27,clemson,@,Florida State,W (59-10),24,44,54.5,404,5,33,120,3.6,3,77,524,6.8,16,6,3,25,5,50,0,1,1
8787,9,2018-11-03,clemson,,Louisville,W (77-16),14,20,70.0,169,5,37,492,13.3,5,57,661,11.6,8,17,2,28,3,15,1,1,2
8788,10,2018-11-10,clemson,@,Boston College,W (27-7),29,41,70.7,295,1,30,129,4.3,1,71,424,6.0,13,5,1,19,2,15,1,1,2
8789,11,2018-11-17,clemson,,Duke,W (35-6),21,39,53.8,251,2,36,208,5.8,3,75,459,6.1,12,12,1,25,7,54,0,0,0
8790,,11 Games,clemson,,,,241,374,64.4,2995,28,409,2742,6.7,35,783,5737,7.3,130,116,13,260,48,427,7,8,15
8791,1,2014-08-30,maryland,,James Madison,W (52-7),18,35,51.4,186,2,50,285,5.7,5,85,471,5.5,11,16,3,30,5,35,0,1,1
8792,2,2014-09-06,maryland,@,South Florida,W (24-17),17,28,60.7,201,2,40,116,2.9,0,68,317,4.7,9,8,0,17,4,35,4,2,6
8793,3,2014-09-13,maryland,,West Virginia,L (37-40),21,38,55.3,284,2,27,163,6.0,1,65,447,6.9,11,5,0,16,7,71,0,1,1
8794,4,2014-09-20,maryland,@,Syracuse,W (34-20),16,26,61.5,280,2,32,89,2.8,1,58,369,6.4,10,6,1,17,8,75,0,0,0
8795,5,2014-09-27,maryland,@,Indiana,W (37-15),22,33,66.7,361,3,36,123,3.4,1,69,484,7.0,14,8,1,23,8,83,0,0,0
8796,6,2014-10-04,maryland,,Ohio State,L (24-52),24,40,60.0,244,1,24,66,2.8,2,64,310,4.8,8,6,3,17,2,23,0,4,4
8797,7,2014-10-18,maryland,,Iowa,W (38-31),17,33,51.5,206,1,46,212,4.6,3,79,418,5.3,8,11,3,22,6,50,0,2,2
8798,8,2014-10-25,maryland,@,Wisconsin,L (7-52),13,29,44.8,129,1,28,46,1.6,0,57,175,3.1,6,3,1,10,7,45,1,0,1
8799,9,2014-11-01,maryland,@,Penn State,W (20-19),18,38,47.4,161,1,30,33,1.1,1,68,194,2.9,7,5,3,15,6,89,2,0,2
8800,10,2014-11-15,maryland,,Michigan State,L (15-37),20,43,46.5,246,2,17,6,0.4,0,60,252,4.2,9,0,2,11,5,30,1,3,4
8801,11,2014-11-22,maryland,@,Michigan,W (23-16),13,24,54.2,165,0,35,147,4.2,2,59,312,5.3,8,8,1,17,4,30,0,0,0
8802,12,2014-11-29,maryland,,Rutgers,L (38-41),14,24,58.3,195,2,36,281,7.8,3,60,476,7.9,8,11,1,20,10,72,0,0,0
8803,13,2014-12-30,maryland,N,Stanford*,L (21-45),15,27,55.6,205,0,27,17,0.6,2,54,222,4.1,10,1,1,12,5,39,0,1,1
8804,,13 Games,maryland,,,,228,418,54.5,2863,19,428,1584,3.7,21,846,4447,5.3,119,88,20,227,77,677,8,14,22
8805,1,2015-09-05,maryland,,Richmond,W (50-21),12,22,54.5,138,2,45,341,7.6,3,67,479,7.1,6,18,0,24,5,39,0,1,1
8806,2,2015-09-12,maryland,,Bowling Green State,L (27-48),16,33,48.5,185,2,26,156,6.0,0,59,341,5.8,8,7,1,16,6,57,1,3,4
8807,3,2015-09-19,maryland,,South Florida,W (35-17),21,34,61.8,297,4,34,114,3.4,1,68,411,6.0,12,4,2,18,12,120,0,3,3
8808,4,2015-09-26,maryland,@,West Virginia,L (6-45),14,36,38.9,153,1,29,173,6.0,0,65,326,5.0,7,4,3,14,10,100,1,5,6
8809,5,2015-10-03,maryland,,Michigan,L (0-28),10,36,27.8,76,0,26,29,1.1,0,62,105,1.7,5,1,1,7,5,66,0,3,3
8810,6,2015-10-10,maryland,@,Ohio State,L (28-49),10,27,37.0,133,1,42,253,6.0,3,69,386,5.6,6,13,1,20,9,63,0,2,2
8811,7,2015-10-24,maryland,N,Penn State,L (30-31),19,28,67.9,225,1,48,241,5.0,2,76,466,6.1,9,11,1,21,6,55,2,3,5
8812,8,2015-10-31,maryland,@,Iowa,L (15-31),11,23,47.8,74,1,34,167,4.9,0,57,241,4.2,3,10,2,15,8,72,1,3,4
8813,9,2015-11-07,maryland,,Wisconsin,L (24-31),13,34,38.2,204,2,32,112,3.5,1,66,316,4.8,9,6,1,16,11,79,0,2,2
8814,10,2015-11-14,maryland,@,Michigan State,L (7-24),17,36,47.2,182,0,37,107,2.9,1,73,289,4.0,8,7,1,16,1,8,2,3,5
8815,11,2015-11-21,maryland,,Indiana,L (28-47),21,41,51.2,170,1,46,314,6.8,3,87,484,5.6,11,11,1,23,8,52,0,0,0
8816,12,2015-11-28,maryland,@,Rutgers,W (46-41),19,38,50.0,255,0,42,401,9.5,6,80,656,8.2,12,13,2,27,3,31,0,1,1
8817,,12 Games,maryland,,,,183,388,47.2,2092,15,441,2408,5.5,20,829,4500,5.4,96,105,16,217,84,742,7,29,36
8818,1,2016-09-03,maryland,,Howard,W (52-13),20,29,69.0,204,0,44,315,7.2,6,73,519,7.1,10,14,1,25,2,25,0,0,0
8819,2,2016-09-09,maryland,@,Florida International,W (41-14),15,21,71.4,238,3,45,239,5.3,1,66,477,7.2,11,11,0,22,8,85,0,0,0
8820,3,2016-09-17,maryland,@,Central Florida,W (30-24),10,23,43.5,127,0,50,246,4.9,4,73,373,5.1,4,16,0,20,6,47,0,0,0
8821,4,2016-10-01,maryland,,Purdue,W (50-7),9,17,52.9,96,3,46,400,8.7,4,63,496,7.9,5,13,1,19,11,92,1,1,2
8822,5,2016-10-08,maryland,@,Penn State,L (14-38),10,16,62.5,100,1,38,170,4.5,1,54,270,5.0,3,8,0,11,5,49,1,1,2
8823,6,2016-10-15,maryland,,Minnesota,L (10-31),18,37,48.6,161,1,36,130,3.6,0,73,291,4.0,8,8,0,16,9,75,2,2,4
8824,7,2016-10-22,maryland,,Michigan State,W (28-17),21,28,75.0,200,2,42,247,5.9,2,70,447,6.4,8,10,4,22,3,25,1,0,1
8825,8,2016-10-29,maryland,@,Indiana,L (36-42),22,34,64.7,248,2,50,269,5.4,3,84,517,6.2,14,13,2,29,6,60,1,1,2
8826,9,2016-11-05,maryland,@,Michigan,L (3-59),17,28,60.7,289,0,38,78,2.1,0,66,367,5.6,12,6,1,19,6,46,0,2,2
8827,10,2016-11-12,maryland,,Ohio State,L (3-62),15,27,55.6,133,0,40,43,1.1,0,67,176,2.6,7,3,0,10,7,74,1,1,2
8828,11,2016-11-19,maryland,@,Nebraska,L (7-28),15,31,48.4,196,1,25,11,0.4,0,56,207,3.7,7,2,0,9,5,65,0,0,0
8829,12,2016-11-26,maryland,,Rutgers,W (31-13),9,16,56.3,96,0,45,318,7.1,3,61,414,6.8,4,12,1,17,9,60,0,0,0
8830,13,2016-12-26,maryland,N,Boston College*,L (30-36),15,35,42.9,229,2,34,128,3.8,2,69,357,5.2,9,7,1,17,11,86,3,1,4
8831,,13 Games,maryland,,,,196,342,57.3,2317,15,533,2594,4.9,26,875,4911,5.6,102,123,11,236,88,789,10,9,19
8832,1,2017-09-02,maryland,@,Texas,W (51-41),12,15,80.0,219,2,43,263,6.1,4,58,482,8.3,7,10,1,18,10,53,0,1,1
8833,2,2017-09-09,maryland,,Towson,W (63-17),14,18,77.8,167,2,36,367,10.2,6,54,534,9.9,7,14,2,23,5,55,0,0,0
8834,3,2017-09-23,maryland,,Central Florida,L (10-38),17,28,60.7,155,1,37,42,1.1,0,65,197,3.0,7,5,6,18,7,53,0,2,2
8835,4,2017-09-30,maryland,@,Minnesota,W (31-24),18,28,64.3,154,2,47,262,5.6,2,75,416,5.5,9,13,1,23,6,70,0,0,0
8836,5,2017-10-07,maryland,@,Ohio State,L (14-62),3,13,23.1,16,0,42,50,1.2,1,55,66,1.2,0,3,3,6,6,66,2,0,2
8837,6,2017-10-14,maryland,,Northwestern,L (21-37),17,38,44.7,255,3,31,85,2.7,0,69,340,4.9,9,7,3,19,2,30,0,0,0
8838,7,2017-10-21,maryland,@,Wisconsin,L (13-38),13,30,43.3,125,1,35,143,4.1,0,65,268,4.1,6,10,2,18,4,54,1,1,2
8839,8,2017-10-28,maryland,,Indiana,W (42-39),10,16,62.5,171,2,40,174,4.4,3,56,345,6.2,6,8,4,18,12,133,0,1,1
8840,9,2017-11-04,maryland,N,Rutgers,L (24-31),19,32,59.4,218,1,37,167,4.5,2,69,385,5.6,11,6,3,20,10,65,0,1,1
8841,10,2017-11-11,maryland,,Michigan,L (10-35),18,38,47.4,160,1,32,180,5.6,0,70,340,4.9,7,8,0,15,7,59,0,2,2
8842,11,2017-11-18,maryland,@,Michigan State,L (7-17),13,25,52.0,121,0,31,83,2.7,1,56,204,3.6,6,5,1,12,6,45,1,0,1
8843,12,2017-11-25,maryland,,Penn State,L (3-66),21,37,56.8,179,0,25,124,5.0,0,62,303,4.9,7,3,1,11,8,91,2,0,2
8844,,12 Games,maryland,,,,175,318,55.0,1940,15,436,1940,4.4,19,754,3880,5.1,82,92,27,201,83,774,6,8,14
8845,1,2018-09-01,maryland,N,Texas,W (34-29),21,34,61.8,264,2,46,143,3.1,2,80,407,5.1,8,8,5,21,8,70,0,0,0
8846,2,2018-09-08,maryland,@,Bowling Green State,W (45-14),8,16,50.0,121,1,53,444,8.4,5,69,565,8.2,4,19,1,24,14,139,1,0,1
8847,3,2018-09-15,maryland,,Temple,L (14-35),8,21,38.1,63,0,31,132,4.3,0,52,195,3.8,2,7,2,11,5,35,0,2,2
8848,4,2018-09-22,maryland,,Minnesota,W (42-13),10,14,71.4,117,1,37,315,8.5,4,51,432,8.5,2,12,1,15,10,118,0,0,0
8849,5,2018-10-06,maryland,@,Michigan,L (21-42),7,13,53.8,73,0,37,147,4.0,2,50,220,4.4,5,5,1,11,12,107,0,1,1
8850,6,2018-10-13,maryland,,Rutgers,W (34-7),9,20,45.0,85,3,40,290,7.3,1,60,375,6.3,4,12,0,16,9,85,1,0,1
8851,7,2018-10-20,maryland,@,Iowa,L (0-23),6,16,37.5,47,0,23,68,3.0,0,39,115,2.9,3,4,0,7,6,46,1,1,2
8852,8,2018-10-27,maryland,,Illinois,W (63-33),13,21,61.9,281,3,48,431,9.0,5,69,712,10.3,10,19,1,30,7,85,0,0,0
8853,9,2018-11-03,maryland,,Michigan State,L (3-24),8,24,33.3,74,0,29,26,0.9,0,53,100,1.9,4,3,2,9,3,25,2,0,2
8854,10,2018-11-10,maryland,@,Indiana,L (32-34),14,25,56.0,189,1,59,353,6.0,2,84,542,6.5,8,18,1,27,10,93,3,1,4
8855,11,2018-11-17,maryland,,Ohio State,L (51-52),7,14,50.0,196,1,47,340,7.2,4,61,536,8.8,5,12,2,19,9,88,1,0,1
8856,,11 Games,maryland,,,,111,218,50.9,1510,12,450,2689,6.0,25,668,4199,6.3,55,119,16,190,93,891,9,5,14
8857,1,2018-08-25,duquesne,@,Massachusetts,L (15-63),16,30,53.3,123,1,36,130,3.6,1,66,253,3.8,6,5,2,13,3,22,1,3,4
8858,2,2018-09-22,duquesne,@,Hawaii,L (21-42),14,26,53.8,142,3,27,24,0.9,0,53,166,3.1,7,1,3,11,8,83,0,1,1
8859,,2 Games,duquesne,,,,30,56,53.6,265,4,63,154,2.4,1,119,419,3.5,13,6,5,24,11,105,1,4,5
8860,1,2014-08-30,nevada,,Southern Utah,W (28-19),30,41,73.2,303,1,55,244,4.4,3,96,547,5.7,16,14,0,30,4,19,1,1,2
8861,2,2014-09-05,nevada,,Washington State,W (24-13),12,21,57.1,110,0,56,214,3.8,3,77,324,4.2,4,10,3,17,9,90,0,0,0
8862,3,2014-09-13,nevada,@,Arizona,L (28-35),29,39,74.4,321,3,40,108,2.7,0,79,429,5.4,17,8,0,25,8,74,0,0,0
8863,4,2014-09-27,nevada,@,San Jose State,W (21-10),10,18,55.6,64,0,36,192,5.3,2,54,256,4.7,2,12,2,16,8,56,0,0,0
8864,5,2014-10-04,nevada,,Boise State,L (46-51),23,43,53.5,306,3,30,156,5.2,2,73,462,6.3,15,6,3,24,3,22,0,4,4
8865,6,2014-10-11,nevada,,Colorado State,L (24-31),27,50,54.0,297,2,36,160,4.4,1,86,457,5.3,16,8,1,25,3,45,0,1,1
8866,7,2014-10-18,nevada,@,Brigham Young,W (42-35),26,40,65.0,285,1,36,126,3.5,4,76,411,5.4,12,7,1,20,6,36,0,0,0
8867,8,2014-10-25,nevada,@,Hawaii,W (26-18),18,28,64.3,132,1,60,295,4.9,2,88,427,4.9,7,19,0,26,4,36,0,1,1
8868,9,2014-11-01,nevada,,San Diego State,W (30-14),10,24,41.7,109,1,47,229,4.9,2,71,338,4.8,6,9,2,17,5,44,0,1,1
8869,10,2014-11-15,nevada,@,Air Force,L (38-45),24,36,66.7,275,2,45,223,5.0,3,81,498,6.1,15,11,1,27,4,42,0,1,1
8870,11,2014-11-22,nevada,,Fresno State,L (20-40),11,24,45.8,126,1,38,227,6.0,2,62,353,5.7,4,9,0,13,7,90,3,1,4
8871,12,2014-11-29,nevada,@,Nevada-Las Vegas,W (49-27),5,13,38.5,46,3,53,408,7.7,3,66,454,6.9,2,18,1,21,11,87,0,1,1
8872,13,2014-12-20,nevada,N,Louisiana*,L (3-16),14,29,48.3,124,0,28,89,3.2,0,57,213,3.7,6,6,1,13,1,5,1,0,1
8873,,13 Games,nevada,,,,239,406,58.9,2498,18,560,2671,4.8,27,966,5169,5.4,122,137,15,274,73,646,5,11,16
8874,1,2015-09-03,nevada,,California-Davis,W (31-17),13,23,56.5,163,1,39,232,5.9,3,62,395,6.4,7,13,2,22,6,50,0,0,0
8875,2,2015-09-12,nevada,,Arizona,L (20-44),18,34,52.9,159,2,42,168,4.0,0,76,327,4.3,7,8,0,15,9,105,0,1,1
8876,3,2015-09-19,nevada,@,Texas A&M,L (27-44),16,29,55.2,206,2,45,153,3.4,1,74,359,4.9,10,6,3,19,3,29,0,1,1
8877,4,2015-09-26,nevada,@,Buffalo,W (24-21),12,21,57.1,90,0,39,289,7.4,3,60,379,6.3,4,10,1,15,9,95,0,0,0
8878,5,2015-10-03,nevada,,Nevada-Las Vegas,L (17-23),20,44,45.5,202,1,35,141,4.0,1,79,343,4.3,13,8,3,24,6,53,0,1,1
8879,6,2015-10-10,nevada,,New Mexico,W (35-17),16,19,84.2,166,2,54,351,6.5,3,73,517,7.1,10,18,2,30,1,5,2,0,2
8880,7,2015-10-17,nevada,@,Wyoming,L (21-28),25,41,61.0,287,2,30,118,3.9,1,71,405,5.7,15,10,2,27,5,41,0,0,0
8881,8,2015-10-24,nevada,,Hawaii,W (30-20),12,23,52.2,128,1,56,244,4.4,2,79,372,4.7,6,13,1,20,4,35,0,1,1
8882,9,2015-11-05,nevada,@,Fresno State,W (30-16),12,17,70.6,206,1,50,292,5.8,1,67,498,7.4,7,11,0,18,10,78,0,1,1
8883,10,2015-11-14,nevada,,San Jose State,W (37-34),16,26,61.5,174,3,49,235,4.8,2,75,409,5.5,10,12,1,23,2,5,0,0,0
8884,11,2015-11-21,nevada,@,Utah State,L (27-31),8,18,44.4,55,0,46,209,4.5,3,64,264,4.1,3,11,1,15,3,32,2,0,2
8885,12,2015-11-28,nevada,@,San Diego State,L (14-31),12,23,52.2,228,0,31,35,1.1,1,54,263,4.9,8,2,0,10,7,60,1,2,3
8886,13,2015-12-29,nevada,N,Colorado State*,W (28-23),6,13,46.2,74,0,40,271,6.8,2,53,345,6.5,5,12,1,18,3,20,0,0,0
8887,,13 Games,nevada,,,,186,331,56.2,2138,15,556,2738,4.9,23,887,4876,5.5,105,134,17,256,68,608,5,7,12
8888,1,2016-09-02,nevada,,Cal Poly,W (30-27),17,24,70.8,189,2,34,174,5.1,2,58,363,6.3,9,8,1,18,4,40,0,0,0
8889,2,2016-09-10,nevada,@,Notre Dame,L (10-39),12,26,46.2,201,0,30,99,3.3,1,56,300,5.4,5,7,4,16,11,88,0,1,1
8890,3,2016-09-17,nevada,,Buffalo,W (38-14),17,25,68.0,169,1,64,352,5.5,4,89,521,5.9,12,18,2,32,5,35,0,0,0
8891,4,2016-09-24,nevada,@,Purdue,L (14-24),23,33,69.7,185,2,33,68,2.1,0,66,253,3.8,10,8,0,18,1,10,0,0,0
8892,5,2016-10-01,nevada,@,Hawaii,L (17-38),19,33,57.6,203,1,42,194,4.6,1,75,397,5.3,7,14,2,23,9,95,0,0,0
8893,6,2016-10-08,nevada,,Fresno State,W (27-22),14,23,60.9,163,3,49,226,4.6,1,72,389,5.4,6,15,2,23,3,35,1,0,1
8894,7,2016-10-15,nevada,@,San Jose State,L (10-14),9,22,40.9,144,1,34,113,3.3,0,56,257,4.6,5,7,1,13,3,35,0,2,2
8895,8,2016-10-22,nevada,,Wyoming,L (34-42),31,48,64.6,347,1,32,132,4.1,3,80,479,6.0,19,10,3,32,7,75,0,1,1
8896,9,2016-11-05,nevada,@,New Mexico,L (26-35),19,34,55.9,301,3,23,108,4.7,1,57,409,7.2,11,7,1,19,5,25,0,2,2
8897,10,2016-11-12,nevada,,San Diego State,L (16-46),21,37,56.8,276,1,34,90,2.6,0,71,366,5.2,11,7,1,19,2,20,0,3,3
8898,11,2016-11-19,nevada,,Utah State,W (38-37),13,26,50.0,127,1,50,214,4.3,3,76,341,4.5,5,16,1,22,1,10,1,0,1
8899,12,2016-11-26,nevada,@,Nevada-Las Vegas,W (45-10),15,23,65.2,193,1,49,318,6.5,4,72,511,7.1,10,16,1,27,1,14,0,0,0
8900,,12 Games,nevada,,,,210,354,59.3,2498,17,474,2088,4.4,20,828,4586,5.5,110,133,19,262,52,482,2,9,11
8901,1,2017-09-02,nevada,@,Northwestern,L (20-31),16,37,43.2,199,2,26,142,5.5,0,63,341,5.4,9,8,2,19,6,65,1,1,2
8902,2,2017-09-09,nevada,,Toledo,L (24-37),19,37,51.4,277,2,24,109,4.5,1,61,386,6.3,10,7,5,22,9,75,1,1,2
8903,3,2017-09-16,nevada,,Idaho State,L (28-30),19,33,57.6,205,3,56,218,3.9,1,89,423,4.8,9,12,4,25,7,62,2,1,3
8904,4,2017-09-23,nevada,@,Washington State,L (7-45),14,30,46.7,105,0,24,46,1.9,1,54,151,2.8,5,5,3,13,5,53,0,3,3
8905,5,2017-09-30,nevada,@,Fresno State,L (21-41),31,49,63.3,253,2,23,61,2.7,1,72,314,4.4,12,3,1,16,4,20,0,3,3
8906,6,2017-10-07,nevada,,Hawaii,W (35-21),26,34,76.5,298,4,38,268,7.1,1,72,566,7.9,12,11,3,26,6,39,0,1,1
8907,7,2017-10-14,nevada,@,Colorado State,L (42-44),25,42,59.5,508,5,31,56,1.8,1,73,564,7.7,16,4,3,23,3,30,0,0,0
8908,8,2017-10-20,nevada,,Air Force,L (42-45),18,35,51.4,267,3,20,157,7.9,2,55,424,7.7,10,9,2,21,3,25,0,0,0
8909,9,2017-11-04,nevada,@,Boise State,L (14-41),24,37,64.9,160,1,29,142,4.9,1,66,302,4.6,8,7,2,17,2,25,0,3,3
8910,10,2017-11-11,nevada,,San Jose State,W (59-14),20,28,71.4,265,3,44,176,4.0,2,72,441,6.1,9,8,3,20,8,70,0,0,0
8911,11,2017-11-18,nevada,@,San Diego State,L (23-42),33,55,60.0,414,3,18,34,1.9,0,73,448,6.1,15,3,0,18,2,20,1,1,2
8912,12,2017-11-25,nevada,,Nevada-Las Vegas,W (23-16),25,34,73.5,294,2,29,117,4.0,1,63,411,6.5,11,7,0,18,4,67,1,1,2
8913,,12 Games,nevada,,,,270,451,59.9,3245,30,362,1526,4.2,12,813,4771,5.9,126,84,28,238,59,551,6,15,21
8914,1,2018-08-31,nevada,,Portland State,W (72-19),18,28,64.3,420,4,35,216,6.2,4,63,636,10.1,12,12,1,25,9,106,0,1,1
8915,2,2018-09-08,nevada,@,Vanderbilt,L (10-41),22,39,56.4,216,1,25,34,1.4,0,64,250,3.9,8,6,0,14,6,67,2,2,4
8916,3,2018-09-15,nevada,,Oregon State,W (37-35),18,37,48.6,201,2,30,156,5.2,2,67,357,5.3,10,6,1,17,5,60,0,1,1
8917,4,2018-09-22,nevada,@,Toledo,L (44-63),29,50,58.0,320,1,35,262,7.5,5,85,582,6.8,14,11,2,27,10,70,1,1,2
8918,5,2018-09-29,nevada,@,Air Force,W (28-25),24,33,72.7,259,4,34,177,5.2,0,67,436,6.5,12,7,0,19,13,103,1,1,2
8919,6,2018-10-06,nevada,,Fresno State,L (3-21),22,43,51.2,195,0,43,132,3.1,0,86,327,3.8,13,7,1,21,1,5,0,3,3
8920,7,2018-10-13,nevada,,Boise State,L (27-31),24,42,57.1,304,2,24,82,3.4,1,66,386,5.8,11,7,5,23,4,20,2,1,3
8921,8,2018-10-20,nevada,@,Hawaii,W (40-22),23,31,74.2,261,1,36,220,6.1,4,67,481,7.2,11,12,2,25,5,55,3,0,3
8922,9,2018-10-27,nevada,,San Diego State,W (28-24),23,43,53.5,235,2,23,62,2.7,1,66,297,4.5,10,3,1,14,5,75,0,0,0
8923,10,2018-11-10,nevada,,Colorado State,W (49-10),28,36,77.8,404,4,35,235,6.7,3,71,639,9.0,20,8,1,29,6,61,1,1,2
8924,11,2018-11-17,nevada,@,San Jose State,W (21-12),19,32,59.4,314,1,47,149,3.2,2,79,463,5.9,13,10,1,24,3,15,1,1,2
8925,,11 Games,nevada,,,,250,414,60.4,3129,22,367,1725,4.7,22,781,4854,6.2,134,89,15,238,67,637,11,12,23
8926,1,2016-09-01,montana-state,@,Idaho,L (17-20),20,36,55.6,190,1,38,110,2.9,1,74,300,4.1,11,6,3,20,4,30,0,1,1
8927,1,2017-09-02,montana-state,@,Washington State,L (0-31),5,12,41.7,28,0,32,115,3.6,0,44,143,3.3,1,6,0,7,4,23,0,1,1
8928,1,2016-10-15,lafayette,@,Army,L (7-62),23,38,60.5,213,0,17,10,0.6,1,55,223,4.1,9,1,0,10,5,45,0,2,2
8929,1,2018-11-10,lafayette,@,Army,L (13-31),9,16,56.3,76,1,24,83,3.5,0,40,159,4.0,4,5,0,9,1,5,0,0,0
8930,1,2016-09-01,presbyterian,@,Central Michigan,L (3-49),10,22,45.5,82,0,33,44,1.3,0,55,126,2.3,4,2,0,6,6,60,1,2,3
8931,2,2016-11-19,presbyterian,@,South Alabama,L (7-31),11,24,45.8,78,0,46,197,4.3,0,70,275,3.9,6,10,2,18,6,60,1,1,2
8932,,2 Games,presbyterian,,,,21,46,45.7,160,0,79,241,3.1,0,125,401,3.2,10,12,2,24,12,120,2,3,5
8933,1,2017-08-31,presbyterian,@,Wake Forest,L (7-51),2,9,22.2,41,0,45,207,4.6,1,54,248,4.6,2,10,0,12,5,45,0,1,1
8934,1,2016-09-10,idaho-state,@,Colorado,L (7-56),19,41,46.3,61,0,14,35,2.5,1,55,96,1.7,4,1,2,7,8,78,0,1,1
8935,2,2016-09-17,idaho-state,@,Oregon State,L (7-37),28,48,58.3,227,0,23,136,5.9,1,71,363,5.1,11,3,3,17,6,43,1,4,5
8936,,2 Games,idaho-state,,,,47,89,52.8,288,0,37,171,4.6,2,126,459,3.6,15,4,5,24,14,121,1,5,6
8937,1,2017-09-07,idaho-state,@,Utah State,L (13-51),17,31,54.8,190,1,38,113,3.0,1,69,303,4.4,8,6,1,15,6,46,0,2,2
8938,2,2017-09-16,idaho-state,@,Nevada,W (30-28),19,38,50.0,269,2,35,114,3.3,1,73,383,5.2,9,6,3,18,9,80,0,0,0
8939,,2 Games,idaho-state,,,,36,69,52.2,459,3,73,227,3.1,2,142,686,4.8,17,12,4,33,15,126,0,2,2
8940,1,2018-09-15,idaho-state,@,California,L (23-45),15,23,65.2,179,1,45,140,3.1,2,68,319,4.7,3,8,6,17,3,27,0,1,1
8941,2,2018-10-20,idaho-state,@,Liberty,L (41-48),20,44,45.5,397,4,42,234,5.6,1,86,631,7.3,18,9,1,28,4,24,1,2,3
8942,,2 Games,idaho-state,,,,35,67,52.2,576,5,87,374,4.3,3,154,950,6.2,21,17,7,45,7,51,1,3,4
8943,1,2016-09-10,mercer,@,Georgia Tech,L (10-35),25,40,62.5,235,1,28,85,3.0,0,68,320,4.7,11,8,0,19,5,45,0,0,0
8944,1,2017-09-16,mercer,@,Auburn,L (10-24),20,32,62.5,146,1,35,100,2.9,0,67,246,3.7,5,5,2,12,2,30,0,0,0
8945,2,2017-11-18,mercer,@,Alabama,L (0-56),7,22,31.8,54,0,39,107,2.7,0,61,161,2.6,5,4,0,9,2,10,0,3,3
8946,,2 Games,mercer,,,,27,54,50.0,200,1,74,207,2.8,0,128,407,3.2,10,9,2,21,4,40,0,3,3
8947,1,2018-09-01,mercer,@,Memphis,L (14-66),14,27,51.9,114,2,24,60,2.5,0,51,174,3.4,6,2,0,8,7,60,0,2,2
8948,1,2016-09-10,wofford,@,Mississippi,L (13-38),5,9,55.6,72,0,57,233,4.1,1,66,305,4.6,3,14,1,18,2,25,1,0,1
8949,1,2017-11-18,wofford,@,South Carolina,L (10-31),5,9,55.6,72,0,41,155,3.8,1,50,227,4.5,2,9,3,14,3,21,1,2,3
8950,1,2018-09-15,wofford,@,Wyoming,L (14-17),9,15,60.0,73,0,49,221,4.5,2,64,294,4.6,4,8,2,14,3,16,1,2,3
8951,1,2016-09-02,furman,@,Michigan State,L (13-28),16,31,51.6,139,0,33,87,2.6,1,64,226,3.5,8,6,4,18,4,34,0,1,1
8952,1,2017-09-16,furman,@,North Carolina State,L (16-49),11,19,57.9,196,1,47,133,2.8,0,66,329,5.0,8,7,1,16,1,5,2,1,3
8953,1,2018-09-01,furman,@,Clemson,L (7-48),4,9,44.4,46,1,52,201,3.9,0,61,247,4.0,3,7,3,13,3,22,2,0,2
8954,1,2016-11-19,citadel,@,North Carolina,L (7-41),3,8,37.5,27,0,72,344,4.8,1,80,371,4.6,1,19,1,21,4,34,3,1,4
8955,1,2017-11-18,citadel,@,Clemson,L (3-61),1,8,12.5,61,0,54,155,2.9,0,62,216,3.5,1,8,1,10,5,41,0,2,2
8956,1,2018-11-17,citadel,@,Alabama,L (17-50),0,2,0.0,0,0,60,275,4.6,2,62,275,4.4,0,11,2,13,6,50,1,0,1
8957,1,2014-08-28,wake-forest,@,Louisiana-Monroe,L (10-17),12,22,54.5,97,0,27,-3,-0.1,0,49,94,1.9,3,2,0,5,8,51,0,1,1
8958,2,2014-09-06,wake-forest,,Gardner-Webb,W (23-7),30,39,76.9,291,2,36,96,2.7,0,75,387,5.2,17,7,0,24,7,71,0,3,3
8959,3,2014-09-13,wake-forest,@,Utah State,L (24-36),20,50,40.0,257,2,24,-25,-1.0,0,74,232,3.1,13,1,2,16,10,103,1,2,3
8960,4,2014-09-20,wake-forest,,Army,W (24-21),25,35,71.4,238,2,30,100,3.3,1,65,338,5.2,12,8,1,21,4,30,0,1,1
8961,5,2014-09-27,wake-forest,@,Louisville,L (10-20),19,34,55.9,122,0,23,-22,-1.0,0,57,100,1.8,5,1,1,7,4,45,0,3,3
8962,6,2014-10-04,wake-forest,@,Florida State,L (3-43),13,22,59.1,86,0,39,40,1.0,0,61,126,2.1,4,4,2,10,7,62,2,1,3
8963,7,2014-10-18,wake-forest,,Syracuse,L (7-30),15,23,65.2,99,1,36,71,2.0,0,59,170,2.9,6,5,1,12,3,35,1,1,2
8964,8,2014-10-25,wake-forest,,Boston College,L (17-23),22,30,73.3,242,0,33,19,0.6,2,63,261,4.1,11,3,3,17,6,49,0,1,1
8965,9,2014-11-06,wake-forest,,Clemson,L (20-34),12,30,40.0,112,2,34,7,0.2,0,64,119,1.9,6,3,6,15,2,29,0,0,0
8966,10,2014-11-15,wake-forest,@,North Carolina State,L (13-42),15,32,46.9,161,0,35,58,1.7,1,67,219,3.3,6,6,0,12,2,21,1,0,1
8967,11,2014-11-22,wake-forest,,Virginia Tech,W (6-3),18,32,56.3,160,0,42,74,1.8,0,74,234,3.2,8,6,1,15,4,43,0,1,1
8968,12,2014-11-29,wake-forest,@,Duke,L (21-41),24,36,66.7,251,3,24,64,2.7,0,60,315,5.3,11,5,2,18,3,35,2,0,2
8969,,12 Games,wake-forest,,,,225,385,58.4,2116,12,383,479,1.3,4,768,2595,3.4,102,51,19,172,60,574,7,14,21
8970,1,2015-09-03,wake-forest,,Elon,W (41-3),29,40,72.5,388,3,42,203,4.8,2,82,591,7.2,19,8,2,29,3,30,0,0,0
8971,2,2015-09-12,wake-forest,@,Syracuse,L (17-30),30,45,66.7,373,1,32,46,1.4,1,77,419,5.4,17,5,1,23,6,52,0,3,3
8972,3,2015-09-19,wake-forest,@,Army,W (17-14),18,33,54.5,175,0,35,171,4.9,2,68,346,5.1,7,9,3,19,6,47,0,3,3
8973,4,2015-09-26,wake-forest,,Indiana,L (24-31),20,48,41.7,264,1,32,99,3.1,2,80,363,4.5,15,5,5,25,7,48,0,1,1
8974,5,2015-10-03,wake-forest,,Florida State,L (16-24),27,43,62.8,215,1,36,142,3.9,0,79,357,4.5,12,10,5,27,5,32,1,1,2
8975,6,2015-10-10,wake-forest,@,Boston College,W (3-0),11,25,44.0,109,0,28,33,1.2,0,53,142,2.7,4,1,0,5,9,102,1,1,2
8976,7,2015-10-17,wake-forest,@,North Carolina,L (14-50),20,30,66.7,197,2,43,113,2.6,0,73,310,4.2,9,6,1,16,3,24,1,0,1
8977,8,2015-10-24,wake-forest,,North Carolina State,L (17-35),14,30,46.7,122,0,38,149,3.9,2,68,271,4.0,7,6,4,17,3,35,0,1,1
8978,9,2015-10-30,wake-forest,,Louisville,L (19-20),9,30,30.0,226,2,32,40,1.3,0,62,266,4.3,7,2,2,11,3,29,1,4,5
8979,10,2015-11-14,wake-forest,@,Notre Dame,L (7-28),19,30,63.3,219,0,44,121,2.8,1,74,340,4.6,9,11,3,23,5,58,0,1,1
8980,11,2015-11-21,wake-forest,@,Clemson,L (13-33),16,28,57.1,113,1,32,39,1.2,1,60,152,2.5,5,4,2,11,6,55,1,1,2
8981,12,2015-11-28,wake-forest,,Duke,L (21-27),23,35,65.7,338,2,23,112,4.9,1,58,450,7.8,12,7,2,21,5,51,1,2,3
8982,,12 Games,wake-forest,,,,236,417,56.6,2739,13,417,1268,3.0,12,834,4007,4.8,123,74,30,227,61,563,6,18,24
8983,1,2016-09-01,wake-forest,,Tulane,W (7-3),12,21,57.1,96,0,34,79,2.3,1,55,175,3.2,4,6,0,10,5,45,0,0,0
8984,2,2016-09-10,wake-forest,@,Duke,W (24-14),9,16,56.3,150,0,49,239,4.9,3,65,389,6.0,4,9,0,13,4,24,1,1,2
8985,3,2016-09-17,wake-forest,,Delaware,W (38-21),15,28,53.6,179,1,59,302,5.1,4,87,481,5.5,10,19,0,29,6,60,1,1,2
8986,4,2016-09-24,wake-forest,@,Indiana,W (33-28),16,29,55.2,172,1,50,180,3.6,2,79,352,4.5,9,9,3,21,5,40,0,0,0
8987,5,2016-10-01,wake-forest,@,North Carolina State,L (16-33),27,46,58.7,283,1,21,69,3.3,0,67,352,5.3,14,4,5,23,3,38,0,0,0
8988,6,2016-10-08,wake-forest,,Syracuse,W (28-9),13,22,59.1,140,0,51,190,3.7,3,73,330,4.5,7,12,2,21,1,5,1,1,2
8989,7,2016-10-15,wake-forest,@,Florida State,L (6-17),16,34,47.1,184,0,32,68,2.1,0,66,252,3.8,8,4,1,13,5,40,1,2,3
8990,8,2016-10-29,wake-forest,,Army,L (13-21),23,43,53.5,220,1,23,123,5.3,0,66,343,5.2,7,10,0,17,7,45,0,3,3
8991,9,2016-11-05,wake-forest,,Virginia,W (27-20),9,10,90.0,83,1,51,226,4.4,1,61,309,5.1,5,10,1,16,6,32,0,0,0
8992,10,2016-11-12,wake-forest,@,Louisville,L (12-44),13,24,54.2,141,0,49,73,1.5,0,73,214,2.9,6,7,3,16,4,25,1,1,2
8993,11,2016-11-19,wake-forest,,Clemson,L (13-35),7,18,38.9,126,0,36,71,2.0,1,54,197,3.6,2,6,1,9,5,44,0,0,0
8994,12,2016-11-26,wake-forest,,Boston College,L (14-17),16,33,48.5,137,2,35,150,4.3,0,68,287,4.2,7,5,3,15,3,35,1,2,3
8995,13,2016-12-27,wake-forest,N,Temple*,W (34-26),14,29,48.3,243,2,43,125,2.9,2,72,368,5.1,11,10,1,22,7,68,0,2,2
8996,,13 Games,wake-forest,,,,190,353,53.8,2154,9,533,1895,3.6,17,886,4049,4.6,94,111,20,225,61,501,6,13,19
8997,1,2017-08-31,wake-forest,,Presbyterian,W (51-7),20,27,74.1,239,5,45,248,5.5,2,72,487,6.8,10,16,2,28,4,25,0,1,1
8998,2,2017-09-09,wake-forest,@,Boston College,W (34-10),13,19,68.4,151,1,52,158,3.0,2,71,309,4.4,7,8,0,15,5,40,0,0,0
8999,3,2017-09-16,wake-forest,,Utah State,W (46-10),16,27,59.3,297,2,59,291,4.9,3,86,588,6.8,11,13,2,26,8,62,0,0,0
9000,4,2017-09-23,wake-forest,@,Appalachian State,W (20-19),14,27,51.9,176,2,40,168,4.2,0,67,344,5.1,9,7,2,18,8,66,0,0,0
9001,5,2017-09-30,wake-forest,,Florida State,L (19-26),24,35,68.6,271,0,34,96,2.8,2,69,367,5.3,13,4,0,17,7,59,1,1,2
9002,6,2017-10-07,wake-forest,@,Clemson,L (14-28),14,30,46.7,203,2,35,133,3.8,0,65,336,5.2,8,7,1,16,4,25,0,0,0
9003,7,2017-10-21,wake-forest,@,Georgia Tech,L (24-38),17,30,56.7,252,2,31,110,3.5,1,61,362,5.9,12,6,2,20,4,40,0,1,1
9004,8,2017-10-28,wake-forest,,Louisville,W (42-32),28,34,82.4,461,5,39,164,4.2,1,73,625,8.6,16,10,0,26,6,55,1,0,1
9005,9,2017-11-04,wake-forest,@,Notre Dame,L (37-48),30,48,62.5,348,2,40,239,6.0,3,88,587,6.7,20,13,1,34,3,15,0,1,1
9006,10,2017-11-11,wake-forest,@,Syracuse,W (64-43),25,38,65.8,363,3,51,371,7.3,5,89,734,8.2,14,18,1,33,10,62,1,0,1
9007,11,2017-11-18,wake-forest,,North Carolina State,W (30-24),19,28,67.9,247,3,28,87,3.1,1,56,334,6.0,10,7,1,18,4,40,0,1,1
9008,12,2017-11-25,wake-forest,,Duke,L (23-31),16,34,47.1,191,2,35,145,4.1,0,69,336,4.9,6,6,2,14,2,10,1,2,3
9009,13,2017-12-29,wake-forest,N,Texas A&M*,W (55-52),32,49,65.3,400,4,46,248,5.4,2,95,648,6.8,18,10,3,31,4,45,2,0,2
9010,,13 Games,wake-forest,,,,268,426,62.9,3599,33,535,2458,4.6,22,961,6057,6.3,154,125,17,296,69,544,6,7,13
9011,1,2018-08-30,wake-forest,@,Tulane,W (23-17),31,51,60.8,378,2,43,170,4.0,1,94,548,5.8,20,10,2,32,6,70,1,2,3
9012,2,2018-09-08,wake-forest,,Towson,W (51-20),17,27,63.0,242,2,54,340,6.3,2,81,582,7.2,13,16,3,32,0,0,1,1,2
9013,3,2018-09-13,wake-forest,,Boston College,L (34-41),20,45,44.4,214,2,60,298,5.0,1,105,512,4.9,10,16,1,27,3,35,0,2,2
9014,4,2018-09-22,wake-forest,,Notre Dame,L (27-56),16,31,51.6,139,0,61,259,4.2,3,92,398,4.3,9,15,3,27,3,23,0,1,1
9015,5,2018-09-29,wake-forest,,Rice,W (56-24),17,20,85.0,243,4,41,171,4.2,2,61,414,6.8,8,9,3,20,3,25,1,1,2
9016,6,2018-10-06,wake-forest,,Clemson,L (3-63),7,27,25.9,74,0,51,175,3.4,0,78,249,3.2,4,7,0,11,5,55,0,1,1
9017,7,2018-10-20,wake-forest,@,Florida State,L (17-38),26,56,46.4,261,2,51,119,2.3,0,107,380,3.6,14,10,1,25,5,65,0,1,1
9018,8,2018-10-27,wake-forest,@,Louisville,W (56-35),16,24,66.7,223,2,48,368,7.7,5,72,591,8.2,10,18,0,28,3,35,0,0,0
9019,9,2018-11-03,wake-forest,,Syracuse,L (24-41),21,37,56.8,275,2,44,159,3.6,1,81,434,5.4,12,10,4,26,10,95,2,1,3
9020,10,2018-11-08,wake-forest,@,North Carolina State,W (27-23),22,33,66.7,297,3,38,138,3.6,0,71,435,6.1,11,10,1,22,5,50,1,0,1
9021,11,2018-11-17,wake-forest,,Pittsburgh,L (13-34),15,30,50.0,206,1,28,79,2.8,0,58,285,4.9,9,6,1,16,1,15,0,2,2
9022,,11 Games,wake-forest,,,,208,381,54.6,2552,20,519,2276,4.4,15,900,4828,5.4,120,127,19,266,44,468,6,12,18
9023,1,2014-08-30,duke,,Elon,W (52-13),28,42,66.7,292,4,44,275,6.3,3,86,567,6.6,14,17,0,31,2,15,0,0,0
9024,2,2014-09-06,duke,@,Troy,W (34-17),28,42,66.7,270,2,41,182,4.4,2,83,452,5.4,15,10,0,25,6,43,0,0,0
9025,3,2014-09-13,duke,,Kansas,W (41-3),20,34,58.8,180,2,36,331,9.2,3,70,511,7.3,9,10,4,23,5,41,0,0,0
9026,4,2014-09-20,duke,,Tulane,W (47-13),15,28,53.6,181,0,42,256,6.1,4,70,437,6.2,8,12,3,23,7,80,1,1,2
9027,5,2014-09-27,duke,@,Miami (FL),L (10-22),22,51,43.1,179,0,25,85,3.4,1,76,264,3.5,8,5,4,17,8,50,1,2,3
9028,6,2014-10-11,duke,@,Georgia Tech,W (31-25),16,26,61.5,131,1,47,242,5.1,3,73,373,5.1,5,16,4,25,5,35,0,0,0
9029,7,2014-10-18,duke,,Virginia,W (20-13),23,38,60.5,179,2,30,155,5.2,0,68,334,4.9,7,10,2,19,3,30,0,0,0
9030,8,2014-11-01,duke,@,Pittsburgh,W (51-48),23,31,74.2,266,3,27,172,6.4,3,58,438,7.6,12,11,2,25,3,20,0,0,0
9031,9,2014-11-08,duke,@,Syracuse,W (27-10),15,33,45.5,161,2,33,98,3.0,0,66,259,3.9,6,5,1,12,5,40,0,1,1
9032,10,2014-11-15,duke,,Virginia Tech,L (16-17),19,41,46.3,185,0,41,141,3.4,1,82,326,4.0,12,9,2,23,8,50,1,2,3
9033,11,2014-11-20,duke,,North Carolina,L (20-45),22,40,55.0,262,2,37,116,3.1,1,77,378,4.9,12,8,1,21,5,35,2,1,3
9034,12,2014-11-29,duke,,Wake Forest,W (41-21),20,32,62.5,293,2,45,146,3.2,3,77,439,5.7,11,10,0,21,3,29,1,0,1
9035,13,2014-12-27,duke,N,Arizona State*,L (31-36),17,33,51.5,235,3,44,165,3.8,0,77,400,5.2,11,10,0,21,4,35,1,1,2
9036,,13 Games,duke,,,,268,471,56.9,2814,23,492,2364,4.8,24,963,5178,5.4,130,133,23,286,64,503,7,8,15
9037,1,2015-09-03,duke,@,Tulane,W (37-7),29,44,65.9,324,2,49,206,4.2,1,93,530,5.7,16,11,2,29,8,78,2,0,2
9038,2,2015-09-12,duke,,North Carolina Central,W (55-0),19,26,73.1,367,3,59,288,4.9,4,85,655,7.7,9,17,3,29,3,34,0,0,0
9039,3,2015-09-19,duke,,Northwestern,L (10-19),24,39,61.5,150,0,35,177,5.1,1,74,327,4.4,6,9,1,16,4,39,2,1,3
9040,4,2015-09-26,duke,,Georgia Tech,W (34-20),17,25,68.0,114,1,36,165,4.6,3,61,279,4.6,6,5,0,11,4,35,1,2,3
9041,5,2015-10-03,duke,,Boston College,W (9-7),18,36,50.0,195,0,35,33,0.9,0,71,228,3.2,9,4,3,16,5,31,0,0,0
9042,6,2015-10-10,duke,@,Army,W (44-3),20,30,66.7,243,1,48,215,4.5,4,78,458,5.9,14,8,3,25,5,50,0,0,0
9043,7,2015-10-24,duke,@,Virginia Tech,W (45-43),19,40,47.5,270,4,32,179,5.6,1,72,449,6.2,12,7,1,20,7,22,0,0,0
9044,8,2015-10-31,duke,,Miami (FL),L (27-30),31,52,59.6,258,1,39,182,4.7,2,91,440,4.8,15,11,8,34,5,41,1,0,1
9045,9,2015-11-07,duke,@,North Carolina,L (31-66),20,40,50.0,206,1,44,327,7.4,3,84,533,6.3,13,15,2,30,8,72,1,2,3
9046,10,2015-11-14,duke,,Pittsburgh,L (13-31),23,43,53.5,248,0,22,113,5.1,1,65,361,5.6,11,5,2,18,4,44,2,1,3
9047,11,2015-11-21,duke,@,Virginia,L (34-42),30,53,56.6,385,2,31,100,3.2,1,84,485,5.8,19,6,4,29,9,80,2,1,3
9048,12,2015-11-28,duke,@,Wake Forest,W (27-21),27,41,65.9,280,2,48,151,3.1,1,89,431,4.8,19,7,4,30,4,34,0,0,0
9049,13,2015-12-26,duke,N,Indiana*,W (44-41),17,40,42.5,163,1,46,373,8.1,3,86,536,6.2,7,15,1,23,5,61,0,3,3
9050,,13 Games,duke,,,,294,509,57.8,3203,18,524,2509,4.8,25,1033,5712,5.5,156,120,34,310,71,621,11,10,21
9051,1,2016-09-03,duke,,North Carolina Central,W (49-6),16,26,61.5,227,3,63,308,4.9,4,89,535,6.0,9,17,3,29,10,85,5,0,5
9052,2,2016-09-10,duke,,Wake Forest,L (14-24),31,48,64.6,332,0,30,37,1.2,2,78,369,4.7,15,5,1,21,5,22,2,1,3
9053,3,2016-09-17,duke,@,Northwestern,L (13-24),27,49,55.1,279,0,34,117,3.4,2,83,396,4.8,15,7,1,23,7,62,1,1,2
9054,4,2016-09-24,duke,@,Notre Dame,W (38-35),24,32,75.0,290,3,42,208,5.0,1,74,498,6.7,12,11,1,24,1,5,0,1,1
9055,5,2016-10-01,duke,,Virginia,L (20-34),33,54,61.1,324,1,31,106,3.4,1,85,430,5.1,17,6,2,25,2,25,1,5,6
9056,6,2016-10-08,duke,,Army,W (13-6),8,16,50.0,44,2,50,145,2.9,0,66,189,2.9,3,6,0,9,6,39,1,0,1
9057,7,2016-10-14,duke,@,Louisville,L (14-24),14,21,66.7,129,2,39,110,2.8,0,60,239,4.0,7,5,1,13,3,25,0,0,0
9058,8,2016-10-29,duke,@,Georgia Tech,L (35-38),22,36,61.1,305,2,37,254,6.9,3,73,559,7.7,13,9,1,23,4,20,2,1,3
9059,9,2016-11-05,duke,,Virginia Tech,L (21-24),18,31,58.1,148,0,45,227,5.0,3,76,375,4.9,9,12,3,24,6,46,0,0,0
9060,10,2016-11-10,duke,,North Carolina,W (28-27),22,34,64.7,240,1,55,227,4.1,3,89,467,5.2,15,10,2,27,5,60,0,0,0
9061,11,2016-11-19,duke,@,Pittsburgh,L (14-56),28,46,60.9,243,1,22,25,1.1,0,68,268,3.9,14,2,2,18,6,45,2,0,2
9062,12,2016-11-26,duke,@,Miami (FL),L (21-40),34,50,68.0,316,3,26,79,3.0,0,76,395,5.2,14,5,3,22,7,51,0,0,0
9063,,12 Games,duke,,,,277,443,62.5,2877,18,474,1843,3.9,19,917,4720,5.1,143,95,20,258,62,485,14,9,23
9064,1,2017-09-02,duke,,North Carolina Central,W (60-7),26,34,76.5,281,3,47,243,5.2,4,81,524,6.5,13,15,2,30,3,40,0,0,0
9065,2,2017-09-09,duke,,Northwestern,W (41-17),29,45,64.4,305,2,59,233,3.9,3,104,538,5.2,17,14,3,34,8,55,1,1,2
9066,3,2017-09-16,duke,,Baylor,W (34-20),20,35,57.1,184,0,51,246,4.8,3,86,430,5.0,7,14,3,24,5,54,1,1,2
9067,4,2017-09-23,duke,@,North Carolina,W (27-17),18,34,52.9,202,1,45,186,4.1,1,79,388,4.9,8,12,0,20,2,12,0,0,0
9068,5,2017-09-29,duke,,Miami (FL),L (6-31),21,42,50.0,166,0,46,183,4.0,0,88,349,4.0,7,14,3,24,7,82,1,1,2
9069,6,2017-10-07,duke,@,Virginia,L (21-28),14,42,33.3,124,1,32,131,4.1,1,74,255,3.4,8,7,2,17,7,68,0,2,2
9070,7,2017-10-14,duke,,Florida State,L (10-17),22,37,59.5,204,0,25,111,4.4,1,62,315,5.1,10,7,0,17,5,37,0,1,1
9071,8,2017-10-21,duke,,Pittsburgh,L (17-24),16,34,47.1,283,2,26,76,2.9,0,60,359,6.0,13,6,3,22,7,32,1,1,2
9072,9,2017-10-28,duke,@,Virginia Tech,L (3-24),10,24,41.7,82,0,35,101,2.9,0,59,183,3.1,3,5,2,10,7,53,1,1,2
9073,10,2017-11-11,duke,@,Army,L (16-21),19,30,63.3,164,0,33,89,2.7,2,63,253,4.0,12,7,3,22,4,43,1,1,2
9074,11,2017-11-18,duke,,Georgia Tech,W (43-20),19,28,67.9,181,3,51,319,6.3,2,79,500,6.3,9,20,1,30,1,15,0,0,0
9075,12,2017-11-25,duke,@,Wake Forest,W (31-23),25,44,56.8,346,2,45,97,2.2,2,89,443,5.0,16,6,0,22,4,20,0,3,3
9076,13,2017-12-26,duke,N,Northern Illinois*,W (36-14),27,40,67.5,252,2,52,213,4.1,3,92,465,5.1,13,14,0,27,2,30,1,0,1
9077,,13 Games,duke,,,,266,469,56.7,2774,16,547,2228,4.1,22,1016,5002,4.9,136,141,22,299,62,541,7,12,19
9078,1,2018-08-31,duke,,Army,W (34-14),13,17,76.5,197,1,35,184,5.3,3,52,381,7.3,8,9,2,19,4,30,1,0,1
9079,2,2018-09-08,duke,@,Northwestern,W (21-7),18,24,75.0,204,3,39,97,2.5,0,63,301,4.8,8,6,1,15,4,42,0,0,0
9080,3,2018-09-15,duke,@,Baylor,W (40-27),12,30,40.0,174,3,44,225,5.1,1,74,399,5.4,7,12,1,20,0,0,0,0,0
9081,4,2018-09-22,duke,,North Carolina Central,W (55-13),20,39,51.3,256,4,59,372,6.3,4,98,628,6.4,11,19,2,32,8,75,1,0,1
9082,5,2018-09-29,duke,,Virginia Tech,L (14-31),25,39,64.1,256,1,36,71,2.0,1,75,327,4.4,12,6,0,18,3,15,0,1,1
9083,6,2018-10-13,duke,@,Georgia Tech,W (28-14),17,27,63.0,206,3,33,98,3.0,1,60,304,5.1,9,10,0,19,3,15,2,1,3
9084,7,2018-10-20,duke,,Virginia,L (14-28),23,42,54.8,262,2,27,58,2.1,0,69,320,4.6,13,5,1,19,6,67,0,2,2
9085,8,2018-10-27,duke,@,Pittsburgh,L (45-54),27,43,62.8,396,4,34,223,6.6,2,77,619,8.0,19,8,1,28,4,36,1,0,1
9086,9,2018-11-03,duke,@,Miami (FL),W (20-12),19,37,51.4,144,1,30,146,4.9,1,67,290,4.3,6,5,2,13,3,25,0,1,1
9087,10,2018-11-10,duke,,North Carolina,W (42-35),31,54,57.4,361,3,35,268,7.7,3,89,629,7.1,15,10,4,29,6,40,2,1,3
9088,11,2018-11-17,duke,@,Clemson,L (6-35),24,44,54.5,158,0,35,104,3.0,0,79,262,3.3,5,10,2,17,6,52,0,0,0
9089,,11 Games,duke,,,,229,396,57.8,2614,25,407,1846,4.5,16,803,4460,5.6,113,100,16,229,47,397,7,6,13
9090,1,2016-10-29,samford,@,Mississippi State,L (41-56),42,70,60.0,468,4,34,159,4.7,1,104,627,6.0,20,7,0,27,9,77,0,3,3
9091,1,2017-09-16,samford,@,Georgia,L (14-42),26,35,74.3,227,2,23,22,1.0,0,58,249,4.3,11,4,1,16,3,17,1,0,1
9092,1,2018-09-08,samford,@,Florida State,L (26-36),39,60,65.0,475,2,19,50,2.6,1,79,525,6.6,18,2,3,23,5,51,1,4,5
9093,1,2016-09-03,virginia-military-institute,@,Akron,L (24-47),28,37,75.7,300,2,45,86,1.9,1,82,386,4.7,10,6,4,20,5,53,0,0,0
9094,1,2017-09-02,virginia-military-institute,@,Air Force,L (0-62),10,19,52.6,40,0,28,55,2.0,0,47,95,2.0,2,2,2,6,2,20,0,1,1
9095,1,2018-09-01,virginia-military-institute,@,Toledo,L (3-66),29,47,61.7,174,0,30,48,1.6,0,77,222,2.9,7,5,2,14,3,11,1,2,3
9096,2,2018-11-17,virginia-military-institute,@,Old Dominion,L (14-77),18,42,42.9,216,1,26,72,2.8,1,68,288,4.2,10,2,3,15,3,40,2,2,4
9097,,2 Games,virginia-military-institute,,,,47,89,52.8,390,1,56,120,2.1,1,145,510,3.5,17,7,5,29,6,51,3,4,7
9098,1,2014-08-30,texas-christian,,Samford,W (48-14),33,50,66.0,355,3,46,200,4.3,3,96,555,5.8,17,15,1,33,4,60,1,1,2
9099,2,2014-09-13,texas-christian,,Minnesota,W (30-7),27,46,58.7,258,2,27,169,6.3,1,73,427,5.8,13,8,1,22,8,72,1,1,2
9100,3,2014-09-27,texas-christian,@,Southern Methodist,W (56-0),28,43,65.1,349,5,38,265,7.0,3,81,614,7.6,18,12,1,31,5,48,0,0,0
9101,4,2014-10-04,texas-christian,,Oklahoma,W (37-33),20,39,51.3,318,2,39,151,3.9,2,78,469,6.0,12,8,3,23,12,90,2,1,3
9102,5,2014-10-11,texas-christian,@,Baylor,L (58-61),22,48,45.8,346,1,41,139,3.4,4,89,485,5.4,12,7,4,23,8,110,1,0,1
9103,6,2014-10-18,texas-christian,,Oklahoma State,W (42-9),27,42,64.3,415,3,40,261,6.5,3,82,676,8.2,12,13,1,26,5,45,0,1,1
9104,7,2014-10-25,texas-christian,,Texas Tech,W (82-27),27,45,60.0,480,7,41,305,7.4,3,86,785,9.1,16,13,3,32,10,77,0,0,0
9105,8,2014-11-01,texas-christian,@,West Virginia,W (31-30),12,30,40.0,166,1,42,223,5.3,3,72,389,5.4,5,11,0,16,5,40,1,1,2
9106,9,2014-11-08,texas-christian,,Kansas State,W (41-20),23,34,67.6,219,1,48,334,7.0,4,82,553,6.7,12,14,2,28,4,35,0,0,0
9107,10,2014-11-15,texas-christian,@,Kansas,W (34-30),26,36,72.2,330,1,36,133,3.7,2,72,463,6.4,13,10,1,24,5,40,2,1,3
9108,11,2014-11-27,texas-christian,@,Texas,W (48-10),20,34,58.8,233,2,31,135,4.4,2,65,368,5.7,10,5,1,16,6,45,1,1,2
9109,12,2014-12-06,texas-christian,,Iowa State,W (55-3),33,45,73.3,525,5,38,197,5.2,1,83,722,8.7,20,12,1,33,5,50,1,1,2
9110,13,2014-12-31,texas-christian,N,Mississippi*,W (42-3),27,37,73.0,246,4,42,177,4.2,1,79,423,5.4,13,11,0,24,5,55,1,3,4
9111,,13 Games,texas-christian,,,,325,529,61.4,4240,37,509,2689,5.3,32,1038,6929,6.7,173,139,19,331,82,767,11,11,22
9112,1,2015-09-03,texas-christian,@,Minnesota,W (23-17),26,42,61.9,246,1,44,203,4.6,1,86,449,5.2,13,10,2,25,9,50,1,1,2
9113,2,2015-09-12,texas-christian,,Stephen F. Austin,W (70-7),26,37,70.3,403,5,45,224,5.0,4,82,627,7.6,14,16,0,30,3,43,0,1,1
9114,3,2015-09-19,texas-christian,,Southern Methodist,W (56-37),21,30,70.0,454,5,41,266,6.5,3,71,720,10.1,16,12,0,28,9,115,0,1,1
9115,4,2015-09-26,texas-christian,@,Texas Tech,W (55-52),35,56,62.5,503,4,47,247,5.3,3,103,750,7.3,24,13,1,38,10,110,0,0,0
9116,5,2015-10-03,texas-christian,,Texas,W (50-7),22,38,57.9,376,6,42,228,5.4,0,80,604,7.6,18,12,1,31,8,84,0,0,0
9117,6,2015-10-10,texas-christian,@,Kansas State,W (52-45),20,30,66.7,301,2,23,242,10.5,4,53,543,10.2,13,7,2,22,11,81,0,2,2
9118,7,2015-10-17,texas-christian,@,Iowa State,W (45-21),28,34,82.4,444,4,41,177,4.3,2,75,621,8.3,20,7,3,30,7,75,1,0,1
9119,8,2015-10-29,texas-christian,,West Virginia,W (40-10),32,48,66.7,388,3,40,228,5.7,1,88,616,7.0,18,12,5,35,9,100,0,0,0
9120,9,2015-11-07,texas-christian,@,Oklahoma State,L (29-49),35,58,60.3,445,1,52,218,4.2,3,110,663,6.0,21,12,3,36,7,70,0,4,4
9121,10,2015-11-14,texas-christian,,Kansas,W (23-17),19,34,55.9,208,1,58,279,4.8,0,92,487,5.3,9,15,1,25,3,27,0,1,1
9122,11,2015-11-21,texas-christian,@,Oklahoma,L (29-30),13,29,44.8,229,3,36,161,4.5,1,65,390,6.0,5,9,2,16,2,19,1,3,4
9123,12,2015-11-27,texas-christian,,Baylor,W (28-21),18,33,54.5,148,2,46,154,3.3,1,79,302,3.8,5,8,2,15,8,65,1,1,2
9124,13,2016-01-02,texas-christian,N,Oregon*,W (47-41),30,47,63.8,371,2,47,174,3.7,3,94,545,5.8,14,12,1,27,8,83,0,1,1
9125,,13 Games,texas-christian,,,,325,516,63.0,4516,39,562,2801,5.0,26,1078,7317,6.8,190,145,23,358,94,922,4,15,19
9126,1,2016-09-03,texas-christian,,South Dakota State,W (59-41),33,50,66.0,439,2,37,223,6.0,5,87,662,7.6,22,11,2,35,12,125,0,2,2
9127,2,2016-09-10,texas-christian,,Arkansas,L (38-41),36,58,62.1,377,1,32,195,6.1,4,90,572,6.4,19,6,0,25,9,95,1,1,2
9128,3,2016-09-17,texas-christian,,Iowa State,W (41-20),22,35,62.9,252,1,37,229,6.2,4,72,481,6.7,12,8,2,22,5,50,0,0,0
9129,4,2016-09-23,texas-christian,@,Southern Methodist,W (33-3),32,47,68.1,452,2,31,137,4.4,1,78,589,7.6,16,8,1,25,8,65,0,1,1
9130,5,2016-10-01,texas-christian,,Oklahoma,L (46-52),26,45,57.8,449,5,29,65,2.2,1,74,514,6.9,14,4,1,19,9,64,0,1,1
9131,6,2016-10-08,texas-christian,@,Kansas,W (24-23),17,32,53.1,206,1,34,160,4.7,2,66,366,5.5,7,9,2,18,7,79,1,3,4
9132,7,2016-10-22,texas-christian,@,West Virginia,L (10-34),18,31,58.1,148,1,29,152,5.2,0,60,300,5.0,6,11,1,18,10,67,2,1,3
9133,8,2016-10-29,texas-christian,,Texas Tech,L (24-27),22,47,46.8,246,1,39,172,4.4,2,86,418,4.9,14,11,0,25,4,25,0,1,1
9134,9,2016-11-05,texas-christian,@,Baylor,W (62-22),18,31,58.1,257,1,59,431,7.3,6,90,688,7.6,9,21,4,34,7,55,0,0,0
9135,10,2016-11-19,texas-christian,,Oklahoma State,L (6-31),20,33,60.6,198,1,39,145,3.7,0,72,343,4.8,9,7,2,18,4,49,0,2,2
9136,11,2016-11-25,texas-christian,@,Texas,W (31-9),16,30,53.3,178,0,46,309,6.7,4,76,487,6.4,10,13,2,25,7,68,0,1,1
9137,12,2016-12-03,texas-christian,,Kansas State,L (6-30),17,36,47.2,138,0,37,142,3.8,0,73,280,3.8,5,8,2,15,4,45,0,1,1
9138,13,2016-12-30,texas-christian,N,Georgia*,L (23-31),18,28,64.3,146,2,39,175,4.5,1,67,321,4.8,7,8,2,17,2,10,2,0,2
9139,,13 Games,texas-christian,,,,295,503,58.6,3486,18,488,2535,5.2,30,991,6021,6.1,150,125,21,296,88,797,6,14,20
9140,1,2017-09-02,texas-christian,,Jackson State,W (63-0),23,30,76.7,300,6,36,242,6.7,1,66,542,8.2,11,13,0,24,5,51,0,1,1
9141,2,2017-09-09,texas-christian,@,Arkansas,W (28-7),21,31,67.7,166,0,42,195,4.6,4,73,361,4.9,8,15,1,24,6,60,1,1,2
9142,3,2017-09-16,texas-christian,,Southern Methodist,W (56-36),24,30,80.0,365,4,49,254,5.2,3,79,619,7.8,16,13,1,30,11,94,3,0,3
9143,4,2017-09-23,texas-christian,@,Oklahoma State,W (44-31),22,33,66.7,228,1,52,238,4.6,4,85,466,5.5,12,14,6,32,4,23,0,1,1
9144,5,2017-10-07,texas-christian,,West Virginia,W (31-24),16,29,55.2,236,2,36,170,4.7,2,65,406,6.2,9,7,0,16,5,51,0,0,0
9145,6,2017-10-14,texas-christian,@,Kansas State,W (26-6),27,37,73.0,297,0,36,98,2.7,3,73,395,5.4,11,5,1,17,7,51,1,0,1
9146,7,2017-10-21,texas-christian,,Kansas,W (43-0),20,28,71.4,284,5,42,191,4.5,0,70,475,6.8,11,10,1,22,7,55,0,0,0
9147,8,2017-10-28,texas-christian,@,Iowa State,L (7-14),12,25,48.0,135,0,34,172,5.1,0,59,307,5.2,7,6,1,14,11,104,1,2,3
9148,9,2017-11-04,texas-christian,,Texas,W (24-7),19,27,70.4,166,0,46,177,3.8,3,73,343,4.7,7,8,2,17,9,49,0,0,0
9149,10,2017-11-11,texas-christian,@,Oklahoma,L (20-38),14,29,48.3,269,1,32,155,4.8,2,61,424,7.0,7,10,2,19,7,60,0,0,0
9150,11,2017-11-18,texas-christian,@,Texas Tech,W (27-3),6,17,35.3,85,1,42,204,4.9,1,59,289,4.9,4,10,3,17,6,55,1,0,1
9151,12,2017-11-24,texas-christian,,Baylor,W (45-22),26,36,72.2,325,3,36,112,3.1,3,72,437,6.1,13,9,3,25,3,23,0,0,0
9152,13,2017-12-02,texas-christian,N,Oklahoma,L (17-41),27,37,73.0,234,2,24,83,3.5,0,61,317,5.2,14,5,1,20,7,70,1,1,2
9153,14,2017-12-28,texas-christian,N,Stanford*,W (39-37),28,41,68.3,341,3,26,147,5.7,1,67,488,7.3,13,8,0,21,1,4,1,2,3
9154,,14 Games,texas-christian,,,,285,430,66.3,3431,28,533,2438,4.6,27,963,5869,6.1,143,133,22,298,89,750,9,8,17
9155,1,2018-09-01,texas-christian,,Southern,W (55-7),21,32,65.6,264,4,42,235,5.6,2,74,499,6.7,16,12,2,30,5,48,0,0,0
9156,2,2018-09-07,texas-christian,@,Southern Methodist,W (42-12),15,28,53.6,146,1,42,247,5.9,3,70,393,5.6,5,17,1,23,4,35,1,1,2
9157,3,2018-09-15,texas-christian,N,Ohio State,L (28-40),24,40,60.0,308,1,36,203,5.6,3,76,511,6.7,13,8,1,22,5,40,1,2,3
9158,4,2018-09-22,texas-christian,@,Texas,L (16-31),20,39,51.3,231,1,32,141,4.4,0,71,372,5.2,9,7,0,16,3,30,1,3,4
9159,5,2018-09-29,texas-christian,,Iowa State,W (17-14),21,29,72.4,182,1,46,117,2.5,0,75,299,4.0,10,9,0,19,5,55,2,1,3
9160,6,2018-10-11,texas-christian,,Texas Tech,L (14-17),26,45,57.8,290,2,32,121,3.8,0,77,411,5.3,12,6,2,20,8,63,1,2,3
9161,7,2018-10-20,texas-christian,,Oklahoma,L (27-52),10,25,40.0,163,2,30,112,3.7,0,55,275,5.0,6,5,1,12,2,10,0,1,1
9162,8,2018-10-27,texas-christian,@,Kansas,L (26-27),23,33,69.7,351,1,39,153,3.9,2,72,504,7.0,17,7,3,27,5,57,1,1,2
9163,9,2018-11-03,texas-christian,,Kansas State,W (14-13),17,33,51.5,218,1,26,57,2.2,1,59,275,4.7,8,5,0,13,2,15,1,0,1
9164,10,2018-11-10,texas-christian,@,West Virginia,L (10-47),22,37,59.5,229,1,24,-7,-0.3,0,61,222,3.6,9,3,0,12,2,15,2,0,2
9165,11,2018-11-17,texas-christian,@,Baylor,W (16-9),15,21,71.4,151,1,42,160,3.8,1,63,311,4.9,4,10,0,14,8,80,0,0,0
9166,,11 Games,texas-christian,,,,214,362,59.1,2533,16,391,1539,3.9,12,753,4072,5.4,109,89,10,208,49,448,10,11,21
9167,1,2014-08-28,vanderbilt,,Temple,L (7-37),16,34,47.1,224,0,29,54,1.9,0,63,278,4.4,11,2,0,13,7,66,4,3,7
9168,2,2014-09-06,vanderbilt,N,Mississippi,L (3-41),6,25,24.0,60,0,25,107,4.3,0,50,167,3.3,4,4,1,9,7,53,0,1,1
9169,3,2014-09-13,vanderbilt,,Massachusetts,W (34-31),16,23,69.6,150,1,40,160,4.0,2,63,310,4.9,8,8,1,17,9,77,0,1,1
9170,4,2014-09-20,vanderbilt,,South Carolina,L (34-48),15,25,60.0,223,2,30,156,5.2,0,55,379,6.9,8,9,1,18,7,75,1,1,2
9171,5,2014-09-27,vanderbilt,@,Kentucky,L (7-17),8,25,32.0,85,0,22,54,2.5,0,47,139,3.0,4,3,1,8,2,10,0,3,3
9172,6,2014-10-04,vanderbilt,@,Georgia,L (17-44),16,31,51.6,188,0,36,132,3.7,2,67,320,4.8,7,8,0,15,4,29,0,1,1
9173,7,2014-10-11,vanderbilt,,Charleston Southern,W (21-20),15,23,65.2,189,1,31,106,3.4,1,54,295,5.5,5,5,1,11,10,85,0,1,1
9174,8,2014-10-25,vanderbilt,@,Missouri,L (14-24),17,31,54.8,196,2,27,44,1.6,0,58,240,4.1,10,3,5,18,5,41,0,1,1
9175,9,2014-11-01,vanderbilt,,Old Dominion,W (42-28),20,29,69.0,281,5,56,243,4.3,1,85,524,6.2,12,17,4,33,4,38,2,0,2
9176,10,2014-11-08,vanderbilt,,Florida,L (10-34),21,45,46.7,225,1,24,83,3.5,0,69,308,4.5,11,4,2,17,6,49,2,2,4
9177,11,2014-11-22,vanderbilt,@,Mississippi State,L (0-51),17,36,47.2,179,0,27,49,1.8,0,63,228,3.6,7,5,3,15,5,57,1,2,3
9178,12,2014-11-29,vanderbilt,,Tennessee,L (17-24),13,30,43.3,149,1,36,123,3.4,1,66,272,4.1,6,10,3,19,7,50,0,3,3
9179,,12 Games,vanderbilt,,,,180,357,50.4,2149,13,383,1311,3.4,7,740,3460,4.7,93,78,22,193,73,630,10,19,29
9180,1,2015-09-03,vanderbilt,,Western Kentucky,L (12-14),18,34,52.9,217,1,42,176,4.2,0,76,393,5.2,9,9,2,20,5,48,1,2,3
9181,2,2015-09-12,vanderbilt,,Georgia,L (14-31),24,50,48.0,295,1,39,105,2.7,0,89,400,4.5,12,6,3,21,4,20,0,3,3
9182,3,2015-09-19,vanderbilt,,Austin Peay,W (47-7),30,39,76.9,394,2,35,147,4.2,4,74,541,7.3,17,9,0,26,7,50,1,1,2
9183,4,2015-09-26,vanderbilt,@,Mississippi,L (16-27),23,42,54.8,194,1,43,128,3.0,0,85,322,3.8,9,8,4,21,8,43,0,0,0
9184,5,2015-10-03,vanderbilt,@,Middle Tennessee State,W (17-13),18,31,58.1,177,0,41,237,5.8,2,72,414,5.8,10,8,0,18,6,40,1,2,3
9185,6,2015-10-17,vanderbilt,@,South Carolina,L (10-19),21,42,50.0,177,1,35,155,4.4,0,77,332,4.3,9,10,1,20,6,53,2,3,5
9186,7,2015-10-24,vanderbilt,,Missouri,W (10-3),17,28,60.7,136,0,49,168,3.4,1,77,304,3.9,8,9,1,18,5,59,1,0,1
9187,8,2015-10-31,vanderbilt,@,Houston,L (0-34),5,20,25.0,44,0,42,141,3.4,0,62,185,3.0,2,10,0,12,6,39,1,3,4
9188,9,2015-11-07,vanderbilt,@,Florida,L (7-9),3,14,21.4,30,0,48,145,3.0,1,62,175,2.8,0,8,3,11,7,45,0,0,0
9189,10,2015-11-14,vanderbilt,,Kentucky,W (21-17),13,26,50.0,166,2,42,135,3.2,0,68,301,4.4,7,6,0,13,3,25,2,0,2
9190,11,2015-11-21,vanderbilt,,Texas A&M,L (0-25),5,16,31.3,23,0,44,125,2.8,0,60,148,2.5,0,8,2,10,7,68,0,1,1
9191,12,2015-11-28,vanderbilt,@,Tennessee,L (28-53),15,34,44.1,209,3,36,202,5.6,1,70,411,5.9,11,8,2,21,9,84,0,1,1
9192,,12 Games,vanderbilt,,,,192,376,51.1,2062,11,496,1864,3.8,9,872,3926,4.5,94,99,18,211,73,574,9,16,25
9193,1,2016-09-01,vanderbilt,,South Carolina,L (10-13),8,23,34.8,73,0,42,169,4.0,1,65,242,3.7,4,9,1,14,5,33,0,0,0
9194,2,2016-09-10,vanderbilt,,Middle Tennessee State,W (47-24),15,28,53.6,113,1,45,231,5.1,5,73,344,4.7,6,12,2,20,4,40,1,0,1
9195,3,2016-09-17,vanderbilt,@,Georgia Tech,L (7-38),20,31,64.5,190,1,30,85,2.8,0,61,275,4.5,12,4,1,17,5,45,0,1,1
9196,4,2016-09-24,vanderbilt,@,Western Kentucky,W (31-30),18,29,62.1,279,1,42,110,2.6,3,71,389,5.5,10,5,4,19,5,51,0,1,1
9197,5,2016-10-01,vanderbilt,,Florida,L (6-13),12,32,37.5,118,0,37,147,4.0,0,69,265,3.8,8,10,3,21,6,47,1,2,3
9198,6,2016-10-08,vanderbilt,@,Kentucky,L (13-20),17,30,56.7,141,0,32,141,4.4,0,62,282,4.5,9,9,0,18,7,35,1,0,1
9199,7,2016-10-15,vanderbilt,@,Georgia,W (17-16),7,18,38.9,109,0,32,62,1.9,2,50,171,3.4,5,3,1,9,5,45,0,0,0
9200,8,2016-10-22,vanderbilt,,Tennessee State,W (35-17),15,24,62.5,143,1,42,358,8.5,4,66,501,7.6,9,16,3,28,5,63,0,0,0
9201,9,2016-11-05,vanderbilt,@,Auburn,L (16-23),24,38,63.2,221,1,33,120,3.6,0,71,341,4.8,15,6,1,22,5,26,0,1,1
9202,10,2016-11-12,vanderbilt,@,Missouri,L (17-26),17,30,56.7,252,0,43,159,3.7,2,73,411,5.6,10,7,1,18,7,80,0,2,2
9203,11,2016-11-19,vanderbilt,,Mississippi,W (38-17),17,30,56.7,273,2,46,208,4.5,3,76,481,6.3,12,9,1,22,5,40,1,0,1
9204,12,2016-11-26,vanderbilt,,Tennessee,W (45-34),21,35,60.0,416,2,38,192,5.1,4,73,608,8.3,18,8,1,27,4,30,0,1,1
9205,13,2016-12-26,vanderbilt,N,North Carolina State*,L (17-41),19,46,41.3,158,0,35,156,4.5,2,81,314,3.9,11,7,0,18,4,40,0,3,3
9206,,13 Games,vanderbilt,,,,210,394,53.3,2486,9,497,2138,4.3,26,891,4624,5.2,129,105,19,253,67,575,4,11,15
9207,1,2017-09-02,vanderbilt,@,Middle Tennessee State,W (28-6),20,28,71.4,296,3,35,76,2.2,1,63,372,5.9,10,5,0,15,6,69,0,0,0
9208,2,2017-09-09,vanderbilt,,Alabama A&M,W (42-0),19,26,73.1,227,4,35,174,5.0,2,61,401,6.6,10,8,0,18,4,40,0,0,0
9209,3,2017-09-16,vanderbilt,,Kansas State,W (14-7),14,23,60.9,205,1,32,65,2.0,1,55,270,4.9,9,2,0,11,5,50,1,0,1
9210,4,2017-09-23,vanderbilt,,Alabama,L (0-59),7,22,31.8,38,0,16,40,2.5,0,38,78,2.1,1,1,1,3,5,20,1,1,2
9211,5,2017-09-30,vanderbilt,@,Florida,L (24-38),18,40,45.0,264,3,20,46,2.3,0,60,310,5.2,13,3,1,17,4,38,0,0,0
9212,6,2017-10-07,vanderbilt,,Georgia,L (14-45),17,31,54.8,172,1,22,64,2.9,1,53,236,4.5,8,3,0,11,5,25,0,0,0
9213,7,2017-10-14,vanderbilt,@,Mississippi,L (35-57),18,37,48.6,229,3,37,188,5.1,2,74,417,5.6,13,7,1,21,6,52,1,1,2
9214,8,2017-10-28,vanderbilt,@,South Carolina,L (27-34),27,49,55.1,333,4,23,107,4.7,0,72,440,6.1,15,8,4,27,10,100,0,1,1
9215,9,2017-11-04,vanderbilt,,Western Kentucky,W (31-17),14,21,66.7,220,2,35,174,5.0,2,56,394,7.0,12,7,0,19,6,54,1,0,1
9216,10,2017-11-11,vanderbilt,,Kentucky,L (21-44),30,43,69.8,308,1,20,60,3.0,2,63,368,5.8,15,3,3,21,4,48,0,4,4
9217,11,2017-11-18,vanderbilt,,Missouri,L (17-45),28,52,53.8,348,1,30,51,1.7,1,82,399,4.9,16,5,4,25,6,45,0,3,3
9218,12,2017-11-25,vanderbilt,@,Tennessee,W (42-24),20,31,64.5,283,4,43,246,5.7,2,74,529,7.1,16,15,2,33,8,60,0,0,0
9219,,12 Games,vanderbilt,,,,232,403,57.6,2923,27,348,1291,3.7,14,751,4214,5.6,138,67,16,221,69,601,4,10,14
9220,1,2018-09-01,vanderbilt,,Middle Tennessee State,W (35-7),10,17,58.8,170,2,37,177,4.8,2,54,347,6.4,8,10,1,19,7,49,0,0,0
9221,2,2018-09-08,vanderbilt,,Nevada,W (41-10),24,34,70.6,270,2,39,198,5.1,3,73,468,6.4,13,9,3,25,6,44,2,0,2
9222,3,2018-09-15,vanderbilt,@,Notre Dame,L (17-22),26,43,60.5,326,1,27,94,3.5,1,70,420,6.0,14,5,4,23,5,60,2,1,3
9223,4,2018-09-22,vanderbilt,,South Carolina,L (14-37),19,40,47.5,192,1,33,92,2.8,1,73,284,3.9,11,9,2,22,4,21,1,1,2
9224,5,2018-09-29,vanderbilt,,Tennessee State,W (31-27),22,30,73.3,297,3,34,256,7.5,1,64,553,8.6,13,8,2,23,2,15,0,2,2
9225,6,2018-10-06,vanderbilt,@,Georgia,L (13-41),16,30,53.3,183,0,29,138,4.8,1,59,321,5.4,9,6,3,18,9,69,0,0,0
9226,7,2018-10-13,vanderbilt,,Florida,L (27-37),18,36,50.0,229,2,22,107,4.9,1,58,336,5.8,9,3,5,17,5,28,0,1,1
9227,8,2018-10-20,vanderbilt,@,Kentucky,L (7-14),15,23,65.2,216,1,31,68,2.2,0,54,284,5.3,7,4,1,12,5,25,2,0,2
9228,9,2018-10-27,vanderbilt,@,Arkansas,W (45-31),13,19,68.4,192,2,49,250,5.1,4,68,442,6.5,8,15,2,25,7,60,0,0,0
9229,10,2018-11-10,vanderbilt,@,Missouri,L (28-33),24,36,66.7,249,3,29,216,7.4,1,65,465,7.2,10,9,0,19,5,45,0,0,0
9230,11,2018-11-17,vanderbilt,,Mississippi,W (36-29),22,35,62.9,191,3,36,196,5.4,1,71,387,5.5,8,10,3,21,10,83,0,1,1
9231,,11 Games,vanderbilt,,,,209,343,60.9,2515,20,366,1792,4.9,16,709,4307,6.1,110,88,26,224,65,499,7,6,13
9232,1,2014-09-06,florida,,Eastern Michigan,W (65-0),33,47,70.2,396,3,39,259,6.6,4,86,655,7.6,12,13,2,27,10,100,0,0,0
9233,2,2014-09-13,florida,,Kentucky,W (36-30),25,44,56.8,295,3,50,237,4.7,1,94,532,5.7,13,14,1,28,8,78,0,1,1
9234,3,2014-09-20,florida,@,Alabama,L (21-42),9,28,32.1,93,1,27,107,4.0,1,55,200,3.6,5,5,1,11,5,36,1,2,3
9235,4,2014-10-04,florida,@,Tennessee,W (10-9),13,27,48.1,76,0,48,156,3.3,1,75,232,3.1,5,11,0,16,5,45,0,3,3
9236,5,2014-10-11,florida,,Louisiana State,L (27-30),14,25,56.0,183,1,32,123,3.8,1,57,306,5.4,4,8,1,13,4,34,1,2,3
9237,6,2014-10-18,florida,,Missouri,L (13-42),15,31,48.4,148,1,48,135,2.8,1,79,283,3.6,7,8,2,17,3,39,3,3,6
9238,7,2014-11-01,florida,N,Georgia,W (38-20),3,6,50.0,27,0,60,418,7.0,5,66,445,6.7,2,16,1,19,4,31,1,0,1
9239,8,2014-11-08,florida,@,Vanderbilt,W (34-10),13,22,59.1,215,0,50,214,4.3,4,72,429,6.0,10,9,0,19,10,82,0,0,0
9240,9,2014-11-15,florida,,South Carolina,L (20-23),5,11,45.5,60,1,49,218,4.4,1,60,278,4.6,2,10,3,15,10,75,1,0,1
9241,10,2014-11-22,florida,,Eastern Kentucky,W (52-3),13,23,56.5,326,5,38,104,2.7,2,61,430,7.0,11,6,0,17,5,45,1,0,1
9242,11,2014-11-29,florida,@,Florida State,L (19-24),13,32,40.6,169,1,33,113,3.4,0,65,282,4.3,9,3,1,13,10,105,0,2,2
9243,12,2015-01-03,florida,N,East Carolina*,W (28-20),13,28,46.4,171,2,43,168,3.9,1,71,339,4.8,6,8,1,15,6,40,2,1,3
9244,,12 Games,florida,,,,169,324,52.2,2159,18,517,2252,4.4,22,841,4411,5.2,86,111,13,210,80,710,10,14,24
9245,1,2015-09-05,florida,,New Mexico State,W (61-13),30,37,81.1,382,4,42,224,5.3,4,79,606,7.7,18,10,0,28,1,10,1,0,1
9246,2,2015-09-12,florida,,East Carolina,W (31-24),15,25,60.0,205,2,38,168,4.4,1,63,373,5.9,8,8,1,17,12,105,1,1,2
9247,3,2015-09-19,florida,@,Kentucky,W (14-9),13,22,59.1,125,0,37,120,3.2,2,59,245,4.2,7,8,1,16,10,61,0,1,1
9248,4,2015-09-26,florida,,Tennessee,W (28-27),23,43,53.5,283,2,28,109,3.9,2,71,392,5.5,13,4,0,17,4,25,0,1,1
9249,5,2015-10-03,florida,,Mississippi,W (38-10),24,29,82.8,271,4,34,84,2.5,1,63,355,5.6,13,4,1,18,6,51,0,0,0
9250,6,2015-10-10,florida,@,Missouri,W (21-3),20,33,60.6,208,0,44,129,2.9,2,77,337,4.4,13,7,3,23,4,30,0,0,0
9251,7,2015-10-17,florida,@,Louisiana State,L (28-35),17,32,53.1,271,2,31,55,1.8,1,63,326,5.2,10,5,0,15,6,45,0,0,0
9252,8,2015-10-31,florida,N,Georgia,W (27-3),8,19,42.1,155,1,48,258,5.4,2,67,413,6.2,4,11,0,15,8,74,1,0,1
9253,9,2015-11-07,florida,,Vanderbilt,W (9-7),13,26,50.0,165,0,34,93,2.7,1,60,258,4.3,7,5,0,12,8,61,3,1,4
9254,10,2015-11-14,florida,@,South Carolina,W (24-14),19,33,57.6,256,1,43,148,3.4,2,76,404,5.3,12,7,1,20,8,55,0,2,2
9255,11,2015-11-21,florida,,Florida Atlantic,W (20-14),8,17,47.1,122,2,43,143,3.3,1,60,265,4.4,6,6,1,13,5,43,1,1,2
9256,12,2015-11-28,florida,,Florida State,L (2-27),19,39,48.7,134,0,40,128,3.2,0,79,262,3.3,5,13,1,19,7,60,0,0,0
9257,13,2015-12-05,florida,N,Alabama,L (15-29),9,24,37.5,165,1,21,15,0.7,0,45,180,4.0,6,1,0,7,5,51,0,1,1
9258,14,2016-01-01,florida,N,Michigan*,L (7-41),10,25,40.0,155,1,27,118,4.4,0,52,273,5.3,7,7,0,14,7,66,0,2,2
9259,,14 Games,florida,,,,228,404,56.4,2897,20,510,1792,3.5,19,914,4689,5.1,129,96,9,234,91,737,7,10,17
9260,1,2016-09-03,florida,,Massachusetts,W (24-7),29,44,65.9,256,2,29,107,3.7,0,73,363,5.0,14,7,0,21,8,80,0,0,0
9261,2,2016-09-10,florida,,Kentucky,W (45-7),19,33,57.6,320,4,50,244,4.9,2,83,564,6.8,15,13,0,28,6,75,0,1,1
9262,3,2016-09-17,florida,,North Texas,W (32-0),16,29,55.2,216,0,43,255,5.9,4,72,471,6.5,10,11,5,26,11,97,0,1,1
9263,4,2016-09-24,florida,@,Tennessee,L (28-38),23,39,59.0,296,3,31,106,3.4,1,70,402,5.7,10,6,1,17,9,75,1,1,2
9264,5,2016-10-01,florida,@,Vanderbilt,W (13-6),19,28,67.9,144,0,35,92,2.6,1,63,236,3.7,7,6,2,15,4,45,1,0,1
9265,6,2016-10-15,florida,,Missouri,W (40-14),18,38,47.4,236,1,39,287,7.4,1,77,523,6.8,12,10,0,22,11,65,1,3,4
9266,7,2016-10-29,florida,N,Georgia,W (24-10),15,25,60.0,131,1,48,100,2.1,2,73,231,3.2,8,9,3,20,6,45,0,1,1
9267,8,2016-11-05,florida,@,Arkansas,L (10-31),19,37,51.4,229,0,14,12,0.9,0,51,241,4.7,11,1,1,13,3,34,0,2,2
9268,9,2016-11-12,florida,,South Carolina,W (20-7),17,21,81.0,201,2,37,171,4.6,0,58,372,6.4,11,7,0,18,10,80,2,1,3
9269,10,2016-11-19,florida,@,Louisiana State,W (16-10),7,17,41.2,144,1,35,126,3.6,0,52,270,5.2,3,10,1,14,1,5,0,0,0
9270,11,2016-11-26,florida,@,Florida State,L (13-31),19,35,54.3,149,0,29,58,2.0,0,64,207,3.2,6,7,1,14,4,44,2,0,2
9271,12,2016-12-03,florida,N,Alabama,L (16-54),26,39,66.7,261,2,30,0,0.0,0,69,261,3.8,13,2,1,16,7,53,0,3,3
9272,13,2017-01-02,florida,N,Iowa*,W (30-3),14,25,56.0,222,2,32,109,3.4,0,57,331,5.8,5,6,0,11,8,60,0,2,2
9273,,13 Games,florida,,,,241,410,58.8,2805,18,452,1667,3.7,11,862,4472,5.2,125,95,15,235,88,758,7,15,22
9274,1,2017-09-02,florida,N,Michigan,L (17-33),14,26,53.8,181,0,27,11,0.4,0,53,192,3.6,6,2,1,9,5,45,3,0,3
9275,2,2017-09-16,florida,,Tennessee,W (26-20),18,28,64.3,212,2,29,168,5.8,0,57,380,6.7,8,6,0,14,8,38,2,1,3
9276,3,2017-09-23,florida,@,Kentucky,W (28-27),17,27,63.0,209,2,36,186,5.2,2,63,395,6.3,10,9,1,20,8,72,0,1,1
9277,4,2017-09-30,florida,,Vanderbilt,W (38-24),17,26,65.4,249,0,51,218,4.3,5,77,467,6.1,9,11,3,23,9,64,0,0,0
9278,5,2017-10-07,florida,,Louisiana State,L (16-17),10,16,62.5,108,0,38,194,5.1,2,54,302,5.6,6,8,2,16,6,48,0,0,0
9279,6,2017-10-14,florida,,Texas A&M,L (17-19),18,27,66.7,135,1,41,236,5.8,1,68,371,5.5,6,11,0,17,6,44,0,2,2
9280,7,2017-10-28,florida,N,Georgia,L (7-42),10,25,40.0,66,0,41,183,4.5,1,66,249,3.8,6,9,0,15,14,85,1,1,2
9281,8,2017-11-04,florida,@,Missouri,L (16-45),20,29,69.0,256,1,31,93,3.0,0,60,349,5.8,12,3,2,17,11,84,1,1,2
9282,9,2017-11-11,florida,@,South Carolina,L (20-28),17,39,43.6,223,0,22,78,3.5,2,61,301,4.9,8,3,1,12,10,56,2,1,3
9283,10,2017-11-18,florida,,Alabama-Birmingham,W (36-7),15,30,50.0,152,2,50,257,5.1,1,80,409,5.1,11,14,0,25,6,60,0,0,0
9284,11,2017-11-25,florida,,Florida State,L (22-38),18,39,46.2,184,2,34,96,2.8,1,73,280,3.8,10,7,0,17,4,50,1,3,4
9285,,11 Games,florida,,,,174,312,55.8,1975,10,400,1720,4.3,15,712,3695,5.2,92,83,10,185,87,646,10,10,20
9286,1,2018-09-01,florida,,Charleston Southern,W (53-6),19,27,70.4,241,5,39,203,5.2,1,66,444,6.7,12,12,1,25,3,20,0,0,0
9287,2,2018-09-08,florida,,Kentucky,L (16-27),17,38,44.7,232,2,29,128,4.4,0,67,360,5.4,14,5,5,24,6,55,1,1,2
9288,3,2018-09-15,florida,,Colorado State,W (48-10),8,15,53.3,119,2,29,222,7.7,2,44,341,7.8,3,10,1,14,8,75,0,1,1
9289,4,2018-09-22,florida,@,Tennessee,W (47-21),10,19,52.6,186,3,34,201,5.9,3,53,387,7.3,6,7,1,14,10,79,1,0,1
9290,5,2018-09-29,florida,@,Mississippi State,W (13-6),23,32,71.9,239,1,34,118,3.5,0,66,357,5.4,13,7,0,20,11,90,0,1,1
9291,6,2018-10-06,florida,,Louisiana State,W (27-19),13,28,46.4,176,1,43,215,5.0,2,71,391,5.5,6,11,2,19,11,115,0,1,1
9292,7,2018-10-13,florida,@,Vanderbilt,W (37-27),19,29,65.5,284,2,63,292,4.6,2,92,576,6.3,13,18,0,31,7,89,2,1,3
9293,8,2018-10-27,florida,N,Georgia,L (17-36),13,21,61.9,105,1,37,170,4.6,1,58,275,4.7,5,9,2,16,7,27,2,1,3
9294,9,2018-11-03,florida,,Missouri,L (17-38),19,40,47.5,210,1,28,113,4.0,1,68,323,4.8,8,7,2,17,8,66,0,0,0
9295,10,2018-11-10,florida,,South Carolina,W (35-31),15,21,71.4,161,1,62,367,5.9,4,83,528,6.4,11,22,0,33,7,55,1,0,1
9296,11,2018-11-17,florida,,Idaho,W (63-10),31,43,72.1,399,5,35,204,5.8,2,78,603,7.7,16,15,1,32,5,55,1,0,1
9297,,11 Games,florida,,,,187,313,59.7,2352,24,433,2233,5.2,18,746,4585,6.1,107,123,15,245,83,726,8,6,14
9298,1,2014-08-30,auburn,,Arkansas,W (45-21),16,22,72.7,293,2,48,302,6.3,3,70,595,8.5,11,15,1,27,7,71,1,0,1
9299,2,2014-09-06,auburn,,San Jose State,W (59-13),13,23,56.5,135,1,50,358,7.2,6,73,493,6.8,6,18,2,26,5,45,2,0,2
9300,3,2014-09-18,auburn,@,Kansas State,W (20-14),17,31,54.8,231,2,45,128,2.8,0,76,359,4.7,15,7,0,22,6,46,0,1,1
9301,4,2014-09-27,auburn,,Louisiana Tech,W (45-17),14,22,63.6,219,4,48,254,5.3,1,70,473,6.8,9,14,0,23,5,51,0,0,0
9302,5,2014-10-04,auburn,,Louisiana State,W (41-7),17,25,68.0,268,2,49,298,6.1,3,74,566,7.6,9,15,1,25,7,80,1,0,1
9303,6,2014-10-11,auburn,@,Mississippi State,L (23-38),17,35,48.6,209,2,43,232,5.4,0,78,441,5.7,9,15,1,25,6,56,2,2,4
9304,7,2014-10-25,auburn,,South Carolina,W (42-35),13,15,86.7,156,1,47,395,8.4,5,62,551,8.9,9,16,0,25,4,53,1,0,1
9305,8,2014-11-01,auburn,@,Mississippi,W (35-31),15,22,68.2,254,2,46,248,5.4,3,68,502,7.4,10,12,0,22,13,145,0,1,1
9306,9,2014-11-08,auburn,,Texas A&M,L (38-41),15,21,71.4,219,1,59,363,6.2,4,80,582,7.3,11,18,2,31,8,65,3,0,3
9307,10,2014-11-15,auburn,@,Georgia,L (7-34),15,28,53.6,142,0,35,150,4.3,1,63,292,4.6,9,8,0,17,7,78,2,1,3
9308,11,2014-11-22,auburn,,Samford,W (31-7),13,22,59.1,186,1,47,200,4.3,3,69,386,5.6,7,14,1,22,8,76,0,1,1
9309,12,2014-11-29,auburn,@,Alabama,L (44-55),27,43,62.8,456,3,47,174,3.7,1,90,630,7.0,18,9,1,28,7,55,1,1,2
9310,13,2015-01-01,auburn,N,Wisconsin*,L (31-34),16,23,69.6,216,2,43,219,5.1,2,66,435,6.6,9,11,1,21,9,75,0,0,0
9311,,13 Games,auburn,,,,208,332,62.7,2984,23,607,3321,5.5,32,939,6305,6.7,132,172,10,314,92,896,13,7,20
9312,1,2015-09-05,auburn,N,Louisville,W (31-24),11,21,52.4,137,1,41,190,4.6,2,62,327,5.3,8,11,2,21,8,80,0,3,3
9313,2,2015-09-12,auburn,,Jacksonville State,W (27-20),21,32,65.6,236,2,38,165,4.3,1,70,401,5.7,13,10,0,23,3,40,1,2,3
9314,3,2015-09-19,auburn,@,Louisiana State,L (21-45),11,19,57.9,100,2,37,160,4.3,1,56,260,4.6,5,10,1,16,4,26,1,1,2
9315,4,2015-09-26,auburn,,Mississippi State,L (9-17),20,28,71.4,188,0,50,201,4.0,0,78,389,5.0,9,16,0,25,6,40,0,1,1
9316,5,2015-10-03,auburn,,San Jose State,W (35-21),6,10,60.0,108,0,48,234,4.9,5,58,342,5.9,3,12,0,15,1,15,0,0,0
9317,6,2015-10-15,auburn,@,Kentucky,W (30-27),17,28,60.7,255,0,47,152,3.2,3,75,407,5.4,11,9,1,21,5,49,0,0,0
9318,7,2015-10-24,auburn,@,Arkansas,L (46-54),19,34,55.9,254,0,52,162,3.1,6,86,416,4.8,13,8,1,22,2,25,0,0,0
9319,8,2015-10-31,auburn,,Mississippi,L (19-27),13,32,40.6,302,1,41,125,3.0,0,73,427,5.8,10,8,0,18,3,20,0,1,1
9320,9,2015-11-07,auburn,@,Texas A&M,W (26-10),13,17,76.5,132,1,52,311,6.0,1,69,443,6.4,4,16,0,20,6,78,0,0,0
9321,10,2015-11-14,auburn,,Georgia,L (13-20),15,27,55.6,62,0,37,213,5.8,1,64,275,4.3,1,14,1,16,2,16,2,1,3
9322,11,2015-11-21,auburn,,Idaho,W (56-34),13,19,68.4,163,2,51,297,5.8,5,70,460,6.6,9,14,2,25,11,107,0,0,0
9323,12,2015-11-28,auburn,,Alabama,L (13-29),10,23,43.5,169,1,37,91,2.5,0,60,260,4.3,4,6,2,12,8,62,1,0,1
9324,13,2015-12-30,auburn,N,Memphis*,W (31-10),10,16,62.5,150,1,56,252,4.5,3,72,402,5.6,7,16,0,23,3,45,0,3,3
9325,,13 Games,auburn,,,,179,306,58.5,2256,11,587,2553,4.3,28,893,4809,5.4,97,150,10,257,62,603,5,12,17
9326,1,2016-09-03,auburn,,Clemson,L (13-19),15,28,53.6,175,0,41,87,2.1,1,69,262,3.8,8,6,3,17,9,60,1,2,3
9327,2,2016-09-10,auburn,,Arkansas State,W (51-14),17,23,73.9,244,3,62,462,7.5,3,85,706,8.3,10,20,2,32,5,40,1,0,1
9328,3,2016-09-17,auburn,,Texas A&M,L (16-29),22,35,62.9,163,0,54,236,4.4,2,89,399,4.5,9,14,3,26,6,28,1,0,1
9329,4,2016-09-24,auburn,,Louisiana State,W (18-13),19,26,73.1,234,0,49,154,3.1,0,75,388,5.2,10,7,1,18,4,28,1,0,1
9330,5,2016-10-01,auburn,,Louisiana-Monroe,W (58-7),15,18,83.3,278,3,66,410,6.2,5,84,688,8.2,11,23,2,36,3,15,1,0,1
9331,6,2016-10-08,auburn,@,Mississippi State,W (38-14),14,18,77.8,204,1,56,228,4.1,3,74,432,5.8,10,10,2,22,5,40,1,1,2
9332,7,2016-10-22,auburn,,Arkansas,W (56-3),7,12,58.3,89,1,57,543,9.5,7,69,632,9.2,4,22,0,26,2,10,0,0,0
9333,8,2016-10-29,auburn,@,Mississippi,W (40-29),15,22,68.2,247,1,52,307,5.9,3,74,554,7.5,12,14,0,26,4,30,0,0,0
9334,9,2016-11-05,auburn,,Vanderbilt,W (23-16),12,17,70.6,115,1,45,271,6.0,1,62,386,6.2,4,11,1,16,5,56,1,0,1
9335,10,2016-11-12,auburn,@,Georgia,L (7-13),8,22,36.4,37,0,32,127,4.0,1,54,164,3.0,2,8,0,10,3,36,0,1,1
9336,11,2016-11-19,auburn,,Alabama A&M,W (55-0),14,20,70.0,147,1,59,451,7.6,6,79,598,7.6,7,19,1,27,5,50,1,0,1
9337,12,2016-11-26,auburn,@,Alabama,L (12-30),7,19,36.8,116,0,26,66,2.5,0,45,182,4.0,3,4,0,7,4,19,0,1,1
9338,13,2017-01-02,auburn,N,Oklahoma*,L (19-35),13,27,48.1,154,1,46,185,4.0,1,73,339,4.6,7,14,1,22,6,63,0,1,1
9339,,13 Games,auburn,,,,178,287,62.0,2203,12,645,3527,5.5,33,932,5730,6.1,97,172,16,285,61,475,8,6,14
9340,1,2017-09-02,auburn,,Georgia Southern,W (41-7),15,26,57.7,184,2,53,351,6.6,3,79,535,6.8,10,15,0,25,4,42,2,1,3
9341,2,2017-09-09,auburn,@,Clemson,L (6-14),13,24,54.2,79,0,42,38,0.9,0,66,117,1.8,2,9,2,13,5,43,0,0,0
9342,3,2017-09-16,auburn,,Mercer,W (24-10),32,37,86.5,364,0,43,146,3.4,3,80,510,6.4,16,8,2,26,6,65,4,1,5
9343,4,2017-09-23,auburn,@,Missouri,W (51-14),16,21,76.2,219,1,53,263,5.0,5,74,482,6.5,7,12,3,22,5,50,0,0,0
9344,5,2017-09-30,auburn,,Mississippi State,W (49-10),14,17,82.4,267,2,39,244,6.3,4,56,511,9.1,5,8,1,14,1,15,2,0,2
9345,6,2017-10-07,auburn,,Mississippi,W (44-23),14,21,66.7,235,2,51,326,6.4,3,72,561,7.8,8,15,2,25,3,30,0,0,0
9346,7,2017-10-14,auburn,@,Louisiana State,L (23-27),9,26,34.6,165,1,44,189,4.3,1,70,354,5.1,5,9,3,17,6,26,0,0,0
9347,8,2017-10-21,auburn,@,Arkansas,W (52-20),21,30,70.0,284,2,47,345,7.3,5,77,629,8.2,8,17,1,26,3,25,1,1,2
9348,9,2017-11-04,auburn,@,Texas A&M,W (42-27),20,27,74.1,268,3,52,228,4.4,2,79,496,6.3,8,14,1,23,3,34,0,0,0
9349,10,2017-11-11,auburn,,Georgia,W (40-17),17,25,68.0,251,3,46,237,5.2,1,71,488,6.9,8,14,3,25,5,29,0,0,0
9350,11,2017-11-18,auburn,,Louisiana-Monroe,W (42-14),18,24,75.0,235,2,48,317,6.6,3,72,552,7.7,10,15,0,25,5,41,1,1,2
9351,12,2017-11-25,auburn,,Alabama,W (26-14),22,29,75.9,240,1,49,168,3.4,2,78,408,5.2,15,8,2,25,4,40,1,0,1
9352,13,2017-12-02,auburn,N,Georgia,L (7-28),16,32,50.0,145,1,31,114,3.7,0,63,259,4.1,7,9,2,18,5,39,2,0,2
9353,14,2018-01-01,auburn,N,Central Florida*,L (27-34),28,43,65.1,331,1,44,90,2.0,2,87,421,4.8,17,8,3,28,8,61,1,2,3
9354,,14 Games,auburn,,,,255,382,66.8,3267,21,642,3056,4.8,34,1024,6323,6.2,126,161,25,312,63,540,14,6,20
9355,1,2018-09-01,auburn,N,Washington,W (21-16),26,36,72.2,273,1,45,147,3.3,1,81,420,5.2,17,8,2,27,12,111,0,0,0
9356,2,2018-09-08,auburn,,Alabama State,W (63-9),8,14,57.1,138,1,59,429,7.3,6,73,567,7.8,4,22,2,28,4,30,4,0,4
9357,3,2018-09-15,auburn,,Louisiana State,L (21-22),16,28,57.1,198,1,38,130,3.4,2,66,328,5.0,10,5,4,19,9,111,0,2,2
9358,4,2018-09-22,auburn,,Arkansas,W (34-3),15,22,68.2,134,0,36,91,2.5,3,58,225,3.9,6,6,1,13,7,40,0,0,0
9359,5,2018-09-29,auburn,,Southern Mississippi,W (24-13),19,33,57.6,245,2,36,96,2.7,1,69,341,4.9,8,7,2,17,9,78,1,0,1
9360,6,2018-10-06,auburn,@,Mississippi State,L (9-23),19,38,50.0,214,0,21,90,4.3,0,59,304,5.2,9,5,1,15,2,10,2,0,2
9361,7,2018-10-13,auburn,,Tennessee,L (24-30),28,45,62.2,322,2,34,126,3.7,1,79,448,5.7,13,8,1,22,5,38,1,2,3
9362,8,2018-10-20,auburn,@,Mississippi,W (31-16),13,22,59.1,215,1,46,269,5.8,3,68,484,7.1,5,15,0,20,8,80,0,0,0
9363,9,2018-11-03,auburn,,Texas A&M,W (28-24),19,30,63.3,259,3,21,19,0.9,1,51,278,5.5,11,2,0,13,6,39,0,0,0
9364,10,2018-11-10,auburn,@,Georgia,L (10-27),25,37,67.6,172,1,20,102,5.1,0,57,274,4.8,10,6,3,19,6,52,0,0,0
9365,11,2018-11-17,auburn,,Liberty,W (53-0),14,21,66.7,191,2,61,340,5.6,3,82,531,6.5,8,22,0,29,3,25,0,0,0
9366,,11 Games,auburn,,,,202,326,62.0,2361,14,417,1839,4.4,21,743,4200,5.7,101,106,16,222,71,614,8,4,12
9367,1,2014-08-30,nebraska,,Florida Atlantic,W (55-7),17,35,48.6,286,2,57,498,8.7,5,92,784,8.5,11,24,0,35,6,60,0,0,0
9368,2,2014-09-06,nebraska,,McNeese State,W (31-24),16,31,51.6,242,2,33,195,5.9,2,64,437,6.8,9,7,1,17,5,40,0,1,1
9369,3,2014-09-13,nebraska,@,Fresno State,W (55-19),14,24,58.3,282,4,42,280,6.7,2,66,562,8.5,13,7,2,22,6,61,1,0,1
9370,4,2014-09-20,nebraska,,Miami (FL),W (41-31),9,13,69.2,113,2,54,343,6.4,2,67,456,6.8,5,17,5,27,7,69,1,1,2
9371,5,2014-09-27,nebraska,,Illinois,W (45-14),10,21,47.6,166,1,70,458,6.5,5,91,624,6.9,6,26,3,35,8,70,1,1,2
9372,6,2014-10-04,nebraska,@,Michigan State,L (22-27),21,45,46.7,282,0,37,47,1.3,2,82,329,4.0,12,5,3,20,6,48,2,2,4
9373,7,2014-10-18,nebraska,@,Northwestern,W (38-17),19,30,63.3,237,1,44,234,5.3,4,74,471,6.4,11,12,2,25,7,68,0,0,0
9374,8,2014-10-25,nebraska,,Rutgers,W (42-24),14,22,63.6,163,2,41,292,7.1,4,63,455,7.2,8,11,2,21,5,35,1,1,2
9375,9,2014-11-01,nebraska,,Purdue,W (35-14),8,21,38.1,118,1,51,179,3.5,4,72,297,4.1,6,10,1,17,3,30,1,2,3
9376,10,2014-11-15,nebraska,@,Wisconsin,L (24-59),6,18,33.3,62,1,46,118,2.6,2,64,180,2.8,3,7,2,12,7,55,4,1,5
9377,11,2014-11-22,nebraska,,Minnesota,L (24-28),12,20,60.0,223,1,38,174,4.6,1,58,397,6.8,7,10,1,18,3,25,2,0,2
9378,12,2014-11-28,nebraska,@,Iowa,W (37-34),12,28,42.9,202,4,31,161,5.2,0,59,363,6.2,8,4,1,13,5,49,0,2,2
9379,13,2014-12-27,nebraska,N,Southern California*,L (42-45),32,51,62.7,381,3,43,144,3.3,2,94,525,5.6,16,9,3,28,7,45,0,1,1
9380,,13 Games,nebraska,,,,190,359,52.9,2757,24,587,3123,5.3,35,946,5880,6.2,115,149,26,290,75,655,13,12,25
9381,1,2015-09-05,nebraska,,Brigham Young,L (28-33),24,41,58.5,319,3,37,126,3.4,1,78,445,5.7,16,9,0,25,12,90,1,1,2
9382,2,2015-09-12,nebraska,,South Alabama,W (48-9),26,38,68.4,303,3,37,258,7.0,3,75,561,7.5,16,14,1,31,7,80,0,1,1
9383,3,2015-09-19,nebraska,@,Miami (FL),L (33-36),21,45,46.7,309,4,32,153,4.8,0,77,462,6.0,12,8,4,24,12,98,0,3,3
9384,4,2015-09-26,nebraska,,Southern Mississippi,W (36-28),23,35,65.7,368,2,39,242,6.2,1,74,610,8.2,14,10,1,25,12,98,1,1,2
9385,5,2015-10-03,nebraska,@,Illinois,L (13-14),10,31,32.3,105,0,34,187,5.5,1,65,292,4.5,2,9,1,12,6,42,1,1,2
9386,6,2015-10-10,nebraska,,Wisconsin,L (21-23),11,28,39.3,129,1,37,196,5.3,2,65,325,5.0,7,5,1,13,9,89,1,0,1
9387,7,2015-10-17,nebraska,@,Minnesota,W (48-25),18,26,69.2,261,3,39,203,5.2,2,65,464,7.1,14,8,1,23,2,25,0,0,0
9388,8,2015-10-24,nebraska,,Northwestern,L (28-30),24,48,50.0,291,1,38,82,2.2,2,86,373,4.3,13,6,3,22,6,64,0,1,1
9389,9,2015-10-31,nebraska,@,Purdue,L (45-55),29,48,60.4,407,4,29,77,2.7,2,77,484,6.3,22,3,3,28,7,40,1,4,5
9390,10,2015-11-07,nebraska,,Michigan State,W (39-38),19,33,57.6,320,2,36,179,5.0,3,69,499,7.2,12,11,1,24,5,55,0,2,2
9391,11,2015-11-14,nebraska,@,Rutgers,W (31-14),14,21,66.7,188,3,38,174,4.6,1,59,362,6.1,8,7,1,16,2,15,0,3,3
9392,12,2015-11-27,nebraska,,Iowa,L (20-28),25,45,55.6,296,0,38,137,3.6,2,83,433,5.2,14,7,1,22,8,95,0,4,4
9393,13,2015-12-26,nebraska,N,UCLA*,W (37-29),12,19,63.2,174,1,62,326,5.3,4,81,500,6.2,10,17,4,31,6,38,1,0,1
9394,,13 Games,nebraska,,,,256,458,55.9,3470,27,496,2340,4.7,24,954,5810,6.1,160,114,22,296,94,829,6,21,27
9395,1,2016-09-03,nebraska,,Fresno State,W (43-10),6,13,46.2,114,1,51,292,5.7,5,64,406,6.3,4,15,1,20,7,80,0,0,0
9396,2,2016-09-10,nebraska,,Wyoming,W (52-17),21,35,60.0,412,4,43,138,3.2,2,78,550,7.1,17,5,3,25,7,93,0,1,1
9397,3,2016-09-17,nebraska,,Oregon,W (35-32),17,35,48.6,200,3,47,228,4.9,2,82,428,5.2,10,12,4,26,7,55,1,0,1
9398,4,2016-09-24,nebraska,@,Northwestern,W (24-13),18,29,62.1,246,1,47,310,6.6,2,76,556,7.3,12,12,2,26,4,60,2,0,2
9399,5,2016-10-01,nebraska,,Illinois,W (31-16),16,23,69.6,220,1,49,203,4.1,3,72,423,5.9,12,9,2,23,3,35,1,1,2
9400,6,2016-10-15,nebraska,@,Indiana,W (27-22),10,26,38.5,208,1,45,152,3.4,1,71,360,5.1,8,9,0,17,9,53,0,2,2
9401,7,2016-10-22,nebraska,,Purdue,W (27-14),17,31,54.8,252,1,36,158,4.4,2,67,410,6.1,11,10,1,22,7,67,0,1,1
9402,8,2016-10-29,nebraska,@,Wisconsin,L (17-23),12,31,38.7,153,0,44,152,3.5,2,75,305,4.1,9,7,0,16,2,10,0,2,2
9403,9,2016-11-05,nebraska,@,Ohio State,L (3-62),9,33,27.3,126,0,24,78,3.3,0,57,204,3.6,6,2,1,9,4,43,0,2,2
9404,10,2016-11-12,nebraska,,Minnesota,W (24-17),19,28,67.9,217,2,32,157,4.9,1,60,374,6.2,10,9,0,19,8,81,0,0,0
9405,11,2016-11-19,nebraska,,Maryland,W (28-7),23,37,62.2,220,1,45,181,4.0,3,82,401,4.9,13,11,4,28,2,20,0,0,0
9406,12,2016-11-25,nebraska,@,Iowa,L (10-40),14,37,37.8,127,1,31,90,2.9,0,68,217,3.2,8,6,3,17,8,57,0,0,0
9407,13,2016-12-30,nebraska,N,Tennessee*,L (24-38),19,42,45.2,257,2,28,61,2.2,1,70,318,4.5,12,5,1,18,7,41,1,0,1
9408,,13 Games,nebraska,,,,201,400,50.3,2752,18,522,2200,4.2,24,922,4952,5.4,132,112,22,266,75,695,5,9,14
9409,1,2017-09-02,nebraska,,Arkansas State,W (43-36),19,32,59.4,238,2,38,225,5.9,2,70,463,6.6,14,10,1,25,8,75,0,0,0
9410,2,2017-09-09,nebraska,@,Oregon,L (35-42),19,41,46.3,252,3,29,109,3.8,2,70,361,5.2,11,6,2,19,3,25,0,4,4
9411,3,2017-09-16,nebraska,,Northern Illinois,L (17-21),25,47,53.2,299,0,36,85,2.4,2,83,384,4.6,12,6,0,18,5,48,0,3,3
9412,4,2017-09-23,nebraska,,Rutgers,W (27-17),13,26,50.0,109,2,47,197,4.2,1,73,306,4.2,8,11,2,21,6,46,0,2,2
9413,5,2017-09-29,nebraska,@,Illinois,W (28-6),17,24,70.8,246,3,38,165,4.3,1,62,411,6.6,12,9,2,23,5,70,1,0,1
9414,6,2017-10-07,nebraska,,Wisconsin,L (17-38),18,35,51.4,271,1,26,110,4.2,0,61,381,6.2,10,5,1,16,4,35,1,1,2
9415,7,2017-10-14,nebraska,,Ohio State,L (14-56),27,47,57.4,349,2,16,44,2.8,0,63,393,6.2,12,2,0,14,12,104,0,1,1
9416,8,2017-10-28,nebraska,@,Purdue,W (25-24),32,50,64.0,431,2,27,40,1.5,0,77,471,6.1,16,5,4,25,9,95,0,0,0
9417,9,2017-11-04,nebraska,,Northwestern,L (24-31),21,38,55.3,225,2,31,112,3.6,0,69,337,4.9,12,7,2,21,7,68,0,3,3
9418,10,2017-11-11,nebraska,@,Minnesota,L (21-54),25,36,69.4,311,1,33,69,2.1,2,69,380,5.5,13,5,2,20,4,54,0,0,0
9419,11,2017-11-18,nebraska,@,Penn State,L (44-56),26,41,63.4,399,2,26,67,2.6,3,67,466,7.0,16,4,1,21,9,89,0,0,0
9420,12,2017-11-24,nebraska,,Iowa,L (14-56),23,42,54.8,200,2,21,67,3.2,0,63,267,4.2,9,3,0,12,3,19,0,3,3
9421,,12 Games,nebraska,,,,265,459,57.7,3330,22,368,1290,3.5,13,827,4620,5.6,145,73,17,235,75,728,2,17,19
9422,1,2018-09-08,nebraska,,Colorado,L (28-33),19,29,65.5,236,1,54,329,6.1,3,83,565,6.8,9,13,3,25,11,95,2,1,3
9423,2,2018-09-15,nebraska,,Troy,L (19-24),19,27,70.4,177,2,48,187,3.9,0,75,364,4.9,7,12,3,22,10,77,1,2,3
9424,3,2018-09-22,nebraska,@,Michigan,L (10-56),13,24,54.2,93,0,30,39,1.3,1,54,132,2.4,4,5,3,12,10,79,1,1,2
9425,4,2018-09-29,nebraska,,Purdue,L (28-42),25,42,59.5,323,2,39,259,6.6,2,81,582,7.2,16,14,1,31,11,136,0,1,1
9426,5,2018-10-06,nebraska,@,Wisconsin,L (24-41),26,44,59.1,407,2,24,111,4.6,1,68,518,7.6,17,7,2,26,10,100,1,0,1
9427,6,2018-10-13,nebraska,@,Northwestern,L (31-34),25,35,71.4,251,1,47,231,4.9,3,82,482,5.9,9,15,0,24,9,89,1,2,3
9428,7,2018-10-20,nebraska,,Minnesota,W (53-28),25,30,83.3,276,3,43,383,8.9,4,73,659,9.0,9,18,1,28,6,43,1,0,1
9429,8,2018-10-27,nebraska,,Bethune-Cookman,W (45-9),17,31,54.8,242,2,33,226,6.8,3,64,468,7.3,11,12,0,23,5,35,0,2,2
9430,9,2018-11-03,nebraska,@,Ohio State,L (31-36),22,33,66.7,266,1,49,184,3.8,3,82,450,5.5,14,11,2,27,5,44,1,0,1
9431,10,2018-11-10,nebraska,,Illinois,W (54-35),24,34,70.6,290,3,34,316,9.3,4,68,606,8.9,12,9,1,22,7,72,1,1,2
9432,11,2018-11-17,nebraska,,Michigan State,W (9-6),16,37,43.2,145,0,30,103,3.4,0,67,248,3.7,8,5,1,14,5,45,2,0,2
9433,,11 Games,nebraska,,,,231,366,63.1,2706,17,431,2368,5.5,24,797,5074,6.4,116,121,17,254,89,815,11,10,21
9434,1,2014-08-30,alabama,N,West Virginia,W (33-23),24,33,72.7,250,0,49,288,5.9,3,82,538,6.6,14,13,3,30,7,49,0,1,1
9435,2,2014-09-06,alabama,,Florida Atlantic,W (41-0),27,38,71.1,430,3,32,190,5.9,2,70,620,8.9,17,10,0,27,6,60,1,0,1
9436,3,2014-09-13,alabama,,Southern Mississippi,W (52-12),17,24,70.8,214,2,49,333,6.8,5,73,547,7.5,14,16,1,31,3,25,1,0,1
9437,4,2014-09-20,alabama,,Florida,W (42-21),24,35,68.6,449,5,52,223,4.3,1,87,672,7.7,13,13,2,28,11,80,3,1,4
9438,5,2014-10-04,alabama,@,Mississippi,L (17-23),19,31,61.3,228,0,44,168,3.8,1,75,396,5.3,13,7,0,20,8,52,1,1,2
9439,6,2014-10-11,alabama,@,Arkansas,W (14-13),11,21,52.4,161,2,32,66,2.1,0,53,227,4.3,6,3,1,10,4,30,2,0,2
9440,7,2014-10-18,alabama,,Texas A&M,W (59-0),21,35,60.0,304,4,45,298,6.6,4,80,602,7.5,15,14,1,30,0,0,0,0,0
9441,8,2014-10-25,alabama,@,Tennessee,W (34-20),14,24,58.3,286,2,41,183,4.5,3,65,469,7.2,10,11,2,23,6,50,2,0,2
9442,9,2014-11-08,alabama,@,Louisiana State,W (20-13),20,46,43.5,209,2,29,106,3.7,0,75,315,4.2,9,6,0,15,3,29,1,0,1
9443,10,2014-11-15,alabama,,Mississippi State,W (25-20),19,31,61.3,211,1,32,124,3.9,2,63,335,5.3,9,7,1,17,7,61,0,0,0
9444,11,2014-11-22,alabama,,Western Carolina,W (48-14),29,43,67.4,337,3,45,275,6.1,3,88,612,7.0,16,19,1,36,5,50,1,1,2
9445,12,2014-11-29,alabama,,Auburn,W (55-44),20,27,74.1,312,4,34,227,6.7,4,61,539,8.8,13,9,2,24,3,30,0,3,3
9446,13,2014-12-06,alabama,N,Missouri,W (42-13),23,27,85.2,262,2,49,242,4.9,4,76,504,6.6,13,14,1,28,2,10,0,0,0
9447,14,2015-01-01,alabama,N,Ohio State*,L (35-42),22,36,61.1,237,2,34,170,5.0,3,70,407,5.8,8,12,1,21,4,36,0,3,3
9448,,14 Games,alabama,,,,290,451,64.3,3890,32,567,2893,5.1,35,1018,6783,6.7,170,154,16,340,69,562,12,10,22
9449,1,2015-09-05,alabama,N,Wisconsin,W (35-17),22,29,75.9,264,1,37,238,6.4,4,66,502,7.6,14,12,1,27,11,120,0,0,0
9450,2,2015-09-12,alabama,,Middle Tennessee State,W (37-10),26,43,60.5,312,2,39,220,5.6,3,82,532,6.5,13,13,2,28,5,40,0,2,2
9451,3,2015-09-19,alabama,,Mississippi,L (37-43),32,59,54.2,288,3,42,215,5.1,2,101,503,5.0,14,11,4,29,4,36,2,3,5
9452,4,2015-09-26,alabama,,Louisiana-Monroe,W (34-0),18,32,56.3,166,3,35,137,3.9,1,67,303,4.5,8,8,1,17,7,72,0,1,1
9453,5,2015-10-03,alabama,@,Georgia,W (38-10),11,16,68.8,190,1,47,189,4.0,2,63,379,6.0,6,6,3,15,7,39,2,0,2
9454,6,2015-10-10,alabama,,Arkansas,W (27-14),24,33,72.7,262,2,46,134,2.9,1,79,396,5.0,8,12,2,22,6,56,0,2,2
9455,7,2015-10-17,alabama,@,Texas A&M,W (41-23),19,25,76.0,138,0,45,258,5.7,2,70,396,5.7,6,11,0,17,7,60,1,0,1
9456,8,2015-10-24,alabama,,Tennessee,W (19-14),21,27,77.8,247,0,42,117,2.8,2,69,364,5.3,12,10,1,23,7,64,0,1,1
9457,9,2015-11-07,alabama,,Louisiana State,W (30-16),18,24,75.0,184,0,55,250,4.5,3,79,434,5.5,12,14,2,28,9,88,1,0,1
9458,10,2015-11-14,alabama,@,Mississippi State,W (31-6),15,25,60.0,144,1,30,235,7.8,2,55,379,6.9,4,8,1,13,4,40,0,1,1
9459,11,2015-11-21,alabama,,Charleston Southern,W (56-6),19,25,76.0,208,2,35,195,5.6,4,60,403,6.7,10,13,0,23,2,30,0,0,0
9460,12,2015-11-28,alabama,@,Auburn,W (29-13),17,26,65.4,179,1,50,286,5.7,1,76,465,6.1,8,13,3,24,7,65,0,0,0
9461,13,2015-12-05,alabama,N,Florida,W (29-15),18,26,69.2,204,2,58,233,4.0,1,84,437,5.2,9,14,2,25,5,35,1,0,1
9462,14,2015-12-31,alabama,N,Michigan State*,W (38-0),25,31,80.6,286,2,35,154,4.4,2,66,440,6.7,12,7,2,21,6,69,0,0,0
9463,15,2016-01-11,alabama,N,Clemson*,W (45-40),16,25,64.0,335,2,46,138,3.0,3,71,473,6.7,11,6,1,18,2,21,0,0,0
9464,,15 Games,alabama,,,,301,446,67.5,3407,22,642,2999,4.7,33,1088,6406,5.9,147,158,25,330,89,835,7,10,17
9465,1,2016-09-03,alabama,N,Southern California,W (52-6),12,18,66.7,223,3,45,242,5.4,3,63,465,7.4,6,9,0,15,4,29,1,1,2
9466,2,2016-09-10,alabama,,Western Kentucky,W (38-10),25,42,59.5,351,2,39,124,3.2,2,81,475,5.9,13,9,1,23,12,84,1,0,1
9467,3,2016-09-17,alabama,@,Mississippi,W (48-43),19,31,61.3,158,0,48,334,7.0,3,79,492,6.2,7,14,1,22,9,75,1,0,1
9468,4,2016-09-24,alabama,,Kent State,W (48-0),22,34,64.7,217,2,46,285,6.2,3,80,502,6.3,10,16,0,26,2,20,0,0,0
9469,5,2016-10-01,alabama,,Kentucky,W (34-6),25,38,65.8,315,2,37,173,4.7,1,75,488,6.5,14,11,0,25,4,20,1,0,1
9470,6,2016-10-08,alabama,@,Arkansas,W (49-30),13,17,76.5,253,2,34,264,7.8,3,51,517,10.1,8,8,0,16,7,86,2,1,3
9471,7,2016-10-15,alabama,@,Tennessee,W (49-10),18,28,64.3,185,1,48,409,8.5,4,76,594,7.8,8,20,0,28,5,38,1,1,2
9472,8,2016-10-22,alabama,,Texas A&M,W (33-14),15,25,60.0,164,2,57,287,5.0,1,82,451,5.5,7,19,2,28,7,44,0,2,2
9473,9,2016-11-05,alabama,@,Louisiana State,W (10-0),10,19,52.6,107,0,51,216,4.2,1,70,323,4.6,3,12,1,16,6,29,1,1,2
9474,10,2016-11-12,alabama,,Mississippi State,W (51-3),31,41,75.6,397,5,31,218,7.0,1,72,615,8.5,17,7,2,26,3,35,1,1,2
9475,11,2016-11-19,alabama,,Chattanooga,W (31-3),15,21,71.4,136,3,37,196,5.3,1,58,332,5.7,4,10,0,14,1,10,1,0,1
9476,12,2016-11-26,alabama,,Auburn,W (30-12),28,37,75.7,298,2,44,203,4.6,1,81,501,6.2,13,12,1,26,4,28,0,2,2
9477,13,2016-12-03,alabama,N,Florida,W (54-16),11,20,55.0,138,1,38,234,6.2,4,58,372,6.4,3,12,3,18,2,14,0,0,0
9478,14,2016-12-31,alabama,N,Washington,W (24-7),7,14,50.0,57,0,50,269,5.4,2,64,326,5.1,3,13,0,16,11,66,0,0,0
9479,15,2017-01-09,alabama,N,Clemson,L (31-35),14,32,43.8,155,1,34,221,6.5,3,66,376,5.7,5,10,1,16,9,82,0,0,0
9480,,15 Games,alabama,,,,265,417,63.5,3154,26,639,3675,5.8,33,1056,6829,6.5,121,182,12,315,86,660,10,9,19
9481,1,2017-09-02,alabama,N,Florida State,W (24-7),10,18,55.6,96,1,42,173,4.1,1,60,269,4.5,4,8,1,13,5,30,0,0,0
9482,2,2017-09-09,alabama,,Fresno State,W (41-10),20,27,74.1,192,2,39,305,7.8,3,66,497,7.5,11,17,0,28,4,30,0,0,0
9483,3,2017-09-16,alabama,,Colorado State,W (41-23),13,21,61.9,248,2,39,239,6.1,3,60,487,8.1,10,12,1,23,4,45,0,0,0
9484,4,2017-09-23,alabama,@,Vanderbilt,W (59-0),17,27,63.0,181,2,66,496,7.5,6,93,677,7.3,12,24,2,38,6,40,0,0,0
9485,5,2017-09-30,alabama,,Mississippi,W (66-3),15,24,62.5,248,3,51,365,7.2,5,75,613,8.2,11,14,1,26,7,60,0,0,0
9486,6,2017-10-07,alabama,@,Texas A&M,W (27-19),13,22,59.1,123,1,44,232,5.3,2,66,355,5.4,6,8,2,16,6,50,1,0,1
9487,7,2017-10-14,alabama,,Arkansas,W (41-9),13,21,61.9,188,1,43,308,7.2,4,64,496,7.8,9,14,0,23,6,66,1,1,2
9488,8,2017-10-21,alabama,,Tennessee,W (45-7),22,33,66.7,332,2,53,272,5.1,4,86,604,7.0,16,16,3,35,7,56,1,1,2
9489,9,2017-11-04,alabama,,Louisiana State,W (24-10),11,24,45.8,183,1,36,116,3.2,2,60,299,5.0,6,7,1,14,1,11,0,0,0
9490,10,2017-11-11,alabama,@,Mississippi State,W (31-24),10,19,52.6,242,1,38,202,5.3,3,57,444,7.8,7,11,1,19,5,60,0,0,0
9491,11,2017-11-18,alabama,,Mercer,W (56-0),14,18,77.8,265,6,42,265,6.3,2,60,530,8.8,10,12,0,22,1,5,2,0,2
9492,12,2017-11-25,alabama,@,Auburn,L (14-26),13,23,56.5,103,1,38,211,5.6,1,61,314,5.1,4,12,2,18,9,65,1,0,1
9493,13,2018-01-01,alabama,N,Clemson*,W (24-6),16,24,66.7,120,2,42,141,3.4,0,66,261,4.0,6,9,3,16,2,10,1,0,1
9494,14,2018-01-08,alabama,N,Georgia*,W (26-23),17,32,53.1,187,3,39,184,4.7,0,71,371,5.2,8,10,2,20,6,41,0,1,1
9495,,14 Games,alabama,,,,204,333,61.3,2708,28,612,3509,5.7,36,945,6217,6.6,120,174,19,311,69,569,7,3,10
9496,1,2018-09-01,alabama,N,Louisville,W (51-14),17,26,65.4,297,2,42,222,5.3,3,68,519,7.6,12,8,1,21,10,111,1,0,1
9497,2,2018-09-08,alabama,,Arkansas State,W (57-7),20,29,69.0,321,6,44,278,6.3,1,73,599,8.2,11,13,2,26,4,35,1,0,1
9498,3,2018-09-15,alabama,@,Mississippi,W (62-7),19,28,67.9,306,4,44,210,4.8,3,72,516,7.2,14,10,3,27,8,60,1,1,2
9499,4,2018-09-22,alabama,,Texas A&M,W (45-23),25,33,75.8,415,4,28,109,3.9,2,61,524,8.6,16,6,2,24,9,82,0,0,0
9500,5,2018-09-29,alabama,,Louisiana,W (56-14),13,16,81.3,340,4,46,268,5.8,3,62,608,9.8,11,14,1,26,3,15,0,0,0
9501,6,2018-10-06,alabama,@,Arkansas,W (65-31),14,18,77.8,393,4,41,246,6.0,4,59,639,10.8,13,11,0,24,5,31,0,0,0
9502,7,2018-10-13,alabama,,Missouri,W (39-10),19,30,63.3,380,3,45,184,4.1,1,75,564,7.5,12,11,2,25,5,60,1,0,1
9503,8,2018-10-20,alabama,@,Tennessee,W (58-21),21,32,65.6,327,4,42,218,5.2,4,74,545,7.4,16,12,2,30,5,36,0,1,1
9504,9,2018-11-03,alabama,@,Louisiana State,W (29-0),25,42,59.5,295,2,37,281,7.6,2,79,576,7.3,15,14,0,29,6,60,0,1,1
9505,10,2018-11-10,alabama,,Mississippi State,W (24-0),17,27,63.0,163,1,45,142,3.2,2,72,305,4.2,9,12,2,23,0,0,1,1,2
9506,11,2018-11-17,alabama,,Citadel,W (50-17),21,26,80.8,371,4,23,190,8.3,2,49,561,11.4,15,5,1,21,6,68,2,0,2
9507,,11 Games,alabama,,,,211,307,68.7,3608,38,437,2348,5.4,27,744,5956,8.0,144,116,16,276,61,558,7,4,11
9508,1,2014-08-30,georgia,,Clemson,W (45-21),18,26,69.2,131,0,41,328,8.0,5,67,459,6.9,7,13,2,22,8,65,1,0,1
9509,2,2014-09-13,georgia,@,South Carolina,L (35-38),16,22,72.7,191,2,38,217,5.7,2,60,408,6.8,8,9,1,18,7,44,0,0,0
9510,3,2014-09-20,georgia,,Troy,W (66-0),14,22,63.6,180,3,39,367,9.4,5,61,547,9.0,8,13,2,23,5,35,0,0,0
9511,4,2014-09-27,georgia,,Tennessee,W (35-32),16,25,64.0,147,1,53,289,5.5,3,78,436,5.6,9,16,0,25,7,57,0,2,2
9512,5,2014-10-04,georgia,,Vanderbilt,W (44-17),14,22,63.6,202,2,35,243,6.9,3,57,445,7.8,7,12,1,20,2,12,0,1,1
9513,6,2014-10-11,georgia,@,Missouri,W (34-0),23,29,79.3,169,1,58,210,3.6,3,87,379,4.4,9,16,0,25,4,30,0,0,0
9514,7,2014-10-18,georgia,N,Arkansas,W (45-32),10,17,58.8,179,2,39,207,5.3,3,56,386,6.9,6,10,2,18,9,101,0,0,0
9515,8,2014-11-01,georgia,N,Florida,L (20-38),26,41,63.4,319,1,32,141,4.4,2,73,460,6.3,15,5,1,21,4,30,1,0,1
9516,9,2014-11-08,georgia,@,Kentucky,W (63-31),18,21,85.7,254,5,39,305,7.8,2,60,559,9.3,13,15,0,28,4,33,1,0,1
9517,10,2014-11-15,georgia,,Auburn,W (34-7),10,19,52.6,123,1,52,289,5.6,3,71,412,5.8,5,19,3,27,6,51,0,0,0
9518,11,2014-11-22,georgia,,Charleston Southern,W (55-9),20,26,76.9,310,4,37,270,7.3,3,63,580,9.2,16,9,3,28,3,30,1,1,2
9519,12,2014-11-29,georgia,,Georgia Tech,L (24-30),18,28,64.3,194,1,39,194,5.0,1,67,388,5.8,12,8,1,21,2,20,2,1,3
9520,13,2014-12-30,georgia,N,Louisville*,W (37-14),14,24,58.3,200,1,52,305,5.9,3,76,505,6.6,11,9,2,22,4,32,1,1,2
9521,,13 Games,georgia,,,,217,322,67.4,2599,24,554,3365,6.1,38,876,5964,6.8,126,154,18,298,65,540,7,6,13
9522,1,2015-09-05,georgia,,Louisiana-Monroe,W (51-14),10,14,71.4,192,3,38,243,6.4,4,52,435,8.4,8,11,0,19,4,30,0,0,0
9523,2,2015-09-12,georgia,@,Vanderbilt,W (31-14),13,25,52.0,141,0,41,282,6.9,2,66,423,6.4,9,9,1,19,10,92,0,0,0
9524,3,2015-09-19,georgia,,South Carolina,W (52-20),24,25,96.0,330,3,38,246,6.5,4,63,576,9.1,17,12,3,32,7,74,1,0,1
9525,4,2015-09-26,georgia,,Southern,W (48-6),20,24,83.3,271,2,33,261,7.9,4,57,532,9.3,13,13,1,27,2,10,1,0,1
9526,5,2015-10-03,georgia,,Alabama,L (10-38),11,31,35.5,106,0,38,193,5.1,1,69,299,4.3,4,7,1,12,8,82,1,3,4
9527,6,2015-10-10,georgia,@,Tennessee,L (31-38),15,33,45.5,279,2,29,165,5.7,0,62,444,7.2,11,4,0,15,7,51,1,0,1
9528,7,2015-10-17,georgia,,Missouri,W (9-6),23,32,71.9,178,0,45,120,2.7,0,77,298,3.9,9,9,1,19,3,30,0,1,1
9529,8,2015-10-31,georgia,N,Florida,L (3-27),15,34,44.1,154,0,22,69,3.1,0,56,223,4.0,8,3,1,12,3,20,1,4,5
9530,9,2015-11-07,georgia,,Kentucky,W (27-3),10,19,52.6,90,1,52,300,5.8,2,71,390,5.5,6,15,0,21,6,60,2,0,2
9531,10,2015-11-14,georgia,@,Auburn,W (20-13),12,17,70.6,97,0,45,146,3.2,1,62,243,3.9,6,8,1,15,5,48,0,0,0
9532,11,2015-11-21,georgia,,Georgia Southern,W (23-17),16,25,64.0,183,1,28,106,3.8,2,53,289,5.5,8,8,0,16,2,15,2,0,2
9533,12,2015-11-28,georgia,@,Georgia Tech,W (13-7),18,25,72.0,224,0,34,178,5.2,1,59,402,6.8,8,7,1,16,5,35,0,0,0
9534,13,2016-01-02,georgia,N,Penn State*,W (24-17),12,23,52.2,161,2,41,166,4.0,1,64,327,5.1,7,9,1,17,5,45,0,0,0
9535,,13 Games,georgia,,,,199,327,60.9,2406,14,484,2475,5.1,22,811,4881,6.0,114,115,11,240,67,592,9,8,17
9536,1,2016-09-03,georgia,N,North Carolina,W (33-24),13,20,65.0,185,1,52,289,5.6,3,72,474,6.6,8,13,4,25,9,70,1,0,1
9537,2,2016-09-10,georgia,,Nicholls State,W (26-24),13,23,56.5,206,1,39,167,4.3,1,62,373,6.0,9,8,0,17,3,34,2,1,3
9538,3,2016-09-17,georgia,@,Missouri,W (28-27),29,55,52.7,308,3,38,101,2.7,1,93,409,4.4,18,5,2,25,3,42,0,1,1
9539,4,2016-09-24,georgia,@,Mississippi,L (14-45),17,37,45.9,166,0,44,230,5.2,2,81,396,4.9,9,12,0,21,8,52,1,1,2
9540,5,2016-10-01,georgia,,Tennessee,L (31-34),17,28,60.7,211,2,46,181,3.9,2,74,392,5.3,11,11,2,24,8,44,1,1,2
9541,6,2016-10-09,georgia,@,South Carolina,W (28-14),5,17,29.4,29,1,50,326,6.5,2,67,355,5.3,1,17,1,19,8,56,0,1,1
9542,7,2016-10-15,georgia,,Vanderbilt,L (16-17),27,40,67.5,346,1,35,75,2.1,0,75,421,5.6,17,4,2,23,8,53,0,0,0
9543,8,2016-10-29,georgia,N,Florida,L (10-24),15,33,45.5,143,1,19,21,1.1,0,52,164,3.2,7,0,1,8,5,49,0,0,0
9544,9,2016-11-05,georgia,@,Kentucky,W (27-24),17,31,54.8,245,1,42,215,5.1,1,73,460,6.3,10,12,1,23,6,54,3,0,3
9545,10,2016-11-12,georgia,,Auburn,W (13-7),20,33,60.6,208,0,43,135,3.1,0,76,343,4.5,8,11,2,21,5,30,0,1,1
9546,11,2016-11-19,georgia,,Louisiana,W (35-21),13,20,65.0,165,2,39,235,6.0,2,59,400,6.8,7,9,0,16,2,15,1,1,2
9547,12,2016-11-26,georgia,,Georgia Tech,L (27-28),14,28,50.0,139,1,42,263,6.3,2,70,402,5.7,7,13,2,22,2,15,0,2,2
9548,13,2016-12-30,georgia,N,Texas Christian*,W (31-23),12,21,57.1,164,2,42,251,6.0,2,63,415,6.6,5,11,1,17,7,45,1,0,1
9549,,13 Games,georgia,,,,212,386,54.9,2515,16,531,2489,4.7,18,917,5004,5.5,117,126,18,261,74,559,10,9,19
9550,1,2017-09-02,georgia,,Appalachian State,W (31-10),11,20,55.0,147,1,44,221,5.0,3,64,368,5.8,6,9,3,18,8,46,0,2,2
9551,2,2017-09-09,georgia,@,Notre Dame,W (20-19),16,29,55.2,141,1,43,185,4.3,1,72,326,4.5,3,9,4,16,12,127,1,1,2
9552,3,2017-09-16,georgia,,Samford,W (42-14),9,15,60.0,175,3,54,284,5.3,3,69,459,6.7,5,22,0,27,3,25,1,0,1
9553,4,2017-09-23,georgia,,Mississippi State,W (31-3),9,12,75.0,201,2,42,203,4.8,2,54,404,7.5,7,7,1,15,4,35,1,0,1
9554,5,2017-09-30,georgia,@,Tennessee,W (41-0),7,17,41.2,84,1,55,294,5.3,4,72,378,5.3,5,13,2,20,6,65,0,1,1
9555,6,2017-10-07,georgia,@,Vanderbilt,W (45-14),10,14,71.4,126,2,54,423,7.8,4,68,549,8.1,6,21,0,27,7,46,1,0,1
9556,7,2017-10-14,georgia,,Missouri,W (53-28),18,26,69.2,326,2,54,370,6.9,4,80,696,8.7,11,13,0,24,8,42,0,1,1
9557,8,2017-10-28,georgia,N,Florida,W (42-7),4,7,57.1,101,1,35,292,8.3,4,42,393,9.4,4,10,0,14,7,40,0,1,1
9558,9,2017-11-04,georgia,,South Carolina,W (24-10),16,22,72.7,196,2,53,242,4.6,1,75,438,5.8,12,13,1,26,5,55,1,0,1
9559,10,2017-11-11,georgia,@,Auburn,L (17-40),13,29,44.8,184,1,32,46,1.4,1,61,230,3.8,8,4,1,13,7,75,1,0,1
9560,11,2017-11-18,georgia,,Kentucky,W (42-13),9,14,64.3,123,1,44,381,8.7,5,58,504,8.7,7,17,1,25,7,59,0,1,1
9561,12,2017-11-25,georgia,@,Georgia Tech,W (38-7),12,17,70.6,224,2,43,247,5.7,3,60,471,7.9,9,13,1,23,2,25,0,0,0
9562,13,2017-12-02,georgia,N,Auburn,W (28-7),16,22,72.7,183,2,41,238,5.8,1,63,421,6.7,6,11,3,20,7,91,0,0,0
9563,14,2018-01-01,georgia,N,Oklahoma*,W (54-48),20,29,69.0,210,2,34,317,9.3,5,63,527,8.4,12,8,1,21,6,39,1,0,1
9564,15,2018-01-08,georgia,N,Alabama*,L (23-26),16,32,50.0,232,1,45,133,3.0,1,77,365,4.7,11,8,3,22,6,65,0,2,2
9565,,15 Games,georgia,,,,186,305,61.0,2653,24,673,3876,5.8,42,978,6529,6.7,112,178,21,311,95,835,7,9,16
9566,1,2018-09-01,georgia,,Austin Peay,W (45-0),21,27,77.8,224,3,33,284,8.6,3,60,508,8.5,13,8,0,21,3,40,1,0,1
9567,2,2018-09-08,georgia,@,South Carolina,W (41-17),16,19,84.2,202,1,52,271,5.2,3,71,473,6.7,12,15,3,30,4,47,0,1,1
9568,3,2018-09-15,georgia,,Middle Tennessee State,W (49-7),17,21,81.0,223,4,35,261,7.5,2,56,484,8.6,10,11,2,23,7,54,0,0,0
9569,4,2018-09-22,georgia,@,Missouri,W (43-29),13,23,56.5,260,3,40,185,4.6,0,63,445,7.1,8,10,0,18,7,66,0,1,1
9570,5,2018-09-29,georgia,,Tennessee,W (38-12),17,24,70.8,190,0,50,251,5.0,5,74,441,6.0,10,16,0,26,6,40,0,0,0
9571,6,2018-10-06,georgia,,Vanderbilt,W (41-13),21,31,67.7,341,3,34,219,6.4,2,65,560,8.6,12,14,2,28,13,115,0,0,0
9572,7,2018-10-13,georgia,@,Louisiana State,L (16-36),16,34,47.1,209,1,30,113,3.8,1,64,322,5.0,10,7,1,18,4,20,2,2,4
9573,8,2018-10-27,georgia,N,Florida,W (36-17),17,24,70.8,240,3,41,189,4.6,1,65,429,6.6,10,8,2,20,4,53,0,0,0
9574,9,2018-11-03,georgia,@,Kentucky,W (34-17),14,20,70.0,113,1,50,331,6.6,3,70,444,6.3,6,16,3,25,4,45,2,0,2
9575,10,2018-11-10,georgia,,Auburn,W (27-10),15,23,65.2,213,2,44,309,7.0,1,67,522,7.8,8,13,3,24,12,85,0,1,1
9576,11,2018-11-17,georgia,,Massachusetts,W (66-27),14,17,82.4,275,3,45,426,9.5,6,62,701,11.3,8,20,2,30,2,20,1,0,1
9577,,11 Games,georgia,,,,181,263,68.8,2490,24,454,2839,6.3,27,717,5329,7.4,107,138,18,263,66,585,6,5,11
9578,1,2014-08-30,mississippi-state,,Southern Mississippi,W (49-0),23,34,67.6,349,5,44,201,4.6,1,78,550,7.1,20,9,0,29,3,30,1,1,2
9579,2,2014-09-06,mississippi-state,,Alabama-Birmingham,W (47-34),14,31,45.2,224,4,57,292,5.1,2,88,516,5.9,8,18,0,26,3,32,0,1,1
9580,3,2014-09-13,mississippi-state,@,South Alabama,W (35-3),16,24,66.7,226,2,45,288,6.4,3,69,514,7.4,9,14,1,24,8,70,2,0,2
9581,4,2014-09-20,mississippi-state,@,Louisiana State,W (34-29),15,24,62.5,268,2,49,302,6.2,2,73,570,7.8,9,14,0,23,6,41,2,0,2
9582,5,2014-10-04,mississippi-state,,Texas A&M,W (48-31),21,27,77.8,279,2,50,280,5.6,5,77,559,7.3,13,11,2,26,3,20,2,0,2
9583,6,2014-10-11,mississippi-state,,Auburn,W (38-23),18,35,51.4,246,1,44,223,5.1,4,79,469,5.9,12,10,2,24,7,50,1,3,4
9584,7,2014-10-25,mississippi-state,@,Kentucky,W (45-31),18,33,54.5,216,1,51,326,6.4,4,84,542,6.5,11,18,1,30,2,20,0,1,1
9585,8,2014-11-01,mississippi-state,,Arkansas,W (17-10),18,27,66.7,331,1,35,128,3.7,1,62,459,7.4,11,8,0,19,8,45,1,2,3
9586,9,2014-11-08,mississippi-state,,Tennessee-Martin,W (45-16),17,27,63.0,266,3,32,254,7.9,3,59,520,8.8,12,8,1,21,3,20,1,0,1
9587,10,2014-11-15,mississippi-state,@,Alabama,L (20-25),27,48,56.3,290,2,40,138,3.5,0,88,428,4.9,13,11,2,26,4,33,0,3,3
9588,11,2014-11-22,mississippi-state,,Vanderbilt,W (51-0),19,25,76.0,219,4,51,283,5.5,2,76,502,6.6,11,18,3,32,11,87,0,0,0
9589,12,2014-11-29,mississippi-state,@,Mississippi,L (17-31),22,37,59.5,282,1,47,163,3.5,1,84,445,5.3,11,9,1,21,4,25,0,0,0
9590,13,2014-12-31,mississippi-state,N,Georgia Tech*,L (34-49),33,51,64.7,453,3,33,152,4.6,1,84,605,7.2,19,12,2,33,5,40,1,1,2
9591,,13 Games,mississippi-state,,,,261,423,61.7,3649,31,578,3030,5.2,29,1001,6679,6.7,159,160,15,334,67,513,11,12,23
9592,1,2015-09-05,mississippi-state,@,Southern Mississippi,W (34-16),22,38,57.9,237,2,28,205,7.3,1,66,442,6.7,9,8,2,19,6,60,2,0,2
9593,2,2015-09-12,mississippi-state,,Louisiana State,L (19-21),34,54,63.0,335,1,26,43,1.7,1,80,378,4.7,0,0,0,27,5,45,0,0,0
9594,3,2015-09-19,mississippi-state,,Northwestern State,W (62-13),16,18,88.9,372,4,37,275,7.4,5,55,647,11.8,11,15,0,26,2,20,2,0,2
9595,4,2015-09-26,mississippi-state,@,Auburn,W (17-9),29,41,70.7,270,2,21,56,2.7,0,62,326,5.3,14,4,0,18,4,30,1,0,1
9596,5,2015-10-03,mississippi-state,@,Texas A&M,L (17-30),20,34,58.8,210,0,34,196,5.8,2,68,406,6.0,9,10,1,20,3,30,2,0,2
9597,6,2015-10-10,mississippi-state,,Troy,W (45-17),10,15,66.7,211,3,33,125,3.8,1,48,336,7.0,4,8,0,12,3,28,0,0,0
9598,7,2015-10-17,mississippi-state,,Louisiana Tech,W (45-20),30,43,69.8,347,3,30,93,3.1,2,73,440,6.0,16,10,2,28,4,38,0,0,0
9599,8,2015-10-24,mississippi-state,,Kentucky,W (42-16),26,36,72.2,382,3,36,204,5.7,3,72,586,8.1,19,11,0,30,6,62,0,1,1
9600,9,2015-11-05,mississippi-state,@,Missouri,W (31-13),27,41,65.9,303,4,36,127,3.5,0,77,430,5.6,12,11,0,23,2,18,2,0,2
9601,10,2015-11-14,mississippi-state,,Alabama,L (6-31),23,45,51.1,304,0,42,89,2.1,0,87,393,4.5,11,8,1,20,4,40,1,1,2
9602,11,2015-11-21,mississippi-state,@,Arkansas,W (51-50),38,51,74.5,508,5,35,123,3.5,2,86,631,7.3,21,10,1,32,3,30,2,1,3
9603,12,2015-11-28,mississippi-state,,Mississippi,L (27-38),31,42,73.8,254,2,34,148,4.4,1,76,402,5.3,12,9,0,21,6,50,1,1,2
9604,13,2015-12-30,mississippi-state,N,North Carolina State*,W (51-28),25,42,59.5,380,4,35,189,5.4,3,77,569,7.4,15,9,2,26,5,55,0,1,1
9605,,13 Games,mississippi-state,,,,331,500,66.2,4113,33,427,1873,4.4,21,927,5986,6.5,153,113,9,302,53,506,13,5,18
9606,1,2016-09-03,mississippi-state,,South Alabama,L (20-21),20,31,64.5,143,1,34,239,7.0,1,65,382,5.9,11,8,3,22,5,41,0,0,0
9607,2,2016-09-10,mississippi-state,,South Carolina,W (27-14),20,30,66.7,195,3,43,294,6.8,0,73,489,6.7,9,12,3,24,6,60,0,1,1
9608,3,2016-09-17,mississippi-state,@,Louisiana State,L (20-23),17,32,53.1,214,1,32,56,1.8,1,64,270,4.2,9,4,1,14,5,35,1,0,1
9609,4,2016-09-24,mississippi-state,@,Massachusetts,W (47-35),26,39,66.7,305,3,44,297,6.8,2,83,602,7.3,14,17,0,31,9,90,1,0,1
9610,5,2016-10-08,mississippi-state,,Auburn,L (14-38),18,35,51.4,186,2,33,103,3.1,0,68,289,4.3,9,7,0,16,7,80,2,1,3
9611,6,2016-10-14,mississippi-state,@,Brigham Young,L (21-28),18,37,48.6,223,1,49,163,3.3,2,86,386,4.5,11,9,3,23,7,63,0,2,2
9612,7,2016-10-22,mississippi-state,@,Kentucky,L (38-40),13,21,61.9,81,1,39,281,7.2,3,60,362,6.0,4,11,1,16,7,50,0,1,1
9613,8,2016-10-29,mississippi-state,,Samford,W (56-41),20,35,57.1,417,5,46,252,5.5,2,81,669,8.3,14,13,2,29,4,35,1,2,3
9614,9,2016-11-05,mississippi-state,,Texas A&M,W (35-28),18,31,58.1,209,2,58,365,6.3,3,89,574,6.4,8,19,2,29,3,30,0,2,2
9615,10,2016-11-12,mississippi-state,@,Alabama,L (3-51),16,43,37.2,180,0,35,94,2.7,0,78,274,3.5,9,6,2,17,4,31,0,1,1
9616,11,2016-11-19,mississippi-state,,Arkansas,L (42-58),23,33,69.7,328,2,35,205,5.9,4,68,533,7.8,14,10,1,25,3,22,0,0,0
9617,12,2016-11-26,mississippi-state,@,Mississippi,W (55-20),8,17,47.1,109,3,47,457,9.7,4,64,566,8.8,5,17,1,23,6,55,1,0,1
9618,13,2016-12-26,mississippi-state,N,Miami (OH)*,W (17-16),13,27,48.1,136,0,33,199,6.0,2,60,335,5.6,6,9,2,17,2,25,0,0,0
9619,,13 Games,mississippi-state,,,,230,411,56.0,2726,24,528,3005,5.7,24,939,5731,6.1,123,142,21,286,68,617,6,10,16
9620,1,2017-09-02,mississippi-state,,Charleston Southern,W (49-0),20,36,55.6,274,3,50,281,5.6,3,86,555,6.5,11,17,1,29,7,60,0,0,0
9621,2,2017-09-09,mississippi-state,@,Louisiana Tech,W (57-21),13,20,65.0,132,3,40,327,8.2,3,60,459,7.7,6,15,0,21,5,39,0,1,1
9622,3,2017-09-16,mississippi-state,,Louisiana State,W (37-7),15,23,65.2,180,2,48,285,5.9,2,71,465,6.5,9,12,4,25,5,49,0,0,0
9623,4,2017-09-23,mississippi-state,@,Georgia,L (3-31),15,33,45.5,103,0,37,177,4.8,0,70,280,4.0,5,10,0,15,4,35,0,2,2
9624,5,2017-09-30,mississippi-state,@,Auburn,L (10-49),13,37,35.1,157,1,47,194,4.1,0,84,351,4.2,5,12,1,18,10,39,0,2,2
9625,6,2017-10-14,mississippi-state,,Brigham Young,W (35-10),20,31,64.5,240,2,53,306,5.8,3,84,546,6.5,14,19,2,35,6,60,1,2,3
9626,7,2017-10-21,mississippi-state,,Kentucky,W (45-7),19,27,70.4,159,1,48,282,5.9,4,75,441,5.9,7,16,2,25,5,55,0,0,0
9627,8,2017-10-28,mississippi-state,@,Texas A&M,W (35-14),12,21,57.1,141,2,52,228,4.4,2,73,369,5.1,7,11,1,19,5,45,0,1,1
9628,9,2017-11-04,mississippi-state,,Massachusetts,W (34-23),14,26,53.8,139,0,45,254,5.6,2,71,393,5.5,7,13,1,21,5,63,0,3,3
9629,10,2017-11-11,mississippi-state,,Alabama,L (24-31),13,24,54.2,158,0,49,172,3.5,3,73,330,4.5,9,10,3,22,4,30,0,0,0
9630,11,2017-11-18,mississippi-state,@,Arkansas,W (28-21),12,23,52.2,153,2,48,195,4.1,2,71,348,4.9,6,13,0,19,4,47,2,0,2
9631,12,2017-11-23,mississippi-state,,Mississippi,L (28-31),14,32,43.8,207,1,62,294,4.7,2,94,501,5.3,9,16,2,27,9,88,3,2,5
9632,13,2017-12-30,mississippi-state,N,Louisville*,W (31-27),11,20,55.0,127,0,55,277,5.0,4,75,404,5.4,4,18,1,23,11,100,2,1,3
9633,,13 Games,mississippi-state,,,,191,353,54.1,2170,17,634,3272,5.2,30,987,5442,5.5,99,182,18,299,80,710,8,14,22
9634,1,2018-09-01,mississippi-state,,Stephen F. Austin,W (63-6),15,34,44.1,398,5,37,220,5.9,4,71,618,8.7,12,12,1,25,7,80,0,0,0
9635,2,2018-09-08,mississippi-state,@,Kansas State,W (31-10),11,27,40.7,154,2,39,384,9.8,2,66,538,8.2,6,18,0,24,11,84,0,1,1
9636,3,2018-09-15,mississippi-state,,Louisiana,W (56-10),16,24,66.7,276,2,47,331,7.0,6,71,607,8.5,11,18,0,29,3,15,0,1,1
9637,4,2018-09-22,mississippi-state,@,Kentucky,L (7-28),16,32,50.0,145,0,28,56,2.0,1,60,201,3.4,6,5,0,11,16,139,0,1,1
9638,5,2018-09-29,mississippi-state,,Florida,L (6-13),11,26,42.3,98,0,32,104,3.3,0,58,202,3.5,6,7,2,15,2,15,0,0,0
9639,6,2018-10-06,mississippi-state,,Auburn,W (23-9),9,17,52.9,69,0,57,349,6.1,2,74,418,5.6,3,18,1,22,1,15,0,1,1
9640,7,2018-10-20,mississippi-state,@,Louisiana State,L (3-19),8,24,33.3,59,0,37,201,5.4,0,61,260,4.3,3,9,3,15,5,45,0,4,4
9641,8,2018-10-27,mississippi-state,,Texas A&M,W (28-13),14,22,63.6,241,2,31,143,4.6,2,53,384,7.2,7,7,1,15,10,95,0,0,0
9642,9,2018-11-03,mississippi-state,,Louisiana Tech,W (45-3),17,29,58.6,243,4,36,289,8.0,2,65,532,8.2,11,13,2,26,3,25,0,0,0
9643,10,2018-11-10,mississippi-state,@,Alabama,L (0-24),11,20,55.0,125,0,30,44,1.5,0,50,169,3.4,3,3,0,6,7,50,1,0,1
9644,11,2018-11-17,mississippi-state,,Arkansas,W (52-6),12,18,66.7,188,5,47,287,6.1,2,65,475,7.3,9,16,4,29,7,60,1,0,1
9645,,11 Games,mississippi-state,,,,140,273,51.3,1996,20,421,2408,5.7,21,694,4404,6.3,77,126,14,217,72,623,2,8,10
9646,1,2014-08-30,north-carolina-state,,Georgia Southern,W (24-23),28,40,70.0,291,3,35,173,4.9,0,75,464,6.2,14,10,2,26,4,20,0,1,1
9647,2,2014-09-06,north-carolina-state,,Old Dominion,W (46-34),21,29,72.4,253,2,39,242,6.2,4,68,495,7.3,14,14,0,28,1,5,0,0,0
9648,3,2014-09-13,north-carolina-state,@,South Florida,W (49-17),21,33,63.6,274,2,53,315,5.9,5,86,589,6.8,15,15,0,30,5,38,1,1,2
9649,4,2014-09-20,north-carolina-state,,Presbyterian,W (42-0),14,22,63.6,195,3,31,265,8.5,3,53,460,8.7,7,11,3,21,7,70,0,0,0
9650,5,2014-09-27,north-carolina-state,,Florida State,L (41-56),32,50,64.0,359,3,37,161,4.4,2,87,520,6.0,15,13,1,29,8,83,2,0,2
9651,6,2014-10-04,north-carolina-state,@,Clemson,L (0-41),4,19,21.1,35,0,38,119,3.1,0,57,154,2.7,1,8,3,12,5,45,3,0,3
9652,7,2014-10-11,north-carolina-state,,Boston College,L (14-30),14,30,46.7,174,1,28,43,1.5,1,58,217,3.7,8,5,0,13,2,20,1,1,2
9653,8,2014-10-18,north-carolina-state,@,Louisville,L (18-30),18,32,56.3,223,2,31,128,4.1,0,63,351,5.6,9,8,3,20,2,20,0,1,1
9654,9,2014-11-01,north-carolina-state,@,Syracuse,W (24-17),20,33,60.6,186,1,35,121,3.5,0,68,307,4.5,8,5,1,14,9,80,0,0,0
9655,10,2014-11-08,north-carolina-state,,Georgia Tech,L (23-56),18,35,51.4,213,1,28,155,5.5,2,63,368,5.8,13,9,1,23,6,52,1,2,3
9656,11,2014-11-15,north-carolina-state,,Wake Forest,W (42-13),8,19,42.1,83,1,46,362,7.9,5,65,445,6.8,4,14,2,20,2,10,0,0,0
9657,12,2014-11-29,north-carolina-state,@,North Carolina,W (35-7),9,11,81.8,66,3,58,388,6.7,2,69,454,6.6,3,15,2,20,6,81,0,0,0
9658,13,2014-12-26,north-carolina-state,N,Central Florida*,W (34-27),17,28,60.7,300,2,49,187,3.8,2,77,487,6.3,11,13,2,26,6,34,1,0,1
9659,,13 Games,north-carolina-state,,,,224,381,58.8,2652,24,508,2659,5.2,26,889,5311,6.0,122,140,20,282,63,558,9,6,15
9660,1,2015-09-05,north-carolina-state,,Troy,W (49-21),22,26,84.6,199,2,58,251,4.3,5,84,450,5.4,12,15,3,30,1,15,0,0,0
9661,2,2015-09-12,north-carolina-state,,Eastern Kentucky,W (35-0),21,30,70.0,244,1,48,199,4.1,4,78,443,5.7,13,10,1,24,7,56,1,0,1
9662,3,2015-09-19,north-carolina-state,@,Old Dominion,W (38-14),18,27,66.7,179,1,52,256,4.9,4,79,435,5.5,10,16,0,26,2,26,0,0,0
9663,4,2015-09-26,north-carolina-state,@,South Alabama,W (63-13),21,27,77.8,256,2,41,330,8.0,7,68,586,8.6,11,15,0,26,4,44,0,0,0
9664,5,2015-10-03,north-carolina-state,,Louisville,L (13-20),16,28,57.1,183,1,30,45,1.5,1,58,228,3.9,6,3,2,11,4,50,2,0,2
9665,6,2015-10-09,north-carolina-state,@,Virginia Tech,L (13-28),12,25,48.0,113,1,40,157,3.9,0,65,270,4.2,7,9,1,17,9,81,0,1,1
9666,7,2015-10-24,north-carolina-state,@,Wake Forest,W (35-17),20,34,58.8,227,2,30,248,8.3,2,64,475,7.4,8,9,2,19,6,46,0,0,0
9667,8,2015-10-31,north-carolina-state,,Clemson,L (41-56),24,41,58.5,254,3,27,135,5.0,2,68,389,5.7,13,4,1,18,4,40,1,0,1
9668,9,2015-11-07,north-carolina-state,@,Boston College,W (24-8),14,27,51.9,212,1,33,139,4.2,2,60,351,5.9,6,5,1,12,5,50,1,1,2
9669,10,2015-11-14,north-carolina-state,@,Florida State,L (17-34),28,49,57.1,218,1,31,79,2.5,1,80,297,3.7,15,5,1,21,9,59,1,0,1
9670,11,2015-11-21,north-carolina-state,,Syracuse,W (42-29),21,34,61.8,235,2,47,276,5.9,3,81,511,6.3,13,14,0,27,10,98,1,1,2
9671,12,2015-11-28,north-carolina-state,,North Carolina,L (34-45),17,37,45.9,206,2,52,308,5.9,2,89,514,5.8,9,18,1,28,7,72,0,1,1
9672,13,2015-12-30,north-carolina-state,N,Mississippi State*,L (28-51),12,28,42.9,214,1,51,210,4.1,3,79,424,5.4,8,10,2,20,4,50,0,2,2
9673,,13 Games,north-carolina-state,,,,246,413,59.6,2740,20,540,2633,4.9,36,953,5373,5.6,131,133,15,279,72,687,7,6,13
9674,1,2016-09-01,north-carolina-state,,William & Mary,W (48-14),23,30,76.7,262,2,57,259,4.5,5,87,521,6.0,13,14,1,28,7,80,0,1,1
9675,2,2016-09-10,north-carolina-state,@,East Carolina,L (30-33),21,32,65.6,287,1,31,215,6.9,3,63,502,8.0,10,8,1,19,8,54,1,0,1
9676,3,2016-09-17,north-carolina-state,,Old Dominion,W (49-22),27,32,84.4,316,4,39,158,4.1,3,71,474,6.7,18,8,2,28,2,24,1,0,1
9677,4,2016-10-01,north-carolina-state,,Wake Forest,W (33-16),24,37,64.9,327,3,39,200,5.1,1,76,527,6.9,16,10,2,28,13,144,0,0,0
9678,5,2016-10-08,north-carolina-state,,Notre Dame,W (10-3),7,14,50.0,41,0,51,157,3.1,0,65,198,3.0,2,11,1,14,2,20,2,0,2
9679,6,2016-10-15,north-carolina-state,@,Clemson,L (17-24),21,42,50.0,269,0,32,128,4.0,1,74,397,5.4,12,9,2,23,13,120,0,2,2
9680,7,2016-10-22,north-carolina-state,@,Louisville,L (13-54),16,36,44.4,236,2,25,14,0.6,0,61,250,4.1,8,0,1,9,6,65,0,3,3
9681,8,2016-10-29,north-carolina-state,,Boston College,L (14-21),23,41,56.1,307,2,23,31,1.3,0,64,338,5.3,10,2,2,14,8,94,1,2,3
9682,9,2016-11-05,north-carolina-state,,Florida State,L (20-24),25,41,61.0,304,1,41,165,4.0,1,82,469,5.7,19,8,4,31,3,28,0,1,1
9683,10,2016-11-12,north-carolina-state,@,Syracuse,W (35-20),23,34,67.6,360,1,48,184,3.8,4,82,544,6.6,14,12,1,27,6,66,0,2,2
9684,11,2016-11-19,north-carolina-state,,Miami (FL),L (13-27),20,44,45.5,210,0,29,119,4.1,1,73,329,4.5,9,8,1,18,4,51,1,1,2
9685,12,2016-11-25,north-carolina-state,@,North Carolina,W (28-21),14,24,58.3,233,1,53,259,4.9,3,77,492,6.4,9,15,0,24,5,59,1,0,1
9686,13,2016-12-26,north-carolina-state,N,Vanderbilt*,W (41-17),19,31,61.3,235,3,36,141,3.9,1,67,376,5.6,14,5,2,21,1,5,1,0,1
9687,,13 Games,north-carolina-state,,,,263,438,60.0,3387,20,504,2030,4.0,23,942,5417,5.8,154,110,20,284,78,810,8,12,20
9688,1,2017-09-02,north-carolina-state,N,South Carolina,L (28-35),45,64,70.3,415,2,35,89,2.5,2,99,504,5.1,21,7,1,29,8,65,2,0,2
9689,2,2017-09-09,north-carolina-state,,Marshall,W (37-20),29,36,80.6,341,3,33,144,4.4,2,69,485,7.0,14,7,2,23,3,33,0,0,0
9690,3,2017-09-16,north-carolina-state,,Furman,W (49-16),24,30,80.0,248,1,39,242,6.2,5,69,490,7.1,12,13,0,25,5,50,0,0,0
9691,4,2017-09-23,north-carolina-state,@,Florida State,W (27-21),23,33,69.7,255,2,37,110,3.0,1,70,365,5.2,11,6,4,21,6,41,0,0,0
9692,5,2017-09-30,north-carolina-state,,Syracuse,W (33-25),21,34,61.8,206,1,47,256,5.4,3,81,462,5.7,11,15,3,29,6,49,0,0,0
9693,6,2017-10-05,north-carolina-state,,Louisville,W (39-25),20,32,62.5,367,1,39,153,3.9,3,71,520,7.3,14,7,2,23,6,50,1,0,1
9694,7,2017-10-14,north-carolina-state,@,Pittsburgh,W (35-17),14,25,56.0,198,1,38,248,6.5,3,63,446,7.1,10,8,0,18,3,39,0,0,0
9695,8,2017-10-28,north-carolina-state,@,Notre Dame,L (14-35),17,37,45.9,213,1,24,50,2.1,0,61,263,4.3,9,4,1,14,12,89,0,1,1
9696,9,2017-11-04,north-carolina-state,,Clemson,L (31-38),31,50,62.0,338,3,34,153,4.5,1,84,491,5.8,14,12,1,27,6,69,0,2,2
9697,10,2017-11-11,north-carolina-state,@,Boston College,W (17-14),13,32,40.6,146,0,41,221,5.4,2,73,367,5.0,9,8,0,17,2,10,1,1,2
9698,11,2017-11-18,north-carolina-state,@,Wake Forest,L (24-30),34,52,65.4,327,1,42,175,4.2,2,94,502,5.3,16,10,2,28,5,64,2,1,3
9699,12,2017-11-25,north-carolina-state,,North Carolina,W (33-21),20,30,66.7,204,0,45,292,6.5,5,75,496,6.6,8,12,5,25,11,108,0,1,1
9700,13,2017-12-29,north-carolina-state,N,Arizona State*,W (52-31),24,29,82.8,318,1,41,169,4.1,6,70,487,7.0,13,10,1,24,5,54,1,0,1
9701,,13 Games,north-carolina-state,,,,315,484,65.1,3576,17,495,2302,4.7,35,979,5878,6.0,162,119,22,303,78,721,7,6,13
9702,1,2018-09-01,north-carolina-state,,James Madison,W (24-13),29,43,67.4,309,2,29,83,2.9,1,72,392,5.4,18,6,1,25,5,50,1,0,1
9703,2,2018-09-08,north-carolina-state,,Georgia State,W (41-7),32,39,82.1,426,2,31,117,3.8,3,70,543,7.8,19,3,2,24,6,52,0,1,1
9704,3,2018-09-22,north-carolina-state,@,Marshall,W (37-20),23,40,57.5,377,1,36,125,3.5,2,76,502,6.6,17,6,1,24,4,25,1,0,1
9705,4,2018-09-29,north-carolina-state,,Virginia,W (35-21),22,32,68.8,257,3,39,176,4.5,1,71,433,6.1,12,10,3,25,7,80,0,0,0
9706,5,2018-10-06,north-carolina-state,,Boston College,W (28-23),25,34,73.5,308,2,53,225,4.2,2,87,533,6.1,17,14,3,34,1,5,2,2,4
9707,6,2018-10-20,north-carolina-state,@,Clemson,L (7-41),22,35,62.9,193,0,32,104,3.3,1,67,297,4.4,5,7,4,16,6,49,1,2,3
9708,7,2018-10-27,north-carolina-state,@,Syracuse,L (41-51),26,44,59.1,473,3,29,68,2.3,2,73,541,7.4,13,6,2,21,9,95,0,1,1
9709,8,2018-11-03,north-carolina-state,,Florida State,W (47-28),21,28,75.0,240,3,49,177,3.6,2,77,417,5.4,10,10,5,25,4,50,0,0,0
9710,9,2018-11-08,north-carolina-state,,Wake Forest,L (23-27),35,53,66.0,374,1,27,47,1.7,1,80,421,5.3,18,3,2,23,6,55,0,1,1
9711,10,2018-11-17,north-carolina-state,@,Louisville,W (52-10),31,42,73.8,354,4,36,164,4.6,3,78,518,6.6,19,9,1,29,2,25,0,0,0
9712,,10 Games,north-carolina-state,,,,266,390,68.2,3311,21,361,1286,3.6,18,751,4597,6.1,148,74,24,246,50,486,5,7,12
9713,1,2014-08-30,north-carolina,,Liberty,W (56-29),29,45,64.4,235,3,48,208,4.3,4,93,443,4.8,14,13,2,29,10,60,1,3,4
9714,2,2014-09-06,north-carolina,,San Diego State,W (31-27),21,31,67.7,263,2,33,131,4.0,1,64,394,6.2,11,8,1,20,5,37,0,1,1
9715,3,2014-09-20,north-carolina,@,East Carolina,L (41-70),24,43,55.8,294,3,39,145,3.7,2,82,439,5.4,14,8,1,23,8,85,0,1,1
9716,4,2014-09-27,north-carolina,@,Clemson,L (35-50),30,49,61.2,394,4,30,84,2.8,1,79,478,6.1,13,8,1,22,15,130,0,1,1
9717,5,2014-10-04,north-carolina,,Virginia Tech,L (17-34),18,37,48.6,198,1,29,125,4.3,1,66,323,4.9,8,8,0,16,10,62,2,1,3
9718,6,2014-10-11,north-carolina,@,Notre Dame,L (43-50),25,42,59.5,326,3,42,190,4.5,2,84,516,6.1,17,10,3,30,9,94,1,1,2
9719,7,2014-10-18,north-carolina,,Georgia Tech,W (48-43),38,47,80.9,390,4,41,189,4.6,3,88,579,6.6,19,12,0,31,4,35,0,1,1
9720,8,2014-10-25,north-carolina,@,Virginia,W (28-27),16,29,55.2,275,3,34,99,2.9,1,63,374,5.9,8,6,6,20,6,45,0,1,1
9721,9,2014-11-01,north-carolina,@,Miami (FL),L (20-47),24,38,63.2,247,0,32,11,0.3,2,70,258,3.7,8,5,4,17,5,28,1,1,2
9722,10,2014-11-15,north-carolina,,Pittsburgh,W (40-35),23,40,57.5,276,1,43,226,5.3,5,83,502,6.0,14,14,2,30,6,41,0,0,0
9723,11,2014-11-20,north-carolina,@,Duke,W (45-20),18,27,66.7,276,2,57,316,5.5,3,84,592,7.0,11,15,2,28,9,85,3,0,3
9724,12,2014-11-29,north-carolina,,North Carolina State,L (7-35),17,35,48.6,177,1,28,30,1.1,0,63,207,3.3,8,6,4,18,6,49,0,2,2
9725,13,2014-12-26,north-carolina,N,Rutgers*,L (21-40),32,46,69.6,263,2,40,219,5.5,1,86,482,5.6,12,15,0,25,6,70,2,0,2
9726,,13 Games,north-carolina,,,,315,509,61.9,3614,29,496,1973,4.0,26,1005,5587,5.6,157,128,26,309,99,821,10,13,23
9727,1,2015-09-03,north-carolina,N,South Carolina,L (13-17),19,31,61.3,232,1,32,208,6.5,0,63,440,7.0,11,8,1,20,6,30,0,3,3
9728,2,2015-09-12,north-carolina,,North Carolina A&T,W (53-14),20,27,74.1,248,3,44,215,4.9,4,71,463,6.5,14,10,0,24,5,50,0,0,0
9729,3,2015-09-19,north-carolina,,Illinois,W (48-14),19,26,73.1,217,3,37,254,6.9,2,63,471,7.5,10,10,3,23,6,51,0,1,1
9730,4,2015-09-26,north-carolina,,Delaware,W (41-14),23,33,69.7,377,4,35,191,5.5,1,68,568,8.4,14,11,4,29,2,20,1,0,1
9731,5,2015-10-03,north-carolina,@,Georgia Tech,W (38-31),15,26,57.7,182,1,31,231,7.5,4,57,413,7.2,8,11,2,21,6,42,0,0,0
9732,6,2015-10-17,north-carolina,,Wake Forest,W (50-14),18,26,69.2,326,3,33,212,6.4,4,59,538,9.1,11,10,1,22,6,44,0,2,2
9733,7,2015-10-24,north-carolina,,Virginia,W (26-13),21,26,80.8,226,0,38,196,5.2,3,64,422,6.6,12,11,1,24,13,135,1,1,2
9734,8,2015-10-29,north-carolina,@,Pittsburgh,W (26-19),14,23,60.9,270,2,35,174,5.0,0,58,444,7.7,8,8,1,17,3,15,0,0,0
9735,9,2015-11-07,north-carolina,,Duke,W (66-31),28,40,70.0,537,4,40,167,4.2,5,80,704,8.8,17,9,3,29,5,39,0,0,0
9736,10,2015-11-14,north-carolina,,Miami (FL),W (59-21),16,22,72.7,189,1,46,298,6.5,6,68,487,7.2,10,15,5,30,5,56,0,0,0
9737,11,2015-11-21,north-carolina,@,Virginia Tech,W (30-27),13,26,50.0,205,1,47,240,5.1,3,73,445,6.1,9,12,1,22,9,60,3,0,3
9738,12,2015-11-28,north-carolina,@,North Carolina State,W (45-34),20,31,64.5,179,2,41,374,9.1,4,72,553,7.7,9,14,2,25,3,30,2,1,3
9739,13,2015-12-05,north-carolina,N,Clemson,L (37-45),12,35,34.3,240,3,32,142,4.4,2,67,382,5.7,10,7,4,21,6,44,1,1,2
9740,14,2015-12-29,north-carolina,N,Baylor*,L (38-49),22,36,61.1,243,3,36,244,6.8,2,72,487,6.8,15,10,3,28,5,34,1,1,2
9741,,14 Games,north-carolina,,,,260,408,63.7,3671,31,527,3146,6.0,40,935,6817,7.3,158,146,31,335,80,650,9,10,19
9742,1,2016-09-03,north-carolina,N,Georgia,L (24-33),24,40,60.0,156,0,19,159,8.4,2,59,315,5.3,10,6,0,16,13,101,0,0,0
9743,2,2016-09-10,north-carolina,@,Illinois,W (48-23),19,25,76.0,265,2,37,197,5.3,4,62,462,7.5,12,6,3,21,6,46,1,0,1
9744,3,2016-09-17,north-carolina,,James Madison,W (56-28),29,33,87.9,462,3,32,173,5.4,5,65,635,9.8,18,9,3,30,10,110,1,0,1
9745,4,2016-09-24,north-carolina,,Pittsburgh,W (37-36),35,46,76.1,453,5,22,18,0.8,0,68,471,6.9,18,3,1,22,5,41,1,0,1
9746,5,2016-10-01,north-carolina,@,Florida State,W (37-35),31,38,81.6,405,3,32,133,4.2,2,70,538,7.7,18,8,2,28,6,49,1,0,1
9747,6,2016-10-08,north-carolina,,Virginia Tech,L (3-34),13,33,39.4,58,0,29,73,2.5,0,62,131,2.1,4,3,1,8,8,49,2,2,4
9748,7,2016-10-15,north-carolina,@,Miami (FL),W (20-13),33,46,71.7,299,2,43,162,3.8,0,89,461,5.2,11,12,0,23,11,70,0,0,0
9749,8,2016-10-22,north-carolina,@,Virginia,W (35-14),24,31,77.4,310,3,36,178,4.9,2,67,488,7.3,15,9,1,25,7,60,2,0,2
9750,9,2016-11-05,north-carolina,,Georgia Tech,W (48-20),23,35,65.7,353,1,35,283,8.1,5,70,636,9.1,16,10,0,26,6,45,0,0,0
9751,10,2016-11-10,north-carolina,@,Duke,L (27-28),24,33,72.7,297,3,27,106,3.9,0,60,403,6.7,13,8,2,23,7,65,0,2,2
9752,11,2016-11-19,north-carolina,,Citadel,W (41-7),12,21,57.1,193,3,26,163,6.3,0,47,356,7.6,6,8,1,15,6,61,0,0,0
9753,12,2016-11-25,north-carolina,,North Carolina State,L (21-28),23,39,59.0,280,3,26,133,5.1,0,65,413,6.4,12,6,2,20,7,50,1,0,1
9754,13,2016-12-30,north-carolina,N,Stanford*,L (23-25),23,39,59.0,280,2,37,118,3.2,1,76,398,5.2,15,8,3,26,7,50,1,2,3
9755,,13 Games,north-carolina,,,,313,459,68.2,3811,30,401,1896,4.7,21,860,5707,6.6,168,96,19,283,99,797,10,6,16
9756,1,2017-09-02,north-carolina,,California,L (30-35),25,44,56.8,221,1,45,219,4.9,3,89,440,4.9,16,10,2,28,7,50,1,2,3
9757,2,2017-09-09,north-carolina,,Louisville,L (35-47),29,38,76.3,384,3,23,17,0.7,1,61,401,6.6,18,0,2,20,5,50,0,0,0
9758,3,2017-09-16,north-carolina,@,Old Dominion,W (53-23),16,26,61.5,259,1,50,252,5.0,6,76,511,6.7,9,14,2,25,9,110,1,0,1
9759,4,2017-09-23,north-carolina,,Duke,L (17-27),17,32,53.1,259,1,33,118,3.6,1,65,377,5.8,10,5,0,15,6,65,0,1,1
9760,5,2017-09-30,north-carolina,@,Georgia Tech,L (7-33),18,32,56.3,141,0,26,106,4.1,1,58,247,4.3,7,4,0,11,6,60,0,2,2
9761,6,2017-10-07,north-carolina,,Notre Dame,L (10-33),19,42,45.2,179,1,28,86,3.1,0,70,265,3.8,6,6,1,13,10,104,2,1,3
9762,7,2017-10-14,north-carolina,,Virginia,L (14-20),7,18,38.9,46,0,35,211,6.0,2,53,257,4.8,4,7,1,12,6,52,0,3,3
9763,8,2017-10-21,north-carolina,@,Virginia Tech,L (7-59),8,22,36.4,118,1,42,54,1.3,0,64,172,2.7,5,5,1,11,14,100,1,2,3
9764,9,2017-10-28,north-carolina,,Miami (FL),L (19-24),20,46,43.5,252,2,46,176,3.8,0,92,428,4.7,12,12,3,27,7,56,1,3,4
9765,10,2017-11-09,north-carolina,@,Pittsburgh,W (34-31),21,32,65.6,270,3,32,96,3.0,0,64,366,5.7,15,5,1,21,7,65,0,0,0
9766,11,2017-11-18,north-carolina,,Western Carolina,W (65-10),20,30,66.7,298,5,43,313,7.3,3,73,611,8.4,13,17,1,31,4,33,0,0,0
9767,12,2017-11-25,north-carolina,@,North Carolina State,L (21-33),21,45,46.7,277,3,24,83,3.5,0,69,360,5.2,14,4,4,22,12,127,0,2,2
9768,,12 Games,north-carolina,,,,221,407,54.3,2704,21,427,1731,4.1,17,834,4435,5.3,129,89,18,236,93,872,6,16,22
9769,1,2018-09-01,north-carolina,@,California,L (17-24),15,35,42.9,137,1,38,164,4.3,1,73,301,4.1,5,10,1,16,13,124,0,4,4
9770,2,2018-09-08,north-carolina,@,East Carolina,L (19-41),25,44,56.8,234,0,25,161,6.4,1,69,395,5.7,9,8,2,19,7,65,0,0,0
9771,3,2018-09-22,north-carolina,,Pittsburgh,W (38-35),22,31,71.0,313,2,40,173,4.3,3,71,486,6.8,13,9,1,23,5,45,1,0,1
9772,4,2018-09-27,north-carolina,@,Miami (FL),L (10-47),20,35,57.1,114,0,40,215,5.4,1,75,329,4.4,8,14,2,24,4,40,3,3,6
9773,5,2018-10-13,north-carolina,,Virginia Tech,L (19-22),22,35,62.9,287,1,38,235,6.2,0,73,522,7.2,12,6,3,21,7,35,2,0,2
9774,6,2018-10-20,north-carolina,@,Syracuse,L (37-40),34,54,63.0,321,2,41,179,4.4,1,95,500,5.3,14,10,0,24,5,34,1,1,2
9775,7,2018-10-27,north-carolina,@,Virginia,L (21-31),22,38,57.9,271,2,22,66,3.0,1,60,337,5.6,11,3,0,14,4,19,1,0,1
9776,8,2018-11-03,north-carolina,,Georgia Tech,L (28-38),18,31,58.1,208,1,36,166,4.6,1,67,374,5.6,10,9,0,19,1,10,0,3,3
9777,9,2018-11-10,north-carolina,@,Duke,L (35-42),27,43,62.8,221,1,37,315,8.5,4,80,536,6.7,11,14,0,25,10,115,0,0,0
9778,10,2018-11-17,north-carolina,,Western Carolina,W (49-26),20,28,71.4,358,3,50,296,5.9,4,78,654,8.4,14,14,2,30,7,85,1,2,3
9779,,10 Games,north-carolina,,,,225,374,60.2,2464,13,367,1970,5.4,17,741,4434,6.0,107,97,11,215,63,572,9,13,22
9780,1,2014-08-30,kentucky,,Tennessee-Martin,W (59-14),22,33,66.7,422,1,28,234,8.4,6,61,656,10.8,13,8,3,24,6,59,0,0,0
9781,2,2014-09-06,kentucky,,Ohio,W (20-3),17,31,54.8,170,1,52,232,4.5,1,83,402,4.8,8,15,1,24,4,45,0,0,0
9782,3,2014-09-13,kentucky,@,Florida,L (30-36),24,45,53.3,369,3,33,81,2.5,0,78,450,5.8,14,6,3,23,8,61,0,3,3
9783,4,2014-09-27,kentucky,,Vanderbilt,W (17-7),23,30,76.7,201,1,50,183,3.7,1,80,384,4.8,10,13,0,23,5,55,2,1,3
9784,5,2014-10-04,kentucky,,South Carolina,W (45-38),20,30,66.7,208,1,36,239,6.6,4,66,447,6.8,9,12,1,22,8,80,1,0,1
9785,6,2014-10-11,kentucky,,Louisiana-Monroe,W (48-14),16,30,53.3,216,3,29,136,4.7,1,59,352,6.0,7,6,2,15,6,54,0,1,1
9786,7,2014-10-18,kentucky,@,Louisiana State,L (3-41),19,36,52.8,146,0,27,71,2.6,0,63,217,3.4,6,5,1,12,5,55,0,0,0
9787,8,2014-10-25,kentucky,,Mississippi State,L (31-45),25,44,56.8,401,2,32,103,3.2,2,76,504,6.6,16,7,0,23,3,25,1,0,1
9788,9,2014-11-01,kentucky,@,Missouri,L (10-20),19,37,51.4,158,1,35,100,2.9,0,72,258,3.6,5,6,3,14,9,65,0,1,1
9789,10,2014-11-08,kentucky,,Georgia,L (31-63),16,31,51.6,139,1,47,214,4.6,3,78,353,4.5,8,12,2,22,3,25,0,1,1
9790,11,2014-11-15,kentucky,@,Tennessee,L (16-50),13,29,44.8,168,0,34,94,2.8,1,63,262,4.2,7,6,2,15,5,35,0,2,2
9791,12,2014-11-29,kentucky,@,Louisville,L (40-44),14,29,48.3,176,0,41,151,3.7,2,70,327,4.7,5,9,0,14,4,45,0,2,2
9792,,12 Games,kentucky,,,,228,405,56.3,2774,14,444,1838,4.1,21,849,4612,5.4,108,105,18,231,66,604,4,11,15
9793,1,2015-09-05,kentucky,,Louisiana,W (40-33),16,34,47.1,257,3,26,178,6.8,2,60,435,7.3,8,7,3,18,4,54,0,1,1
9794,2,2015-09-12,kentucky,@,South Carolina,W (26-22),21,29,72.4,192,0,38,207,5.4,3,67,399,6.0,7,12,0,19,7,74,0,1,1
9795,3,2015-09-19,kentucky,,Florida,L (9-14),8,24,33.3,126,0,41,115,2.8,0,65,241,3.7,5,8,1,14,5,37,0,2,2
9796,4,2015-09-26,kentucky,,Missouri,W (21-13),22,27,81.5,249,2,38,120,3.2,1,65,369,5.7,8,9,1,18,8,91,0,0,0
9797,5,2015-10-03,kentucky,,Eastern Kentucky,W (34-27),29,42,69.0,329,3,36,55,1.5,2,78,384,4.9,16,5,3,24,6,46,1,2,3
9798,6,2015-10-15,kentucky,,Auburn,L (27-30),27,44,61.4,359,0,33,138,4.2,3,77,497,6.5,17,6,2,25,5,37,0,1,1
9799,7,2015-10-24,kentucky,@,Mississippi State,L (16-42),30,52,57.7,260,0,33,163,4.9,1,85,423,5.0,14,12,4,30,3,30,0,3,3
9800,8,2015-10-31,kentucky,,Tennessee,L (21-52),16,33,48.5,184,1,32,165,5.2,1,65,349,5.4,8,7,3,18,9,93,1,1,2
9801,9,2015-11-07,kentucky,@,Georgia,L (3-27),9,23,39.1,101,0,24,79,3.3,0,47,180,3.8,4,4,0,8,7,58,1,2,3
9802,10,2015-11-14,kentucky,@,Vanderbilt,L (17-21),15,34,44.1,127,1,37,225,6.1,1,71,352,5.0,3,9,0,12,4,31,1,2,3
9803,11,2015-11-21,kentucky,,UNC Charlotte,W (58-10),16,29,55.2,129,0,44,415,9.4,6,73,544,7.5,7,15,0,22,2,30,1,0,1
9804,12,2015-11-28,kentucky,,Louisville,L (24-38),9,26,34.6,199,0,37,92,2.5,2,63,291,4.6,6,6,2,14,9,95,1,1,2
9805,,12 Games,kentucky,,,,218,397,54.9,2512,10,419,1952,4.7,22,816,4464,5.5,103,100,19,222,69,676,6,16,22
9806,1,2016-09-03,kentucky,,Southern Mississippi,L (35-44),16,25,64.0,313,4,25,96,3.8,1,50,409,8.2,8,5,1,14,6,75,2,1,3
9807,2,2016-09-10,kentucky,@,Florida,L (7-45),3,14,21.4,55,0,34,94,2.8,1,48,149,3.1,1,6,2,9,2,25,1,3,4
9808,3,2016-09-17,kentucky,,New Mexico State,W (62-42),18,24,75.0,311,3,51,381,7.5,5,75,692,9.2,12,16,0,28,11,87,2,1,3
9809,4,2016-09-24,kentucky,,South Carolina,W (17-10),11,19,57.9,135,0,50,216,4.3,2,69,351,5.1,7,14,2,23,4,30,1,1,2
9810,5,2016-10-01,kentucky,@,Alabama,L (6-34),13,22,59.1,89,0,36,72,2.0,0,58,161,2.8,4,7,1,12,2,15,2,0,2
9811,6,2016-10-08,kentucky,,Vanderbilt,W (20-13),10,24,41.7,49,0,52,258,5.0,2,76,307,4.0,2,18,0,20,5,42,1,1,2
9812,7,2016-10-22,kentucky,,Mississippi State,W (40-38),17,33,51.5,292,2,44,262,6.0,1,77,554,7.2,13,12,1,26,2,20,2,0,2
9813,8,2016-10-29,kentucky,@,Missouri,W (35-21),15,24,62.5,205,2,59,377,6.4,3,83,582,7.0,9,14,2,25,3,25,1,1,2
9814,9,2016-11-05,kentucky,,Georgia,L (24-27),11,21,52.4,122,0,40,186,4.7,3,61,308,5.0,5,8,3,16,5,40,1,1,2
9815,10,2016-11-12,kentucky,@,Tennessee,L (36-49),12,29,41.4,192,0,55,443,8.1,4,84,635,7.6,10,16,3,29,6,59,1,1,2
9816,11,2016-11-19,kentucky,,Austin Peay,W (49-13),8,14,57.1,129,2,35,281,8.0,5,49,410,8.4,4,10,0,14,10,85,0,1,1
9817,12,2016-11-26,kentucky,@,Louisville,W (41-38),17,29,58.6,352,3,43,229,5.3,2,72,581,8.1,11,10,3,24,4,41,1,1,2
9818,13,2016-12-31,kentucky,N,Georgia Tech*,L (18-33),19,34,55.9,175,1,36,149,4.1,1,70,324,4.6,10,9,1,20,6,61,1,0,1
9819,,13 Games,kentucky,,,,170,312,54.5,2419,17,560,3044,5.4,30,872,5463,6.3,96,145,19,260,66,605,16,12,28
9820,1,2017-09-02,kentucky,@,Southern Mississippi,W (24-17),11,20,55.0,176,1,35,78,2.2,1,55,254,4.6,5,5,2,12,8,60,1,0,1
9821,2,2017-09-09,kentucky,,Eastern Kentucky,W (27-16),16,24,66.7,229,1,39,207,5.3,2,63,436,6.9,10,9,3,22,6,60,0,0,0
9822,3,2017-09-16,kentucky,@,South Carolina,W (23-13),16,26,61.5,169,0,47,184,3.9,2,73,353,4.8,11,7,2,20,4,10,1,1,2
9823,4,2017-09-23,kentucky,,Florida,L (27-28),18,27,66.7,220,3,32,120,3.8,0,59,340,5.8,11,7,3,21,7,55,0,0,0
9824,5,2017-09-30,kentucky,,Eastern Michigan,W (24-20),18,27,66.7,175,2,37,53,1.4,1,64,228,3.6,9,4,3,16,5,40,1,0,1
9825,6,2017-10-07,kentucky,,Missouri,W (40-34),22,37,59.5,298,2,39,188,4.8,2,76,486,6.4,14,7,1,22,6,34,0,1,1
9826,7,2017-10-21,kentucky,@,Mississippi State,L (7-45),14,30,46.7,145,0,29,115,4.0,1,59,260,4.4,8,5,1,14,4,41,0,2,2
9827,8,2017-10-28,kentucky,,Tennessee,W (29-26),7,16,43.8,82,0,36,289,8.0,4,52,371,7.1,3,13,1,17,4,44,4,0,4
9828,9,2017-11-04,kentucky,,Mississippi,L (34-37),20,25,80.0,236,1,45,219,4.9,3,70,455,6.5,10,12,1,23,4,40,0,0,0
9829,10,2017-11-11,kentucky,@,Vanderbilt,W (44-21),13,17,76.5,195,0,47,232,4.9,5,64,427,6.7,8,10,3,21,9,61,1,0,1
9830,11,2017-11-18,kentucky,@,Georgia,L (13-42),12,23,52.2,138,0,37,124,3.4,1,60,262,4.4,5,10,2,17,2,30,0,1,1
9831,12,2017-11-25,kentucky,,Louisville,L (17-44),8,19,42.1,110,0,43,228,5.3,2,62,338,5.5,6,13,1,20,7,86,0,0,0
9832,13,2017-12-29,kentucky,N,Northwestern*,L (23-24),21,39,53.8,273,0,22,65,3.0,3,61,338,5.5,12,3,2,17,5,65,0,2,2
9833,,13 Games,kentucky,,,,196,330,59.4,2446,10,488,2102,4.3,27,818,4548,5.6,112,105,25,242,71,626,8,7,15
9834,1,2018-09-01,kentucky,,Central Michigan,W (35-20),15,27,55.6,128,1,43,299,7.0,4,70,427,6.1,8,15,4,27,3,40,2,2,4
9835,2,2018-09-08,kentucky,@,Florida,W (27-16),11,16,68.8,151,2,41,303,7.4,1,57,454,8.0,5,15,0,20,12,114,1,1,2
9836,3,2018-09-15,kentucky,,Murray State,W (48-10),24,31,77.4,283,2,43,245,5.7,4,74,528,7.1,13,14,1,28,7,67,0,0,0
9837,4,2018-09-22,kentucky,,Mississippi State,W (28-7),8,14,57.1,71,0,47,229,4.9,4,61,300,4.9,3,11,4,18,5,42,0,1,1
9838,5,2018-09-29,kentucky,,South Carolina,W (24-10),13,20,65.0,132,0,44,221,5.0,3,64,353,5.5,7,12,1,20,11,115,0,1,1
9839,6,2018-10-06,kentucky,@,Texas A&M,L (14-20),13,20,65.0,108,1,30,70,2.3,0,50,178,3.6,3,5,0,8,8,52,0,0,0
9840,7,2018-10-20,kentucky,,Vanderbilt,W (14-7),3,9,33.3,18,1,53,280,5.3,1,62,298,4.8,2,15,0,17,4,35,2,0,2
9841,8,2018-10-27,kentucky,@,Missouri,W (15-14),25,39,64.1,294,1,35,91,2.6,0,74,385,5.2,13,5,3,21,5,31,0,1,1
9842,9,2018-11-03,kentucky,,Georgia,L (17-34),23,29,79.3,226,1,35,84,2.4,1,64,310,4.8,11,8,2,21,6,64,2,0,2
9843,10,2018-11-10,kentucky,@,Tennessee,L (7-24),23,38,60.5,185,1,34,85,2.5,0,72,270,3.8,10,8,1,19,3,20,1,2,3
9844,11,2018-11-17,kentucky,,Middle Tennessee State,W (34-23),10,14,71.4,121,1,40,203,5.1,2,54,324,6.0,5,10,0,15,6,51,0,0,0
9845,,11 Games,kentucky,,,,168,257,65.4,1717,11,445,2110,4.7,20,702,3827,5.5,80,118,16,214,70,631,8,8,16
9846,1,2014-08-31,tennessee,,Utah State,W (38-7),28,40,70.0,273,3,39,110,2.8,2,79,383,4.8,13,8,3,24,6,40,0,0,0
9847,2,2014-09-06,tennessee,,Arkansas State,W (34-19),22,38,57.9,247,2,45,168,3.7,2,83,415,5.0,12,9,2,23,2,14,0,1,1
9848,3,2014-09-13,tennessee,@,Oklahoma,L (10-34),21,44,47.7,201,1,33,112,3.4,0,77,313,4.1,12,5,1,18,1,10,1,2,3
9849,4,2014-09-27,tennessee,@,Georgia,L (32-35),27,44,61.4,284,3,34,117,3.4,1,78,401,5.1,11,9,2,22,7,49,2,0,2
9850,5,2014-10-04,tennessee,,Florida,L (9-10),26,39,66.7,205,0,29,28,1.0,0,68,233,3.4,10,2,0,12,8,49,1,2,3
9851,6,2014-10-11,tennessee,,Chattanooga,W (45-10),22,29,75.9,217,3,42,123,2.9,3,71,340,4.8,11,9,0,20,1,5,1,0,1
9852,7,2014-10-18,tennessee,@,Mississippi,L (3-34),19,34,55.9,191,0,28,0,0.0,0,62,191,3.1,8,2,0,10,3,23,1,3,4
9853,8,2014-10-25,tennessee,,Alabama,L (20-34),21,36,58.3,202,2,43,181,4.2,0,79,383,4.8,10,10,1,21,4,33,1,1,2
9854,9,2014-11-01,tennessee,@,South Carolina,W (45-42),23,40,57.5,301,2,55,344,6.3,4,95,645,6.8,13,18,4,35,4,31,0,1,1
9855,10,2014-11-15,tennessee,,Kentucky,W (50-16),19,29,65.5,297,3,51,214,4.2,2,80,511,6.4,14,13,1,28,3,40,0,0,0
9856,11,2014-11-22,tennessee,,Missouri,L (21-29),25,38,65.8,226,2,29,53,1.8,0,67,279,4.2,11,6,1,18,5,40,1,1,2
9857,12,2014-11-29,tennessee,@,Vanderbilt,W (24-17),11,20,55.0,92,0,45,170,3.8,2,65,262,4.0,4,12,3,19,6,55,0,2,2
9858,13,2015-01-02,tennessee,N,Iowa*,W (45-28),17,22,77.3,178,2,51,283,5.5,4,73,461,6.3,10,15,2,27,4,55,0,1,1
9859,,13 Games,tennessee,,,,281,453,62.0,2914,23,524,1903,3.6,20,977,4817,4.9,139,118,20,277,54,444,8,14,22
9860,1,2015-09-05,tennessee,N,Bowling Green State,W (59-30),15,23,65.2,205,2,64,399,6.2,6,87,604,6.9,10,17,2,29,4,40,0,0,0
9861,2,2015-09-12,tennessee,,Oklahoma,L (24-31),13,31,41.9,125,1,45,129,2.9,2,76,254,3.3,7,11,1,19,10,80,0,1,1
9862,3,2015-09-19,tennessee,,Western Carolina,W (55-10),21,29,72.4,237,3,49,210,4.3,2,78,447,5.7,10,13,2,25,3,15,0,0,0
9863,4,2015-09-26,tennessee,@,Florida,L (27-28),12,19,63.2,165,1,51,254,5.0,2,70,419,6.0,7,13,0,20,4,25,1,0,1
9864,5,2015-10-03,tennessee,,Arkansas,L (20-24),20,37,54.1,232,0,33,133,4.0,1,70,365,5.2,11,8,0,19,4,39,0,0,0
9865,6,2015-10-10,tennessee,,Georgia,W (38-31),25,42,59.5,312,3,48,207,4.3,2,90,519,5.8,15,10,1,26,3,15,1,1,2
9866,7,2015-10-24,tennessee,@,Alabama,L (14-19),13,22,59.1,171,1,39,132,3.4,1,61,303,5.0,9,11,1,21,6,30,1,0,1
9867,8,2015-10-31,tennessee,@,Kentucky,W (52-21),16,26,61.5,233,2,43,249,5.8,3,69,482,7.0,11,10,0,21,6,65,1,1,2
9868,9,2015-11-07,tennessee,,South Carolina,W (27-24),20,34,58.8,255,2,41,153,3.7,1,75,408,5.4,12,6,1,19,6,47,2,1,3
9869,10,2015-11-14,tennessee,,North Texas,W (24-0),18,28,64.3,172,0,48,237,4.9,3,76,409,5.4,11,13,0,24,2,10,0,1,1
9870,11,2015-11-21,tennessee,@,Missouri,W (19-8),16,25,64.0,89,0,51,248,4.9,1,76,337,4.4,7,11,1,19,4,27,0,0,0
9871,12,2015-11-28,tennessee,,Vanderbilt,W (53-28),15,25,60.0,192,2,52,331,6.4,3,77,523,6.8,12,13,2,27,6,47,0,0,0
9872,13,2016-01-01,tennessee,N,Northwestern*,W (45-6),16,30,53.3,194,0,53,226,4.3,5,83,420,5.1,8,14,2,24,8,90,0,0,0
9873,,13 Games,tennessee,,,,220,371,59.3,2582,17,617,2908,4.7,32,988,5490,5.6,130,150,13,293,66,530,6,5,11
9874,1,2016-09-01,tennessee,,Appalachian State,W (20-13),16,29,55.2,192,1,43,127,3.0,1,72,319,4.4,10,9,0,19,6,55,1,1,2
9875,2,2016-09-10,tennessee,N,Virginia Tech,W (45-24),10,19,52.6,91,3,46,239,5.2,3,65,330,5.1,4,9,3,16,6,60,0,1,1
9876,3,2016-09-17,tennessee,,Ohio,W (28-19),19,27,70.4,203,2,42,201,4.8,2,69,404,5.9,10,13,0,23,9,94,0,1,1
9877,4,2016-09-24,tennessee,,Florida,W (38-28),16,33,48.5,319,4,46,179,3.9,1,79,498,6.3,13,7,2,22,5,40,0,2,2
9878,5,2016-10-01,tennessee,@,Georgia,W (34-31),16,26,61.5,230,3,38,127,3.3,1,64,357,5.6,8,10,0,18,2,25,2,1,3
9879,6,2016-10-08,tennessee,@,Texas A&M,L (38-45),29,48,60.4,402,2,51,282,5.5,3,99,684,6.9,16,12,1,29,12,84,5,2,7
9880,7,2016-10-15,tennessee,,Alabama,L (10-49),18,31,58.1,131,0,32,32,1.0,1,63,163,2.6,8,2,1,11,1,10,0,1,1
9881,8,2016-10-29,tennessee,@,South Carolina,L (21-24),12,27,44.4,161,1,37,136,3.7,1,64,297,4.6,5,9,2,16,9,87,1,2,3
9882,9,2016-11-05,tennessee,,Tennessee Tech,W (55-0),22,27,81.5,294,3,25,177,7.1,3,52,471,9.1,14,4,3,21,6,71,0,0,0
9883,10,2016-11-12,tennessee,,Kentucky,W (49-36),11,18,61.1,223,3,41,376,9.2,4,59,599,10.2,10,17,2,29,9,64,2,1,3
9884,11,2016-11-19,tennessee,,Missouri,W (63-37),15,22,68.2,223,3,45,386,8.6,5,67,609,9.1,10,12,2,24,5,45,0,0,0
9885,12,2016-11-26,tennessee,@,Vanderbilt,L (34-45),31,34,91.2,340,2,33,176,5.3,2,67,516,7.7,16,10,1,27,4,35,2,0,2
9886,13,2016-12-30,tennessee,N,Nebraska*,W (38-24),23,38,60.5,291,1,38,230,6.1,4,76,521,6.9,12,12,1,25,6,65,1,0,1
9887,,13 Games,tennessee,,,,238,379,62.8,3100,28,517,2668,5.2,31,896,5768,6.4,136,126,18,280,80,735,14,12,26
9888,1,2017-09-04,tennessee,N,Georgia Tech,W (42-41),20,37,54.1,221,2,22,148,6.7,4,59,369,6.3,10,6,2,18,2,20,0,0,0
9889,2,2017-09-09,tennessee,,Indiana State,W (42-7),17,30,56.7,235,3,37,160,4.3,2,67,395,5.9,11,11,2,24,6,53,1,1,2
9890,3,2017-09-16,tennessee,@,Florida,L (20-26),21,39,53.8,259,1,33,183,5.5,1,72,442,6.1,12,9,2,23,7,54,0,3,3
9891,4,2017-09-23,tennessee,,Massachusetts,W (17-13),19,32,59.4,184,1,39,135,3.5,1,71,319,4.5,9,8,1,18,5,51,1,0,1
9892,5,2017-09-30,tennessee,,Georgia,L (0-41),11,23,47.8,80,0,29,62,2.1,0,52,142,2.7,2,3,2,7,5,26,2,2,4
9893,6,2017-10-14,tennessee,,South Carolina,L (9-15),11,19,57.9,133,0,39,120,3.1,0,58,253,4.4,6,6,4,16,7,40,0,0,0
9894,7,2017-10-21,tennessee,@,Alabama,L (7-45),9,16,56.3,44,0,30,64,2.1,0,46,108,2.3,2,3,2,7,9,81,0,1,1
9895,8,2017-10-28,tennessee,@,Kentucky,L (26-29),18,23,78.3,242,0,55,203,3.7,2,78,445,5.7,12,13,2,27,9,54,0,0,0
9896,9,2017-11-04,tennessee,,Southern Mississippi,W (24-10),10,21,47.6,115,0,38,95,2.5,3,59,210,3.6,7,3,4,14,3,29,0,0,0
9897,10,2017-11-11,tennessee,@,Missouri,L (17-50),16,32,50.0,139,1,36,146,4.1,0,68,285,4.2,6,10,0,16,4,36,2,2,4
9898,11,2017-11-18,tennessee,,Louisiana State,L (10-30),14,25,56.0,249,1,33,44,1.3,0,58,293,5.1,9,2,1,12,5,26,2,0,2
9899,12,2017-11-25,tennessee,,Vanderbilt,L (24-42),14,22,63.6,183,2,21,55,2.6,1,43,238,5.5,9,3,3,15,5,27,0,1,1
9900,,12 Games,tennessee,,,,180,319,56.4,2084,11,412,1415,3.4,14,731,3499,4.8,95,77,25,197,67,497,8,10,18
9901,1,2018-09-01,tennessee,N,West Virginia,L (14-40),19,25,76.0,172,1,38,129,3.4,1,63,301,4.8,9,9,1,19,6,48,0,0,0
9902,2,2018-09-08,tennessee,,East Tennessee State,W (59-3),11,16,68.8,224,1,44,190,4.3,5,60,414,6.9,8,10,1,19,3,19,0,0,0
9903,3,2018-09-15,tennessee,,Texas-El Paso,W (24-0),13,19,68.4,167,1,50,345,6.9,2,69,512,7.4,9,14,1,24,8,65,2,0,2
9904,4,2018-09-22,tennessee,,Florida,L (21-47),10,25,40.0,208,0,52,161,3.1,2,77,369,4.8,6,6,6,18,6,58,4,2,6
9905,5,2018-09-29,tennessee,@,Georgia,L (12-38),13,21,61.9,143,2,25,66,2.6,0,46,209,4.5,5,4,2,11,5,25,1,0,1
9906,6,2018-10-13,tennessee,@,Auburn,W (30-24),21,32,65.6,328,2,35,70,2.0,0,67,398,5.9,12,4,0,16,5,40,0,0,0
9907,7,2018-10-20,tennessee,,Alabama,L (21-58),14,25,56.0,227,2,30,31,1.0,0,55,258,4.7,9,2,2,13,9,59,1,0,1
9908,8,2018-10-27,tennessee,@,South Carolina,L (24-27),27,39,69.2,207,2,34,144,4.2,1,73,351,4.8,12,10,1,23,9,75,0,0,0
9909,9,2018-11-03,tennessee,,UNC Charlotte,W (14-3),16,21,76.2,172,1,26,20,0.8,0,47,192,4.1,7,2,1,10,4,55,0,0,0
9910,10,2018-11-10,tennessee,,Kentucky,W (24-7),12,20,60.0,197,2,38,219,5.8,1,58,416,7.2,7,8,1,16,4,30,2,0,2
9911,11,2018-11-17,tennessee,,Missouri,L (17-50),7,21,33.3,173,0,28,82,2.9,2,49,255,5.2,5,3,3,11,6,59,1,2,3
9912,,11 Games,tennessee,,,,163,264,61.7,2218,14,400,1457,3.6,14,664,3675,5.5,89,72,19,180,65,533,11,4,15
9913,1,2014-08-30,michigan,,Appalachian State,W (52-14),16,19,84.2,210,3,36,350,9.7,3,55,560,10.2,10,12,2,24,4,44,0,1,1
9914,2,2014-09-06,michigan,@,Notre Dame,L (0-31),19,32,59.4,189,0,35,100,2.9,0,67,289,4.3,12,6,0,18,5,50,1,3,4
9915,3,2014-09-13,michigan,,Miami (OH),W (34-10),13,22,59.1,184,2,45,276,6.1,2,67,460,6.9,8,15,0,23,3,20,2,1,3
9916,4,2014-09-20,michigan,,Utah,L (10-26),18,39,46.2,190,0,36,118,3.3,0,75,308,4.1,8,11,0,19,3,20,1,3,4
9917,5,2014-09-27,michigan,,Minnesota,L (14-30),10,25,40.0,88,0,28,83,3.0,2,53,171,3.2,4,5,3,12,2,23,1,1,2
9918,6,2014-10-04,michigan,@,Rutgers,L (24-26),13,22,59.1,178,0,35,158,4.5,3,57,336,5.9,8,7,3,18,3,30,0,1,1
9919,7,2014-10-11,michigan,,Penn State,W (18-13),16,26,61.5,192,1,31,64,2.1,0,57,256,4.5,7,5,0,12,3,30,0,1,1
9920,8,2014-10-25,michigan,@,Michigan State,L (11-35),15,31,48.4,125,0,26,61,2.3,1,57,186,3.3,7,3,3,13,4,27,1,2,3
9921,9,2014-11-01,michigan,,Indiana,W (34-10),22,29,75.9,220,2,35,184,5.3,2,64,404,6.3,11,8,1,20,3,25,0,1,1
9922,10,2014-11-08,michigan,@,Northwestern,W (10-9),11,24,45.8,109,0,35,147,4.2,1,59,256,4.3,7,6,0,13,5,50,1,2,3
9923,11,2014-11-22,michigan,,Maryland,L (16-23),13,24,54.2,106,0,45,292,6.5,1,69,398,5.8,8,13,2,23,3,24,0,1,1
9924,12,2014-11-29,michigan,@,Ohio State,L (28-42),23,33,69.7,251,2,38,121,3.2,2,71,372,5.2,14,10,3,27,4,38,1,1,2
9925,,12 Games,michigan,,,,189,326,58.0,2042,10,425,1954,4.6,17,751,3996,5.3,104,101,17,222,42,381,8,18,26
9926,1,2015-09-03,michigan,@,Utah,L (17-24),27,43,62.8,279,2,29,76,2.6,0,72,355,4.9,15,3,2,20,3,25,0,3,3
9927,2,2015-09-12,michigan,,Oregon State,W (35-7),18,26,69.2,180,0,48,225,4.7,4,74,405,5.5,9,12,0,21,10,105,1,1,2
9928,3,2015-09-19,michigan,,Nevada-Las Vegas,W (28-7),14,25,56.0,123,1,39,254,6.5,3,64,377,5.9,6,11,0,17,3,34,0,1,1
9929,4,2015-09-26,michigan,,Brigham Young,W (31-0),14,25,56.0,194,1,51,254,5.0,3,76,448,5.9,11,8,3,22,5,53,0,0,0
9930,5,2015-10-03,michigan,@,Maryland,W (28-0),16,33,48.5,180,1,40,198,5.0,2,73,378,5.2,7,7,0,14,7,65,2,1,3
9931,6,2015-10-10,michigan,,Northwestern,W (38-0),17,23,73.9,179,0,46,201,4.4,3,69,380,5.5,10,11,0,21,3,28,0,0,0
9932,7,2015-10-17,michigan,,Michigan State,L (23-27),15,25,60.0,168,0,33,62,1.9,2,58,230,4.0,6,3,1,10,8,70,1,0,1
9933,8,2015-10-31,michigan,@,Minnesota,W (29-26),16,27,59.3,169,2,34,127,3.7,2,61,296,4.9,9,8,3,20,5,47,1,1,2
9934,9,2015-11-07,michigan,,Rutgers,W (49-16),18,26,69.2,337,2,42,150,3.6,4,68,487,7.2,14,8,3,25,6,60,0,0,0
9935,10,2015-11-14,michigan,@,Indiana,W (48-41),33,46,71.7,440,6,28,141,5.0,0,74,581,7.9,20,6,2,28,13,72,0,1,1
9936,11,2015-11-21,michigan,@,Penn State,W (28-16),25,38,65.8,256,2,30,87,2.9,2,68,343,5.0,12,5,2,19,13,117,1,1,2
9937,12,2015-11-28,michigan,,Ohio State,L (13-42),25,47,53.2,307,1,25,57,2.3,0,72,364,5.1,16,3,1,20,7,72,0,1,1
9938,13,2016-01-01,michigan,N,Florida*,W (41-7),20,31,64.5,278,3,46,225,4.9,2,77,503,6.5,14,11,3,28,4,30,0,0,0
9939,,13 Games,michigan,,,,258,415,62.2,3090,21,491,2057,4.2,27,906,5147,5.7,149,96,20,265,87,778,6,10,16
9940,1,2016-09-03,michigan,,Hawaii,W (63-3),17,20,85.0,206,3,39,306,7.8,4,59,512,8.7,9,17,0,26,3,33,0,1,1
9941,2,2016-09-10,michigan,,Central Florida,W (51-14),27,41,65.9,328,4,41,119,2.9,2,82,447,5.5,13,8,2,23,2,20,0,0,0
9942,3,2016-09-17,michigan,,Colorado,W (45-28),16,30,53.3,229,1,41,168,4.1,3,71,397,5.6,11,8,1,20,5,41,1,0,1
9943,4,2016-09-24,michigan,,Penn State,W (49-10),21,35,60.0,189,1,49,326,6.7,6,84,515,6.1,10,14,1,25,7,80,0,0,0
9944,5,2016-10-01,michigan,,Wisconsin,W (14-7),20,32,62.5,219,1,44,130,3.0,1,76,349,4.6,8,11,2,21,6,45,0,1,1
9945,6,2016-10-08,michigan,@,Rutgers,W (78-0),8,16,50.0,119,2,53,486,9.2,9,69,605,8.8,4,18,1,23,3,25,1,0,1
9946,7,2016-10-22,michigan,,Illinois,W (41-8),20,28,71.4,291,2,59,270,4.6,3,87,561,6.4,12,15,2,29,5,41,1,0,1
9947,8,2016-10-29,michigan,@,Michigan State,W (32-23),16,25,64.0,244,0,42,192,4.6,3,67,436,6.5,11,9,4,24,5,62,0,1,1
9948,9,2016-11-05,michigan,,Maryland,W (59-3),21,27,77.8,387,3,39,273,7.0,5,66,660,10.0,14,14,3,31,6,62,0,0,0
9949,10,2016-11-12,michigan,@,Iowa,L (13-14),11,26,42.3,103,0,35,98,2.8,1,61,201,3.3,7,5,2,14,5,48,1,1,2
9950,11,2016-11-19,michigan,,Indiana,W (20-10),7,16,43.8,59,0,50,225,4.5,2,66,284,4.3,2,12,1,15,5,40,0,0,0
9951,12,2016-11-26,michigan,@,Ohio State,L (27-30),23,36,63.9,219,2,43,91,2.1,1,79,310,3.9,9,7,0,16,7,59,1,2,3
9952,13,2016-12-30,michigan,N,Florida State*,L (32-33),21,38,55.3,163,1,36,89,2.5,1,74,252,3.4,10,5,1,16,4,37,0,1,1
9953,,13 Games,michigan,,,,228,370,61.6,2756,20,571,2773,4.9,41,941,5529,5.9,120,143,20,283,63,593,5,7,12
9954,1,2017-09-02,michigan,N,Florida,W (33-17),12,26,46.2,218,1,49,215,4.4,1,75,433,5.8,8,10,1,19,7,55,0,2,2
9955,2,2017-09-09,michigan,,Cincinnati,W (36-14),17,29,58.6,221,2,37,193,5.2,0,66,414,6.3,7,9,0,16,7,68,2,0,2
9956,3,2017-09-16,michigan,,Air Force,W (29-13),14,23,60.9,169,0,42,190,4.5,1,65,359,5.5,6,11,0,17,7,72,1,0,1
9957,4,2017-09-23,michigan,@,Purdue,W (28-10),21,31,67.7,284,1,44,139,3.2,3,75,423,5.6,14,6,4,24,7,57,1,1,2
9958,5,2017-10-07,michigan,,Michigan State,L (10-14),16,35,45.7,198,0,39,102,2.6,1,74,300,4.1,7,8,2,17,7,53,2,3,5
9959,6,2017-10-14,michigan,@,Indiana,W (27-20),10,20,50.0,58,0,44,271,6.2,3,64,329,5.1,3,12,2,17,16,141,0,0,0
9960,7,2017-10-21,michigan,@,Penn State,L (13-42),16,28,57.1,166,0,42,103,2.5,2,70,269,3.8,8,8,0,16,6,59,1,0,1
9961,8,2017-10-28,michigan,,Rutgers,W (35-14),13,20,65.0,137,1,51,334,6.5,4,71,471,6.6,9,16,0,25,3,25,0,1,1
9962,9,2017-11-04,michigan,,Minnesota,W (33-10),8,13,61.5,56,1,37,371,10.0,4,50,427,8.5,2,12,0,14,9,85,0,0,0
9963,10,2017-11-11,michigan,@,Maryland,W (35-10),9,18,50.0,145,2,38,160,4.2,3,56,305,5.4,6,8,2,16,1,10,0,0,0
9964,11,2017-11-18,michigan,@,Wisconsin,L (10-24),11,26,42.3,176,0,37,58,1.6,1,63,234,3.7,7,5,1,13,4,28,1,0,1
9965,12,2017-11-25,michigan,,Ohio State,L (20-31),17,32,53.1,195,1,36,100,2.8,2,68,295,4.3,8,7,1,16,6,50,0,1,1
9966,13,2018-01-01,michigan,N,South Carolina*,L (19-26),21,45,46.7,203,0,33,74,2.2,1,78,277,3.6,11,3,3,17,6,40,3,2,5
9967,,13 Games,michigan,,,,185,346,53.5,2226,9,529,2310,4.4,26,875,4536,5.2,96,115,16,227,86,743,11,10,21
9968,1,2018-09-01,michigan,@,Notre Dame,L (17-24),24,36,66.7,249,0,33,58,1.8,1,69,307,4.4,14,4,2,20,7,52,1,1,2
9969,2,2018-09-08,michigan,,Western Michigan,W (49-3),13,18,72.2,143,4,35,308,8.8,3,53,451,8.5,7,12,1,20,7,55,0,0,0
9970,3,2018-09-15,michigan,,Southern Methodist,W (45-20),14,18,77.8,237,3,41,197,4.8,2,59,434,7.4,8,10,3,21,13,137,0,1,1
9971,4,2018-09-22,michigan,,Nebraska,W (56-10),18,31,58.1,206,2,45,285,6.3,4,76,491,6.5,9,12,1,22,8,77,0,1,1
9972,5,2018-09-29,michigan,@,Northwestern,W (20-17),15,24,62.5,196,0,42,180,4.3,2,66,376,5.7,7,10,1,18,11,100,0,0,0
9973,6,2018-10-06,michigan,,Maryland,W (42-21),20,28,71.4,294,3,40,171,4.3,1,68,465,6.8,11,11,2,24,6,52,0,1,1
9974,7,2018-10-13,michigan,,Wisconsin,W (38-13),14,21,66.7,124,0,48,320,6.7,3,69,444,6.4,5,14,2,21,1,15,0,0,0
9975,8,2018-10-20,michigan,@,Michigan State,W (21-7),14,25,56.0,212,2,53,183,3.5,1,78,395,5.1,8,11,0,19,9,99,2,0,2
9976,9,2018-11-03,michigan,,Penn State,W (42-7),11,17,64.7,144,2,52,259,5.0,3,69,403,5.8,6,14,0,20,9,80,0,0,0
9977,10,2018-11-10,michigan,@,Rutgers,W (42-7),18,27,66.7,260,3,40,193,4.8,3,67,453,6.8,14,10,0,24,2,20,0,0,0
9978,11,2018-11-17,michigan,,Indiana,W (31-20),16,28,57.1,250,1,50,257,5.1,1,78,507,6.5,10,13,2,25,4,45,0,1,1
9979,,11 Games,michigan,,,,177,273,64.8,2315,20,479,2411,5.0,24,752,4726,6.3,99,121,14,234,77,732,3,5,8
9980,1,2014-08-30,texas,,North Texas,W (38-7),19,34,55.9,190,1,40,163,4.1,3,74,353,4.8,10,6,2,18,7,65,2,0,2
9981,2,2014-09-06,texas,,Brigham Young,L (7-41),20,31,64.5,176,1,35,82,2.3,0,66,258,3.9,9,6,0,15,6,64,3,1,4
9982,3,2014-09-13,texas,N,UCLA,L (17-20),24,34,70.6,196,2,30,126,4.2,0,64,322,5.0,8,6,0,14,7,50,0,0,0
9983,4,2014-09-27,texas,@,Kansas,W (23-0),19,34,55.9,218,2,36,111,3.1,1,70,329,4.7,9,8,2,19,6,46,1,0,1
9984,5,2014-10-04,texas,,Baylor,L (7-28),16,34,47.1,144,0,40,190,4.8,1,74,334,4.5,6,9,5,20,5,45,1,2,3
9985,6,2014-10-11,texas,N,Oklahoma,L (26-31),27,44,61.4,334,2,40,148,3.7,1,84,482,5.7,12,12,0,24,11,85,0,1,1
9986,7,2014-10-18,texas,,Iowa State,W (48-45),24,36,66.7,321,1,39,191,4.9,4,75,512,6.8,13,11,3,27,4,33,1,1,2
9987,8,2014-10-25,texas,@,Kansas State,L (0-23),13,25,52.0,106,0,27,90,3.3,0,52,196,3.8,6,6,0,12,7,66,1,0,1
9988,9,2014-11-01,texas,@,Texas Tech,W (34-13),13,25,52.0,228,1,51,241,4.7,3,76,469,6.2,7,13,1,21,5,50,2,0,2
9989,10,2014-11-08,texas,,West Virginia,W (33-16),11,29,37.9,124,1,39,227,5.8,3,68,351,5.2,7,10,2,19,5,60,0,1,1
9990,11,2014-11-15,texas,@,Oklahoma State,W (28-7),24,33,72.7,305,2,43,125,2.9,1,76,430,5.7,15,7,2,24,6,49,0,0,0
9991,12,2014-11-27,texas,,Texas Christian,L (10-48),20,34,58.8,200,1,36,90,2.5,0,70,290,4.1,7,5,0,12,3,17,2,4,6
9992,13,2014-12-29,texas,N,Arkansas*,L (7-31),13,25,52.0,57,0,18,2,0.1,1,43,59,1.4,6,1,0,7,5,34,1,1,2
9993,,13 Games,texas,,,,243,418,58.1,2599,14,474,1786,3.8,18,892,4385,4.9,115,100,17,232,77,664,14,11,25
9994,1,2015-09-05,texas,@,Notre Dame,L (3-38),8,23,34.8,103,0,29,60,2.1,0,52,163,3.1,5,2,1,8,4,50,0,0,0
9995,2,2015-09-12,texas,,Rice,W (42-28),5,10,50.0,128,2,28,149,5.3,2,38,277,7.3,4,7,0,11,4,42,1,0,1
9996,3,2015-09-19,texas,,California,L (44-45),20,31,64.5,364,0,52,286,5.5,6,83,650,7.8,13,12,3,28,10,93,1,1,2
9997,4,2015-09-26,texas,,Oklahoma State,L (27-30),9,17,52.9,119,0,42,171,4.1,1,59,290,4.9,3,8,0,11,16,128,0,1,1
9998,5,2015-10-03,texas,@,Texas Christian,L (7-50),13,28,46.4,122,1,51,191,3.7,0,79,313,4.0,5,13,2,20,4,40,1,0,1
9999,6,2015-10-10,texas,N,Oklahoma,W (24-17),9,12,75.0,55,2,58,313,5.4,1,70,368,5.3,4,15,1,20,5,67,0,0,0
10000,7,2015-10-24,texas,,Kansas State,W (23-9),10,16,62.5,99,0,53,274,5.2,3,69,373,5.4,5,15,0,20,3,35,0,0,0
10001,8,2015-10-31,texas,@,Iowa State,L (0-24),12,22,54.5,85,0,32,119,3.7,0,54,204,3.8,4,7,0,11,3,39,0,1,1
10002,9,2015-11-07,texas,,Kansas,W (59-20),19,30,63.3,299,2,40,299,7.5,6,70,598,8.5,11,9,0,20,6,36,1,0,1
10003,10,2015-11-14,texas,@,West Virginia,L (20-38),11,19,57.9,162,1,54,277,5.1,1,73,439,6.0,7,12,0,19,7,55,3,2,5
10004,11,2015-11-26,texas,,Texas Tech,L (45-48),11,23,47.8,64,0,48,403,8.4,6,71,467,6.6,1,16,2,19,8,64,1,1,2
10005,12,2015-12-05,texas,@,Baylor,W (23-17),12,21,57.1,151,1,42,156,3.7,1,63,307,4.9,7,7,1,15,7,60,0,0,0
10006,,12 Games,texas,,,,139,252,55.2,1751,9,529,2698,5.1,27,781,4449,5.7,69,123,10,202,77,709,8,6,14
10007,1,2016-09-04,texas,,Notre Dame,W (50-47),16,27,59.3,280,2,59,237,4.0,5,86,517,6.0,10,14,2,26,11,104,0,1,1
10008,2,2016-09-10,texas,,Texas-El Paso,W (41-7),23,28,82.1,245,4,47,171,3.6,1,75,416,5.5,10,11,2,23,10,115,1,0,1
10009,3,2016-09-17,texas,@,California,L (43-50),23,39,59.0,261,1,51,307,6.0,4,90,568,6.3,11,19,4,34,7,50,0,2,2
10010,4,2016-10-01,texas,@,Oklahoma State,L (31-49),21,33,63.6,239,1,49,329,6.7,4,82,568,6.9,8,16,2,26,5,39,0,1,1
10011,5,2016-10-08,texas,N,Oklahoma,L (40-45),19,36,52.8,245,3,46,180,3.9,2,82,425,5.2,10,10,3,23,2,10,1,1,2
10012,6,2016-10-15,texas,,Iowa State,W (27-6),26,38,68.4,296,2,47,209,4.4,1,85,505,5.9,12,14,2,28,9,100,1,1,2
10013,7,2016-10-22,texas,@,Kansas State,L (21-24),17,24,70.8,222,2,36,133,3.7,1,60,355,5.9,9,8,3,20,10,72,0,0,0
10014,8,2016-10-29,texas,,Baylor,W (35-34),12,21,57.1,291,2,51,257,5.0,2,72,548,7.6,8,11,0,19,4,23,1,1,2
10015,9,2016-11-05,texas,@,Texas Tech,W (45-37),20,40,50.0,244,2,50,414,8.3,4,90,658,7.3,13,16,0,29,9,99,2,0,2
10016,10,2016-11-12,texas,,West Virginia,L (20-24),31,50,62.0,318,1,50,218,4.4,1,100,536,5.4,15,16,1,33,5,50,2,1,3
10017,11,2016-11-19,texas,@,Kansas,L (21-24),17,27,63.0,165,1,63,238,3.8,2,90,403,4.5,5,15,2,22,7,65,3,3,6
10018,12,2016-11-25,texas,,Texas Christian,L (9-31),16,39,41.0,218,0,46,189,4.1,0,85,407,4.8,11,7,1,19,6,42,0,1,1
10019,,12 Games,texas,,,,241,402,60.0,3024,21,595,2882,4.8,27,997,5906,5.9,122,157,22,302,85,769,11,12,23
10020,1,2017-09-02,texas,,Maryland,L (41-51),34,53,64.2,375,2,31,98,3.2,1,84,473,5.6,19,8,2,26,11,117,1,1,2
10021,2,2017-09-09,texas,,San Jose State,W (56-0),16,29,55.2,217,1,59,406,6.9,6,88,623,7.1,10,21,1,32,6,68,0,0,0
10022,3,2017-09-16,texas,@,Southern California,L (24-27),21,40,52.5,298,2,35,68,1.9,0,75,366,4.9,13,3,1,17,10,73,2,2,4
10023,4,2017-09-28,texas,@,Iowa State,W (17-7),19,26,73.1,171,1,52,141,2.7,1,78,312,4.0,7,10,2,19,10,76,1,1,2
10024,5,2017-10-07,texas,,Kansas State,W (40-34),30,51,58.8,380,2,40,166,4.2,3,91,546,6.0,21,10,1,32,3,30,0,1,1
10025,6,2017-10-14,texas,N,Oklahoma,L (24-29),21,41,51.2,289,1,39,139,3.6,2,80,428,5.4,13,7,3,23,5,33,0,0,0
10026,7,2017-10-21,texas,,Oklahoma State,L (10-13),22,36,61.1,241,0,33,42,1.3,1,69,283,4.1,5,7,1,13,8,73,0,1,1
10027,8,2017-10-28,texas,@,Baylor,W (38-7),27,36,75.0,256,1,35,171,4.9,3,71,427,6.0,11,8,0,19,7,72,0,1,1
10028,9,2017-11-04,texas,@,Texas Christian,L (7-24),21,44,47.7,254,1,26,9,0.3,0,70,263,3.8,10,3,1,14,6,65,0,0,0
10029,10,2017-11-11,texas,,Kansas,W (42-27),24,34,70.6,258,2,40,113,2.8,3,74,371,5.0,9,8,1,18,8,68,1,1,2
10030,11,2017-11-18,texas,@,West Virginia,W (28-14),17,27,63.0,187,2,42,233,5.5,2,69,420,6.1,7,10,1,18,6,75,0,1,1
10031,12,2017-11-24,texas,,Texas Tech,L (23-27),29,51,56.9,272,1,33,116,3.5,1,84,388,4.6,11,6,1,18,5,37,2,2,4
10032,13,2017-12-27,texas,N,Missouri*,W (33-16),17,29,58.6,167,2,41,118,2.9,1,70,285,4.1,7,6,4,17,7,82,0,0,0
10033,,13 Games,texas,,,,298,497,60.0,3365,18,506,1820,3.6,24,1003,5185,5.2,143,107,19,266,92,869,7,11,18
10034,1,2018-09-01,texas,N,Maryland,L (29-34),21,39,53.8,263,2,36,142,3.9,2,75,405,5.4,10,9,1,20,10,102,1,2,3
10035,2,2018-09-08,texas,,Tulsa,W (28-21),21,27,77.8,237,2,47,241,5.1,2,74,478,6.5,9,12,3,24,8,65,1,0,1
10036,3,2018-09-15,texas,,Southern California,W (37-14),16,34,47.1,234,2,48,160,3.3,1,82,394,4.8,11,10,4,25,7,86,1,0,1
10037,4,2018-09-22,texas,,Texas Christian,W (31-16),22,32,68.8,255,2,45,112,2.5,2,77,367,4.8,14,6,0,20,4,25,0,0,0
10038,5,2018-09-29,texas,@,Kansas State,W (19-14),30,38,78.9,228,1,27,115,4.3,0,65,343,5.3,14,8,0,22,10,104,0,0,0
10039,6,2018-10-06,texas,N,Oklahoma,W (48-45),26,37,70.3,324,3,38,177,4.7,3,75,501,6.7,15,9,3,27,6,43,0,0,0
10040,7,2018-10-13,texas,,Baylor,W (23-17),24,39,61.5,219,1,41,170,4.1,1,80,389,4.9,13,9,3,25,8,56,0,1,1
10041,8,2018-10-27,texas,@,Oklahoma State,L (35-38),22,42,52.4,283,2,30,119,4.0,3,72,402,5.6,13,8,3,24,11,86,0,0,0
10042,9,2018-11-03,texas,,West Virginia,L (41-42),25,36,69.4,354,3,39,166,4.3,2,75,520,6.9,15,11,2,28,7,64,1,0,1
10043,10,2018-11-10,texas,@,Texas Tech,W (41-34),22,34,64.7,312,4,48,157,3.3,1,82,469,5.7,15,10,3,28,6,59,0,0,0
10044,11,2018-11-17,texas,,Iowa State,W (24-10),22,25,88.0,226,2,46,179,3.9,1,71,405,5.7,10,10,0,20,3,25,1,0,1
10045,,11 Games,texas,,,,251,383,65.5,2935,24,445,1738,3.9,18,828,4673,5.6,139,102,22,263,80,715,5,3,8
10046,1,2014-08-30,oklahoma,,Louisiana Tech,W (48-16),19,34,55.9,253,1,40,183,4.6,5,74,436,5.9,13,11,2,26,3,34,1,1,2
10047,2,2014-09-06,oklahoma,@,Tulsa,W (52-7),24,38,63.2,319,2,31,261,8.4,4,69,580,8.4,14,9,3,26,5,60,0,0,0
10048,3,2014-09-13,oklahoma,,Tennessee,W (34-10),20,33,60.6,308,1,34,146,4.3,2,67,454,6.8,14,7,0,21,5,41,1,1,2
10049,4,2014-09-20,oklahoma,@,West Virginia,W (45-33),17,30,56.7,209,1,46,301,6.5,4,76,510,6.7,10,13,1,24,8,82,0,1,1
10050,5,2014-10-04,oklahoma,@,Texas Christian,L (33-37),14,36,38.9,309,1,42,152,3.6,3,78,461,5.9,8,10,1,19,7,73,0,2,2
10051,6,2014-10-11,oklahoma,N,Texas,W (31-26),12,20,60.0,129,1,30,103,3.4,1,50,232,4.6,6,5,0,11,3,20,0,0,0
10052,7,2014-10-18,oklahoma,,Kansas State,L (30-31),28,36,77.8,335,3,42,198,4.7,1,78,533,6.8,15,14,1,30,3,19,0,2,2
10053,8,2014-11-01,oklahoma,@,Iowa State,W (59-14),23,43,53.5,241,3,59,510,8.6,5,102,751,7.4,11,29,1,41,5,60,0,3,3
10054,9,2014-11-08,oklahoma,,Baylor,L (14-48),13,29,44.8,148,2,33,171,5.2,0,62,319,5.1,5,8,0,13,7,59,0,1,1
10055,10,2014-11-15,oklahoma,@,Texas Tech,W (42-30),10,20,50.0,133,1,51,384,7.5,5,71,517,7.3,6,18,1,25,9,67,0,3,3
10056,11,2014-11-22,oklahoma,,Kansas,W (44-7),3,13,23.1,39,0,55,510,9.3,5,68,549,8.1,3,15,1,19,4,25,2,0,2
10057,12,2014-12-06,oklahoma,,Oklahoma State,L (35-38),10,17,58.8,120,1,63,304,4.8,4,80,424,5.3,7,11,3,21,3,28,1,0,1
10058,13,2014-12-29,oklahoma,N,Clemson*,L (6-40),17,37,45.9,103,0,31,172,5.5,1,68,275,4.0,6,11,0,17,8,80,2,3,5
10059,,13 Games,oklahoma,,,,210,386,54.4,2646,17,557,3395,6.1,40,943,6041,6.4,118,161,14,293,70,648,7,17,24
10060,1,2015-09-05,oklahoma,,Akron,W (41-3),28,42,66.7,439,3,33,100,3.0,2,75,539,7.2,18,5,3,26,9,90,1,1,2
10061,2,2015-09-12,oklahoma,@,Tennessee,W (31-24),19,39,48.7,187,3,48,161,3.4,1,87,348,4.0,7,9,4,20,9,67,0,2,2
10062,3,2015-09-19,oklahoma,,Tulsa,W (52-38),32,38,84.2,487,4,47,286,6.1,3,85,773,9.1,22,14,3,39,8,85,2,0,2
10063,4,2015-10-03,oklahoma,,West Virginia,W (44-24),14,25,56.0,320,3,33,107,3.2,1,58,427,7.4,11,3,2,16,12,134,1,1,2
10064,5,2015-10-10,oklahoma,N,Texas,L (17-24),20,28,71.4,211,1,37,67,1.8,1,65,278,4.3,12,6,3,21,5,45,1,0,1
10065,6,2015-10-17,oklahoma,@,Kansas State,W (55-0),25,32,78.1,336,5,52,232,4.5,1,84,568,6.8,18,12,0,30,3,24,0,0,0
10066,7,2015-10-24,oklahoma,,Texas Tech,W (63-27),15,22,68.2,212,2,57,405,7.1,7,79,617,7.8,9,24,2,35,3,34,1,1,2
10067,8,2015-10-31,oklahoma,@,Kansas,W (62-7),33,41,80.5,445,5,41,265,6.5,3,82,710,8.7,19,11,5,35,4,40,2,0,2
10068,9,2015-11-07,oklahoma,,Iowa State,W (52-16),25,33,75.8,405,4,39,279,7.2,3,72,684,9.5,14,13,1,28,2,10,1,0,1
10069,10,2015-11-14,oklahoma,@,Baylor,W (44-34),24,34,70.6,270,3,53,241,4.5,3,87,511,5.9,13,12,3,28,8,83,0,1,1
10070,11,2015-11-21,oklahoma,,Texas Christian,W (30-29),14,37,37.8,203,2,59,333,5.6,1,96,536,5.6,10,17,1,28,8,90,0,1,1
10071,12,2015-11-28,oklahoma,@,Oklahoma State,W (58-23),17,25,68.0,180,2,42,344,8.2,5,67,524,7.8,11,11,1,23,4,33,0,0,0
10072,13,2015-12-31,oklahoma,N,Clemson*,L (17-37),26,43,60.5,311,1,33,67,2.0,1,76,378,5.0,16,6,2,24,5,65,0,2,2
10073,,13 Games,oklahoma,,,,292,439,66.5,4006,38,574,2887,5.0,32,1013,6893,6.8,180,143,30,353,80,800,9,9,18
10074,1,2016-09-03,oklahoma,N,Houston,L (23-33),24,34,70.6,323,2,26,70,2.7,1,60,393,6.6,11,5,1,17,5,66,2,0,2
10075,2,2016-09-10,oklahoma,,Louisiana-Monroe,W (59-17),26,35,74.3,352,5,46,288,6.3,3,81,640,7.9,18,11,1,30,4,30,1,0,1
10076,3,2016-09-17,oklahoma,,Ohio State,L (24-45),17,32,53.1,226,2,35,178,5.1,0,67,404,6.0,9,9,1,19,4,28,0,2,2
10077,4,2016-10-01,oklahoma,@,Texas Christian,W (52-46),23,30,76.7,274,2,48,260,5.4,5,78,534,6.8,11,10,2,23,5,54,2,0,2
10078,5,2016-10-08,oklahoma,N,Texas,W (45-40),22,31,71.0,390,3,55,282,5.1,3,86,672,7.8,14,14,0,28,5,55,2,2,4
10079,6,2016-10-15,oklahoma,,Kansas State,W (38-17),26,32,81.3,372,5,33,138,4.2,0,65,510,7.8,15,9,0,24,3,35,0,1,1
10080,7,2016-10-22,oklahoma,@,Texas Tech,W (66-59),27,36,75.0,545,7,40,309,7.7,2,76,854,11.2,21,12,0,33,6,60,0,0,0
10081,8,2016-10-29,oklahoma,,Kansas,W (56-3),20,33,60.6,271,4,38,267,7.0,2,71,538,7.6,14,9,1,24,6,45,1,0,1
10082,9,2016-11-03,oklahoma,@,Iowa State,W (34-24),25,34,73.5,328,4,42,149,3.5,0,76,477,6.3,16,11,1,28,5,50,0,1,1
10083,10,2016-11-12,oklahoma,,Baylor,W (45-24),20,25,80.0,300,2,50,253,5.1,4,75,553,7.4,14,9,0,23,3,30,0,1,1
10084,11,2016-11-19,oklahoma,@,West Virginia,W (56-28),9,15,60.0,169,2,64,316,4.9,5,79,485,6.1,7,15,5,27,6,72,0,1,1
10085,12,2016-12-03,oklahoma,,Oklahoma State,W (38-20),13,19,68.4,288,3,52,341,6.6,2,71,629,8.9,12,11,2,25,4,54,1,0,1
10086,13,2017-01-02,oklahoma,N,Auburn*,W (35-19),19,28,67.9,296,2,43,228,5.3,3,71,524,7.4,14,11,3,28,10,100,0,0,0
10087,,13 Games,oklahoma,,,,271,384,70.6,4134,43,572,3079,5.4,30,956,7213,7.5,176,136,17,329,66,679,9,8,17
10088,1,2017-09-02,oklahoma,,Texas-El Paso,W (56-7),32,36,88.9,496,4,38,180,4.7,4,74,676,9.1,23,14,1,35,5,60,0,0,0
10089,2,2017-09-09,oklahoma,@,Ohio State,W (31-16),27,35,77.1,386,3,37,104,2.8,1,72,490,6.8,17,6,4,27,3,26,2,0,2
10090,3,2017-09-16,oklahoma,,Tulane,W (56-14),20,30,66.7,434,5,32,197,6.2,2,62,631,10.2,15,8,1,24,4,37,2,0,2
10091,4,2017-09-23,oklahoma,@,Baylor,W (49-41),13,19,68.4,283,3,40,342,8.6,4,59,625,10.6,8,12,0,20,10,105,1,0,1
10092,5,2017-10-07,oklahoma,,Iowa State,L (31-38),25,34,73.5,323,2,35,190,5.4,2,69,513,7.4,18,10,0,28,6,59,1,0,1
10093,6,2017-10-14,oklahoma,N,Texas,W (29-24),18,28,64.3,344,2,39,174,4.5,1,67,518,7.7,8,12,0,20,8,81,0,1,1
10094,7,2017-10-21,oklahoma,@,Kansas State,W (42-35),32,41,78.0,410,2,38,209,5.5,3,79,619,7.8,18,10,0,28,5,37,1,1,2
10095,8,2017-10-28,oklahoma,,Texas Tech,W (49-27),22,34,64.7,281,4,47,336,7.1,3,81,617,7.6,15,14,2,31,7,94,0,1,1
10096,9,2017-11-04,oklahoma,@,Oklahoma State,W (62-52),24,36,66.7,598,5,40,187,4.7,3,76,785,10.3,19,10,1,30,9,81,0,2,2
10097,10,2017-11-11,oklahoma,,Texas Christian,W (38-20),18,27,66.7,333,3,41,200,4.9,2,68,533,7.8,12,8,1,21,4,29,0,0,0
10098,11,2017-11-18,oklahoma,@,Kansas,W (41-3),23,35,65.7,312,3,36,157,4.4,2,71,469,6.6,15,6,3,24,8,63,0,0,0
10099,12,2017-11-25,oklahoma,,West Virginia,W (59-31),16,19,84.2,333,4,35,313,8.9,4,54,646,12.0,13,12,2,27,9,102,0,0,0
10100,13,2017-12-02,oklahoma,N,Texas Christian,W (41-17),15,23,65.2,243,4,43,218,5.1,0,66,461,7.0,10,10,2,22,3,30,0,0,0
10101,14,2018-01-01,oklahoma,N,Georgia*,L (48-54),24,36,66.7,289,3,45,242,5.4,2,81,531,6.6,11,11,2,24,1,5,0,1,1
10102,,14 Games,oklahoma,,,,309,433,71.4,5065,47,546,3049,5.6,33,979,8114,8.3,202,143,19,361,82,809,7,6,13
10103,1,2018-09-01,oklahoma,,Florida Atlantic,W (63-14),19,23,82.6,334,3,39,316,8.1,5,62,650,10.5,13,12,1,26,6,70,0,0,0
10104,2,2018-09-08,oklahoma,,UCLA,W (49-21),19,35,54.3,306,3,35,179,5.1,4,70,485,6.9,14,9,4,27,6,40,0,1,1
10105,3,2018-09-15,oklahoma,@,Iowa State,W (37-27),21,29,72.4,348,3,39,171,4.4,1,68,519,7.6,13,10,1,24,5,60,1,0,1
10106,4,2018-09-22,oklahoma,,Army,W (28-21),11,15,73.3,165,3,25,190,7.6,1,40,355,8.9,8,10,1,19,4,20,0,1,1
10107,5,2018-09-29,oklahoma,,Baylor,W (66-33),17,23,73.9,432,6,31,175,5.6,3,54,607,11.2,12,8,2,22,7,80,0,0,0
10108,6,2018-10-06,oklahoma,N,Texas,L (45-48),20,27,74.1,310,4,31,222,7.2,2,58,532,9.2,12,9,0,21,7,73,2,1,3
10109,7,2018-10-20,oklahoma,@,Texas Christian,W (52-27),19,25,76.0,213,4,47,323,6.9,3,72,536,7.4,11,15,0,26,8,60,0,0,0
10110,8,2018-10-27,oklahoma,,Kansas State,W (51-14),22,29,75.9,380,3,39,322,8.3,3,68,702,10.3,15,15,2,32,5,69,0,0,0
10111,9,2018-11-03,oklahoma,@,Texas Tech,W (51-46),20,35,57.1,360,3,44,323,7.3,4,79,683,8.6,15,16,1,32,10,113,0,2,2
10112,10,2018-11-10,oklahoma,,Oklahoma State,W (48-47),21,30,70.0,349,1,47,353,7.5,5,77,702,9.1,15,14,0,29,8,70,0,0,0
10113,11,2018-11-17,oklahoma,,Kansas,W (55-40),21,32,65.6,272,2,38,296,7.8,5,70,568,8.1,15,14,2,31,2,25,1,1,2
10114,,11 Games,oklahoma,,,,210,303,69.3,3469,35,415,2870,6.9,36,718,6339,8.8,143,132,14,289,68,680,4,6,10
10115,1,2014-08-30,arkansas,@,Auburn,L (21-45),18,31,58.1,175,2,29,153,5.3,1,60,328,5.5,9,9,2,20,4,40,0,1,1
10116,2,2014-09-06,arkansas,,Nicholls State,W (73-7),8,14,57.1,189,4,40,495,12.4,6,54,684,12.7,7,19,0,26,7,69,0,1,1
10117,3,2014-09-13,arkansas,@,Texas Tech,W (49-28),6,12,50.0,61,0,68,438,6.4,7,80,499,6.2,5,24,3,32,2,15,2,0,2
10118,4,2014-09-20,arkansas,,Northern Illinois,W (52-14),16,23,69.6,215,2,45,212,4.7,3,68,427,6.3,11,11,2,24,4,30,0,0,0
10119,5,2014-09-27,arkansas,N,Texas A&M,L (28-35),15,27,55.6,199,1,47,285,6.1,3,74,484,6.5,7,13,2,22,8,76,1,0,1
10120,6,2014-10-11,arkansas,,Alabama,L (13-14),21,40,52.5,246,1,39,89,2.3,1,79,335,4.2,12,5,1,18,4,28,2,1,3
10121,7,2014-10-18,arkansas,N,Georgia,L (32-45),28,45,62.2,296,3,37,126,3.4,2,82,422,5.1,13,9,7,29,7,79,2,2,4
10122,8,2014-10-25,arkansas,,Alabama-Birmingham,W (45-17),16,26,61.5,211,3,46,273,5.9,3,72,484,6.7,10,14,0,24,2,9,1,0,1
10123,9,2014-11-01,arkansas,@,Mississippi State,L (10-17),22,44,50.0,238,0,38,163,4.3,1,82,401,4.9,13,8,0,21,6,40,0,1,1
10124,10,2014-11-15,arkansas,,Louisiana State,W (17-0),16,27,59.3,169,0,38,95,2.5,2,65,264,4.1,10,6,1,17,4,43,0,0,0
10125,11,2014-11-22,arkansas,,Mississippi,W (30-0),8,17,47.1,152,1,50,159,3.2,1,67,311,4.6,7,10,0,17,6,44,1,0,1
10126,12,2014-11-28,arkansas,@,Missouri,L (14-21),13,30,43.3,133,2,30,155,5.2,0,60,288,4.8,9,7,2,18,12,93,2,0,2
10127,13,2014-12-29,arkansas,N,Texas*,W (31-7),12,23,52.2,160,2,50,191,3.8,1,73,351,4.8,7,11,2,20,2,15,0,0,0
10128,,13 Games,arkansas,,,,199,359,55.4,2444,21,557,2834,5.1,31,916,5278,5.8,120,146,22,288,68,581,11,6,17
10129,1,2015-09-05,arkansas,,Texas-El Paso,W (48-13),14,20,70.0,308,4,34,182,5.4,2,54,490,9.1,11,7,0,18,6,68,0,0,0
10130,2,2015-09-12,arkansas,N,Toledo,L (12-16),32,53,60.4,412,0,31,103,3.3,1,84,515,6.1,20,9,1,30,9,85,0,1,1
10131,3,2015-09-19,arkansas,,Texas Tech,L (24-35),16,21,76.2,196,2,43,228,5.3,1,64,424,6.6,10,12,1,23,5,43,1,1,2
10132,4,2015-09-26,arkansas,N,Texas A&M,L (21-28),20,25,80.0,225,1,42,232,5.5,2,67,457,6.8,11,13,1,25,11,93,1,1,2
10133,5,2015-10-03,arkansas,@,Tennessee,W (24-20),11,24,45.8,219,1,49,288,5.9,2,73,507,6.9,10,12,1,23,3,20,0,0,0
10134,6,2015-10-10,arkansas,@,Alabama,L (14-27),15,32,46.9,176,2,25,44,1.8,0,57,220,3.9,8,1,1,10,7,44,0,1,1
10135,7,2015-10-24,arkansas,,Auburn,W (54-46),20,32,62.5,244,3,49,213,4.3,4,81,457,5.6,14,14,1,29,3,25,0,1,1
10136,8,2015-10-31,arkansas,,Tennessee-Martin,W (63-28),15,20,75.0,300,3,36,291,8.1,6,56,591,10.6,10,12,0,22,3,25,0,0,0
10137,9,2015-11-07,arkansas,@,Mississippi,W (53-52),33,45,73.3,442,6,39,163,4.2,1,84,605,7.2,24,9,1,34,2,20,0,0,0
10138,10,2015-11-14,arkansas,@,Louisiana State,W (31-14),9,16,56.3,141,1,40,299,7.5,3,56,440,7.9,7,10,0,17,2,20,1,1,2
10139,11,2015-11-21,arkansas,,Mississippi State,L (50-51),30,43,69.8,406,7,29,73,2.5,0,72,479,6.7,21,2,1,24,1,9,0,0,0
10140,12,2015-11-27,arkansas,,Missouri,W (28-3),11,17,64.7,102,0,52,208,4.0,4,69,310,4.5,6,12,1,19,1,5,0,1,1
10141,13,2016-01-02,arkansas,N,Kansas State*,W (45-23),20,26,76.9,315,1,42,254,6.0,5,68,569,8.4,14,16,0,30,2,20,0,1,1
10142,,13 Games,arkansas,,,,246,374,65.8,3486,31,511,2578,5.0,31,885,6064,6.9,166,129,9,304,55,477,3,8,11
10143,1,2016-09-03,arkansas,,Louisiana Tech,W (21-20),20,29,69.0,191,2,40,106,2.7,1,69,297,4.3,12,8,1,21,4,35,0,2,2
10144,2,2016-09-10,arkansas,@,Texas Christian,W (41-38),17,29,58.6,223,3,43,180,4.2,1,72,403,5.6,11,9,0,20,5,45,0,0,0
10145,3,2016-09-17,arkansas,,Texas State,W (42-3),16,22,72.7,241,2,44,226,5.1,3,66,467,7.1,9,15,2,26,7,40,1,0,1
10146,4,2016-09-24,arkansas,N,Texas A&M,L (24-45),28,42,66.7,371,2,40,120,3.0,1,82,491,6.0,17,4,6,27,7,62,3,0,3
10147,5,2016-10-01,arkansas,,Alcorn State,W (52-10),13,18,72.2,206,3,38,353,9.3,3,56,559,10.0,8,17,0,25,4,45,1,0,1
10148,6,2016-10-08,arkansas,,Alabama,L (30-49),25,48,52.1,400,3,36,73,2.0,1,84,473,5.6,13,7,5,25,6,60,2,3,5
10149,7,2016-10-15,arkansas,,Mississippi,W (34-30),19,32,59.4,229,3,51,200,3.9,1,83,429,5.2,13,12,2,27,6,71,0,1,1
10150,8,2016-10-22,arkansas,@,Auburn,L (3-56),18,33,54.5,190,0,31,25,0.8,0,64,215,3.4,10,4,0,14,4,29,1,1,2
10151,9,2016-11-05,arkansas,,Florida,W (31-10),15,26,57.7,243,1,49,223,4.6,2,75,466,6.2,10,9,3,22,9,97,0,1,1
10152,10,2016-11-12,arkansas,,Louisiana State,L (10-38),15,31,48.4,210,1,24,81,3.4,0,55,291,5.3,8,4,1,13,7,56,1,2,3
10153,11,2016-11-19,arkansas,@,Mississippi State,W (58-42),19,26,73.1,304,3,40,359,9.0,5,66,663,10.0,14,13,0,27,1,10,0,0,0
10154,12,2016-11-25,arkansas,@,Missouri,L (24-28),24,39,61.5,348,1,46,155,3.4,2,85,503,5.9,14,13,0,27,8,55,0,2,2
10155,13,2016-12-29,arkansas,N,Virginia Tech*,L (24-35),18,31,58.1,278,2,34,36,1.1,1,65,314,4.8,11,1,2,16,12,70,1,3,4
10156,,13 Games,arkansas,,,,247,406,60.8,3434,26,516,2137,4.1,21,922,5571,6.0,150,116,22,290,80,675,10,15,25
10157,1,2017-08-31,arkansas,N,Florida A&M,W (49-7),16,22,72.7,179,2,45,236,5.2,4,67,415,6.2,9,16,1,26,2,20,0,1,1
10158,2,2017-09-09,arkansas,,Texas Christian,L (7-28),9,23,39.1,138,1,31,129,4.2,0,54,267,4.9,6,5,2,13,5,49,1,0,1
10159,3,2017-09-23,arkansas,N,Texas A&M,L (43-50),13,27,48.1,231,3,45,226,5.0,3,72,457,6.3,8,12,1,21,9,69,0,1,1
10160,4,2017-09-30,arkansas,,New Mexico State,W (42-24),19,26,73.1,264,3,51,230,4.5,3,77,494,6.4,13,13,3,29,3,35,0,1,1
10161,5,2017-10-07,arkansas,@,South Carolina,L (22-48),20,37,54.1,224,2,32,106,3.3,1,69,330,4.8,11,7,1,19,4,25,2,2,4
10162,6,2017-10-14,arkansas,@,Alabama,L (9-41),23,43,53.5,200,1,29,27,0.9,0,72,227,3.2,9,3,3,15,5,25,0,1,1
10163,7,2017-10-21,arkansas,,Auburn,L (20-52),15,26,57.7,163,0,42,171,4.1,1,68,334,4.9,7,10,2,19,7,50,3,0,3
10164,8,2017-10-28,arkansas,@,Mississippi,W (38-37),19,30,63.3,189,3,53,260,4.9,1,83,449,5.4,10,15,2,27,1,10,1,1,2
10165,9,2017-11-04,arkansas,,Coastal Carolina,W (39-38),16,25,64.0,264,1,35,259,7.4,4,60,523,8.7,8,13,0,21,5,52,1,0,1
10166,10,2017-11-11,arkansas,@,Louisiana State,L (10-33),16,33,48.5,176,0,34,142,4.2,1,67,318,4.7,10,6,1,17,5,59,0,1,1
10167,11,2017-11-18,arkansas,,Mississippi State,L (21-28),12,18,66.7,124,0,34,97,2.9,2,52,221,4.3,7,3,2,12,4,35,1,0,1
10168,12,2017-11-24,arkansas,,Missouri,L (45-48),14,30,46.7,313,2,31,133,4.3,4,61,446,7.3,10,7,2,19,8,76,0,1,1
10169,,12 Games,arkansas,,,,192,340,56.5,2465,18,462,2016,4.4,24,802,4481,5.6,108,110,20,238,58,505,9,9,18
10170,1,2018-09-01,arkansas,,Eastern Illinois,W (55-20),21,29,72.4,353,4,37,80,2.2,2,66,433,6.6,13,5,0,18,4,40,0,0,0
10171,2,2018-09-08,arkansas,@,Colorado State,L (27-34),11,22,50.0,138,2,53,299,5.6,1,75,437,5.8,5,16,3,24,6,60,0,2,2
10172,3,2018-09-15,arkansas,,North Texas,L (17-44),20,45,44.4,210,0,32,126,3.9,2,77,336,4.4,12,4,4,20,10,70,0,6,6
10173,4,2018-09-22,arkansas,@,Auburn,L (3-34),13,32,40.6,141,0,38,149,3.9,0,70,290,4.1,5,6,2,13,8,57,1,1,2
10174,5,2018-09-29,arkansas,N,Texas A&M,L (17-24),14,27,51.9,193,1,26,55,2.1,1,53,248,4.7,8,3,0,11,6,61,0,1,1
10175,6,2018-10-06,arkansas,,Alabama,L (31-65),26,40,65.0,233,3,31,172,5.5,1,71,405,5.7,12,7,3,22,2,20,2,1,3
10176,7,2018-10-13,arkansas,,Mississippi,L (33-37),15,22,68.2,177,2,48,299,6.2,1,70,476,6.8,7,17,3,27,5,65,0,1,1
10177,8,2018-10-20,arkansas,,Tulsa,W (23-0),11,19,57.9,131,1,53,196,3.7,1,72,327,4.5,6,12,2,20,3,40,1,1,2
10178,9,2018-10-27,arkansas,,Vanderbilt,L (31-45),23,36,63.9,240,2,29,207,7.1,2,65,447,6.9,12,8,1,21,6,46,0,2,2
10179,10,2018-11-10,arkansas,,Louisiana State,L (17-24),19,39,48.7,200,2,19,16,0.8,0,58,216,3.7,9,2,3,14,6,60,1,1,2
10180,11,2018-11-17,arkansas,@,Mississippi State,L (6-52),19,34,55.9,150,0,35,69,2.0,0,69,219,3.2,6,10,1,17,9,85,2,1,3
10181,,11 Games,arkansas,,,,192,345,55.7,2166,17,401,1668,4.2,11,746,3834,5.1,95,90,22,207,65,604,7,17,24
10182,1,2014-08-30,rice,@,Notre Dame,L (17-48),15,26,57.7,226,2,40,141,3.5,0,66,367,5.6,9,7,0,16,5,30,1,1,2
10183,2,2014-09-13,rice,@,Texas A&M,L (10-38),24,36,66.7,241,1,55,240,4.4,0,91,481,5.3,15,11,2,28,8,66,0,0,0
10184,3,2014-09-20,rice,,Old Dominion,L (42-45),22,34,64.7,242,2,54,284,5.3,4,88,526,6.0,11,18,1,30,5,50,0,0,0
10185,4,2014-09-27,rice,@,Southern Mississippi,W (41-23),14,22,63.6,178,2,48,217,4.5,3,70,395,5.6,7,12,1,20,6,65,0,1,1
10186,5,2014-10-04,rice,,Hawaii,W (28-14),10,23,43.5,248,2,44,143,3.3,2,67,391,5.8,7,9,1,17,3,40,2,1,3
10187,6,2014-10-11,rice,@,Army,W (41-21),15,21,71.4,209,3,41,182,4.4,2,62,391,6.3,9,7,1,17,5,41,0,0,0
10188,7,2014-10-25,rice,,North Texas,W (41-21),13,26,50.0,233,1,46,188,4.1,3,72,421,5.8,9,9,2,20,4,50,0,0,0
10189,8,2014-11-01,rice,@,Florida International,W (31-17),11,25,44.0,230,2,38,169,4.4,2,63,399,6.3,8,8,1,17,2,15,0,0,0
10190,9,2014-11-08,rice,,Texas-San Antonio,W (17-7),18,28,64.3,213,1,56,200,3.6,1,84,413,4.9,9,11,2,22,8,69,0,1,1
10191,10,2014-11-15,rice,@,Marshall,L (14-41),11,23,47.8,99,0,35,81,2.3,2,58,180,3.1,7,5,3,15,2,19,0,0,0
10192,11,2014-11-21,rice,,Texas-El Paso,W (31-13),10,22,45.5,227,2,42,165,3.9,2,64,392,6.1,8,9,0,17,12,95,0,1,1
10193,12,2014-11-29,rice,@,Louisiana Tech,L (31-76),25,40,62.5,337,4,32,34,1.1,0,72,371,5.2,13,4,0,17,5,55,1,3,4
10194,13,2014-12-24,rice,N,Fresno State*,W (30-6),16,26,61.5,326,3,40,137,3.4,1,66,463,7.0,8,7,1,16,12,100,0,0,0
10195,,13 Games,rice,,,,204,352,58.0,3009,25,571,2181,3.8,22,923,5190,5.6,120,117,15,252,77,695,4,8,12
10196,1,2015-09-05,rice,,Wagner,W (56-16),12,21,57.1,142,1,54,401,7.4,7,75,543,7.2,6,21,1,28,4,49,1,1,2
10197,2,2015-09-12,rice,@,Texas,L (28-42),23,38,60.5,234,2,58,228,3.9,2,96,462,4.8,14,15,1,30,6,55,2,3,5
10198,3,2015-09-19,rice,@,North Texas,W (38-24),29,39,74.4,373,3,51,189,3.7,2,90,562,6.2,15,12,1,28,7,60,0,0,0
10199,4,2015-09-26,rice,@,Baylor,L (17-70),11,21,52.4,152,1,45,94,2.1,1,66,246,3.7,6,8,6,20,9,70,2,0,2
10200,5,2015-10-03,rice,,Western Kentucky,L (10-49),16,30,53.3,237,0,34,85,2.5,1,64,322,5.0,10,4,1,15,8,70,3,2,5
10201,6,2015-10-10,rice,@,Florida Atlantic,W (27-26),22,35,62.9,284,3,50,203,4.1,1,85,487,5.7,13,15,1,29,10,88,1,0,1
10202,7,2015-10-24,rice,,Army,W (38-31),20,30,66.7,267,2,35,165,4.7,3,65,432,6.6,14,6,1,21,8,64,2,0,2
10203,8,2015-10-30,rice,,Louisiana Tech,L (17-42),14,28,50.0,180,2,33,101,3.1,0,61,281,4.6,9,5,1,15,8,62,0,0,0
10204,9,2015-11-06,rice,@,Texas-El Paso,L (21-24),14,28,50.0,230,2,30,96,3.2,1,58,326,5.6,9,6,1,16,5,42,0,0,0
10205,10,2015-11-14,rice,,Southern Mississippi,L (10-65),13,36,36.1,107,1,35,107,3.1,0,71,214,3.0,7,6,2,15,7,67,1,0,1
10206,11,2015-11-21,rice,@,Texas-San Antonio,L (24-34),23,41,56.1,359,2,46,161,3.5,1,87,520,6.0,19,8,1,28,7,70,1,2,3
10207,12,2015-11-28,rice,,UNC Charlotte,W (27-7),15,26,57.7,126,1,61,307,5.0,2,87,433,5.0,7,17,4,28,5,55,0,1,1
10208,,12 Games,rice,,,,212,373,56.8,2691,20,532,2137,4.0,21,905,4828,5.3,129,123,21,273,84,752,13,9,22
10209,1,2016-09-01,rice,@,Western Kentucky,L (14-46),23,38,60.5,186,0,33,105,3.2,2,71,291,4.1,10,7,3,20,10,62,0,2,2
10210,2,2016-09-10,rice,@,Army,L (14-31),16,30,53.3,197,1,21,92,4.4,1,51,289,5.7,8,4,0,12,6,55,1,1,2
10211,3,2016-09-16,rice,,Baylor,L (10-38),9,27,33.3,31,0,42,234,5.6,1,69,265,3.8,3,8,3,14,3,21,1,0,1
10212,4,2016-09-24,rice,,North Texas,L (35-42),24,40,60.0,236,1,60,255,4.3,3,100,491,4.9,8,16,4,28,8,65,2,1,3
10213,5,2016-10-01,rice,@,Southern Mississippi,L (28-44),16,20,80.0,166,2,45,180,4.0,2,65,346,5.3,7,12,0,19,8,81,0,0,0
10214,6,2016-10-15,rice,,Texas-San Antonio,L (13-14),23,37,62.2,237,1,32,114,3.6,1,69,351,5.1,11,9,2,22,3,20,1,0,1
10215,7,2016-10-22,rice,,Prairie View A&M,W (65-44),23,32,71.9,434,6,36,203,5.6,3,68,637,9.4,14,9,5,28,10,86,0,0,0
10216,8,2016-10-29,rice,@,Louisiana Tech,L (16-61),15,27,55.6,152,0,43,153,3.6,2,70,305,4.4,7,10,1,18,1,6,1,1,2
10217,9,2016-11-05,rice,,Florida Atlantic,L (25-42),20,33,60.6,281,1,45,159,3.5,2,78,440,5.6,10,10,3,23,6,61,1,2,3
10218,10,2016-11-12,rice,@,UNC Charlotte,W (22-21),36,52,69.2,292,1,42,141,3.4,2,94,433,4.6,18,9,1,28,6,57,0,2,2
10219,11,2016-11-19,rice,,Texas-El Paso,W (44-24),21,28,75.0,246,3,44,236,5.4,2,72,482,6.7,10,15,2,27,3,17,1,1,2
10220,12,2016-11-26,rice,@,Stanford,L (17-41),15,48,31.3,124,0,39,167,4.3,2,87,291,3.3,6,14,1,21,5,35,0,0,0
10221,,12 Games,rice,,,,241,412,58.5,2582,16,482,2039,4.2,23,894,4621,5.2,112,123,25,260,69,566,8,10,18
10222,1,2017-08-26,rice,N,Stanford,L (7-62),10,24,41.7,95,0,38,146,3.8,1,62,241,3.9,5,8,1,14,6,45,1,1,2
10223,2,2017-09-09,rice,@,Texas-El Paso,W (31-14),10,18,55.6,131,1,49,306,6.2,3,67,437,6.5,6,16,0,22,4,31,1,0,1
10224,3,2017-09-16,rice,@,Houston,L (3-38),11,25,44.0,113,0,35,129,3.7,0,60,242,4.0,7,7,0,14,2,15,2,1,3
10225,4,2017-09-23,rice,,Florida International,L (7-13),16,27,59.3,148,0,41,100,2.4,1,68,248,3.6,11,6,2,19,4,30,0,1,1
10226,5,2017-09-30,rice,@,Pittsburgh,L (10-42),15,32,46.9,222,1,23,55,2.4,0,55,277,5.0,9,4,1,14,4,37,0,3,3
10227,6,2017-10-07,rice,,Army,L (12-49),9,21,42.9,146,1,37,200,5.4,1,58,346,6.0,5,12,0,17,3,33,5,1,6
10228,7,2017-10-21,rice,@,Texas-San Antonio,L (7-20),6,14,42.9,145,1,41,155,3.8,0,55,300,5.5,4,8,1,13,7,70,1,2,3
10229,8,2017-10-28,rice,,Louisiana Tech,L (28-42),7,17,41.2,187,1,46,247,5.4,3,63,434,6.9,5,14,0,19,5,49,1,3,4
10230,9,2017-11-04,rice,@,Alabama-Birmingham,L (21-52),14,24,58.3,227,1,35,236,6.7,2,59,463,7.8,9,8,0,17,6,50,1,2,3
10231,10,2017-11-11,rice,,Southern Mississippi,L (34-43),10,16,62.5,127,0,49,254,5.2,5,65,381,5.9,7,14,5,26,3,30,0,0,0
10232,11,2017-11-18,rice,@,Old Dominion,L (21-24),8,12,66.7,90,0,50,241,4.8,3,62,331,5.3,5,13,0,18,4,30,1,1,2
10233,12,2017-11-25,rice,,North Texas,L (14-30),6,16,37.5,107,0,42,175,4.2,1,58,282,4.9,3,10,0,13,5,40,0,1,1
10234,,12 Games,rice,,,,122,246,49.6,1738,6,486,2244,4.6,20,732,3982,5.4,76,120,10,206,53,460,13,16,29
10235,1,2018-08-25,rice,,Prairie View A&M,W (31-28),12,24,50.0,87,0,50,310,6.2,3,74,397,5.4,4,16,2,22,7,54,0,0,0
10236,2,2018-09-01,rice,,Houston,L (27-45),24,41,58.5,292,3,43,147,3.4,0,84,439,5.2,14,5,3,22,6,57,0,1,1
10237,3,2018-09-08,rice,@,Hawaii,L (29-43),20,33,60.6,299,2,39,147,3.8,1,72,446,6.2,11,8,2,21,5,54,1,1,2
10238,4,2018-09-22,rice,@,Southern Mississippi,L (22-40),13,26,50.0,125,2,29,137,4.7,1,55,262,4.8,7,5,0,12,3,30,0,2,2
10239,5,2018-09-29,rice,@,Wake Forest,L (24-56),17,32,53.1,103,2,44,267,6.1,1,76,370,4.9,9,9,1,19,6,55,1,2,3
10240,6,2018-10-06,rice,,Texas-San Antonio,L (3-20),16,30,53.3,175,0,37,47,1.3,0,67,222,3.3,8,2,1,11,4,20,2,2,4
10241,7,2018-10-13,rice,,Alabama-Birmingham,L (0-42),13,28,46.4,136,0,37,50,1.4,0,65,186,2.9,7,1,1,9,5,42,1,0,1
10242,8,2018-10-20,rice,@,Florida International,L (17-36),12,21,57.1,115,0,29,125,4.3,2,50,240,4.8,6,10,0,16,0,0,0,3,3
10243,9,2018-10-27,rice,@,North Texas,L (17-41),21,37,56.8,204,1,37,95,2.6,1,74,299,4.0,12,6,0,18,8,99,1,0,1
10244,10,2018-11-03,rice,,Texas-El Paso,L (26-34),17,32,53.1,313,2,28,70,2.5,1,60,383,6.4,10,4,2,16,7,45,1,2,3
10245,11,2018-11-10,rice,@,Louisiana Tech,L (13-28),19,35,54.3,226,1,29,100,3.4,0,64,326,5.1,8,7,0,15,1,3,0,3,3
10246,12,2018-11-17,rice,@,Louisiana State,L (10-42),7,15,46.7,101,0,43,97,2.3,1,58,198,3.4,6,8,1,15,3,22,0,0,0
10247,,12 Games,rice,,,,191,354,54.0,2176,13,445,1592,3.6,11,799,3768,4.7,102,81,13,196,55,481,7,16,23
10248,1,2014-08-31,baylor,,Southern Methodist,W (45-0),27,47,57.4,313,3,50,261,5.2,3,97,574,5.9,15,15,1,31,11,96,1,1,2
10249,2,2014-09-06,baylor,,Northwestern State,W (70-6),19,28,67.9,455,5,50,265,5.3,5,78,720,9.2,12,19,1,32,10,91,2,0,2
10250,3,2014-09-12,baylor,@,Buffalo,W (63-21),25,37,67.6,480,5,41,189,4.6,4,78,669,8.6,17,10,0,27,5,40,0,0,0
10251,4,2014-09-27,baylor,@,Iowa State,W (49-28),32,50,64.0,357,1,47,244,5.2,6,97,601,6.2,17,12,3,32,10,78,0,1,1
10252,5,2014-10-04,baylor,@,Texas,W (28-7),7,22,31.8,111,2,60,278,4.6,1,82,389,4.7,5,17,0,22,10,95,0,0,0
10253,6,2014-10-11,baylor,,Texas Christian,W (61-58),28,55,50.9,510,6,54,272,5.0,1,109,782,7.2,17,18,4,39,12,117,1,2,3
10254,7,2014-10-18,baylor,@,West Virginia,L (27-41),16,37,43.2,223,2,42,95,2.3,1,79,318,4.0,10,5,7,22,18,215,0,0,0
10255,8,2014-11-01,baylor,,Kansas,W (60-14),21,36,58.3,343,3,52,326,6.3,4,88,669,7.6,12,17,1,30,6,54,0,0,0
10256,9,2014-11-08,baylor,@,Oklahoma,W (48-14),33,43,76.7,396,1,52,148,2.8,5,95,544,5.7,20,9,2,31,7,40,0,0,0
10257,10,2014-11-22,baylor,,Oklahoma State,W (49-28),18,29,62.1,262,2,58,317,5.5,5,87,579,6.7,10,19,0,29,12,68,0,2,2
10258,11,2014-11-29,baylor,N,Texas Tech,W (48-46),26,42,61.9,292,3,54,255,4.7,3,96,547,5.7,17,14,6,37,8,80,1,0,1
10259,12,2014-12-06,baylor,,Kansas State,W (38-27),34,41,82.9,412,1,37,172,4.6,4,78,584,7.5,24,10,0,34,7,70,0,1,1
10260,13,2015-01-01,baylor,N,Michigan State*,L (41-42),37,52,71.2,603,4,22,-20,-0.9,1,74,583,7.9,17,6,2,25,11,105,0,1,1
10261,,13 Games,baylor,,,,323,519,62.2,4757,38,619,2802,4.5,43,1138,7559,6.6,193,171,27,391,127,1149,5,8,13
10262,1,2015-09-04,baylor,@,Southern Methodist,W (56-21),17,32,53.1,423,6,37,300,8.1,2,69,723,10.5,12,14,1,27,13,105,0,1,1
10263,2,2015-09-12,baylor,,Lamar,W (66-31),26,38,68.4,373,4,56,412,7.4,5,94,785,8.4,16,21,1,38,12,93,1,3,4
10264,3,2015-09-26,baylor,,Rice,W (70-17),19,25,76.0,366,7,53,427,8.1,3,78,793,10.2,15,23,1,39,14,145,1,0,1
10265,4,2015-10-03,baylor,N,Texas Tech,W (63-35),16,24,66.7,312,4,52,368,7.1,5,76,680,8.9,12,12,2,26,8,72,0,1,1
10266,5,2015-10-10,baylor,@,Kansas,W (66-7),27,37,73.0,363,5,45,281,6.2,3,82,644,7.9,16,17,1,34,4,33,1,0,1
10267,6,2015-10-17,baylor,,West Virginia,W (62-38),21,34,61.8,389,6,50,304,6.1,2,84,693,8.3,15,16,3,34,6,80,0,0,0
10268,7,2015-10-24,baylor,,Iowa State,W (45-27),17,38,44.7,209,3,49,276,5.6,3,87,485,5.6,10,16,1,27,9,48,1,1,2
10269,8,2015-11-05,baylor,@,Kansas State,W (31-24),23,33,69.7,419,3,34,103,3.0,1,67,522,7.8,14,5,1,20,11,119,0,0,0
10270,9,2015-11-14,baylor,,Oklahoma,L (34-44),16,27,59.3,257,2,44,159,3.6,3,71,416,5.9,9,7,2,18,6,66,1,2,3
10271,10,2015-11-21,baylor,@,Oklahoma State,W (45-35),17,31,54.8,396,3,73,304,4.2,3,104,700,6.7,11,21,0,32,8,55,2,1,3
10272,11,2015-11-27,baylor,@,Texas Christian,L (21-28),7,24,29.2,62,1,71,273,3.8,2,95,335,3.5,3,16,2,21,6,50,4,1,5
10273,12,2015-12-05,baylor,,Texas,L (17-23),13,28,46.4,84,0,66,395,6.0,2,94,479,5.1,5,22,2,29,10,60,2,2,4
10274,13,2015-12-29,baylor,N,North Carolina*,W (49-38),10,18,55.6,111,0,82,651,7.9,7,100,762,7.6,6,30,2,38,11,117,0,1,1
10275,,13 Games,baylor,,,,229,389,58.9,3764,44,712,4253,6.0,41,1101,8017,7.3,144,220,19,383,118,1043,13,13,26
10276,1,2016-09-02,baylor,,Northwestern State,W (55-7),19,29,65.5,223,5,43,275,6.4,2,72,498,6.9,10,13,0,23,12,93,1,0,1
10277,2,2016-09-10,baylor,,Southern Methodist,W (40-13),26,48,54.2,261,2,55,275,5.0,2,103,536,5.2,9,18,2,29,14,101,1,2,3
10278,3,2016-09-16,baylor,@,Rice,W (38-10),23,42,54.8,342,3,54,296,5.5,2,96,638,6.6,15,16,0,31,8,85,0,1,1
10279,4,2016-09-24,baylor,,Oklahoma State,W (35-24),18,28,64.3,387,4,37,136,3.7,1,65,523,8.0,11,8,1,20,7,70,1,1,2
10280,5,2016-10-01,baylor,@,Iowa State,W (45-42),12,22,54.5,178,1,62,469,7.6,5,84,647,7.7,6,22,2,30,9,79,0,0,0
10281,6,2016-10-15,baylor,,Kansas,W (49-7),13,30,43.3,207,2,49,246,5.0,4,79,453,5.7,4,15,1,20,6,38,1,0,1
10282,7,2016-10-29,baylor,@,Texas,L (34-35),14,28,50.0,226,2,68,398,5.9,2,96,624,6.5,9,22,0,31,10,39,1,1,2
10283,8,2016-11-05,baylor,,Texas Christian,L (22-62),22,43,51.2,282,1,45,133,3.0,2,88,415,4.7,11,7,1,19,11,121,0,1,1
10284,9,2016-11-12,baylor,@,Oklahoma,L (24-45),21,46,45.7,292,2,45,212,4.7,1,91,504,5.5,12,11,1,24,9,55,1,2,3
10285,10,2016-11-19,baylor,,Kansas State,L (21-42),27,46,58.7,258,3,33,110,3.3,0,79,368,4.7,11,8,3,22,9,84,1,3,4
10286,11,2016-11-25,baylor,N,Texas Tech,L (35-54),30,47,63.8,377,3,53,257,4.8,2,100,634,6.3,15,15,2,32,11,78,3,1,4
10287,12,2016-12-03,baylor,@,West Virginia,L (21-24),15,31,48.4,244,2,41,196,4.8,1,72,440,6.1,12,7,0,19,12,100,2,2,4
10288,13,2016-12-27,baylor,N,Boise State*,W (31-12),29,40,72.5,375,3,43,140,3.3,1,83,515,6.2,16,12,1,29,11,125,0,1,1
10289,,13 Games,baylor,,,,269,480,56.0,3652,33,628,3143,5.0,25,1108,6795,6.1,141,174,14,329,129,1068,12,15,27
10290,1,2017-09-02,baylor,,Liberty,L (45-48),14,30,46.7,278,3,34,254,7.5,3,64,532,8.3,9,10,3,22,7,61,0,2,2
10291,2,2017-09-09,baylor,,Texas-San Antonio,L (10-17),11,27,40.7,137,1,31,137,4.4,0,58,274,4.7,5,7,2,14,10,98,0,1,1
10292,3,2017-09-16,baylor,@,Duke,L (20-34),12,34,35.3,263,3,27,57,2.1,0,61,320,5.2,6,3,0,9,11,100,1,3,4
10293,4,2017-09-23,baylor,,Oklahoma,L (41-49),33,50,66.0,463,4,35,60,1.7,0,85,523,6.2,19,2,1,22,6,29,1,0,1
10294,5,2017-09-30,baylor,@,Kansas State,L (20-33),26,44,59.1,291,1,27,84,3.1,1,71,375,5.3,13,4,1,18,10,60,1,1,2
10295,6,2017-10-14,baylor,@,Oklahoma State,L (16-59),14,36,38.9,168,0,46,219,4.8,1,82,387,4.7,10,11,1,22,5,39,1,2,3
10296,7,2017-10-21,baylor,,West Virginia,L (36-38),24,40,60.0,370,2,42,127,3.0,2,82,497,6.1,13,9,8,30,6,20,0,0,0
10297,8,2017-10-28,baylor,,Texas,L (7-38),21,38,55.3,218,0,37,31,0.8,1,75,249,3.3,5,6,1,12,6,34,2,1,3
10298,9,2017-11-04,baylor,@,Kansas,W (38-9),24,30,80.0,335,3,39,120,3.1,2,69,455,6.6,13,7,0,20,7,60,0,0,0
10299,10,2017-11-11,baylor,N,Texas Tech,L (24-38),43,63,68.3,417,3,29,106,3.7,0,92,523,5.7,21,7,3,31,6,65,3,1,4
10300,11,2017-11-18,baylor,,Iowa State,L (13-23),26,36,72.2,198,1,38,133,3.5,0,74,331,4.5,13,10,2,25,4,30,1,1,2
10301,12,2017-11-24,baylor,@,Texas Christian,L (22-45),21,34,61.8,314,2,29,79,2.7,0,63,393,6.2,10,4,0,14,10,75,1,2,3
10302,,12 Games,baylor,,,,269,462,58.2,3452,23,414,1407,3.4,10,876,4859,5.5,137,80,22,239,88,671,11,14,25
10303,1,2018-09-01,baylor,,Abilene Christian,W (55-27),18,28,64.3,311,2,36,295,8.2,5,64,606,9.5,12,14,0,26,5,53,0,1,1
10304,2,2018-09-08,baylor,@,Texas-San Antonio,W (37-20),27,41,65.9,403,3,31,91,2.9,1,72,494,6.9,16,7,3,26,7,70,1,0,1
10305,3,2018-09-15,baylor,,Duke,L (27-40),24,42,57.1,270,1,32,130,4.1,2,74,400,5.4,12,9,0,21,6,62,1,1,2
10306,4,2018-09-22,baylor,,Kansas,W (26-7),20,29,69.0,257,3,39,190,4.9,0,68,447,6.6,10,10,2,22,13,141,0,0,0
10307,5,2018-09-29,baylor,@,Oklahoma,L (33-66),40,63,63.5,416,2,38,77,2.0,2,101,493,4.9,18,11,4,33,9,75,1,0,1
10308,6,2018-10-06,baylor,,Kansas State,W (37-34),30,45,66.7,296,1,48,261,5.4,3,93,557,6.0,19,17,2,38,2,10,0,2,2
10309,7,2018-10-13,baylor,@,Texas,L (17-23),20,39,51.3,240,1,34,88,2.6,1,73,328,4.5,10,8,1,19,10,142,0,1,1
10310,8,2018-10-25,baylor,@,West Virginia,L (14-58),17,29,58.6,205,0,36,82,2.3,2,65,287,4.4,9,7,1,17,8,75,1,3,4
10311,9,2018-11-03,baylor,,Oklahoma State,W (35-31),14,26,53.8,158,2,39,244,6.3,2,65,402,6.2,6,12,8,26,6,69,0,1,1
10312,10,2018-11-10,baylor,@,Iowa State,L (14-28),29,48,60.4,359,2,32,146,4.6,0,80,505,6.3,15,9,1,25,7,70,0,0,0
10313,11,2018-11-17,baylor,,Texas Christian,L (9-16),14,29,48.3,163,0,40,140,3.5,1,69,303,4.4,7,10,3,20,9,66,2,1,3
10314,,11 Games,baylor,,,,253,419,60.4,3078,17,405,1744,4.3,19,824,4822,5.9,134,114,25,273,82,833,6,10,16
10315,1,2014-08-30,kansas-state,,Stephen F. Austin,W (55-16),20,30,66.7,238,3,51,240,4.7,4,81,478,5.9,13,16,0,29,3,15,0,1,1
10316,2,2014-09-06,kansas-state,@,Iowa State,W (32-28),16,29,55.2,239,0,41,232,5.7,4,70,471,6.7,9,12,3,24,10,77,0,0,0
10317,3,2014-09-18,kansas-state,,Auburn,L (14-20),24,40,60.0,245,0,30,40,1.3,2,70,285,4.1,13,4,3,20,0,0,1,2,3
10318,4,2014-09-27,kansas-state,,Texas-El Paso,W (58-28),13,19,68.4,263,1,37,188,5.1,6,56,451,8.1,9,7,0,16,6,55,1,0,1
10319,5,2014-10-04,kansas-state,,Texas Tech,W (45-13),24,31,77.4,290,4,50,245,4.9,2,81,535,6.6,13,12,4,29,1,15,1,0,1
10320,6,2014-10-18,kansas-state,@,Oklahoma,W (31-30),15,23,65.2,225,2,32,160,5.0,1,55,385,7.0,8,9,0,17,2,20,0,0,0
10321,7,2014-10-25,kansas-state,,Texas,W (23-0),19,30,63.3,224,0,43,143,3.3,2,73,367,5.0,9,10,3,22,3,25,0,0,0
10322,8,2014-11-01,kansas-state,,Oklahoma State,W (48-14),20,33,60.6,287,2,33,134,4.1,3,66,421,6.4,11,7,3,21,2,15,0,1,1
10323,9,2014-11-08,kansas-state,@,Texas Christian,L (20-41),22,40,55.0,376,2,19,34,1.8,1,59,410,6.9,13,2,1,16,5,68,0,1,1
10324,10,2014-11-20,kansas-state,@,West Virginia,W (26-20),22,34,64.7,400,1,29,1,0.0,0,63,401,6.4,16,0,2,18,10,102,1,1,2
10325,11,2014-11-29,kansas-state,,Kansas,W (51-13),23,30,76.7,311,4,39,194,5.0,2,69,505,7.3,17,10,1,28,6,50,0,0,0
10326,12,2014-12-06,kansas-state,@,Baylor,L (27-38),22,27,81.5,300,2,40,103,2.6,1,67,403,6.0,14,10,3,27,3,30,0,1,1
10327,13,2015-01-02,kansas-state,N,UCLA*,L (35-40),31,49,63.3,338,2,32,31,1.0,2,81,369,4.6,17,5,5,27,6,39,1,1,2
10328,,13 Games,kansas-state,,,,271,415,65.3,3736,23,476,1745,3.7,30,891,5481,6.2,162,104,28,294,57,511,5,8,13
10329,1,2015-09-05,kansas-state,,South Dakota,W (34-0),9,18,50.0,147,1,40,185,4.6,2,58,332,5.7,6,10,0,16,8,66,1,0,1
10330,2,2015-09-12,kansas-state,@,Texas-San Antonio,W (30-3),12,23,52.2,243,0,44,175,4.0,3,67,418,6.2,10,9,3,22,9,85,0,0,0
10331,3,2015-09-19,kansas-state,,Louisiana Tech,W (39-33),15,26,57.7,195,3,45,160,3.6,1,71,355,5.0,8,8,1,17,4,35,1,0,1
10332,4,2015-10-03,kansas-state,@,Oklahoma State,L (34-36),13,25,52.0,207,2,42,144,3.4,3,67,351,5.2,8,9,5,22,9,54,0,1,1
10333,5,2015-10-10,kansas-state,,Texas Christian,L (45-52),13,33,39.4,157,0,48,228,4.8,6,81,385,4.8,8,14,6,28,3,35,1,1,2
10334,6,2015-10-17,kansas-state,,Oklahoma,L (0-55),5,22,22.7,45,0,31,65,2.1,0,53,110,2.1,2,5,0,7,1,5,0,3,3
10335,7,2015-10-24,kansas-state,@,Texas,L (9-23),11,24,45.8,107,1,37,135,3.6,0,61,242,4.0,5,9,1,15,5,27,0,1,1
10336,8,2015-11-05,kansas-state,,Baylor,L (24-31),13,23,56.5,172,1,48,258,5.4,2,71,430,6.1,6,15,1,22,7,39,1,2,3
10337,9,2015-11-14,kansas-state,@,Texas Tech,L (44-59),19,42,45.2,289,2,34,123,3.6,3,76,412,5.4,11,6,2,19,7,55,1,1,2
10338,10,2015-11-21,kansas-state,,Iowa State,W (38-35),19,33,57.6,220,2,41,165,4.0,2,74,385,5.2,11,11,0,22,5,35,1,0,1
10339,11,2015-11-28,kansas-state,@,Kansas,W (45-14),11,20,55.0,137,0,49,226,4.6,5,69,363,5.3,7,12,3,22,1,5,0,1,1
10340,12,2015-12-05,kansas-state,,West Virginia,W (24-23),10,31,32.3,206,1,49,98,2.0,1,80,304,3.8,7,6,2,15,3,35,0,2,2
10341,13,2016-01-02,kansas-state,N,Arkansas*,L (23-45),12,25,48.0,163,1,22,79,3.6,1,47,242,5.1,10,2,1,13,4,25,0,1,1
10342,,13 Games,kansas-state,,,,162,345,47.0,2288,14,530,2041,3.9,29,875,4329,4.9,99,116,25,240,66,501,6,13,19
10343,1,2016-09-02,kansas-state,@,Stanford,L (13-26),19,41,46.3,243,1,32,92,2.9,0,73,335,4.6,11,6,1,18,8,44,0,2,2
10344,2,2016-09-17,kansas-state,,Florida Atlantic,W (63-7),13,18,72.2,159,1,54,336,6.2,7,72,495,6.9,7,15,2,24,13,131,1,0,1
10345,3,2016-09-24,kansas-state,,Missouri State,W (35-0),10,13,76.9,105,2,22,165,7.5,3,35,270,7.7,5,8,0,13,2,24,0,0,0
10346,4,2016-10-01,kansas-state,@,West Virginia,L (16-17),10,30,33.3,166,0,42,120,2.9,1,72,286,4.0,8,7,2,17,6,25,0,1,1
10347,5,2016-10-08,kansas-state,,Texas Tech,W (44-38),10,20,50.0,104,1,39,231,5.9,2,59,335,5.7,7,13,1,21,6,50,0,0,0
10348,6,2016-10-15,kansas-state,@,Oklahoma,L (17-38),20,37,54.1,225,1,32,110,3.4,1,69,335,4.9,12,6,1,19,7,35,0,0,0
10349,7,2016-10-22,kansas-state,,Texas,W (24-21),20,27,74.1,171,1,49,240,4.9,2,76,411,5.4,4,18,5,27,8,75,2,1,3
10350,8,2016-10-29,kansas-state,@,Iowa State,W (31-26),18,28,64.3,151,1,43,247,5.7,3,71,398,5.6,11,14,2,27,4,35,0,0,0
10351,9,2016-11-05,kansas-state,,Oklahoma State,L (37-43),12,18,66.7,87,0,56,345,6.2,4,74,432,5.8,5,16,3,24,4,31,0,1,1
10352,10,2016-11-19,kansas-state,@,Baylor,W (42-21),16,25,64.0,177,0,51,237,4.6,6,76,414,5.4,9,14,2,25,8,85,2,0,2
10353,11,2016-11-26,kansas-state,,Kansas,W (34-19),6,11,54.5,99,0,58,342,5.9,4,69,441,6.4,4,17,4,25,5,60,1,0,1
10354,12,2016-12-03,kansas-state,@,Texas Christian,W (30-6),9,21,42.9,159,1,51,336,6.6,3,72,495,6.9,6,15,0,21,6,61,1,0,1
10355,13,2016-12-28,kansas-state,N,Texas A&M*,W (33-28),14,20,70.0,195,1,41,218,5.3,3,61,413,6.8,6,9,2,17,12,80,0,0,0
10356,,13 Games,kansas-state,,,,177,309,57.3,2041,10,570,3019,5.3,39,879,5060,5.8,95,158,25,278,89,736,7,5,12
10357,1,2017-09-02,kansas-state,,Central Arkansas,W (55-19),10,16,62.5,333,4,31,186,6.0,2,47,519,11.0,8,8,0,16,6,58,0,0,0
10358,2,2017-09-09,kansas-state,,UNC Charlotte,W (55-7),17,23,73.9,189,0,51,304,6.0,5,74,493,6.7,12,15,1,28,5,44,0,0,0
10359,3,2017-09-16,kansas-state,@,Vanderbilt,L (7-14),10,28,35.7,76,0,35,201,5.7,1,63,277,4.4,3,10,0,13,7,68,0,2,2
10360,4,2017-09-30,kansas-state,,Baylor,W (33-20),7,17,41.2,119,1,43,225,5.2,2,60,344,5.7,6,13,0,19,6,45,1,0,1
10361,5,2017-10-07,kansas-state,@,Texas,L (34-40),14,23,60.9,254,2,39,140,3.6,2,62,394,6.4,8,7,1,16,7,70,0,1,1
10362,6,2017-10-14,kansas-state,,Texas Christian,L (6-26),11,30,36.7,146,0,29,70,2.4,0,59,216,3.7,6,3,1,10,5,38,1,0,1
10363,7,2017-10-21,kansas-state,,Oklahoma,L (35-42),12,14,85.7,144,1,42,268,6.4,4,56,412,7.4,4,13,1,18,2,25,1,1,2
10364,8,2017-10-28,kansas-state,@,Kansas,W (30-20),8,13,61.5,138,0,43,202,4.7,2,56,340,6.1,4,11,0,15,6,35,1,0,1
10365,9,2017-11-04,kansas-state,@,Texas Tech,W (42-35),18,28,64.3,263,2,36,145,4.0,2,64,408,6.4,14,6,4,24,6,46,0,1,1
10366,10,2017-11-11,kansas-state,,West Virginia,L (23-28),13,26,50.0,159,0,42,173,4.1,2,68,332,4.9,6,7,1,14,5,61,0,2,2
10367,11,2017-11-18,kansas-state,@,Oklahoma State,W (45-40),10,13,76.9,204,3,49,217,4.4,2,62,421,6.8,7,10,1,18,6,41,1,0,1
10368,12,2017-11-25,kansas-state,,Iowa State,W (20-19),16,22,72.7,155,2,30,109,3.6,1,52,264,5.1,7,4,1,12,4,45,0,0,0
10369,13,2017-12-26,kansas-state,N,UCLA*,W (35-17),10,17,58.8,79,1,49,344,7.0,4,66,423,6.4,4,14,3,21,2,20,0,1,1
10370,,13 Games,kansas-state,,,,156,270,57.8,2259,16,519,2584,5.0,29,789,4843,6.1,89,121,14,224,67,596,5,8,13
10371,1,2018-09-01,kansas-state,,South Dakota,W (27-24),13,28,46.4,152,1,47,256,5.4,0,75,408,5.4,8,10,1,19,13,129,2,2,4
10372,2,2018-09-08,kansas-state,,Mississippi State,L (10-31),9,21,42.9,100,1,35,113,3.2,0,56,213,3.8,5,7,3,15,2,15,0,1,1
10373,3,2018-09-15,kansas-state,,Texas-San Antonio,W (41-17),14,19,73.7,285,3,44,164,3.7,2,63,449,7.1,11,8,1,20,4,41,2,0,2
10374,4,2018-09-22,kansas-state,@,West Virginia,L (6-35),18,29,62.1,227,0,36,91,2.5,0,65,318,4.9,9,7,1,17,8,69,1,0,1
10375,5,2018-09-29,kansas-state,,Texas,L (14-19),11,25,44.0,110,0,39,107,2.7,2,64,217,3.4,6,7,4,17,0,0,0,0,0
10376,6,2018-10-06,kansas-state,@,Baylor,L (34-37),15,26,57.7,149,1,35,319,9.1,4,61,468,7.7,5,15,0,20,6,55,1,2,3
10377,7,2018-10-13,kansas-state,,Oklahoma State,W (31-12),11,22,50.0,130,0,55,291,5.3,4,77,421,5.5,7,13,3,23,4,40,0,0,0
10378,8,2018-10-27,kansas-state,@,Oklahoma,L (14-51),13,21,61.9,108,0,32,137,4.3,2,53,245,4.6,5,6,2,13,4,50,1,0,1
10379,9,2018-11-03,kansas-state,@,Texas Christian,L (13-14),16,28,57.1,162,1,47,139,3.0,1,75,301,4.0,8,11,2,21,2,3,2,1,3
10380,10,2018-11-10,kansas-state,,Kansas,W (21-17),11,18,61.1,126,0,40,175,4.4,3,58,301,5.2,7,8,2,17,7,55,0,0,0
10381,11,2018-11-17,kansas-state,,Texas Tech,W (21-6),17,26,65.4,213,1,50,154,3.1,0,76,367,4.8,11,9,2,22,2,20,0,1,1
10382,,11 Games,kansas-state,,,,148,263,56.3,1762,8,460,1946,4.2,18,723,3708,5.1,82,101,21,204,52,477,9,7,16
10383,1,2014-08-29,colorado,N,Colorado State,L (17-31),24,39,61.5,241,2,34,134,3.9,0,73,375,5.1,11,8,3,22,6,65,0,0,0
10384,2,2014-09-06,colorado,N,Massachusetts,W (41-38),26,42,61.9,318,3,47,156,3.3,2,89,474,5.3,15,9,5,29,12,124,0,1,1
10385,3,2014-09-13,colorado,,Arizona State,L (24-38),35,54,64.8,313,3,37,232,6.3,0,91,545,6.0,17,8,3,28,8,75,1,2,3
10386,4,2014-09-20,colorado,,Hawaii,W (21-12),29,45,64.4,287,2,36,118,3.3,1,81,405,5.0,15,4,1,20,9,83,0,2,2
10387,5,2014-09-27,colorado,@,California,L (56-59),46,67,68.7,449,7,43,180,4.2,1,110,629,5.7,26,8,5,39,9,75,0,1,1
10388,6,2014-10-04,colorado,,Oregon State,L (31-36),32,49,65.3,308,2,28,123,4.4,2,77,431,5.6,14,9,2,25,6,67,0,1,1
10389,7,2014-10-18,colorado,@,Southern California,L (28-56),31,49,63.3,231,2,46,172,3.7,2,95,403,4.2,12,11,4,27,7,61,0,2,2
10390,8,2014-10-25,colorado,,UCLA,L (37-40),28,46,60.9,267,2,45,233,5.2,2,91,500,5.5,11,15,5,31,6,50,0,2,2
10391,9,2014-11-01,colorado,,Washington,L (23-38),36,52,69.2,314,2,37,181,4.9,0,89,495,5.6,14,10,0,24,5,39,3,1,4
10392,10,2014-11-08,colorado,@,Arizona,L (20-38),25,39,64.1,259,2,36,94,2.6,0,75,353,4.7,9,8,2,19,10,103,2,2,4
10393,11,2014-11-22,colorado,@,Oregon,L (10-44),16,32,50.0,105,1,30,121,4.0,0,62,226,3.6,5,5,4,14,4,36,0,0,0
10394,12,2014-11-29,colorado,,Utah,L (34-38),20,31,64.5,317,1,32,116,3.6,3,63,433,6.9,10,6,2,18,4,35,0,1,1
10395,,12 Games,colorado,,,,348,545,63.9,3409,29,451,1860,4.1,13,996,5269,5.3,159,101,36,296,86,813,6,15,21
10396,1,2015-09-03,colorado,@,Hawaii,L (20-28),23,40,57.5,156,0,53,215,4.1,2,93,371,4.0,8,14,1,23,5,70,2,1,3
10397,2,2015-09-12,colorado,,Massachusetts,W (48-14),15,24,62.5,168,1,59,390,6.6,5,83,558,6.7,8,22,2,32,7,65,0,0,0
10398,3,2015-09-19,colorado,N,Colorado State,W (27-24),15,29,51.7,220,2,32,125,3.9,0,61,345,5.7,9,6,3,18,6,65,0,0,0
10399,4,2015-09-26,colorado,,Nicholls State,W (48-0),18,31,58.1,278,1,62,358,5.8,5,93,636,6.8,14,16,3,33,4,30,1,0,1
10400,5,2015-10-03,colorado,,Oregon,L (24-41),25,42,59.5,231,1,36,77,2.1,2,78,308,3.9,13,5,0,18,6,41,2,1,3
10401,6,2015-10-10,colorado,@,Arizona State,L (23-48),26,41,63.4,401,1,28,49,1.8,2,69,450,6.5,13,5,1,19,9,88,1,1,2
10402,7,2015-10-17,colorado,,Arizona,L (31-38),28,44,63.6,339,2,43,128,3.0,2,87,467,5.4,15,6,1,22,9,65,1,0,1
10403,8,2015-10-24,colorado,@,Oregon State,W (17-13),16,23,69.6,140,1,45,188,4.2,1,68,328,4.8,8,11,1,20,9,80,0,0,0
10404,9,2015-10-31,colorado,@,UCLA,L (31-35),37,58,63.8,312,0,56,242,4.3,2,114,554,4.9,14,18,2,34,7,68,0,2,2
10405,10,2015-11-07,colorado,,Stanford,L (10-42),13,23,56.5,148,0,30,83,2.8,1,53,231,4.4,7,7,1,15,3,21,0,2,2
10406,11,2015-11-13,colorado,,Southern California,L (24-27),24,31,77.4,222,2,36,59,1.6,1,67,281,4.2,12,7,2,21,5,39,1,0,1
10407,12,2015-11-21,colorado,@,Washington State,L (3-27),26,41,63.4,238,0,30,85,2.8,0,71,323,4.5,12,4,1,17,7,61,0,2,2
10408,13,2015-11-28,colorado,@,Utah,L (14-20),19,38,50.0,258,2,33,49,1.5,0,71,307,4.3,11,5,3,19,3,31,1,3,4
10409,,13 Games,colorado,,,,285,465,61.3,3111,13,543,2048,3.8,23,1008,5159,5.1,144,126,21,291,80,724,9,12,21
10410,1,2016-09-02,colorado,N,Colorado State,W (44-7),23,33,69.7,318,1,56,260,4.6,3,89,578,6.5,12,15,1,28,4,35,2,0,2
10411,2,2016-09-10,colorado,,Idaho State,W (56-7),22,31,71.0,335,4,57,262,4.6,4,88,597,6.8,13,15,4,32,5,37,1,0,1
10412,3,2016-09-17,colorado,@,Michigan,L (28-45),18,34,52.9,261,3,33,64,1.9,0,67,325,4.9,8,5,2,15,7,46,0,0,0
10413,4,2016-09-24,colorado,@,Oregon,W (41-38),23,32,71.9,333,3,52,260,5.0,2,84,593,7.1,15,14,3,32,5,47,0,2,2
10414,5,2016-10-01,colorado,,Oregon State,W (47-6),21,30,70.0,316,3,54,247,4.6,2,84,563,6.7,13,13,0,26,5,55,0,0,0
10415,6,2016-10-08,colorado,@,Southern California,L (17-21),28,44,63.6,275,2,29,96,3.3,0,73,371,5.1,15,4,1,20,5,26,0,1,1
10416,7,2016-10-15,colorado,,Arizona State,W (40-16),23,32,71.9,265,0,52,315,6.1,5,84,580,6.9,9,18,0,27,3,20,2,0,2
10417,8,2016-10-22,colorado,@,Stanford,W (10-5),12,25,48.0,135,1,44,241,5.5,0,69,376,5.4,7,15,1,23,6,60,0,0,0
10418,9,2016-11-03,colorado,,UCLA,W (20-10),20,33,60.6,160,0,52,144,2.8,1,85,304,3.6,10,8,6,24,12,128,1,3,4
10419,10,2016-11-12,colorado,@,Arizona,W (49-24),19,27,70.4,213,3,46,175,3.8,4,73,388,5.3,8,11,6,25,7,62,0,1,1
10420,11,2016-11-19,colorado,,Washington State,W (38-24),27,41,65.9,345,0,59,258,4.4,5,100,603,6.0,15,15,1,31,9,75,1,0,1
10421,12,2016-11-26,colorado,,Utah,W (27-22),23,44,52.3,270,1,38,108,2.8,1,82,378,4.6,10,6,2,18,0,0,2,0,2
10422,13,2016-12-02,colorado,N,Washington,L (10-41),8,25,32.0,81,0,29,82,2.8,1,54,163,3.0,3,4,2,9,3,35,0,3,3
10423,14,2016-12-29,colorado,N,Oklahoma State*,L (8-38),22,38,57.9,256,0,29,62,2.1,1,67,318,4.7,11,6,1,18,5,35,0,1,1
10424,,14 Games,colorado,,,,289,469,61.6,3563,21,630,2574,4.1,29,1099,6137,5.6,149,149,30,328,76,661,9,11,20
10425,1,2017-09-01,colorado,N,Colorado State,W (17-3),21,29,72.4,202,1,36,145,4.0,1,65,347,5.3,9,7,3,19,7,59,0,2,2
10426,2,2017-09-09,colorado,,Texas State,W (37-3),23,36,63.9,339,1,39,94,2.4,2,75,433,5.8,14,6,1,21,5,35,0,0,0
10427,3,2017-09-16,colorado,,Northern Colorado,W (41-21),29,41,70.7,357,4,39,212,5.4,1,80,569,7.1,16,12,2,30,14,114,2,1,3
10428,4,2017-09-23,colorado,,Washington,L (10-37),22,30,73.3,191,0,42,131,3.1,1,72,322,4.5,9,11,0,20,3,35,0,3,3
10429,5,2017-09-30,colorado,@,UCLA,L (23-27),17,38,44.7,243,1,38,191,5.0,1,76,434,5.7,10,9,5,24,6,53,0,0,0
10430,6,2017-10-07,colorado,,Arizona,L (42-45),19,32,59.4,251,3,58,300,5.2,3,90,551,6.1,11,18,0,29,12,110,0,0,0
10431,7,2017-10-14,colorado,@,Oregon State,W (36-33),15,25,60.0,179,3,41,206,5.0,2,66,385,5.8,9,13,3,25,3,14,0,0,0
10432,8,2017-10-21,colorado,@,Washington State,L (0-28),13,34,38.2,94,0,40,80,2.0,0,74,174,2.4,3,8,2,13,5,45,1,0,1
10433,9,2017-10-28,colorado,,California,W (44-28),21,27,77.8,353,3,53,200,3.8,1,80,553,6.9,10,16,1,27,7,58,1,0,1
10434,10,2017-11-04,colorado,@,Arizona State,L (30-41),23,41,56.1,345,1,39,109,2.8,2,80,454,5.7,15,8,0,23,3,25,0,1,1
10435,11,2017-11-11,colorado,,Southern California,L (24-38),27,49,55.1,376,2,34,110,3.2,1,83,486,5.9,15,7,1,23,4,45,0,2,2
10436,12,2017-11-25,colorado,@,Utah,L (13-34),14,28,50.0,195,0,35,124,3.5,2,63,319,5.1,7,9,1,17,6,75,1,0,1
10437,,12 Games,colorado,,,,244,410,59.5,3125,19,494,1902,3.9,17,904,5027,5.6,128,124,19,271,75,668,5,9,14
10438,1,2018-08-31,colorado,N,Colorado State,W (45-13),22,25,88.0,338,4,40,258,6.5,2,65,596,9.2,11,12,0,23,6,44,1,1,2
10439,2,2018-09-08,colorado,@,Nebraska,W (33-28),33,50,66.0,351,3,35,44,1.3,1,85,395,4.6,16,7,3,26,8,46,0,0,0
10440,3,2018-09-15,colorado,,New Hampshire,W (45-14),17,24,70.8,180,1,51,311,6.1,4,75,491,6.5,9,12,0,21,6,60,0,2,2
10441,4,2018-09-28,colorado,,UCLA,W (38-16),23,27,85.2,268,1,48,209,4.4,4,75,477,6.4,12,11,3,26,6,60,0,0,0
10442,5,2018-10-06,colorado,,Arizona State,W (28-21),24,33,72.7,328,2,45,166,3.7,2,78,494,6.3,12,12,1,25,6,60,0,0,0
10443,6,2018-10-13,colorado,@,Southern California,L (20-31),26,47,55.3,170,0,37,95,2.6,3,84,265,3.2,7,6,4,17,8,81,0,1,1
10444,7,2018-10-20,colorado,@,Washington,L (13-27),17,28,60.7,144,1,35,119,3.4,0,63,263,4.2,8,6,1,15,4,48,0,1,1
10445,8,2018-10-27,colorado,,Oregon State,L (34-41),24,39,61.5,319,2,36,217,6.0,1,75,536,7.1,13,8,2,23,7,70,0,0,0
10446,9,2018-11-02,colorado,@,Arizona,L (34-42),27,43,62.8,343,3,32,40,1.3,1,75,383,5.1,18,3,6,27,5,52,1,1,2
10447,10,2018-11-10,colorado,,Washington State,L (7-31),21,38,55.3,222,0,16,75,4.7,1,54,297,5.5,10,2,0,12,4,51,2,1,3
10448,11,2018-11-17,colorado,,Utah,L (7-30),21,33,63.6,162,0,34,34,1.0,1,67,196,2.9,8,3,3,14,4,38,1,2,3
10449,,11 Games,colorado,,,,255,387,65.9,2825,17,409,1568,3.8,20,796,4393,5.5,124,82,23,229,64,610,5,9,14
10450,1,2014-08-30,wyoming,,Montana,W (17-12),13,21,61.9,92,0,46,209,4.5,2,67,301,4.5,6,10,2,18,1,4,1,1,2
10451,2,2014-09-06,wyoming,,Air Force,W (17-13),23,37,62.2,282,2,26,51,2.0,0,63,333,5.3,14,1,0,15,2,15,0,0,0
10452,3,2014-09-13,wyoming,@,Oregon,L (14-48),19,33,57.6,284,2,41,155,3.8,0,74,439,5.9,16,7,1,24,5,48,1,2,3
10453,4,2014-09-20,wyoming,,Florida Atlantic,W (20-19),10,23,43.5,161,0,41,173,4.2,2,64,334,5.2,5,10,2,17,4,36,1,0,1
10454,5,2014-09-27,wyoming,@,Michigan State,L (14-56),16,24,66.7,188,1,27,98,3.6,1,51,286,5.6,6,5,0,11,5,43,2,1,3
10455,6,2014-10-11,wyoming,@,Hawaii,L (28-38),19,30,63.3,221,2,33,101,3.1,1,63,322,5.1,9,7,1,17,5,40,0,2,2
10456,7,2014-10-18,wyoming,,San Jose State,L (20-27),11,28,39.3,119,0,30,158,5.3,1,58,277,4.8,5,6,0,11,7,72,0,0,0
10457,8,2014-10-25,wyoming,@,Colorado State,L (31-45),24,38,63.2,335,2,38,119,3.1,2,76,454,6.0,13,8,4,25,7,53,0,0,0
10458,9,2014-11-01,wyoming,@,Fresno State,W (45-17),19,28,67.9,320,2,43,374,8.7,4,71,694,9.8,14,10,0,24,8,64,1,0,1
10459,10,2014-11-07,wyoming,,Utah State,L (3-20),20,40,50.0,212,0,35,151,4.3,0,75,363,4.8,10,7,1,18,10,95,0,2,2
10460,11,2014-11-22,wyoming,,Boise State,L (14-63),16,29,55.2,147,0,38,80,2.1,2,67,227,3.4,7,5,0,12,3,20,2,1,3
10461,12,2014-11-29,wyoming,@,New Mexico,L (30-36),21,43,48.8,366,1,51,175,3.4,2,94,541,5.8,19,7,3,29,6,30,0,1,1
10462,,12 Games,wyoming,,,,211,374,56.4,2727,12,449,1844,4.1,17,823,4571,5.6,124,83,14,221,63,520,8,10,18
10463,1,2015-09-05,wyoming,,North Dakota,L (13-24),20,39,51.3,289,2,19,41,2.2,0,58,330,5.7,10,3,1,14,8,96,0,0,0
10464,2,2015-09-12,wyoming,,Eastern Michigan,L (29-48),6,17,35.3,32,0,58,430,7.4,4,75,462,6.2,3,22,4,29,4,30,1,0,1
10465,3,2015-09-19,wyoming,@,Washington State,L (14-31),25,36,69.4,296,2,40,113,2.8,0,76,409,5.4,10,11,1,22,8,57,1,1,2
10466,4,2015-09-26,wyoming,,New Mexico,L (28-38),30,42,71.4,366,4,30,42,1.4,0,72,408,5.7,16,5,5,26,10,98,0,2,2
10467,5,2015-10-03,wyoming,@,Appalachian State,L (13-31),14,19,73.7,155,1,51,218,4.3,1,70,373,5.3,7,11,0,18,7,65,2,1,3
10468,6,2015-10-10,wyoming,@,Air Force,L (17-31),15,29,51.7,192,2,35,115,3.3,0,64,307,4.8,8,9,2,19,1,10,2,2,4
10469,7,2015-10-17,wyoming,,Nevada,W (28-21),18,20,90.0,213,3,51,272,5.3,1,71,485,6.8,9,15,1,25,7,71,0,0,0
10470,8,2015-10-24,wyoming,@,Boise State,L (14-34),12,21,57.1,123,1,33,110,3.3,1,54,233,4.3,6,6,4,16,5,35,0,1,1
10471,9,2015-10-30,wyoming,@,Utah State,L (27-58),10,18,55.6,83,2,49,270,5.5,2,67,353,5.3,7,14,1,22,4,33,0,0,0
10472,10,2015-11-07,wyoming,,Colorado State,L (7-26),10,21,47.6,109,0,34,130,3.8,1,55,239,4.3,6,8,1,15,9,66,3,1,4
10473,11,2015-11-14,wyoming,@,San Diego State,L (3-38),9,21,42.9,129,0,32,62,1.9,0,53,191,3.6,5,5,2,12,7,63,1,2,3
10474,12,2015-11-28,wyoming,,Nevada-Las Vegas,W (35-28),14,25,56.0,248,3,46,290,6.3,2,71,538,7.6,8,14,1,23,5,57,0,1,1
10475,,12 Games,wyoming,,,,183,308,59.4,2235,20,478,2093,4.4,12,786,4328,5.5,95,123,23,241,75,681,10,11,21
10476,1,2016-09-03,wyoming,,Northern Illinois,W (40-34),19,29,65.5,245,2,56,243,4.3,3,85,488,5.7,13,9,6,28,10,100,0,0,0
10477,2,2016-09-10,wyoming,@,Nebraska,L (17-52),16,32,50.0,189,1,31,131,4.2,1,63,320,5.1,8,5,3,16,5,42,1,5,6
10478,3,2016-09-17,wyoming,,California-Davis,W (45-22),11,15,73.3,198,3,48,274,5.7,3,63,472,7.5,10,12,0,22,5,41,1,0,1
10479,4,2016-09-23,wyoming,@,Eastern Michigan,L (24-27),19,29,65.5,234,0,38,79,2.1,1,67,313,4.7,12,4,3,19,3,35,2,1,3
10480,5,2016-10-01,wyoming,@,Colorado State,W (38-17),7,18,38.9,165,1,49,269,5.5,3,67,434,6.5,7,12,0,19,4,30,0,0,0
10481,6,2016-10-08,wyoming,,Air Force,W (35-26),15,27,55.6,173,3,48,189,3.9,1,75,362,4.8,10,9,2,21,5,50,1,0,1
10482,7,2016-10-22,wyoming,@,Nevada,W (42-34),10,14,71.4,149,1,54,393,7.3,5,68,542,8.0,6,20,1,27,6,67,0,0,0
10483,8,2016-10-29,wyoming,,Boise State,W (30-28),18,31,58.1,274,3,49,215,4.4,0,80,489,6.1,12,13,0,25,0,0,0,1,1
10484,9,2016-11-05,wyoming,,Utah State,W (52-28),16,26,61.5,261,4,46,267,5.8,3,72,528,7.3,10,14,1,25,7,70,0,1,1
10485,10,2016-11-12,wyoming,@,Nevada-Las Vegas,L (66-69),14,34,41.2,334,4,32,151,4.7,3,66,485,7.3,11,8,1,20,2,12,2,2,4
10486,11,2016-11-19,wyoming,,San Diego State,W (34-33),16,31,51.6,282,2,53,205,3.9,2,84,487,5.8,12,15,2,29,2,20,0,1,1
10487,12,2016-11-26,wyoming,@,New Mexico,L (35-56),18,28,64.3,248,0,45,201,4.5,5,73,449,6.2,11,12,2,25,4,44,1,0,1
10488,13,2016-12-03,wyoming,,San Diego State,L (24-27),14,31,45.2,248,3,31,95,3.1,0,62,343,5.5,10,3,0,13,6,45,1,2,3
10489,14,2016-12-21,wyoming,N,Brigham Young*,L (21-24),17,33,51.5,207,2,45,186,4.1,1,78,393,5.0,9,10,3,22,7,59,0,2,2
10490,,14 Games,wyoming,,,,210,378,55.6,3207,29,625,2898,4.6,31,1003,6105,6.1,141,146,24,311,66,615,9,15,24
10491,1,2017-09-02,wyoming,@,Iowa,L (3-24),23,40,57.5,174,0,30,59,2.0,0,70,233,3.3,10,4,1,15,5,40,0,2,2
10492,2,2017-09-09,wyoming,,Gardner-Webb,W (27-0),22,32,68.8,328,2,28,65,2.3,1,60,393,6.6,15,3,1,19,4,45,0,0,0
10493,3,2017-09-16,wyoming,,Oregon,L (13-49),10,25,40.0,66,0,32,117,3.7,1,57,183,3.2,2,6,2,10,6,62,1,1,2
10494,4,2017-09-23,wyoming,,Hawaii,W (28-21),9,19,47.4,92,1,29,177,6.1,2,48,269,5.6,3,8,0,11,4,51,0,0,0
10495,5,2017-09-30,wyoming,,Texas State,W (45-10),15,26,57.7,249,3,35,84,2.4,0,61,333,5.5,12,5,1,18,4,33,1,0,1
10496,6,2017-10-14,wyoming,@,Utah State,W (28-23),18,26,69.2,208,1,36,85,2.4,1,62,293,4.7,8,5,1,14,8,75,0,1,1
10497,7,2017-10-21,wyoming,@,Boise State,L (14-24),12,27,44.4,131,1,34,111,3.3,1,61,242,4.0,6,7,2,15,1,12,0,2,2
10498,8,2017-10-28,wyoming,,New Mexico,W (42-3),16,28,57.1,234,4,32,75,2.3,2,60,309,5.2,12,3,3,18,5,50,0,0,0
10499,9,2017-11-04,wyoming,,Colorado State,W (16-13),10,20,50.0,138,0,34,156,4.6,1,54,294,5.4,9,8,1,18,1,5,1,0,1
10500,10,2017-11-11,wyoming,@,Air Force,W (28-14),11,15,73.3,129,1,43,100,2.3,3,58,229,3.9,6,8,2,16,5,50,1,0,1
10501,11,2017-11-18,wyoming,,Fresno State,L (7-13),20,33,60.6,231,1,28,77,2.8,0,61,308,5.0,9,3,0,12,3,15,2,0,2
10502,12,2017-11-25,wyoming,@,San Jose State,L (17-20),18,38,47.4,170,1,43,187,4.3,1,81,357,4.4,5,10,2,17,4,35,0,2,2
10503,13,2017-12-22,wyoming,N,Central Michigan*,W (37-14),11,19,57.9,154,3,42,121,2.9,0,61,275,4.5,8,6,1,15,5,49,0,0,0
10504,,13 Games,wyoming,,,,195,348,56.0,2304,18,446,1414,3.2,13,794,3718,4.7,105,76,17,198,55,522,6,8,14
10505,1,2018-08-25,wyoming,@,New Mexico State,W (29-7),13,22,59.1,137,0,56,313,5.6,3,78,450,5.8,7,13,2,22,4,60,0,0,0
10506,2,2018-09-01,wyoming,,Washington State,L (19-41),8,20,40.0,67,0,39,139,3.6,2,59,206,3.5,3,11,1,15,13,109,0,1,1
10507,3,2018-09-08,wyoming,@,Missouri,L (13-40),13,28,46.4,160,0,30,88,2.9,1,58,248,4.3,7,5,3,15,3,17,1,0,1
10508,4,2018-09-15,wyoming,,Wofford,W (17-14),25,42,59.5,224,2,27,89,3.3,0,69,313,4.5,13,5,1,19,5,40,0,1,1
10509,5,2018-09-29,wyoming,,Boise State,L (14-34),15,26,57.7,214,1,24,81,3.4,1,50,295,5.9,7,3,1,11,6,59,1,0,1
10510,6,2018-10-06,wyoming,@,Hawaii,L (13-17),9,18,50.0,87,0,34,157,4.6,0,52,244,4.7,4,8,1,13,6,45,0,0,0
10511,7,2018-10-13,wyoming,@,Fresno State,L (3-27),12,32,37.5,117,0,30,104,3.5,0,62,221,3.6,6,6,2,14,5,22,0,1,1
10512,8,2018-10-20,wyoming,,Utah State,L (16-24),10,24,41.7,100,0,50,231,4.6,1,74,331,4.5,3,10,2,15,10,80,1,1,2
10513,9,2018-10-26,wyoming,@,Colorado State,W (34-21),7,10,70.0,116,2,55,297,5.4,2,65,413,6.4,5,14,1,20,6,57,0,0,0
10514,10,2018-11-03,wyoming,,San Jose State,W (24-9),4,8,50.0,51,1,64,424,6.6,2,72,475,6.6,4,18,0,22,4,25,2,0,2
10515,11,2018-11-17,wyoming,,Air Force,W (35-27),15,29,51.7,262,2,29,111,3.8,3,58,373,6.4,9,7,2,18,5,35,1,0,1
10516,,11 Games,wyoming,,,,131,259,50.6,1535,8,438,2034,4.6,15,697,3569,5.1,68,100,16,184,67,549,6,4,10
10517,1,2014-08-28,utah,,Idaho State,W (56-14),22,32,68.8,351,1,46,238,5.2,5,78,589,7.6,16,11,0,27,7,54,1,0,1
10518,2,2014-09-06,utah,,Fresno State,W (59-27),15,27,55.6,268,6,54,258,4.8,2,81,526,6.5,10,14,2,26,12,118,0,0,0
10519,3,2014-09-20,utah,@,Michigan,W (26-10),18,27,66.7,205,1,37,81,2.2,0,64,286,4.5,7,6,0,13,6,50,0,1,1
10520,4,2014-09-27,utah,,Washington State,L (27-28),18,40,45.0,165,0,40,192,4.8,1,80,357,4.5,7,10,1,18,8,78,1,0,1
10521,5,2014-10-04,utah,@,UCLA,W (30-28),12,18,66.7,100,1,55,242,4.4,1,73,342,4.7,3,14,1,18,4,40,0,0,0
10522,6,2014-10-16,utah,@,Oregon State,W (29-23),9,18,50.0,62,0,46,253,5.5,3,64,315,4.9,3,10,3,16,6,67,1,1,2
10523,7,2014-10-25,utah,,Southern California,W (24-21),18,32,56.3,194,1,42,137,3.3,1,74,331,4.5,11,9,1,21,4,25,2,0,2
10524,8,2014-11-01,utah,@,Arizona State,L (16-19),12,22,54.5,57,1,52,184,3.5,0,74,241,3.3,4,8,1,13,6,45,0,0,0
10525,9,2014-11-08,utah,,Oregon,L (27-51),22,33,66.7,320,2,35,120,3.4,1,68,440,6.5,10,6,1,17,3,31,2,2,4
10526,10,2014-11-15,utah,@,Stanford,W (20-17),21,28,75.0,177,2,32,70,2.2,1,60,247,4.1,9,4,1,14,5,55,0,0,0
10527,11,2014-11-22,utah,,Arizona,L (10-42),18,35,51.4,171,1,43,213,5.0,0,78,384,4.9,8,10,2,20,3,26,1,3,4
10528,12,2014-11-29,utah,@,Colorado,W (38-34),25,37,67.6,311,3,35,128,3.7,1,72,439,6.1,11,9,1,21,6,45,0,0,0
10529,13,2014-12-20,utah,N,Colorado State*,W (45-10),19,29,65.5,189,1,48,359,7.5,5,77,548,7.1,13,15,1,29,7,68,0,1,1
10530,,13 Games,utah,,,,229,378,60.6,2570,20,565,2475,4.4,21,943,5045,5.3,112,126,15,253,77,702,8,8,16
10531,1,2015-09-03,utah,,Michigan,W (24-17),24,33,72.7,208,0,37,129,3.5,2,70,337,4.8,10,9,1,20,6,55,0,1,1
10532,2,2015-09-11,utah,,Utah State,W (24-14),17,22,77.3,132,0,44,195,4.4,3,66,327,5.0,8,10,3,21,5,43,0,0,0
10533,3,2015-09-19,utah,@,Fresno State,W (45-24),19,26,73.1,159,1,48,221,4.6,2,74,380,5.1,9,12,2,23,1,10,2,1,3
10534,4,2015-09-26,utah,@,Oregon,W (62-20),20,32,62.5,257,5,42,273,6.5,2,74,530,7.2,12,11,1,24,6,54,0,0,0
10535,5,2015-10-10,utah,,California,W (30-24),16,26,61.5,170,1,51,265,5.2,2,77,435,5.6,6,14,1,21,5,48,1,2,3
10536,6,2015-10-17,utah,,Arizona State,W (34-18),26,36,72.2,297,2,31,72,2.3,2,67,369,5.5,11,4,1,16,4,19,0,0,0
10537,7,2015-10-24,utah,@,Southern California,L (24-42),24,36,66.7,254,2,28,99,3.5,1,64,353,5.5,9,8,3,20,4,34,0,4,4
10538,8,2015-10-31,utah,,Oregon State,W (27-12),14,17,82.4,198,1,44,174,4.0,2,61,372,6.1,9,10,1,20,5,45,0,0,0
10539,9,2015-11-07,utah,@,Washington,W (34-23),12,25,48.0,155,0,45,191,4.2,3,70,346,4.9,6,12,1,19,6,60,2,1,3
10540,10,2015-11-14,utah,@,Arizona,L (30-37),20,31,64.5,219,2,55,223,4.1,1,86,442,5.1,7,15,2,24,10,112,1,1,2
10541,11,2015-11-21,utah,,UCLA,L (9-17),13,26,50.0,110,0,49,197,4.0,0,75,307,4.1,5,14,4,23,4,45,2,0,2
10542,12,2015-11-28,utah,,Colorado,W (20-14),10,26,38.5,108,1,50,216,4.3,1,76,324,4.3,7,9,2,18,9,92,2,1,3
10543,13,2015-12-19,utah,N,Brigham Young*,W (35-28),9,16,56.3,71,0,47,126,2.7,3,63,197,3.1,3,8,3,14,7,76,0,0,0
10544,,13 Games,utah,,,,224,352,63.6,2338,15,571,2381,4.2,24,923,4719,5.1,102,136,25,263,72,693,10,11,21
10545,1,2016-09-01,utah,,Southern Utah,W (24-0),23,39,59.0,298,2,37,138,3.7,1,76,436,5.7,11,8,0,19,6,40,1,0,1
10546,2,2016-09-10,utah,,Brigham Young,W (20-19),14,23,60.9,194,1,42,169,4.0,0,65,363,5.6,8,9,3,20,9,85,3,3,6
10547,3,2016-09-17,utah,@,San Jose State,W (34-17),21,30,70.0,255,1,37,201,5.4,3,67,456,6.8,8,11,0,19,7,69,1,1,2
10548,4,2016-09-23,utah,,Southern California,W (31-27),21,34,61.8,270,2,47,186,4.0,1,81,456,5.6,12,16,2,30,5,43,1,0,1
10549,5,2016-10-01,utah,@,California,L (23-28),24,43,55.8,266,0,54,176,3.3,3,97,442,4.6,13,14,3,30,3,30,0,0,0
10550,6,2016-10-08,utah,,Arizona,W (36-23),13,29,44.8,245,1,45,210,4.7,3,74,455,6.1,7,12,4,23,14,98,0,0,0
10551,7,2016-10-15,utah,@,Oregon State,W (19-14),4,13,30.8,42,0,60,275,4.6,2,73,317,4.3,2,14,1,17,5,40,2,0,2
10552,8,2016-10-22,utah,@,UCLA,W (52-45),12,24,50.0,179,0,49,360,7.3,5,73,539,7.4,7,12,1,20,9,103,1,1,2
10553,9,2016-10-29,utah,,Washington,L (24-31),14,33,42.4,163,2,47,213,4.5,1,80,376,4.7,8,13,4,25,10,65,0,0,0
10554,10,2016-11-10,utah,@,Arizona State,W (49-26),21,37,56.8,296,4,22,201,9.1,2,59,497,8.4,12,6,4,22,7,60,2,0,2
10555,11,2016-11-19,utah,,Oregon,L (28-30),20,30,66.7,235,1,37,218,5.9,2,67,453,6.8,14,10,0,24,3,30,1,0,1
10556,12,2016-11-26,utah,@,Colorado,L (22-27),13,40,32.5,160,1,41,179,4.4,0,81,339,4.2,8,7,0,15,3,36,2,2,4
10557,13,2016-12-28,utah,N,Indiana*,W (26-24),12,24,50.0,214,0,52,256,4.9,2,76,470,6.2,8,12,1,21,9,86,3,1,4
10558,,13 Games,utah,,,,212,399,53.1,2817,15,570,2782,4.9,25,969,5599,5.8,118,144,23,285,90,785,17,8,25
10559,1,2017-08-31,utah,,North Dakota,W (37-16),23,32,71.9,227,1,47,272,5.8,3,79,499,6.3,10,15,2,27,11,139,0,1,1
10560,2,2017-09-09,utah,@,Brigham Young,W (19-13),28,37,75.7,314,0,36,116,3.2,1,73,430,5.9,11,6,1,18,11,97,2,0,2
10561,3,2017-09-16,utah,,San Jose State,W (54-16),30,44,68.2,341,4,40,160,4.0,2,84,501,6.0,15,12,2,29,6,50,2,1,3
10562,4,2017-09-22,utah,@,Arizona,W (30-24),17,28,60.7,229,1,38,112,2.9,1,66,341,5.2,8,9,4,21,9,83,2,0,2
10563,5,2017-10-07,utah,,Stanford,L (20-23),20,40,50.0,238,1,33,144,4.4,1,73,382,5.2,12,9,4,25,7,62,0,2,2
10564,6,2017-10-14,utah,@,Southern California,L (27-28),17,28,60.7,267,2,41,169,4.1,1,69,436,6.3,8,9,3,20,6,40,0,1,1
10565,7,2017-10-21,utah,,Arizona State,L (10-30),19,35,54.3,155,0,25,110,4.4,1,60,265,4.4,9,9,1,19,6,50,0,4,4
10566,8,2017-10-28,utah,@,Oregon,L (20-41),25,43,58.1,293,2,30,91,3.0,0,73,384,5.3,14,4,2,20,5,49,1,0,1
10567,9,2017-11-03,utah,,UCLA,W (48-17),15,22,68.2,234,4,50,272,5.4,2,72,506,7.0,7,15,2,24,10,70,0,0,0
10568,10,2017-11-11,utah,,Washington State,L (25-33),21,40,52.5,305,1,36,62,1.7,2,76,367,4.8,13,9,5,27,7,69,3,4,7
10569,11,2017-11-18,utah,@,Washington,L (30-33),19,27,70.4,293,2,45,117,2.6,1,72,410,5.7,13,9,0,22,3,30,0,1,1
10570,12,2017-11-25,utah,,Colorado,W (34-13),15,24,62.5,181,0,52,310,6.0,4,76,491,6.5,9,18,2,29,2,22,0,0,0
10571,13,2017-12-26,utah,N,West Virginia*,W (30-14),12,27,44.4,165,0,53,197,3.7,3,80,362,4.5,7,10,2,19,5,32,2,0,2
10572,,13 Games,utah,,,,261,427,61.1,3242,18,526,2132,4.1,22,953,5374,5.6,136,134,30,300,88,793,12,14,26
10573,1,2018-08-30,utah,,Weber State,W (41-10),26,41,63.4,293,4,36,294,8.2,1,77,587,7.6,12,11,2,25,4,20,3,1,4
10574,2,2018-09-08,utah,@,Northern Illinois,W (17-6),20,31,64.5,286,0,39,68,1.7,1,70,354,5.1,13,4,2,19,6,60,2,0,2
10575,3,2018-09-15,utah,,Washington,L (7-21),20,39,51.3,138,0,29,123,4.2,1,68,261,3.8,6,7,0,13,6,55,2,1,3
10576,4,2018-09-29,utah,@,Washington State,L (24-28),12,21,57.1,118,0,50,204,4.1,3,71,322,4.5,4,11,5,20,9,76,0,0,0
10577,5,2018-10-06,utah,@,Stanford,W (40-21),17,21,81.0,199,1,43,222,5.2,2,64,421,6.6,8,12,2,22,7,65,0,0,0
10578,6,2018-10-12,utah,,Arizona,W (42-10),16,22,72.7,265,3,46,230,5.0,3,68,495,7.3,8,12,3,23,9,94,0,1,1
10579,7,2018-10-20,utah,,Southern California,W (41-28),22,30,73.3,341,4,51,200,3.9,1,81,541,6.7,12,15,0,27,7,69,2,0,2
10580,8,2018-10-26,utah,@,UCLA,W (41-10),14,22,63.6,145,1,50,325,6.5,4,72,470,6.5,9,17,0,26,5,45,0,1,1
10581,9,2018-11-03,utah,@,Arizona State,L (20-38),11,26,42.3,147,1,32,178,5.6,1,58,325,5.6,6,9,2,17,3,28,0,3,3
10582,10,2018-11-10,utah,,Oregon,W (32-25),18,31,58.1,262,0,46,244,5.3,2,77,506,6.6,12,10,2,24,3,25,0,0,0
10583,11,2018-11-17,utah,@,Colorado,W (30-7),11,23,47.8,221,2,47,169,3.6,1,70,390,5.6,8,11,0,19,5,64,0,0,0
10584,,11 Games,utah,,,,187,307,60.9,2415,16,469,2257,4.8,20,776,4672,6.0,98,119,18,235,64,601,9,7,16
10585,1,2014-08-30,iowa-state,,North Dakota State,L (14-34),20,31,64.5,151,0,26,102,3.9,2,57,253,4.4,5,10,1,16,5,31,0,2,2
10586,2,2014-09-06,iowa-state,,Kansas State,L (28-32),22,33,66.7,214,2,37,105,2.8,1,70,319,4.6,13,6,2,21,5,55,0,1,1
10587,3,2014-09-13,iowa-state,@,Iowa,W (20-17),25,36,69.4,255,2,26,82,3.2,0,62,337,5.4,13,4,2,19,4,50,1,0,1
10588,4,2014-09-27,iowa-state,,Baylor,L (28-49),17,39,43.6,212,2,34,127,3.7,2,73,339,4.6,9,6,3,18,7,45,0,1,1
10589,5,2014-10-04,iowa-state,@,Oklahoma State,L (20-37),17,39,43.6,200,2,33,122,3.7,0,72,322,4.5,8,8,1,17,3,45,0,0,0
10590,6,2014-10-11,iowa-state,,Toledo,W (37-30),37,53,69.8,351,3,34,103,3.0,1,87,454,5.2,23,7,4,34,5,50,0,0,0
10591,7,2014-10-18,iowa-state,@,Texas,L (45-48),36,55,65.5,345,3,38,179,4.7,2,93,524,5.6,18,11,1,30,5,59,1,2,3
10592,8,2014-11-01,iowa-state,,Oklahoma,L (14-59),17,45,37.8,247,1,31,87,2.8,1,76,334,4.4,9,5,3,17,4,40,1,0,1
10593,9,2014-11-08,iowa-state,@,Kansas,L (14-34),25,50,50.0,275,2,25,98,3.9,0,75,373,5.0,11,9,2,22,4,26,1,1,2
10594,10,2014-11-22,iowa-state,,Texas Tech,L (31-34),24,38,63.2,304,2,46,265,5.8,2,84,569,6.8,12,14,1,27,3,35,1,0,1
10595,11,2014-11-29,iowa-state,,West Virginia,L (24-37),26,50,52.0,275,2,40,135,3.4,1,90,410,4.6,12,8,2,22,4,35,0,2,2
10596,12,2014-12-06,iowa-state,@,Texas Christian,L (3-55),16,41,39.0,152,0,32,84,2.6,0,73,236,3.2,8,4,1,13,2,19,0,2,2
10597,,12 Games,iowa-state,,,,282,510,55.3,2981,21,402,1489,3.7,12,912,4470,4.9,141,92,23,256,51,490,5,11,16
10598,1,2015-09-05,iowa-state,,Northern Iowa,W (31-7),21,29,72.4,233,2,32,77,2.4,1,61,310,5.1,10,3,2,15,5,48,2,0,2
10599,2,2015-09-12,iowa-state,,Iowa,L (17-31),19,35,54.3,247,2,27,63,2.3,0,62,310,5.0,8,5,5,18,4,45,0,1,1
10600,3,2015-09-19,iowa-state,@,Toledo,L (23-30),26,43,60.5,274,1,49,207,4.2,1,92,481,5.2,13,13,1,27,14,113,1,0,1
10601,4,2015-10-03,iowa-state,,Kansas,W (38-13),27,37,73.0,269,2,37,243,6.6,3,74,512,6.9,12,11,1,24,2,10,0,2,2
10602,5,2015-10-10,iowa-state,@,Texas Tech,L (31-66),15,30,50.0,180,1,45,315,7.0,3,75,495,6.6,6,13,0,19,4,45,0,3,3
10603,6,2015-10-17,iowa-state,,Texas Christian,L (21-45),24,38,63.2,346,1,38,115,3.0,2,76,461,6.1,12,8,4,24,8,55,2,0,2
10604,7,2015-10-24,iowa-state,@,Baylor,L (27-45),15,29,51.7,156,3,55,232,4.2,1,84,388,4.6,7,15,1,23,4,30,2,2,4
10605,8,2015-10-31,iowa-state,,Texas,W (24-0),19,38,50.0,188,1,54,238,4.4,2,92,426,4.6,12,13,3,28,4,45,0,0,0
10606,9,2015-11-07,iowa-state,@,Oklahoma,L (16-52),26,51,51.0,260,1,38,114,3.0,0,89,374,4.2,11,11,0,22,5,23,0,1,1
10607,10,2015-11-14,iowa-state,,Oklahoma State,L (31-35),11,22,50.0,162,1,38,249,6.6,3,60,411,6.9,6,12,1,19,3,30,0,1,1
10608,11,2015-11-21,iowa-state,@,Kansas State,L (35-38),15,20,75.0,210,3,44,238,5.4,2,64,448,7.0,11,10,0,21,2,15,4,0,4
10609,12,2015-11-28,iowa-state,@,West Virginia,L (6-30),19,39,48.7,191,0,41,93,2.3,0,80,284,3.6,10,6,1,17,4,30,1,2,3
10610,,12 Games,iowa-state,,,,237,411,57.7,2716,18,498,2184,4.4,18,909,4900,5.4,118,120,19,257,59,489,12,12,24
10611,1,2016-09-03,iowa-state,,Northern Iowa,L (20-25),18,28,64.3,256,3,25,51,2.0,0,53,307,5.8,10,3,3,16,9,89,2,2,4
10612,2,2016-09-10,iowa-state,@,Iowa,L (3-42),14,35,40.0,165,0,35,126,3.6,0,70,291,4.2,8,7,1,16,10,73,0,1,1
10613,3,2016-09-17,iowa-state,@,Texas Christian,L (20-41),19,36,52.8,217,0,47,138,2.9,2,83,355,4.3,7,10,1,18,7,44,0,0,0
10614,4,2016-09-24,iowa-state,,San Jose State,W (44-10),22,29,75.9,316,5,32,187,5.8,1,61,503,8.2,13,9,1,23,3,25,1,0,1
10615,5,2016-10-01,iowa-state,,Baylor,L (42-45),17,23,73.9,261,2,54,204,3.8,4,77,465,6.0,12,12,2,26,9,80,0,0,0
10616,6,2016-10-08,iowa-state,@,Oklahoma State,L (31-38),25,44,56.8,283,3,42,165,3.9,1,86,448,5.2,14,9,3,26,7,41,1,2,3
10617,7,2016-10-15,iowa-state,@,Texas,L (6-27),19,34,55.9,182,0,43,98,2.3,0,77,280,3.6,7,9,3,19,6,64,1,0,1
10618,8,2016-10-29,iowa-state,,Kansas State,L (26-31),24,43,55.8,339,2,31,154,5.0,1,74,493,6.7,16,8,1,25,6,51,0,1,1
10619,9,2016-11-03,iowa-state,,Oklahoma,L (24-34),16,30,53.3,160,2,26,130,5.0,1,56,290,5.2,8,6,1,15,5,45,0,0,0
10620,10,2016-11-12,iowa-state,@,Kansas,W (31-24),21,30,70.0,220,2,46,238,5.2,2,76,458,6.0,12,11,1,24,5,59,0,1,1
10621,11,2016-11-19,iowa-state,,Texas Tech,W (66-10),17,22,77.3,336,2,43,272,6.3,6,65,608,9.4,14,10,0,24,2,25,0,0,0
10622,12,2016-11-26,iowa-state,,West Virginia,L (19-49),23,44,52.3,371,0,34,190,5.6,0,78,561,7.2,12,9,0,21,7,85,3,1,4
10623,,12 Games,iowa-state,,,,235,398,59.0,3106,21,458,1953,4.3,18,856,5059,5.9,133,103,17,253,76,681,8,8,16
10624,1,2017-09-02,iowa-state,,Northern Iowa,W (42-24),27,36,75.0,271,2,35,134,3.8,2,71,405,5.7,16,7,1,24,7,74,0,1,1
10625,2,2017-09-09,iowa-state,,Iowa,L (41-44),25,46,54.3,347,4,26,120,4.6,1,72,467,6.5,14,5,3,22,2,15,0,1,1
10626,3,2017-09-16,iowa-state,@,Akron,W (41-14),24,33,72.7,317,2,37,191,5.2,3,70,508,7.3,12,7,4,23,7,72,0,0,0
10627,4,2017-09-28,iowa-state,,Texas,L (7-17),24,49,49.0,246,1,15,10,0.7,0,64,256,4.0,15,2,1,18,4,40,0,3,3
10628,5,2017-10-07,iowa-state,@,Oklahoma,W (38-31),20,27,74.1,368,3,32,81,2.5,1,59,449,7.6,10,6,5,21,3,17,0,0,0
10629,6,2017-10-14,iowa-state,,Kansas,W (45-0),18,30,60.0,212,1,43,106,2.5,4,73,318,4.4,8,5,2,15,4,38,0,0,0
10630,7,2017-10-21,iowa-state,@,Texas Tech,W (31-13),22,32,68.8,192,3,36,208,5.8,0,68,400,5.9,11,8,1,20,0,0,0,1,1
10631,8,2017-10-28,iowa-state,,Texas Christian,W (14-7),21,35,60.0,202,2,33,53,1.6,0,68,255,3.8,11,2,4,17,4,35,0,1,1
10632,9,2017-11-04,iowa-state,@,West Virginia,L (16-20),27,40,67.5,249,1,29,101,3.5,0,69,350,5.1,13,5,5,23,3,30,0,1,1
10633,10,2017-11-11,iowa-state,,Oklahoma State,L (42-49),30,47,63.8,386,2,29,105,3.6,4,76,491,6.5,18,5,7,30,7,40,0,1,1
10634,11,2017-11-18,iowa-state,@,Baylor,W (23-13),14,28,50.0,180,2,40,214,5.4,0,68,394,5.8,7,13,1,21,4,50,0,0,0
10635,12,2017-11-25,iowa-state,@,Kansas State,L (19-20),24,36,66.7,264,2,30,115,3.8,0,66,379,5.7,10,7,1,18,9,85,0,0,0
10636,13,2017-12-30,iowa-state,@,Memphis*,W (21-20),24,38,63.2,314,2,42,32,0.8,1,80,346,4.3,15,5,2,22,3,20,1,0,1
10637,,13 Games,iowa-state,,,,300,477,62.9,3548,27,427,1470,3.4,16,904,5018,5.6,160,77,37,274,57,516,1,9,10
10638,1,2018-09-08,iowa-state,@,Iowa,L (3-13),19,31,61.3,169,0,25,19,0.8,0,56,188,3.4,6,4,1,11,7,65,1,0,1
10639,2,2018-09-15,iowa-state,,Oklahoma,L (27-37),25,36,69.4,360,2,29,87,3.0,1,65,447,6.9,12,6,2,20,4,35,0,1,1
10640,3,2018-09-22,iowa-state,,Akron,W (26-13),26,34,76.5,233,1,35,132,3.8,1,69,365,5.3,12,8,1,21,5,50,2,0,2
10641,4,2018-09-29,iowa-state,@,Texas Christian,L (14-17),14,28,50.0,79,1,28,119,4.3,1,56,198,3.5,6,6,3,15,1,15,1,0,1
10642,5,2018-10-06,iowa-state,@,Oklahoma State,W (48-42),19,25,76.0,325,4,38,140,3.7,2,63,465,7.4,11,7,3,21,5,36,1,1,2
10643,6,2018-10-13,iowa-state,,West Virginia,W (30-14),18,25,72.0,254,3,47,244,5.2,1,72,498,6.9,11,10,4,25,10,95,0,1,1
10644,7,2018-10-27,iowa-state,,Texas Tech,W (40-31),13,27,48.1,250,2,51,172,3.4,2,78,422,5.4,9,10,5,24,4,25,1,0,1
10645,8,2018-11-03,iowa-state,@,Kansas,W (27-3),17,24,70.8,273,3,38,121,3.2,0,62,394,6.4,10,9,1,20,2,12,0,0,0
10646,9,2018-11-10,iowa-state,,Baylor,W (28-14),18,23,78.3,230,1,30,127,4.2,2,53,357,6.7,12,8,1,21,4,30,0,0,0
10647,10,2018-11-17,iowa-state,@,Texas,L (10-24),13,29,44.8,148,0,30,62,2.1,1,59,210,3.6,5,7,0,12,3,20,1,1,2
10648,,10 Games,iowa-state,,,,182,282,64.5,2321,17,351,1223,3.5,11,633,3544,5.6,94,75,21,190,45,383,7,4,11
10649,1,2014-09-06,kansas,,Southeast Missouri State,W (34-28),12,24,50.0,196,3,49,261,5.3,1,73,457,6.3,8,11,1,20,9,80,0,0,0
10650,2,2014-09-13,kansas,@,Duke,L (3-41),12,29,41.4,95,0,47,202,4.3,0,76,297,3.9,2,13,2,17,7,74,0,2,2
10651,3,2014-09-20,kansas,,Central Michigan,W (24-10),24,34,70.6,231,2,35,138,3.9,1,69,369,5.3,10,5,0,15,8,65,0,1,1
10652,4,2014-09-27,kansas,,Texas,L (0-23),12,31,38.7,140,0,51,173,3.4,0,82,313,3.8,6,12,1,19,7,52,0,4,4
10653,5,2014-10-04,kansas,@,West Virginia,L (14-33),13,28,46.4,111,0,34,65,1.9,1,62,176,2.8,4,4,1,9,11,101,0,0,0
10654,6,2014-10-11,kansas,,Oklahoma State,L (20-27),20,37,54.1,288,0,41,91,2.2,2,78,379,4.9,12,5,1,18,8,65,0,1,1
10655,7,2014-10-18,kansas,@,Texas Tech,L (21-34),20,32,62.5,235,2,40,128,3.2,1,72,363,5.0,11,8,0,19,4,37,1,1,2
10656,8,2014-11-01,kansas,@,Baylor,L (14-60),21,30,70.0,288,2,27,16,0.6,0,57,304,5.3,8,1,3,12,6,60,3,0,3
10657,9,2014-11-08,kansas,,Iowa State,W (34-14),26,43,60.5,286,1,48,228,4.8,3,91,514,5.6,18,11,0,29,4,32,0,0,0
10658,10,2014-11-15,kansas,,Texas Christian,L (30-34),20,38,52.6,342,2,36,76,2.1,2,74,418,5.6,13,5,1,19,7,55,0,1,1
10659,11,2014-11-22,kansas,@,Oklahoma,L (7-44),8,23,34.8,84,0,36,19,0.5,0,59,103,1.7,4,2,1,7,2,20,1,1,2
10660,12,2014-11-29,kansas,@,Kansas State,L (13-51),16,27,59.3,139,2,22,57,2.6,0,49,196,4.0,8,4,1,13,3,28,0,2,2
10661,,12 Games,kansas,,,,204,376,54.3,2435,14,466,1454,3.1,11,842,3889,4.6,104,81,12,197,76,669,5,13,18
10662,1,2015-09-05,kansas,,South Dakota State,L (38-41),25,40,62.5,291,1,51,285,5.6,3,91,576,6.3,15,14,0,29,7,75,1,1,2
10663,2,2015-09-12,kansas,,Memphis,L (23-55),18,38,47.4,165,0,46,194,4.2,2,84,359,4.3,0,0,0,23,7,68,0,0,0
10664,3,2015-09-26,kansas,@,Rutgers,L (14-27),19,32,59.4,278,0,29,64,2.2,2,61,342,5.6,15,1,2,18,4,46,0,1,1
10665,4,2015-10-03,kansas,@,Iowa State,L (13-38),23,37,62.2,250,1,33,38,1.2,0,70,288,4.1,11,4,0,15,5,37,1,0,1
10666,5,2015-10-10,kansas,,Baylor,L (7-66),20,36,55.6,158,1,39,69,1.8,0,75,227,3.0,7,5,2,14,4,50,2,1,3
10667,6,2015-10-17,kansas,,Texas Tech,L (20-30),35,50,70.0,330,2,40,145,3.6,1,90,475,5.3,17,7,2,26,5,41,2,1,3
10668,7,2015-10-24,kansas,@,Oklahoma State,L (10-58),12,31,38.7,191,1,27,30,1.1,0,58,221,3.8,7,2,0,9,10,102,0,2,2
10669,8,2015-10-31,kansas,,Oklahoma,L (7-62),20,34,58.8,181,1,36,35,1.0,0,70,216,3.1,10,3,2,15,6,81,2,0,2
10670,9,2015-11-07,kansas,@,Texas,L (20-59),19,41,46.3,234,1,48,192,4.0,1,89,426,4.8,10,13,0,23,3,15,1,3,4
10671,10,2015-11-14,kansas,@,Texas Christian,L (17-23),20,41,48.8,203,1,30,121,4.0,1,71,324,4.6,7,5,1,13,8,53,0,1,1
10672,11,2015-11-21,kansas,,West Virginia,L (0-49),13,37,35.1,127,0,30,82,2.7,0,67,209,3.1,3,5,2,10,5,46,1,3,4
10673,12,2015-11-28,kansas,,Kansas State,L (14-45),19,35,54.3,215,2,35,100,2.9,0,70,315,4.5,10,7,0,17,6,50,0,1,1
10674,,12 Games,kansas,,,,243,452,53.8,2623,11,444,1355,3.1,10,896,3978,4.4,112,66,11,212,70,664,10,14,24
10675,1,2016-09-03,kansas,,Rhode Island,W (55-6),28,38,73.7,399,6,35,171,4.9,2,73,570,7.8,16,12,0,28,4,37,1,1,2
10676,2,2016-09-10,kansas,,Ohio,L (21-37),18,29,62.1,206,2,15,26,1.7,0,44,232,5.3,7,1,1,9,4,50,2,1,3
10677,3,2016-09-17,kansas,@,Memphis,L (7-43),26,41,63.4,193,0,31,121,3.9,1,72,314,4.4,6,5,3,14,8,41,4,2,6
10678,4,2016-09-29,kansas,@,Texas Tech,L (19-55),25,48,52.1,250,2,28,46,1.6,0,76,296,3.9,13,4,0,17,7,55,1,1,2
10679,5,2016-10-08,kansas,,Texas Christian,L (23-24),31,45,68.9,348,0,44,122,2.8,2,89,470,5.3,13,8,2,23,5,61,1,3,4
10680,6,2016-10-15,kansas,@,Baylor,L (7-49),13,27,48.1,134,0,48,83,1.7,1,75,217,2.9,4,9,2,15,4,35,1,4,5
10681,7,2016-10-22,kansas,,Oklahoma State,L (20-44),24,40,60.0,250,1,33,204,6.2,1,73,454,6.2,11,8,1,20,5,46,1,2,3
10682,8,2016-10-29,kansas,@,Oklahoma,L (3-56),21,37,56.8,121,0,28,49,1.8,0,65,170,2.6,4,5,2,11,6,40,0,2,2
10683,9,2016-11-05,kansas,@,West Virginia,L (21-48),21,36,58.3,291,2,37,150,4.1,1,73,441,6.0,10,6,2,18,9,104,0,2,2
10684,10,2016-11-12,kansas,,Iowa State,L (24-31),26,38,68.4,171,1,40,244,6.1,2,78,415,5.3,7,16,2,25,1,15,1,1,2
10685,11,2016-11-19,kansas,,Texas,W (24-21),21,42,50.0,220,0,39,112,2.9,1,81,332,4.1,7,6,2,15,9,85,1,1,2
10686,12,2016-11-26,kansas,@,Kansas State,L (19-34),24,44,54.5,302,2,27,101,3.7,0,71,403,5.7,8,9,1,18,9,85,1,2,3
10687,,12 Games,kansas,,,,278,465,59.8,2885,16,405,1429,3.5,11,870,4314,5.0,106,89,18,213,71,654,14,22,36
10688,1,2017-09-02,kansas,,Southeast Missouri State,W (38-16),23,37,62.2,364,4,25,73,2.9,1,62,437,7.0,12,4,1,17,5,49,1,2,3
10689,2,2017-09-09,kansas,,Central Michigan,L (27-45),32,62,51.6,323,0,34,147,4.3,3,96,470,4.9,20,7,2,29,9,65,0,2,2
10690,3,2017-09-16,kansas,@,Ohio,L (30-42),30,47,63.8,343,2,32,108,3.4,2,79,451,5.7,17,5,1,23,7,50,0,1,1
10691,4,2017-09-23,kansas,,West Virginia,L (34-56),17,34,50.0,197,1,50,367,7.3,3,84,564,6.7,8,13,3,24,8,43,1,2,3
10692,5,2017-10-07,kansas,,Texas Tech,L (19-65),23,43,53.5,256,1,33,112,3.4,1,76,368,4.8,9,7,1,17,4,35,2,2,4
10693,6,2017-10-14,kansas,@,Iowa State,L (0-45),11,26,42.3,44,0,33,62,1.9,0,59,106,1.8,1,3,1,5,8,75,1,1,2
10694,7,2017-10-21,kansas,@,Texas Christian,L (0-43),8,18,44.4,46,0,31,-25,-0.8,0,49,21,0.4,1,1,2,4,4,40,0,0,0
10695,8,2017-10-28,kansas,,Kansas State,L (20-30),23,48,47.9,418,1,28,64,2.3,1,76,482,6.3,14,6,0,20,4,42,1,1,2
10696,9,2017-11-04,kansas,,Baylor,L (9-38),19,36,52.8,163,0,33,126,3.8,0,69,289,4.2,6,8,1,15,4,30,1,1,2
10697,10,2017-11-11,kansas,@,Texas,L (27-42),27,43,62.8,268,3,35,96,2.7,0,78,364,4.7,11,7,1,19,5,45,1,3,4
10698,11,2017-11-18,kansas,,Oklahoma,L (3-41),19,34,55.9,123,0,27,32,1.2,0,61,155,2.5,6,2,2,10,5,60,1,1,2
10699,12,2017-11-25,kansas,@,Oklahoma State,L (17-58),17,32,53.1,172,2,30,69,2.3,0,62,241,3.9,8,3,0,11,3,19,0,1,1
10700,,12 Games,kansas,,,,249,460,54.1,2717,14,391,1231,3.1,11,851,3948,4.6,113,66,15,194,66,553,9,17,26
10701,1,2018-09-01,kansas,,Nicholls State,L (23-26),21,38,55.3,199,2,32,56,1.8,0,70,255,3.6,8,5,1,14,7,54,1,0,1
10702,2,2018-09-08,kansas,@,Central Michigan,W (31-7),18,27,66.7,145,1,45,216,4.8,2,72,361,5.0,8,10,2,20,7,55,0,0,0
10703,3,2018-09-15,kansas,,Rutgers,W (55-14),15,25,60.0,144,1,48,400,8.3,4,73,544,7.5,9,12,1,22,7,67,0,0,0
10704,4,2018-09-22,kansas,@,Baylor,L (7-26),16,27,59.3,149,1,28,122,4.4,0,55,271,4.9,5,5,4,14,7,55,0,0,0
10705,5,2018-09-29,kansas,,Oklahoma State,L (28-48),24,32,75.0,247,3,32,121,3.8,1,64,368,5.8,11,5,2,18,4,43,1,0,1
10706,6,2018-10-06,kansas,@,West Virginia,L (22-38),21,34,61.8,206,2,26,80,3.1,1,60,286,4.8,9,5,2,16,6,45,1,2,3
10707,7,2018-10-20,kansas,@,Texas Tech,L (16-48),18,41,43.9,221,2,29,98,3.4,0,70,319,4.6,9,6,1,16,6,62,1,1,2
10708,8,2018-10-27,kansas,,Texas Christian,W (27-26),19,29,65.5,249,2,38,58,1.5,1,67,307,4.6,12,4,1,17,8,59,0,0,0
10709,9,2018-11-03,kansas,,Iowa State,L (3-27),19,43,44.2,185,0,40,147,3.7,0,83,332,4.0,11,8,1,20,3,25,1,0,1
10710,10,2018-11-10,kansas,@,Kansas State,L (17-21),21,34,61.8,232,2,35,115,3.3,0,69,347,5.0,13,4,2,19,8,53,2,0,2
10711,11,2018-11-17,kansas,@,Oklahoma,L (40-55),20,28,71.4,176,1,36,348,9.7,4,64,524,8.2,8,17,0,25,6,53,0,0,0
10712,,11 Games,kansas,,,,212,358,59.2,2153,17,389,1761,4.5,13,747,3914,5.2,103,81,17,201,69,571,7,3,10
10713,1,2014-08-30,missouri,,South Dakota State,W (38-18),13,21,61.9,178,3,39,215,5.5,1,60,393,6.6,6,13,0,19,5,27,0,0,0
10714,2,2014-09-06,missouri,@,Toledo,W (49-24),21,33,63.6,325,5,47,177,3.8,2,80,502,6.3,15,9,1,25,2,25,0,2,2
10715,3,2014-09-13,missouri,,Central Florida,W (38-10),14,24,58.3,144,4,35,178,5.1,0,59,322,5.5,8,10,1,19,4,47,0,1,1
10716,4,2014-09-20,missouri,,Indiana,L (27-31),29,48,60.4,331,2,35,172,4.9,1,83,503,6.1,18,8,2,27,10,75,0,1,1
10717,5,2014-09-27,missouri,@,South Carolina,W (21-20),12,34,35.3,132,0,36,148,4.1,3,70,280,4.0,5,9,2,16,8,74,0,0,0
10718,6,2014-10-11,missouri,,Georgia,L (0-34),9,21,42.9,97,0,22,50,2.3,0,43,147,3.4,5,4,1,10,4,30,1,4,5
10719,7,2014-10-18,missouri,@,Florida,W (42-13),6,18,33.3,20,0,31,99,3.2,1,49,119,2.4,1,6,0,7,11,74,0,1,1
10720,8,2014-10-25,missouri,,Vanderbilt,W (24-14),11,23,47.8,141,2,46,244,5.3,1,69,385,5.6,7,12,1,20,14,100,0,0,0
10721,9,2014-11-01,missouri,,Kentucky,W (20-10),18,33,54.5,164,2,45,156,3.5,0,78,320,4.1,10,8,3,21,5,50,0,0,0
10722,10,2014-11-15,missouri,@,Texas A&M,W (34-27),23,40,57.5,252,1,49,335,6.8,3,89,587,6.6,13,16,3,32,12,81,0,1,1
10723,11,2014-11-22,missouri,@,Tennessee,W (29-21),12,25,48.0,230,2,45,180,4.0,2,70,410,5.9,8,9,2,19,12,82,0,0,0
10724,12,2014-11-28,missouri,,Arkansas,W (21-14),25,42,59.5,265,1,41,158,3.9,1,83,423,5.1,12,12,2,26,7,75,1,1,2
10725,13,2014-12-06,missouri,N,Alabama,L (13-42),16,34,47.1,272,1,23,41,1.8,0,57,313,5.5,9,1,0,10,6,60,1,0,1
10726,14,2015-01-01,missouri,N,Minnesota*,W (33-17),12,19,63.2,97,2,45,337,7.5,2,64,434,6.8,5,12,1,18,2,15,0,2,2
10727,,14 Games,missouri,,,,221,415,53.3,2648,25,539,2490,4.6,17,954,5138,5.4,122,129,19,269,102,815,3,13,16
10728,1,2015-09-05,missouri,,Southeast Missouri State,W (34-3),18,32,56.3,319,3,33,98,3.0,0,65,417,6.4,11,5,3,19,6,54,0,1,1
10729,2,2015-09-12,missouri,@,Arkansas State,W (27-20),16,37,43.2,148,3,34,140,4.1,0,71,288,4.1,8,8,3,19,9,75,0,3,3
10730,3,2015-09-19,missouri,,Connecticut,W (9-6),20,31,64.5,185,0,34,85,2.5,1,65,270,4.2,7,7,2,16,3,30,1,1,2
10731,4,2015-09-26,missouri,@,Kentucky,L (13-21),18,35,51.4,227,1,33,111,3.4,0,68,338,5.0,12,7,5,24,3,30,0,0,0
10732,5,2015-10-03,missouri,,South Carolina,W (24-10),21,28,75.0,136,2,42,163,3.9,1,70,299,4.3,5,13,0,18,3,29,0,0,0
10733,6,2015-10-10,missouri,,Florida,L (3-21),16,39,41.0,151,0,26,106,4.1,0,65,257,4.0,6,6,0,12,6,38,0,2,2
10734,7,2015-10-17,missouri,@,Georgia,L (6-9),11,26,42.3,143,0,22,21,1.0,0,48,164,3.4,5,0,1,6,4,27,1,0,1
10735,8,2015-10-24,missouri,@,Vanderbilt,L (3-10),14,34,41.2,108,0,19,80,4.2,0,53,188,3.5,5,3,2,10,6,37,1,0,1
10736,9,2015-11-05,missouri,,Mississippi State,L (13-31),11,26,42.3,107,0,45,215,4.8,1,71,322,4.5,6,9,1,16,6,38,0,2,2
10737,10,2015-11-14,missouri,N,Brigham Young,W (20-16),19,28,67.9,244,1,55,190,3.5,1,83,434,5.2,12,9,2,23,8,91,1,1,2
10738,11,2015-11-21,missouri,,Tennessee,L (8-19),13,30,43.3,135,0,29,88,3.0,1,59,223,3.8,5,4,1,10,7,50,1,1,2
10739,12,2015-11-27,missouri,@,Arkansas,L (3-28),9,27,33.3,83,0,25,88,3.5,0,52,171,3.3,3,5,0,8,2,18,0,1,1
10740,,12 Games,missouri,,,,186,373,49.9,1986,10,397,1385,3.5,5,770,3371,4.4,85,76,20,181,63,517,5,12,17
10741,1,2016-09-03,missouri,@,West Virginia,L (11-26),24,53,45.3,282,1,47,180,3.8,0,100,462,4.6,11,13,2,26,6,51,1,0,1
10742,2,2016-09-10,missouri,,Eastern Michigan,W (61-21),27,40,67.5,477,5,38,170,4.5,2,78,647,8.3,15,12,3,30,8,75,2,0,2
10743,3,2016-09-17,missouri,,Georgia,L (27-28),23,38,60.5,376,3,37,95,2.6,0,75,471,6.3,10,8,0,18,7,50,2,3,5
10744,4,2016-09-24,missouri,,Delaware State,W (79-0),29,39,74.4,430,6,39,268,6.9,5,78,698,8.9,15,17,2,34,6,60,0,0,0
10745,5,2016-10-01,missouri,@,Louisiana State,L (7-42),18,38,47.4,188,1,22,77,3.5,0,60,265,4.4,10,3,1,14,5,50,0,1,1
10746,6,2016-10-15,missouri,@,Florida,L (14-40),7,22,31.8,98,0,46,265,5.8,2,68,363,5.3,4,11,1,16,5,24,1,2,3
10747,7,2016-10-22,missouri,,Middle Tennessee State,L (45-51),20,40,50.0,281,2,64,348,5.4,4,104,629,6.0,13,21,2,36,13,125,2,0,2
10748,8,2016-10-29,missouri,,Kentucky,L (21-35),19,32,59.4,229,2,37,157,4.2,1,69,386,5.6,9,8,1,18,9,65,0,0,0
10749,9,2016-11-05,missouri,@,South Carolina,L (21-31),23,40,57.5,302,1,36,163,4.5,2,76,465,6.1,12,11,1,24,5,45,1,2,3
10750,10,2016-11-12,missouri,,Vanderbilt,W (26-17),22,37,59.5,294,2,37,187,5.1,1,74,481,6.5,10,7,3,20,7,90,1,0,1
10751,11,2016-11-19,missouri,@,Tennessee,L (37-63),21,43,48.8,320,1,67,420,6.3,4,110,740,6.7,13,27,1,41,7,51,2,2,4
10752,12,2016-11-25,missouri,,Arkansas,W (28-24),16,26,61.5,268,1,30,131,4.4,3,56,399,7.1,8,6,1,15,2,10,1,0,1
10753,,12 Games,missouri,,,,249,448,55.6,3545,25,500,2461,4.9,24,948,6006,6.3,130,144,18,292,80,696,13,10,23
10754,1,2017-09-02,missouri,,Missouri State,W (72-43),21,34,61.8,521,7,41,294,7.2,3,75,815,10.9,19,15,1,35,6,52,1,1,2
10755,2,2017-09-09,missouri,,South Carolina,L (13-31),14,32,43.8,245,1,37,178,4.8,0,69,423,6.1,10,11,0,21,4,24,1,2,3
10756,3,2017-09-16,missouri,,Purdue,L (3-35),12,28,42.9,133,0,24,70,2.9,0,52,203,3.9,5,4,1,10,6,46,1,2,3
10757,4,2017-09-23,missouri,,Auburn,L (14-51),23,39,59.0,216,2,30,124,4.1,0,69,340,4.9,12,7,2,21,7,55,3,1,4
10758,5,2017-10-07,missouri,@,Kentucky,L (34-40),22,43,51.2,355,3,33,213,6.5,1,76,568,7.5,11,13,0,24,7,55,2,0,2
10759,6,2017-10-14,missouri,@,Georgia,L (28-53),15,25,60.0,253,4,24,59,2.5,0,49,312,6.4,6,4,0,10,4,40,0,1,1
10760,7,2017-10-21,missouri,,Idaho,W (68-21),24,34,70.6,475,6,30,183,6.1,2,64,658,10.3,20,7,1,28,6,45,0,1,1
10761,8,2017-10-28,missouri,@,Connecticut,W (52-12),34,43,79.1,408,5,34,175,5.1,2,77,583,7.6,16,12,3,31,12,107,0,1,1
10762,9,2017-11-04,missouri,,Florida,W (45-16),15,21,71.4,228,3,46,227,4.9,3,67,455,6.8,10,12,4,26,7,71,0,1,1
10763,10,2017-11-11,missouri,,Tennessee,W (50-17),14,30,46.7,226,4,53,433,8.2,2,83,659,7.9,7,20,2,29,7,60,0,1,1
10764,11,2017-11-18,missouri,@,Vanderbilt,W (45-17),10,25,40.0,235,3,39,191,4.9,1,64,426,6.7,7,9,1,17,11,56,0,0,0
10765,12,2017-11-24,missouri,@,Arkansas,W (48-45),25,42,59.5,448,5,60,248,4.1,1,102,696,6.8,17,14,4,35,10,77,0,2,2
10766,13,2017-12-27,missouri,N,Texas*,L (16-33),18,34,52.9,269,1,33,134,4.1,1,67,403,6.0,10,5,2,17,9,86,3,1,4
10767,,13 Games,missouri,,,,247,430,57.4,4012,44,484,2529,5.2,16,914,6541,7.2,150,133,21,304,96,774,11,14,25
10768,1,2018-09-01,missouri,,Tennessee-Martin,W (51-14),23,34,67.6,394,4,44,164,3.7,2,78,558,7.2,13,8,5,26,4,45,0,0,0
10769,2,2018-09-08,missouri,,Wyoming,W (40-13),33,45,73.3,398,4,46,203,4.4,1,91,601,6.6,23,10,0,33,8,79,1,0,1
10770,3,2018-09-15,missouri,@,Purdue,W (40-37),26,43,60.5,375,3,46,233,5.1,1,89,608,6.8,14,14,3,31,4,27,0,1,1
10771,4,2018-09-22,missouri,,Georgia,L (29-43),23,48,47.9,221,0,37,172,4.6,4,85,393,4.6,15,9,2,26,5,30,2,1,3
10772,5,2018-10-06,missouri,@,South Carolina,L (35-37),17,36,47.2,204,0,46,286,6.2,3,82,490,6.0,9,10,4,23,10,83,0,2,2
10773,6,2018-10-13,missouri,@,Alabama,L (10-39),13,26,50.0,142,1,35,70,2.0,0,61,212,3.5,6,5,2,13,5,53,1,2,3
10774,7,2018-10-20,missouri,,Memphis,W (65-33),24,32,75.0,373,4,40,273,6.8,4,72,646,9.0,13,14,3,30,12,122,0,0,0
10775,8,2018-10-27,missouri,,Kentucky,L (14-15),15,27,55.6,165,0,35,84,2.4,2,62,249,4.0,7,3,3,13,8,69,0,0,0
10776,9,2018-11-03,missouri,@,Florida,W (38-17),24,32,75.0,250,3,42,221,5.3,2,74,471,6.4,12,10,0,22,11,84,0,0,0
10777,10,2018-11-10,missouri,,Vanderbilt,W (33-28),22,33,66.7,253,2,49,253,5.2,2,82,506,6.2,12,17,1,30,2,15,0,2,2
10778,11,2018-11-17,missouri,@,Tennessee,W (50-17),21,30,70.0,257,2,49,227,4.6,3,79,484,6.1,14,12,3,29,10,79,1,0,1
10779,,11 Games,missouri,,,,241,386,62.4,3032,23,469,2186,4.7,24,855,5218,6.1,138,112,26,276,79,686,5,8,13
10780,1,2016-09-01,maine,@,Connecticut,L (21-24),19,33,57.6,269,2,19,40,2.1,0,52,309,5.9,12,2,2,16,4,46,0,0,0
10781,2,2016-09-10,maine,@,Toledo,L (3-45),9,25,36.0,65,0,42,170,4.0,0,67,235,3.5,4,6,2,12,8,65,0,0,0
10782,,2 Games,maine,,,,28,58,48.3,334,2,61,210,3.4,0,119,544,4.6,16,8,4,28,12,111,0,0,0
10783,1,2017-11-11,maine,N,Massachusetts,L (31-44),16,41,39.0,232,0,29,148,5.1,3,70,380,5.4,7,6,4,17,12,124,0,2,2
10784,1,2018-09-08,maine,@,Western Kentucky,W (31-28),12,29,41.4,182,3,41,142,3.5,0,70,324,4.6,7,6,1,14,6,40,0,1,1
10785,2,2018-09-22,maine,@,Central Michigan,L (5-17),19,36,52.8,183,0,37,82,2.2,0,73,265,3.6,9,6,3,18,11,113,0,2,2
10786,,2 Games,maine,,,,31,65,47.7,365,3,78,224,2.9,0,143,589,4.1,16,12,4,32,17,153,0,3,3
10787,1,2016-09-03,new-hampshire,@,San Diego State,L (0-31),7,20,35.0,70,0,31,71,2.3,0,51,141,2.8,3,4,1,8,8,49,0,1,1
10788,1,2017-09-09,new-hampshire,N,Georgia Southern,W (22-12),13,22,59.1,129,2,32,145,4.5,1,54,274,5.1,7,7,0,14,6,41,0,0,0
10789,1,2018-09-15,new-hampshire,@,Colorado,L (14-45),16,39,41.0,228,1,31,42,1.4,0,70,270,3.9,6,7,2,15,6,35,2,1,3
10790,1,2014-08-30,ohio-state,N,Navy,W (34-17),12,15,80.0,226,2,40,194,4.9,1,55,420,7.6,7,12,0,19,2,20,0,1,1
10791,2,2014-09-06,ohio-state,,Virginia Tech,L (21-35),9,29,31.0,219,1,40,108,2.7,2,69,327,4.7,7,9,3,19,7,62,0,3,3
10792,3,2014-09-13,ohio-state,,Kent State,W (66-0),25,34,73.5,344,6,53,284,5.4,3,87,628,7.2,15,15,3,33,6,63,2,1,3
10793,4,2014-09-27,ohio-state,,Cincinnati,W (50-28),26,36,72.2,330,4,65,380,5.8,2,101,710,7.0,17,27,1,45,7,40,1,0,1
10794,5,2014-10-04,ohio-state,@,Maryland,W (52-24),19,24,79.2,264,4,53,269,5.1,2,77,533,6.9,10,15,1,26,7,66,0,0,0
10795,6,2014-10-18,ohio-state,,Rutgers,W (56-17),19,31,61.3,261,3,40,324,8.1,4,71,585,8.2,12,19,0,31,4,28,1,0,1
10796,7,2014-10-25,ohio-state,@,Penn State,W (31-24),12,19,63.2,74,1,57,219,3.8,3,76,293,3.9,4,14,1,19,8,70,0,2,2
10797,8,2014-11-01,ohio-state,,Illinois,W (55-14),20,34,58.8,249,4,44,296,6.7,3,78,545,7.0,12,16,0,28,6,56,1,0,1
10798,9,2014-11-08,ohio-state,@,Michigan State,W (49-37),16,26,61.5,300,3,41,268,6.5,4,67,568,8.5,9,14,2,25,7,50,2,0,2
10799,10,2014-11-15,ohio-state,@,Minnesota,W (31-24),15,25,60.0,200,3,38,289,7.6,1,63,489,7.8,8,12,2,22,4,49,2,1,3
10800,11,2014-11-22,ohio-state,,Indiana,W (42-27),25,35,71.4,302,4,39,225,5.8,1,74,527,7.1,13,11,0,24,3,25,1,2,3
10801,12,2014-11-29,ohio-state,,Michigan,W (42-28),15,24,62.5,183,1,39,233,6.0,4,63,416,6.6,8,11,1,20,9,84,0,0,0
10802,13,2014-12-06,ohio-state,N,Wisconsin,W (59-0),12,18,66.7,257,3,38,301,7.9,4,56,558,10.0,10,12,2,24,5,44,0,0,0
10803,14,2015-01-01,ohio-state,N,Alabama*,W (42-35),19,36,52.8,256,2,42,281,6.7,2,78,537,6.9,10,12,1,23,4,24,1,1,2
10804,15,2015-01-12,ohio-state,N,Oregon*,W (42-20),16,23,69.6,242,1,61,296,4.9,5,84,538,6.4,8,18,2,28,5,30,3,1,4
10805,,15 Games,ohio-state,,,,260,409,63.6,3707,42,690,3967,5.7,41,1099,7674,7.0,150,217,19,386,84,711,14,12,26
10806,1,2015-09-07,ohio-state,@,Virginia Tech,W (42-24),10,19,52.6,212,3,37,360,9.7,3,56,572,10.2,8,11,2,21,6,58,2,1,3
10807,2,2015-09-12,ohio-state,,Hawaii,W (38-0),20,34,58.8,181,0,49,182,3.7,4,83,363,4.4,11,13,2,26,7,115,0,0,0
10808,3,2015-09-19,ohio-state,,Northern Illinois,W (20-13),16,29,55.2,136,1,37,162,4.4,0,66,298,4.5,6,8,0,14,6,39,2,3,5
10809,4,2015-09-26,ohio-state,,Western Michigan,W (38-12),20,36,55.6,288,2,34,223,6.6,2,70,511,7.3,13,11,1,25,12,86,0,2,2
10810,5,2015-10-03,ohio-state,@,Indiana,W (34-27),18,27,66.7,245,1,34,272,8.0,3,61,517,8.5,8,5,0,13,8,109,2,1,3
10811,6,2015-10-10,ohio-state,,Maryland,W (49-28),23,30,76.7,317,2,47,182,3.9,5,77,499,6.5,15,13,3,31,6,45,0,0,0
10812,7,2015-10-17,ohio-state,,Penn State,W (38-10),13,19,68.4,114,2,50,315,6.3,3,69,429,6.2,7,18,0,25,5,70,0,0,0
10813,8,2015-10-24,ohio-state,@,Rutgers,W (49-7),17,21,81.0,247,3,49,281,5.7,4,70,528,7.5,12,13,2,27,0,0,1,0,1
10814,9,2015-11-07,ohio-state,,Minnesota,W (28-14),12,22,54.5,187,1,44,189,4.3,2,66,376,5.7,9,9,0,18,5,45,1,0,1
10815,10,2015-11-14,ohio-state,@,Illinois,W (28-3),17,25,68.0,157,1,50,283,5.7,3,75,440,5.9,8,14,1,23,7,40,1,1,2
10816,11,2015-11-21,ohio-state,,Michigan State,L (14-17),9,16,56.3,46,1,29,86,3.0,1,45,132,2.9,1,4,0,5,4,20,0,0,0
10817,12,2015-11-28,ohio-state,@,Michigan,W (42-13),9,15,60.0,113,1,54,369,6.8,5,69,482,7.0,4,18,3,25,5,39,0,0,0
10818,13,2016-01-01,ohio-state,N,Notre Dame*,W (44-28),19,31,61.3,211,1,54,285,5.3,4,85,496,5.8,12,14,1,27,4,45,0,1,1
10819,,13 Games,ohio-state,,,,203,324,62.7,2454,19,568,3189,5.6,39,892,5643,6.3,114,151,15,280,75,711,9,9,18
10820,1,2016-09-03,ohio-state,,Bowling Green State,W (77-10),27,39,69.2,417,7,55,359,6.5,3,94,776,8.3,14,25,2,41,9,66,0,1,1
10821,2,2016-09-10,ohio-state,,Tulsa,W (48-3),14,22,63.6,149,0,48,268,5.6,4,70,417,6.0,7,12,1,20,9,67,1,0,1
10822,3,2016-09-17,ohio-state,@,Oklahoma,W (45-24),14,20,70.0,152,4,48,291,6.1,1,68,443,6.5,7,14,1,22,11,75,0,0,0
10823,4,2016-10-01,ohio-state,,Rutgers,W (58-0),25,36,69.4,259,4,53,410,7.7,4,89,669,7.5,10,21,1,32,6,64,0,1,1
10824,5,2016-10-08,ohio-state,,Indiana,W (38-17),9,21,42.9,93,1,50,290,5.8,4,71,383,5.4,3,15,0,18,9,83,1,1,2
10825,6,2016-10-15,ohio-state,@,Wisconsin,W (30-23),17,29,58.6,226,1,45,185,4.1,2,74,411,5.6,10,12,1,23,4,40,0,1,1
10826,7,2016-10-22,ohio-state,@,Penn State,L (21-24),28,43,65.1,245,1,40,168,4.2,1,83,413,5.0,9,9,1,19,8,45,0,0,0
10827,8,2016-10-29,ohio-state,,Northwestern,W (24-20),21,32,65.6,223,0,41,208,5.1,3,73,431,5.9,10,13,0,23,2,10,0,0,0
10828,9,2016-11-05,ohio-state,,Nebraska,W (62-3),32,44,72.7,352,4,42,238,5.7,2,86,590,6.9,17,15,2,34,4,35,1,0,1
10829,10,2016-11-12,ohio-state,@,Maryland,W (62-3),24,36,66.7,328,3,43,253,5.9,5,79,581,7.4,15,13,4,32,6,55,0,0,0
10830,11,2016-11-19,ohio-state,@,Michigan State,W (17-16),10,22,45.5,86,1,45,224,5.0,1,67,310,4.6,3,11,2,16,4,40,1,0,1
10831,12,2016-11-26,ohio-state,,Michigan,W (30-27),15,32,46.9,124,0,50,206,4.1,3,82,330,4.0,7,13,3,23,2,6,0,1,1
10832,13,2016-12-31,ohio-state,N,Clemson,L (0-31),19,33,57.6,127,0,23,88,3.8,0,56,215,3.8,4,3,2,9,8,72,1,2,3
10833,,13 Games,ohio-state,,,,255,409,62.3,2781,26,583,3188,5.5,33,992,5969,6.0,116,176,20,312,82,658,5,7,12
10834,1,2017-08-31,ohio-state,@,Indiana,W (49-21),20,35,57.1,304,3,51,292,5.7,3,86,596,6.9,10,14,2,26,5,50,0,0,0
10835,2,2017-09-09,ohio-state,,Oklahoma,L (16-31),19,35,54.3,183,0,34,167,4.9,1,69,350,5.1,9,11,1,21,9,87,0,1,1
10836,3,2017-09-16,ohio-state,,Army,W (38-7),29,37,78.4,316,2,32,270,8.4,3,69,586,8.5,12,18,0,30,5,55,0,0,0
10837,4,2017-09-23,ohio-state,,Nevada-Las Vegas,W (54-21),31,44,70.5,474,7,40,190,4.8,0,84,664,7.9,17,16,1,34,8,85,2,1,3
10838,5,2017-09-30,ohio-state,@,Rutgers,W (56-0),20,31,64.5,353,4,36,278,7.7,4,67,631,9.4,11,11,2,24,10,106,0,0,0
10839,6,2017-10-07,ohio-state,,Maryland,W (62-14),23,36,63.9,303,3,50,281,5.6,5,86,584,6.8,15,13,5,33,8,85,2,0,2
10840,7,2017-10-14,ohio-state,@,Nebraska,W (56-14),31,39,79.5,354,5,47,279,5.9,3,86,633,7.4,19,18,4,41,7,53,0,0,0
10841,8,2017-10-28,ohio-state,,Penn State,W (39-38),33,39,84.6,328,4,39,201,5.2,1,78,529,6.8,14,10,3,27,10,79,2,0,2
10842,9,2017-11-04,ohio-state,@,Iowa,L (24-55),18,34,52.9,208,3,30,163,5.4,0,64,371,5.8,9,10,1,20,9,95,0,4,4
10843,10,2017-11-11,ohio-state,,Michigan State,W (48-3),15,23,65.2,189,2,42,335,8.0,4,65,524,8.1,9,13,3,25,2,27,0,2,2
10844,11,2017-11-18,ohio-state,,Illinois,W (52-14),16,29,55.2,218,3,59,325,5.5,4,88,543,6.2,11,14,2,27,7,68,1,0,1
10845,12,2017-11-25,ohio-state,@,Michigan,W (31-20),9,15,60.0,124,1,48,226,4.7,3,63,350,5.6,4,11,2,17,9,75,0,0,0
10846,13,2017-12-02,ohio-state,N,Wisconsin,W (27-21),12,26,46.2,211,2,42,238,5.7,1,68,449,6.6,5,9,2,16,5,48,1,2,3
10847,14,2017-12-29,ohio-state,N,Southern California*,W (24-7),11,17,64.7,114,0,38,163,4.3,2,55,277,5.0,5,6,2,13,3,30,1,0,1
10848,,14 Games,ohio-state,,,,287,440,65.2,3679,39,588,3408,5.8,34,1028,7087,6.9,150,174,30,354,97,943,9,10,19
10849,1,2018-09-01,ohio-state,,Oregon State,W (77-31),25,34,73.5,346,5,52,377,7.3,5,86,723,8.4,14,18,3,35,6,50,1,1,2
10850,2,2018-09-08,ohio-state,,Rutgers,W (52-3),30,33,90.9,354,5,40,225,5.6,2,73,579,7.9,15,12,5,32,11,120,0,0,0
10851,3,2018-09-15,ohio-state,N,Texas Christian,W (40-28),24,38,63.2,344,2,42,182,4.3,1,80,526,6.6,14,13,2,29,5,39,0,0,0
10852,4,2018-09-22,ohio-state,,Tulane,W (49-6),31,38,81.6,419,5,38,151,4.0,2,76,570,7.5,22,8,2,32,10,89,0,0,0
10853,5,2018-09-29,ohio-state,@,Penn State,W (27-26),22,39,56.4,270,3,37,119,3.2,1,76,389,5.1,11,8,2,21,10,105,0,1,1
10854,6,2018-10-06,ohio-state,,Indiana,W (49-26),33,44,75.0,455,6,48,154,3.2,1,92,609,6.6,19,13,1,33,9,82,1,2,3
10855,7,2018-10-13,ohio-state,,Minnesota,W (30-14),33,44,75.0,412,3,32,92,2.9,0,76,504,6.6,20,6,3,29,5,36,0,0,0
10856,8,2018-10-20,ohio-state,@,Purdue,L (20-49),49,73,67.1,470,2,25,76,3.0,0,98,546,5.6,24,4,3,31,10,86,0,1,1
10857,9,2018-11-03,ohio-state,,Nebraska,W (36-31),18,32,56.3,252,2,40,229,5.7,3,72,481,6.7,10,11,2,23,6,46,2,1,3
10858,10,2018-11-10,ohio-state,@,Michigan State,W (26-6),24,39,61.5,227,1,45,120,2.7,1,84,347,4.1,12,8,1,21,4,30,1,0,1
10859,11,2018-11-17,ohio-state,@,Maryland,W (52-51),28,38,73.7,405,3,56,283,5.1,4,94,688,7.3,17,12,7,36,10,79,2,1,3
10860,,11 Games,ohio-state,,,,317,452,70.1,3954,37,455,2008,4.4,20,907,5962,6.6,178,113,31,322,86,762,7,7,14
10861,1,2014-08-30,iowa,,Northern Iowa,W (31-23),31,41,75.6,250,2,36,151,4.2,2,77,401,5.2,11,9,6,26,4,35,1,0,1
10862,2,2014-09-06,iowa,,Ball State,W (17-13),35,55,63.6,342,2,29,113,3.9,0,84,455,5.4,17,9,1,27,3,30,2,0,2
10863,3,2014-09-13,iowa,,Iowa State,L (17-20),16,24,66.7,146,0,44,129,2.9,2,68,275,4.0,5,12,1,18,6,50,1,1,2
10864,4,2014-09-20,iowa,@,Pittsburgh,W (24-20),12,18,66.7,178,1,35,133,3.8,2,53,311,5.9,7,8,2,17,2,20,0,1,1
10865,5,2014-09-27,iowa,@,Purdue,W (24-10),17,37,45.9,245,1,51,175,3.4,2,88,420,4.8,10,11,1,22,3,14,0,1,1
10866,6,2014-10-11,iowa,,Indiana,W (45-29),21,32,65.6,219,2,44,207,4.7,3,76,426,5.6,6,12,4,22,4,30,0,0,0
10867,7,2014-10-18,iowa,@,Maryland,L (31-38),32,56,57.1,317,2,31,116,3.7,2,87,433,5.0,11,8,0,19,7,65,2,1,3
10868,8,2014-11-01,iowa,,Northwestern,W (48-7),17,25,68.0,262,1,46,221,4.8,4,71,483,6.8,12,11,1,24,5,35,1,0,1
10869,9,2014-11-08,iowa,@,Minnesota,L (14-51),13,26,50.0,121,1,30,84,2.8,1,56,205,3.7,6,6,1,13,1,15,2,1,3
10870,10,2014-11-15,iowa,@,Illinois,W (30-14),17,24,70.8,283,3,55,304,5.5,1,79,587,7.4,12,13,1,26,1,10,1,0,1
10871,11,2014-11-22,iowa,,Wisconsin,L (24-26),20,30,66.7,311,2,28,101,3.6,1,58,412,7.1,12,4,3,19,3,22,1,0,1
10872,12,2014-11-28,iowa,,Nebraska,L (34-37),19,38,50.0,230,2,50,142,2.8,0,88,372,4.2,11,11,2,24,3,21,3,1,4
10873,13,2015-01-02,iowa,N,Tennessee*,L (28-45),15,31,48.4,177,2,35,244,7.0,2,66,421,6.4,10,9,4,23,4,37,1,1,2
10874,,13 Games,iowa,,,,265,437,60.6,3081,21,514,2120,4.1,22,951,5201,5.5,130,123,27,280,46,384,15,7,22
10875,1,2015-09-05,iowa,,Illinois State,W (31-14),16,25,64.0,221,1,44,210,4.8,3,69,431,6.2,10,12,0,22,5,51,1,0,1
10876,2,2015-09-12,iowa,@,Iowa State,W (31-17),15,25,60.0,215,3,45,260,5.8,1,70,475,6.8,9,13,0,22,6,50,1,0,1
10877,3,2015-09-19,iowa,,Pittsburgh,W (27-24),27,40,67.5,258,0,29,105,3.6,3,69,363,5.3,11,9,2,22,5,50,0,1,1
10878,4,2015-09-26,iowa,,North Texas,W (62-16),19,22,86.4,278,2,43,210,4.9,5,65,488,7.5,11,11,1,23,4,24,2,0,2
10879,5,2015-10-03,iowa,@,Wisconsin,W (10-6),9,21,42.9,77,1,40,144,3.6,0,61,221,3.6,3,8,3,14,6,54,1,1,2
10880,6,2015-10-10,iowa,,Illinois,W (29-20),15,31,48.4,200,2,51,278,5.5,1,82,478,5.8,6,15,2,23,6,80,0,0,0
10881,7,2015-10-17,iowa,@,Northwestern,W (40-10),16,27,59.3,198,0,51,294,5.8,5,78,492,6.3,9,14,1,24,5,47,0,1,1
10882,8,2015-10-31,iowa,,Maryland,W (31-15),12,24,50.0,183,0,44,110,2.5,3,68,293,4.3,9,6,3,18,7,53,1,0,1
10883,9,2015-11-07,iowa,@,Indiana,W (35-27),19,31,61.3,233,1,44,234,5.3,4,75,467,6.2,13,11,2,26,5,55,0,0,0
10884,10,2015-11-14,iowa,,Minnesota,W (40-35),19,27,70.4,234,0,48,272,5.7,5,75,506,6.7,12,12,3,27,4,50,0,0,0
10885,11,2015-11-21,iowa,,Purdue,W (40-20),12,20,60.0,213,3,39,174,4.5,3,59,387,6.6,10,9,2,21,2,20,1,0,1
10886,12,2015-11-27,iowa,@,Nebraska,W (28-20),9,16,56.3,97,1,28,153,5.5,2,44,250,5.7,3,4,4,11,6,54,1,0,1
10887,13,2015-12-05,iowa,N,Michigan State,L (13-16),18,27,66.7,216,1,24,52,2.2,0,51,268,5.3,6,5,2,13,5,45,2,1,3
10888,14,2016-01-01,iowa,N,Stanford*,L (16-45),21,33,63.6,239,2,38,48,1.3,0,71,287,4.0,11,6,1,18,7,50,1,1,2
10889,,14 Games,iowa,,,,227,369,61.5,2862,17,568,2544,4.5,35,937,5406,5.8,123,135,26,284,73,683,11,5,16
10890,1,2016-09-03,iowa,,Miami (OH),W (45-21),13,21,61.9,192,1,29,212,7.3,5,50,404,8.1,6,11,0,17,3,35,0,0,0
10891,2,2016-09-10,iowa,,Iowa State,W (42-3),20,30,66.7,237,3,36,198,5.5,3,66,435,6.6,12,10,3,25,5,35,0,0,0
10892,3,2016-09-17,iowa,,North Dakota State,L (21-23),13,24,54.2,197,3,25,34,1.4,0,49,231,4.7,5,6,1,12,3,16,0,1,1
10893,4,2016-09-24,iowa,@,Rutgers,W (14-7),12,23,52.2,162,1,38,193,5.1,1,61,355,5.8,8,11,0,19,7,57,0,0,0
10894,5,2016-10-01,iowa,,Northwestern,L (31-38),19,27,70.4,204,1,41,79,1.9,3,68,283,4.2,9,6,0,15,6,70,0,1,1
10895,6,2016-10-08,iowa,@,Minnesota,W (14-7),17,31,54.8,142,0,41,179,4.4,1,72,321,4.5,7,9,1,17,4,32,1,2,3
10896,7,2016-10-15,iowa,@,Purdue,W (49-35),12,20,60.0,155,2,53,365,6.9,4,73,520,7.1,5,17,2,24,12,94,0,0,0
10897,8,2016-10-22,iowa,,Wisconsin,L (9-17),17,33,51.5,153,0,27,83,3.1,0,60,236,3.9,9,5,0,14,5,30,0,0,0
10898,9,2016-11-05,iowa,@,Penn State,L (14-41),18,26,69.2,204,2,26,30,1.2,0,52,234,4.5,8,2,4,14,4,24,0,1,1
10899,10,2016-11-12,iowa,,Michigan,W (14-13),8,19,42.1,66,1,49,164,3.3,0,68,230,3.4,2,13,2,17,3,24,0,1,1
10900,11,2016-11-19,iowa,@,Illinois,W (28-0),9,17,52.9,80,0,49,262,5.3,3,66,342,5.2,5,11,0,16,5,40,1,1,2
10901,12,2016-11-25,iowa,,Nebraska,W (40-10),10,15,66.7,144,3,47,264,5.6,3,62,408,6.6,5,7,1,13,7,70,0,0,0
10902,13,2017-01-02,iowa,N,Florida*,L (3-30),7,24,29.2,55,0,41,171,4.2,0,65,226,3.5,3,9,2,14,1,10,0,3,3
10903,,13 Games,iowa,,,,175,310,56.5,1991,17,502,2234,4.5,23,812,4225,5.2,84,117,16,217,65,537,2,10,12
10904,1,2017-09-02,iowa,,Wyoming,W (24-3),8,15,53.3,125,3,41,138,3.4,0,56,263,4.7,5,9,2,16,3,25,3,1,4
10905,2,2017-09-09,iowa,@,Iowa State,W (44-41),27,41,65.9,333,5,41,164,4.0,1,82,497,6.1,16,12,1,29,10,84,0,0,0
10906,3,2017-09-16,iowa,,North Texas,W (31-14),16,27,59.3,197,2,59,238,4.0,2,86,435,5.1,10,15,3,28,6,63,2,0,2
10907,4,2017-09-23,iowa,,Penn State,L (19-21),13,22,59.1,191,2,23,82,3.6,1,45,273,6.1,6,3,2,11,3,25,1,0,1
10908,5,2017-09-30,iowa,@,Michigan State,L (10-17),17,32,53.1,207,0,25,19,0.8,1,57,226,4.0,9,2,0,11,7,47,2,0,2
10909,6,2017-10-07,iowa,,Illinois,W (45-16),18,34,52.9,250,4,38,191,5.0,1,72,441,6.1,10,10,0,20,3,18,1,1,2
10910,7,2017-10-21,iowa,@,Northwestern,L (10-17),19,33,57.6,223,1,33,89,2.7,0,66,312,4.7,9,5,0,14,6,50,0,1,1
10911,8,2017-10-28,iowa,,Minnesota,W (17-10),15,27,55.6,190,1,33,125,3.8,1,60,315,5.3,7,6,2,15,6,50,1,1,2
10912,9,2017-11-04,iowa,,Ohio State,W (55-24),21,32,65.6,244,5,38,243,6.4,1,70,487,7.0,13,8,3,24,5,34,0,0,0
10913,10,2017-11-11,iowa,@,Wisconsin,L (14-38),8,24,33.3,41,0,26,25,1.0,0,50,66,1.3,2,3,0,5,5,32,2,1,3
10914,11,2017-11-18,iowa,,Purdue,L (15-24),16,33,48.5,176,1,38,82,2.2,1,71,258,3.6,10,6,1,17,6,56,1,1,2
10915,12,2017-11-24,iowa,@,Nebraska,W (56-14),13,20,65.0,192,2,47,313,6.7,6,67,505,7.5,4,18,1,23,3,30,0,0,0
10916,13,2017-12-27,iowa,N,Boston College*,W (27-20),8,15,53.3,99,1,39,101,2.6,2,54,200,3.7,5,6,2,13,3,20,0,0,0
10917,,13 Games,iowa,,,,199,355,56.1,2468,27,481,1810,3.8,17,836,4278,5.1,106,103,17,226,66,534,13,6,19
10918,1,2018-09-01,iowa,,Northern Illinois,W (33-7),13,25,52.0,143,1,48,209,4.4,3,73,352,4.8,6,8,4,18,8,66,0,1,1
10919,2,2018-09-08,iowa,,Iowa State,W (13-3),16,28,57.1,166,0,36,105,2.9,1,64,271,4.2,7,6,1,14,6,55,0,0,0
10920,3,2018-09-15,iowa,,Northern Iowa,W (38-14),25,31,80.6,338,2,50,207,4.1,3,81,545,6.7,15,12,0,27,10,88,0,2,2
10921,4,2018-09-22,iowa,,Wisconsin,L (17-28),14,23,60.9,256,2,31,148,4.8,0,54,404,7.5,11,5,3,19,1,5,2,1,3
10922,5,2018-10-06,iowa,@,Minnesota,W (48-31),23,39,59.0,314,4,40,106,2.7,2,79,420,5.3,13,5,0,18,5,45,1,1,2
10923,6,2018-10-13,iowa,@,Indiana,W (42-16),21,33,63.6,320,6,32,159,5.0,0,65,479,7.4,12,7,7,26,11,110,0,1,1
10924,7,2018-10-20,iowa,,Maryland,W (23-0),11,24,45.8,86,1,52,224,4.3,0,76,310,4.1,7,14,1,22,0,0,0,1,1
10925,8,2018-10-27,iowa,@,Penn State,L (24-30),19,50,38.0,215,1,38,135,3.6,0,88,350,4.0,13,8,2,23,6,25,0,2,2
10926,9,2018-11-03,iowa,@,Purdue,L (36-38),21,32,65.6,275,1,37,118,3.2,4,69,393,5.7,15,5,2,22,8,75,1,0,1
10927,10,2018-11-10,iowa,,Northwestern,L (10-14),27,41,65.9,269,1,22,64,2.9,0,63,333,5.3,12,3,1,16,3,35,2,0,2
10928,11,2018-11-17,iowa,@,Illinois,W (63-0),14,23,60.9,197,3,37,203,5.5,4,60,400,6.7,9,11,0,20,2,28,0,1,1
10929,,11 Games,iowa,,,,204,349,58.5,2579,22,423,1678,4.0,17,772,4257,5.5,120,84,21,225,60,532,6,10,16
10930,1,2014-08-30,indiana,,Indiana State,W (28-10),11,18,61.1,111,0,69,455,6.6,4,87,566,6.5,4,24,1,29,4,30,1,1,2
10931,2,2014-09-13,indiana,@,Bowling Green State,L (42-45),31,41,75.6,347,1,37,235,6.4,5,78,582,7.5,16,11,3,30,11,143,1,0,1
10932,3,2014-09-20,indiana,@,Missouri,W (31-27),18,33,54.5,252,1,50,241,4.8,3,83,493,5.9,13,11,3,27,5,50,0,0,0
10933,4,2014-09-27,indiana,,Maryland,L (15-37),14,37,37.8,126,0,47,206,4.4,1,84,332,4.0,6,11,5,22,9,55,0,1,1
10934,5,2014-10-04,indiana,,North Texas,W (49-24),23,29,79.3,230,3,44,363,8.3,4,73,593,8.1,6,16,0,22,6,55,1,0,1
10935,6,2014-10-11,indiana,@,Iowa,L (29-45),7,21,33.3,116,1,39,316,8.1,3,60,432,7.2,5,8,0,13,9,110,0,3,3
10936,7,2014-10-18,indiana,,Michigan State,L (17-56),5,16,31.3,11,0,33,213,6.5,2,49,224,4.6,1,4,2,7,4,25,1,0,1
10937,8,2014-11-01,indiana,@,Michigan,L (10-34),5,8,62.5,24,0,45,167,3.7,1,53,191,3.6,0,10,0,10,3,25,2,0,2
10938,9,2014-11-08,indiana,,Penn State,L (7-13),13,28,46.4,68,0,40,153,3.8,0,68,221,3.3,2,9,2,13,10,82,0,2,2
10939,10,2014-11-15,indiana,@,Rutgers,L (23-45),15,31,48.4,179,1,53,294,5.5,1,84,473,5.6,6,15,1,22,9,82,2,1,3
10940,11,2014-11-22,indiana,@,Ohio State,L (27-42),11,27,40.7,114,0,36,281,7.8,3,63,395,6.3,6,6,1,13,2,10,0,1,1
10941,12,2014-11-29,indiana,,Purdue,W (23-16),15,24,62.5,119,0,46,239,5.2,2,70,358,5.1,8,9,1,18,6,61,2,0,2
10942,,12 Games,indiana,,,,168,313,53.7,1697,7,539,3163,5.9,29,852,4860,5.7,73,134,19,226,78,728,10,9,19
10943,1,2015-09-05,indiana,,Southern Illinois,W (48-47),19,32,59.4,349,1,42,246,5.9,5,74,595,8.0,13,9,1,23,6,43,0,0,0
10944,2,2015-09-12,indiana,,Florida International,W (36-22),19,33,57.6,234,1,52,205,3.9,2,85,439,5.2,10,14,1,25,11,110,0,1,1
10945,3,2015-09-19,indiana,,Western Kentucky,W (38-35),20,27,74.1,355,3,59,284,4.8,1,86,639,7.4,13,18,3,34,5,50,1,0,1
10946,4,2015-09-26,indiana,@,Wake Forest,W (31-24),19,34,55.9,205,2,52,211,4.1,1,86,416,4.8,12,13,1,26,11,119,0,0,0
10947,5,2015-10-03,indiana,,Ohio State,L (27-34),17,36,47.2,226,0,55,176,3.2,3,91,402,4.4,11,5,5,21,7,50,0,0,0
10948,6,2015-10-10,indiana,@,Penn State,L (7-29),15,33,45.5,155,0,33,79,2.4,1,66,234,3.5,7,7,0,14,8,65,0,1,1
10949,7,2015-10-17,indiana,,Rutgers,L (52-55),32,42,76.2,464,4,34,163,4.8,3,76,627,8.3,21,7,0,28,4,19,1,2,3
10950,8,2015-10-24,indiana,@,Michigan State,L (26-52),23,37,62.2,308,3,23,81,3.5,1,60,389,6.5,15,3,2,20,6,45,1,1,2
10951,9,2015-11-07,indiana,,Iowa,L (27-35),16,37,43.2,180,1,39,227,5.8,2,76,407,5.4,13,11,2,26,3,35,0,1,1
10952,10,2015-11-14,indiana,,Michigan,L (41-48),20,34,58.8,220,1,55,307,5.6,2,89,527,5.9,9,20,3,32,9,79,0,0,0
10953,11,2015-11-21,indiana,@,Maryland,W (47-28),23,35,65.7,385,4,45,170,3.8,1,80,555,6.9,15,6,3,24,7,55,1,0,1
10954,12,2015-11-28,indiana,@,Purdue,W (54-36),18,29,62.1,350,4,56,309,5.5,3,85,659,7.8,13,14,4,31,7,54,1,0,1
10955,13,2015-12-26,indiana,N,Duke*,L (41-44),28,52,53.8,389,3,47,278,5.9,2,99,667,6.7,16,14,3,33,7,54,1,2,3
10956,,13 Games,indiana,,,,269,461,58.4,3820,27,592,2736,4.6,27,1053,6556,6.2,168,141,28,337,91,778,6,8,14
10957,1,2016-09-01,indiana,@,Florida International,W (34-13),18,28,64.3,240,1,52,246,4.7,1,80,486,6.1,10,15,1,26,9,74,1,0,1
10958,2,2016-09-10,indiana,,Ball State,W (30-20),17,27,63.0,266,3,45,187,4.2,0,72,453,6.3,8,11,0,19,8,69,0,0,0
10959,3,2016-09-24,indiana,,Wake Forest,L (28-33),28,47,59.6,496,3,32,115,3.6,1,79,611,7.7,18,5,2,25,9,84,0,5,5
10960,4,2016-10-01,indiana,,Michigan State,W (24-21),17,28,60.7,281,3,39,156,4.0,0,67,437,6.5,12,6,1,19,7,60,0,1,1
10961,5,2016-10-08,indiana,@,Ohio State,L (17-38),14,28,50.0,182,2,40,99,2.5,0,68,281,4.1,6,7,1,14,5,40,1,1,2
10962,6,2016-10-15,indiana,,Nebraska,L (22-27),24,39,61.5,245,1,30,88,2.9,1,69,333,4.8,12,4,2,18,1,10,0,2,2
10963,7,2016-10-22,indiana,@,Northwestern,L (14-24),35,59,59.3,317,0,27,84,3.1,1,86,401,4.7,14,6,3,23,5,53,0,2,2
10964,8,2016-10-29,indiana,,Maryland,W (42-36),17,26,65.4,236,0,57,414,7.3,6,83,650,7.8,14,18,2,34,6,65,0,0,0
10965,9,2016-11-05,indiana,@,Rutgers,W (33-27),29,41,70.7,420,3,44,147,3.3,2,85,567,6.7,17,6,4,27,4,22,2,2,4
10966,10,2016-11-12,indiana,,Penn State,L (31-45),24,41,58.5,344,2,41,110,2.7,2,82,454,5.5,15,5,0,20,8,80,5,0,5
10967,11,2016-11-19,indiana,@,Michigan,L (10-20),14,30,46.7,191,0,36,64,1.8,1,66,255,3.9,9,4,2,15,4,35,0,0,0
10968,12,2016-11-26,indiana,,Purdue,W (26-24),11,22,50.0,117,1,54,152,2.8,2,76,269,3.5,6,10,1,17,9,70,0,4,4
10969,13,2016-12-28,indiana,N,Utah*,L (24-26),15,40,37.5,224,2,37,117,3.2,1,77,341,4.4,11,8,3,22,4,24,2,1,3
10970,,13 Games,indiana,,,,263,456,57.7,3559,21,534,1979,3.7,18,990,5538,5.6,152,105,22,279,79,686,11,18,29
10971,1,2017-08-31,indiana,,Ohio State,L (21-49),42,68,61.8,420,3,27,17,0.6,0,95,437,4.6,22,1,2,25,5,33,1,2,3
10972,2,2017-09-09,indiana,@,Virginia,W (34-17),19,30,63.3,197,2,41,111,2.7,1,71,308,4.3,11,7,1,19,7,78,0,1,1
10973,3,2017-09-23,indiana,,Georgia Southern,W (52-17),11,22,50.0,185,2,47,282,6.0,3,69,467,6.8,5,12,3,20,5,30,0,0,0
10974,4,2017-09-30,indiana,@,Penn State,L (14-45),15,32,46.9,175,1,47,177,3.8,1,79,352,4.5,8,10,1,19,2,20,3,1,4
10975,5,2017-10-07,indiana,,Charleston Southern,W (27-0),32,41,78.0,321,2,45,157,3.5,1,86,478,5.6,15,9,1,25,7,60,2,1,3
10976,6,2017-10-14,indiana,,Michigan,L (20-27),21,43,48.8,198,1,29,80,2.8,1,72,278,3.9,8,3,3,14,5,55,0,2,2
10977,7,2017-10-21,indiana,@,Michigan State,L (9-17),22,34,64.7,158,0,35,94,2.7,0,69,252,3.7,8,3,3,14,10,115,0,0,0
10978,8,2017-10-28,indiana,@,Maryland,L (39-42),43,62,69.4,410,5,35,73,2.1,0,97,483,5.0,21,7,7,35,7,70,0,1,1
10979,9,2017-11-04,indiana,,Wisconsin,L (17-45),20,34,58.8,226,2,21,40,1.9,0,55,266,4.8,9,5,2,16,10,98,1,2,3
10980,10,2017-11-11,indiana,@,Illinois,W (24-14),32,48,66.7,289,2,42,139,3.3,1,90,428,4.8,13,7,2,22,5,49,0,1,1
10981,11,2017-11-18,indiana,,Rutgers,W (41-0),17,28,60.7,236,2,48,267,5.6,3,76,503,6.6,11,11,1,23,1,15,0,1,1
10982,12,2017-11-25,indiana,@,Purdue,L (24-31),32,60,53.3,373,3,32,124,3.9,0,92,497,5.4,13,5,2,20,7,84,0,1,1
10983,,12 Games,indiana,,,,306,502,61.0,3188,25,449,1561,3.5,11,951,4749,5.0,144,80,28,252,71,707,7,13,20
10984,1,2018-09-01,indiana,@,Florida International,W (38-28),28,37,75.7,252,4,45,213,4.7,0,82,465,5.7,14,12,5,31,8,90,0,1,1
10985,2,2018-09-08,indiana,,Virginia,W (20-16),16,22,72.7,150,2,44,237,5.4,1,66,387,5.9,7,12,2,21,6,42,0,1,1
10986,3,2018-09-15,indiana,,Ball State,W (38-10),24,32,75.0,202,0,44,255,5.8,4,76,457,6.0,9,13,4,26,5,45,1,0,1
10987,4,2018-09-22,indiana,,Michigan State,L (21-35),32,46,69.6,272,2,32,29,0.9,0,78,301,3.9,15,1,2,18,6,85,0,2,2
10988,5,2018-09-29,indiana,@,Rutgers,W (24-17),27,40,67.5,288,1,42,163,3.9,2,82,451,5.5,14,8,2,24,5,60,1,1,2
10989,6,2018-10-06,indiana,@,Ohio State,L (26-49),26,49,53.1,322,3,21,84,4.0,0,70,406,5.8,14,4,4,22,3,35,2,0,2
10990,7,2018-10-13,indiana,,Iowa,L (16-42),31,42,73.8,263,1,25,67,2.7,1,67,330,4.9,10,8,4,22,10,99,0,2,2
10991,8,2018-10-20,indiana,,Penn State,L (28-33),35,55,63.6,330,1,45,224,5.0,3,100,554,5.5,17,13,2,32,7,55,2,1,3
10992,9,2018-10-26,indiana,@,Minnesota,L (31-38),29,44,65.9,232,2,30,153,5.1,1,74,385,5.2,11,9,0,20,5,37,1,2,3
10993,10,2018-11-10,indiana,,Maryland,W (34-32),16,28,57.1,243,2,30,131,4.4,2,58,374,6.4,8,7,3,18,3,39,0,1,1
10994,11,2018-11-17,indiana,@,Michigan,L (20-31),16,35,45.7,195,1,40,190,4.8,1,75,385,5.1,8,10,3,21,7,62,1,1,2
10995,,11 Games,indiana,,,,280,430,65.1,2749,19,398,1746,4.4,15,828,4495,5.4,127,97,31,255,65,649,8,12,20
10996,1,2014-08-28,minnesota,,Eastern Illinois,W (42-20),10,18,55.6,156,1,40,182,4.6,4,58,338,5.8,6,11,1,18,5,50,1,0,1
10997,2,2014-09-06,minnesota,,Middle Tennessee State,W (35-24),5,11,45.5,67,1,50,284,5.7,3,61,351,5.8,3,14,1,18,3,24,0,1,1
10998,3,2014-09-13,minnesota,@,Texas Christian,L (7-30),14,29,48.3,169,1,39,99,2.5,0,68,268,3.9,8,5,1,14,4,40,2,3,5
10999,4,2014-09-20,minnesota,,San Jose State,W (24-7),1,7,14.3,7,0,58,380,6.6,3,65,387,6.0,1,18,0,19,10,80,1,1,2
11000,5,2014-09-27,minnesota,@,Michigan,W (30-14),14,23,60.9,167,1,47,206,4.4,1,70,373,5.3,9,11,0,20,7,65,0,0,0
11001,6,2014-10-11,minnesota,,Northwestern,W (24-17),10,15,66.7,153,0,39,121,3.1,2,54,274,5.1,5,7,2,14,6,47,0,1,1
11002,7,2014-10-18,minnesota,,Purdue,W (39-38),9,18,50.0,165,2,52,285,5.5,3,70,450,6.4,6,15,1,22,7,66,1,0,1
11003,8,2014-10-25,minnesota,@,Illinois,L (24-28),12,30,40.0,240,1,41,171,4.2,2,71,411,5.8,8,9,2,19,4,30,2,1,3
11004,9,2014-11-08,minnesota,,Iowa,W (51-14),10,14,71.4,138,4,59,291,4.9,3,73,429,5.9,4,18,1,23,2,17,0,0,0
11005,10,2014-11-15,minnesota,,Ohio State,L (24-31),7,20,35.0,85,0,44,218,5.0,3,64,303,4.7,5,9,3,17,7,54,0,2,2
11006,11,2014-11-22,minnesota,@,Nebraska,W (28-24),8,18,44.4,135,0,53,281,5.3,4,71,416,5.9,7,15,1,23,1,15,0,0,0
11007,12,2014-11-29,minnesota,@,Wisconsin,L (24-34),5,18,27.8,95,0,44,177,4.0,3,62,272,4.4,3,8,1,12,7,72,1,0,1
11008,13,2015-01-01,minnesota,N,Missouri*,L (17-33),22,33,66.7,267,1,33,106,3.2,1,66,373,5.7,11,8,0,19,6,45,3,0,3
11009,,13 Games,minnesota,,,,127,254,50.0,1844,12,599,2801,4.7,32,853,4645,5.4,76,148,14,238,69,605,11,9,20
11010,1,2015-09-03,minnesota,,Texas Christian,L (17-23),19,35,54.3,197,1,39,144,3.7,1,74,341,4.6,12,6,0,18,7,60,2,0,2
11011,2,2015-09-12,minnesota,@,Colorado State,W (23-20),23,45,51.1,233,2,41,180,4.4,0,86,413,4.8,11,9,3,23,8,60,2,0,2
11012,3,2015-09-19,minnesota,,Kent State,W (10-7),17,27,63.0,184,1,44,104,2.4,0,71,288,4.1,9,3,1,13,8,85,1,2,3
11013,4,2015-09-26,minnesota,,Ohio,W (27-24),22,31,71.0,264,0,36,204,5.7,3,67,468,7.0,14,8,2,24,4,31,1,0,1
11014,5,2015-10-03,minnesota,@,Northwestern,L (0-27),15,32,46.9,99,0,33,74,2.2,0,65,173,2.7,5,6,0,11,2,10,1,1,2
11015,6,2015-10-10,minnesota,@,Purdue,W (41-13),11,18,61.1,82,2,48,326,6.8,2,66,408,6.2,4,13,0,17,6,55,0,1,1
11016,7,2015-10-17,minnesota,,Nebraska,L (25-48),26,40,65.0,301,1,26,65,2.5,2,66,366,5.5,15,3,0,18,6,55,1,2,3
11017,8,2015-10-31,minnesota,,Michigan,L (26-29),16,33,48.5,317,1,35,144,4.1,1,68,461,6.8,13,5,2,20,7,53,0,0,0
11018,9,2015-11-07,minnesota,@,Ohio State,L (14-28),27,45,60.0,281,2,26,33,1.3,0,71,314,4.4,12,0,1,13,3,25,0,1,1
11019,10,2015-11-14,minnesota,@,Iowa,L (35-40),20,28,71.4,301,2,29,133,4.6,3,57,434,7.6,14,8,2,24,12,87,0,0,0
11020,11,2015-11-21,minnesota,,Illinois,W (32-23),15,26,57.7,88,1,32,255,8.0,3,58,343,5.9,5,9,2,16,5,30,1,0,1
11021,12,2015-11-28,minnesota,,Wisconsin,L (21-31),16,37,43.2,223,1,18,53,2.9,1,55,276,5.0,6,3,2,11,4,35,2,3,5
11022,13,2015-12-28,minnesota,N,Central Michigan*,W (21-14),24,30,80.0,223,1,39,158,4.1,1,69,381,5.5,13,7,1,21,1,5,0,1,1
11023,,13 Games,minnesota,,,,251,427,58.8,2793,15,446,1873,4.2,17,873,4666,5.3,133,80,16,229,73,591,11,11,22
11024,1,2016-09-01,minnesota,,Oregon State,W (30-23),13,27,48.1,130,0,47,150,3.2,4,74,280,3.8,8,11,2,21,8,70,1,0,1
11025,2,2016-09-10,minnesota,,Indiana State,W (58-28),21,32,65.6,301,4,44,292,6.6,3,76,593,7.8,16,14,1,31,10,82,0,0,0
11026,3,2016-09-24,minnesota,,Colorado State,W (31-24),16,20,80.0,174,0,45,243,5.4,4,65,417,6.4,10,10,1,21,9,68,0,1,1
11027,4,2016-10-01,minnesota,@,Penn State,L (26-29),24,41,58.5,241,1,48,228,4.8,1,89,469,5.3,14,13,4,31,8,83,0,1,1
11028,5,2016-10-08,minnesota,,Iowa,L (7-14),13,33,39.4,166,0,29,102,3.5,1,62,268,4.3,8,5,0,13,8,58,1,2,3
11029,6,2016-10-15,minnesota,@,Maryland,W (31-10),7,15,46.7,82,1,48,229,4.8,2,63,311,4.9,5,9,2,16,7,50,0,0,0
11030,7,2016-10-22,minnesota,,Rutgers,W (34-32),11,19,57.9,156,0,53,243,4.6,3,72,399,5.5,6,13,0,19,6,55,1,1,2
11031,8,2016-10-29,minnesota,@,Illinois,W (40-17),10,19,52.6,112,0,48,171,3.6,5,67,283,4.2,4,10,1,15,6,56,0,0,0
11032,9,2016-11-05,minnesota,,Purdue,W (44-31),14,23,60.9,231,0,43,235,5.5,5,66,466,7.1,6,12,0,18,5,65,0,1,1
11033,10,2016-11-12,minnesota,@,Nebraska,L (17-24),18,28,64.3,180,0,34,85,2.5,2,62,265,4.3,8,4,3,15,2,15,0,1,1
11034,11,2016-11-19,minnesota,,Northwestern,W (29-12),14,25,56.0,197,1,40,131,3.3,2,65,328,5.0,7,8,0,15,6,50,1,1,2
11035,12,2016-11-26,minnesota,@,Wisconsin,L (17-31),9,26,34.6,158,1,38,128,3.4,1,64,286,4.5,7,9,2,18,3,26,0,4,4
11036,13,2016-12-27,minnesota,N,Washington State*,W (17-12),11,20,55.0,129,1,41,150,3.7,1,61,279,4.6,8,8,1,17,10,65,1,0,1
11037,,13 Games,minnesota,,,,181,328,55.2,2257,9,558,2387,4.3,34,886,4644,5.2,107,126,17,250,88,743,5,12,17
11038,1,2017-08-31,minnesota,,Buffalo,W (17-7),19,32,59.4,239,1,51,169,3.3,1,83,408,4.9,10,10,1,21,4,35,0,1,1
11039,2,2017-09-09,minnesota,@,Oregon State,W (48-14),7,8,87.5,158,1,58,253,4.4,5,66,411,6.2,5,12,4,21,6,70,1,0,1
11040,3,2017-09-16,minnesota,,Middle Tennessee State,W (34-3),11,18,61.1,122,0,47,221,4.7,3,65,343,5.3,4,14,0,18,3,22,0,0,0
11041,4,2017-09-30,minnesota,,Maryland,L (24-31),13,26,50.0,229,1,31,80,2.6,2,57,309,5.4,11,4,3,18,3,29,0,2,2
11042,5,2017-10-07,minnesota,@,Purdue,L (17-31),11,25,44.0,101,2,47,227,4.8,0,72,328,4.6,4,11,1,16,5,47,1,1,2
11043,6,2017-10-14,minnesota,,Michigan State,L (27-30),16,32,50.0,216,3,27,74,2.7,0,59,290,4.9,10,4,0,14,1,15,1,1,2
11044,7,2017-10-21,minnesota,,Illinois,W (24-17),5,15,33.3,47,1,55,292,5.3,1,70,339,4.8,2,19,1,22,3,12,1,2,3
11045,8,2017-10-28,minnesota,@,Iowa,L (10-17),9,29,31.0,139,0,43,142,3.3,1,72,281,3.9,4,10,1,15,5,37,0,1,1
11046,9,2017-11-04,minnesota,@,Michigan,L (10-33),5,12,41.7,74,0,44,90,2.0,1,56,164,2.9,3,8,2,13,3,10,1,0,1
11047,10,2017-11-11,minnesota,,Nebraska,W (54-21),9,16,56.3,105,0,45,409,9.1,6,61,514,8.4,5,17,2,24,3,35,0,0,0
11048,11,2017-11-18,minnesota,@,Northwestern,L (0-39),2,11,18.2,43,0,38,139,3.7,0,49,182,3.7,1,6,0,7,2,18,2,3,5
11049,12,2017-11-25,minnesota,,Wisconsin,L (0-31),3,9,33.3,40,0,39,93,2.4,0,48,133,2.8,2,5,1,8,1,10,0,0,0
11050,,12 Games,minnesota,,,,110,233,47.2,1513,9,525,2189,4.2,20,758,3702,4.9,61,120,16,197,39,340,7,11,18
11051,1,2018-08-30,minnesota,,New Mexico State,W (48-10),17,34,50.0,227,2,46,300,6.5,3,80,527,6.6,9,14,0,23,9,92,1,0,1
11052,2,2018-09-08,minnesota,,Fresno State,W (21-14),16,26,61.5,175,0,45,132,2.9,2,71,307,4.3,12,7,1,20,3,30,1,0,1
11053,3,2018-09-15,minnesota,,Miami (OH),W (26-3),14,26,53.8,177,3,44,118,2.7,0,70,295,4.2,8,12,2,22,5,52,1,1,2
11054,4,2018-09-22,minnesota,@,Maryland,L (13-42),14,32,43.8,169,1,40,94,2.4,0,72,263,3.7,9,8,6,23,1,15,1,2,3
11055,5,2018-10-06,minnesota,,Iowa,L (31-48),18,36,50.0,234,3,31,86,2.8,1,67,320,4.8,9,8,3,20,2,10,0,4,4
11056,6,2018-10-13,minnesota,@,Ohio State,L (14-30),13,23,56.5,218,0,33,178,5.4,2,56,396,7.1,10,7,2,19,4,60,1,2,3
11057,7,2018-10-20,minnesota,@,Nebraska,L (28-53),20,36,55.6,349,1,36,125,3.5,3,72,474,6.6,16,5,1,22,8,80,0,1,1
11058,8,2018-10-26,minnesota,,Indiana,W (38-31),17,24,70.8,302,3,40,180,4.5,2,64,482,7.5,12,8,2,22,3,20,3,1,4
11059,9,2018-11-03,minnesota,@,Illinois,L (31-55),15,28,53.6,260,2,42,178,4.2,2,70,438,6.3,7,10,3,20,2,15,2,0,2
11060,10,2018-11-10,minnesota,,Purdue,W (41-10),11,20,55.0,150,2,41,265,6.5,2,61,415,6.8,6,11,5,22,5,50,0,1,1
11061,11,2018-11-17,minnesota,,Northwestern,L (14-24),19,32,59.4,197,1,35,109,3.1,1,67,306,4.6,9,7,2,18,3,34,1,2,3
11062,,11 Games,minnesota,,,,174,317,54.9,2458,18,433,1765,4.1,18,750,4223,5.6,107,97,27,231,45,458,11,14,25
11063,1,2014-08-30,purdue,,Western Michigan,W (43-34),19,38,50.0,181,2,39,226,5.8,3,77,407,5.3,10,11,1,22,7,52,0,0,0
11064,2,2014-09-06,purdue,,Central Michigan,L (17-38),24,49,49.0,204,1,34,122,3.6,1,83,326,3.9,9,10,0,19,7,69,1,2,3
11065,3,2014-09-13,purdue,N,Notre Dame,L (14-30),27,40,67.5,234,2,26,56,2.2,0,66,290,4.4,11,5,1,17,5,41,1,2,3
11066,4,2014-09-20,purdue,,Southern Illinois,W (35-13),15,26,57.7,198,2,44,183,4.2,2,70,381,5.4,9,11,3,23,4,26,1,0,1
11067,5,2014-09-27,purdue,,Iowa,L (10-24),13,32,40.6,72,0,30,84,2.8,0,62,156,2.5,2,7,0,9,3,19,0,2,2
11068,6,2014-10-04,purdue,@,Illinois,W (38-27),15,20,75.0,202,1,45,349,7.8,4,65,551,8.5,8,10,1,19,6,64,0,0,0
11069,7,2014-10-11,purdue,,Michigan State,L (31-45),24,37,64.9,211,1,25,129,5.2,3,62,340,5.5,11,5,2,18,4,21,1,1,2
11070,8,2014-10-18,purdue,@,Minnesota,L (38-39),16,26,61.5,153,3,35,298,8.5,2,61,451,7.4,6,10,1,17,7,55,0,2,2
11071,9,2014-11-01,purdue,@,Nebraska,L (14-35),18,46,39.1,216,1,32,124,3.9,1,78,340,4.4,8,8,0,16,5,51,0,2,2
11072,10,2014-11-08,purdue,,Wisconsin,L (16-34),17,37,45.9,204,1,26,26,1.0,0,63,230,3.7,7,3,1,11,2,15,0,0,0
11073,11,2014-11-22,purdue,,Northwestern,L (14-38),26,48,54.2,251,2,32,61,1.9,0,80,312,3.9,13,6,1,20,4,41,3,2,5
11074,12,2014-11-29,purdue,@,Indiana,L (16-23),19,35,54.3,123,0,34,228,6.7,1,69,351,5.1,6,9,1,16,5,49,1,3,4
11075,,12 Games,purdue,,,,233,434,53.7,2249,16,402,1886,4.7,17,836,4135,4.9,100,95,12,207,59,503,8,16,24
11076,1,2015-09-06,purdue,@,Marshall,L (31-41),31,48,64.6,270,1,47,184,3.9,3,95,454,4.8,14,10,4,28,4,53,0,4,4
11077,2,2015-09-12,purdue,,Indiana State,W (38-14),20,36,55.6,289,4,45,251,5.6,1,81,540,6.7,10,12,2,24,5,42,2,0,2
11078,3,2015-09-19,purdue,,Virginia Tech,L (24-51),12,35,34.3,121,0,29,144,5.0,2,64,265,4.1,3,4,2,9,10,79,1,2,3
11079,4,2015-09-26,purdue,,Bowling Green State,L (28-35),30,40,75.0,349,2,38,77,2.0,2,78,426,5.5,15,6,4,25,9,92,0,1,1
11080,5,2015-10-03,purdue,@,Michigan State,L (21-24),15,31,48.4,136,1,32,165,5.2,2,63,301,4.8,7,6,3,16,2,20,2,1,3
11081,6,2015-10-10,purdue,,Minnesota,L (13-41),21,49,42.9,207,1,28,68,2.4,1,77,275,3.6,11,4,2,17,0,0,1,3,4
11082,7,2015-10-17,purdue,@,Wisconsin,L (7-24),15,26,57.7,136,0,29,55,1.9,1,55,191,3.5,7,4,1,12,7,67,1,0,1
11083,8,2015-10-31,purdue,,Nebraska,W (55-45),28,43,65.1,274,4,37,183,4.9,4,80,457,5.7,10,8,2,20,6,58,0,0,0
11084,9,2015-11-07,purdue,,Illinois,L (14-48),29,47,61.7,174,1,28,89,3.2,1,75,263,3.5,7,8,2,17,3,34,0,2,2
11085,10,2015-11-14,purdue,@,Northwestern,L (14-21),26,45,57.8,287,1,30,73,2.4,1,75,360,4.8,12,5,1,18,6,60,0,1,1
11086,11,2015-11-21,purdue,@,Iowa,L (20-40),26,46,56.5,268,1,38,137,3.6,1,84,405,4.8,13,7,1,21,5,43,1,0,1
11087,12,2015-11-28,purdue,,Indiana,L (36-54),37,58,63.8,336,2,36,150,4.2,3,94,486,5.2,18,11,1,30,8,99,2,2,4
11088,,12 Games,purdue,,,,290,504,57.5,2847,18,417,1576,3.8,22,921,4423,4.8,127,85,25,237,65,647,10,16,26
11089,1,2016-09-03,purdue,,Eastern Kentucky,W (45-24),26,44,59.1,251,1,39,261,6.7,4,83,512,6.2,15,9,1,25,2,17,0,1,1
11090,2,2016-09-10,purdue,,Cincinnati,L (20-38),32,57,56.1,401,2,25,103,4.1,1,82,504,6.1,20,7,2,29,2,24,0,5,5
11091,3,2016-09-24,purdue,,Nevada,W (24-14),21,31,67.7,300,2,44,166,3.8,1,75,466,6.2,14,11,0,25,4,50,3,1,4
11092,4,2016-10-01,purdue,@,Maryland,L (7-50),22,53,41.5,195,1,27,10,0.4,0,80,205,2.6,10,3,3,16,8,69,0,1,1
11093,5,2016-10-08,purdue,@,Illinois,W (34-31),23,37,62.2,228,1,41,231,5.6,3,78,459,5.9,8,14,3,25,5,45,0,2,2
11094,6,2016-10-15,purdue,,Iowa,L (35-49),30,59,50.8,458,5,21,47,2.2,0,80,505,6.3,17,3,4,24,6,38,0,1,1
11095,7,2016-10-22,purdue,@,Nebraska,L (14-27),25,45,55.6,309,2,21,26,1.2,0,66,335,5.1,9,4,0,13,4,32,0,2,2
11096,8,2016-10-29,purdue,,Penn State,L (24-62),36,55,65.5,295,2,26,46,1.8,1,81,341,4.2,12,4,4,20,8,76,2,2,4
11097,9,2016-11-05,purdue,@,Minnesota,L (31-44),29,49,59.2,391,4,28,23,0.8,0,77,414,5.4,13,4,2,19,2,10,2,1,3
11098,10,2016-11-12,purdue,,Northwestern,L (17-45),29,51,56.9,264,1,32,130,4.1,1,83,394,4.7,13,9,0,22,2,15,0,4,4
11099,11,2016-11-19,purdue,,Wisconsin,L (20-49),15,31,48.4,222,2,22,71,3.2,0,53,293,5.5,8,5,3,16,4,20,0,3,3
11100,12,2016-11-26,purdue,@,Indiana,L (24-26),24,45,53.3,225,2,34,42,1.2,1,79,267,3.4,13,5,2,20,5,51,1,2,3
11101,,12 Games,purdue,,,,312,557,56.0,3539,25,360,1156,3.2,12,917,4695,5.1,152,78,24,254,52,447,8,25,33
11102,1,2017-09-02,purdue,N,Louisville,L (28-35),33,57,57.9,293,4,21,51,2.4,0,78,344,4.4,17,5,3,25,6,69,1,3,4
11103,2,2017-09-08,purdue,,Ohio,W (44-21),16,24,66.7,295,4,44,263,6.0,1,68,558,8.2,10,14,1,25,4,45,0,0,0
11104,3,2017-09-16,purdue,@,Missouri,W (35-3),26,34,76.5,272,2,50,205,4.1,3,84,477,5.7,13,12,1,26,3,25,0,1,1
11105,4,2017-09-23,purdue,,Michigan,L (10-28),13,30,43.3,159,1,20,30,1.5,0,50,189,3.8,6,2,1,9,10,82,1,0,1
11106,5,2017-10-07,purdue,,Minnesota,W (31-17),25,36,69.4,307,2,29,132,4.6,1,65,439,6.8,8,12,2,22,6,61,2,2,4
11107,6,2017-10-14,purdue,@,Wisconsin,L (9-17),13,29,44.8,155,0,26,66,2.5,0,55,221,4.0,8,4,2,14,7,45,0,1,1
11108,7,2017-10-21,purdue,@,Rutgers,L (12-14),23,44,52.3,195,1,41,279,6.8,0,85,474,5.6,10,13,2,25,9,55,0,2,2
11109,8,2017-10-28,purdue,,Nebraska,L (24-25),16,28,57.1,164,1,38,199,5.2,2,66,363,5.5,9,8,3,20,7,63,0,0,0
11110,9,2017-11-04,purdue,,Illinois,W (29-10),18,28,64.3,226,1,44,209,4.8,2,72,435,6.0,13,11,1,25,8,66,1,0,1
11111,10,2017-11-11,purdue,@,Northwestern,L (13-23),38,61,62.3,398,2,22,40,1.8,0,83,438,5.3,18,3,1,22,5,50,0,1,1
11112,11,2017-11-18,purdue,@,Iowa,W (24-15),22,37,59.5,229,3,29,65,2.2,0,66,294,4.5,11,6,3,20,3,30,0,0,0
11113,12,2017-11-25,purdue,,Indiana,W (31-24),16,30,53.3,181,2,43,272,6.3,2,73,453,6.2,6,13,3,22,4,17,1,0,1
11114,13,2017-12-27,purdue,N,Arizona*,W (38-35),33,53,62.3,396,4,40,159,4.0,1,93,555,6.0,15,11,1,27,5,50,0,1,1
11115,,13 Games,purdue,,,,292,491,59.5,3270,27,447,1970,4.4,12,938,5240,5.6,144,114,24,282,77,658,6,11,17
11116,1,2018-08-30,purdue,,Northwestern,L (27-31),30,46,65.2,270,1,25,202,8.1,2,71,472,6.6,13,8,2,23,9,95,0,3,3
11117,2,2018-09-08,purdue,,Eastern Michigan,L (19-20),14,24,58.3,135,1,42,341,8.1,1,66,476,7.2,6,13,0,19,7,85,2,0,2
11118,3,2018-09-15,purdue,,Missouri,L (37-40),39,55,70.9,572,3,16,42,2.6,1,71,614,8.6,21,2,0,23,7,65,0,1,1
11119,4,2018-09-22,purdue,,Boston College,W (30-13),21,28,75.0,296,3,41,76,1.9,1,69,372,5.4,10,6,1,17,2,25,2,0,2
11120,5,2018-09-29,purdue,@,Nebraska,W (42-28),25,42,59.5,328,1,37,188,5.1,4,79,516,6.5,11,10,6,27,10,75,0,0,0
11121,6,2018-10-13,purdue,@,Illinois,W (46-7),26,37,70.3,384,4,44,227,5.2,2,81,611,7.5,14,11,4,29,5,45,0,1,1
11122,7,2018-10-20,purdue,,Ohio State,W (49-20),25,43,58.1,378,3,29,161,5.6,3,72,539,7.5,12,9,3,24,7,95,0,0,0
11123,8,2018-10-27,purdue,@,Michigan State,L (13-23),29,49,59.2,277,0,13,62,4.8,1,62,339,5.5,13,2,1,16,4,30,0,3,3
11124,9,2018-11-03,purdue,,Iowa,W (38-36),23,32,71.9,333,4,31,101,3.3,1,63,434,6.9,9,10,2,21,6,60,0,2,2
11125,10,2018-11-10,purdue,@,Minnesota,L (10-41),21,32,65.6,145,1,30,88,2.9,0,62,233,3.8,7,6,1,14,7,81,1,0,1
11126,11,2018-11-17,purdue,,Wisconsin,L (44-47),31,48,64.6,386,4,31,76,2.5,1,79,462,5.8,16,6,6,28,5,48,1,0,1
11127,,11 Games,purdue,,,,284,436,65.1,3504,25,339,1564,4.6,17,775,5068,6.5,132,83,26,241,69,704,6,10,16
11128,1,2014-08-30,wisconsin,N,Louisiana State,L (24-28),8,24,33.3,50,0,39,268,6.9,3,63,318,5.0,3,10,1,14,3,26,0,2,2
11129,2,2014-09-06,wisconsin,,Western Illinois,W (37-3),24,29,82.8,289,4,39,167,4.3,1,68,456,6.7,17,8,0,25,4,38,0,1,1
11130,3,2014-09-20,wisconsin,,Bowling Green State,W (68-17),9,18,50.0,112,1,60,644,10.7,8,78,756,9.7,3,26,0,29,5,55,2,1,3
11131,4,2014-09-27,wisconsin,,South Florida,W (27-10),11,18,61.1,160,1,57,294,5.2,2,75,454,6.1,8,14,4,26,4,35,1,0,1
11132,5,2014-10-04,wisconsin,@,Northwestern,L (14-20),12,29,41.4,138,1,37,284,7.7,1,66,422,6.4,6,13,0,19,6,49,0,4,4
11133,6,2014-10-11,wisconsin,,Illinois,W (38-28),10,18,55.6,97,0,47,401,8.5,5,65,498,7.7,5,15,2,22,4,53,0,0,0
11134,7,2014-10-25,wisconsin,,Maryland,W (52-7),15,23,65.2,216,2,49,311,6.3,5,72,527,7.3,10,14,1,25,2,20,0,0,0
11135,8,2014-11-01,wisconsin,@,Rutgers,W (37-0),8,20,40.0,87,0,46,298,6.5,4,66,385,5.8,3,13,0,16,7,56,0,1,1
11136,9,2014-11-08,wisconsin,@,Purdue,W (34-16),20,30,66.7,225,2,42,264,6.3,2,72,489,6.8,13,12,0,25,4,40,1,1,2
11137,10,2014-11-15,wisconsin,,Nebraska,W (59-24),7,11,63.6,46,1,53,581,11.0,7,64,627,9.8,3,17,0,20,6,55,4,0,4
11138,11,2014-11-22,wisconsin,@,Iowa,W (26-24),11,14,78.6,139,0,42,266,6.3,3,56,405,7.2,7,11,0,18,7,60,0,0,0
11139,12,2014-11-29,wisconsin,,Minnesota,W (34-24),11,18,61.1,215,2,46,233,5.1,2,64,448,7.0,7,10,3,20,7,69,1,0,1
11140,13,2014-12-06,wisconsin,N,Ohio State,L (0-59),17,43,39.5,187,0,37,71,1.9,0,80,258,3.2,11,6,1,18,3,23,1,3,4
11141,14,2015-01-01,wisconsin,N,Auburn*,W (34-31),14,27,51.9,121,1,54,400,7.4,3,81,521,6.4,7,20,4,31,3,28,0,3,3
11142,,14 Games,wisconsin,,,,177,322,55.0,2082,15,648,4482,6.9,46,970,6564,6.8,103,189,16,308,65,607,10,16,26
11143,1,2015-09-05,wisconsin,N,Alabama,L (17-35),26,39,66.7,228,2,21,40,1.9,0,60,268,4.5,12,2,3,17,5,50,0,1,1
11144,2,2015-09-12,wisconsin,,Miami (OH),W (58-0),23,36,63.9,263,4,45,188,4.2,3,81,451,5.6,14,11,1,26,8,65,0,1,1
11145,3,2015-09-19,wisconsin,,Troy,W (28-3),13,18,72.2,202,1,35,199,5.7,3,53,401,7.6,6,11,0,17,6,63,0,0,0
11146,4,2015-09-26,wisconsin,,Hawaii,W (28-0),15,25,60.0,186,1,54,326,6.0,3,79,512,6.5,11,18,2,31,6,52,0,0,0
11147,5,2015-10-03,wisconsin,,Iowa,L (6-10),21,38,55.3,234,0,34,86,2.5,0,72,320,4.4,15,3,3,21,8,90,2,2,4
11148,6,2015-10-10,wisconsin,@,Nebraska,W (23-21),24,50,48.0,322,1,34,147,4.3,1,84,469,5.6,16,6,4,26,6,45,0,0,0
11149,7,2015-10-17,wisconsin,,Purdue,W (24-7),30,39,76.9,322,0,37,96,2.6,3,76,418,5.5,17,6,3,26,7,65,0,1,1
11150,8,2015-10-24,wisconsin,@,Illinois,W (24-13),25,40,62.5,281,2,40,138,3.5,1,80,419,5.2,16,5,2,23,4,45,0,2,2
11151,9,2015-10-31,wisconsin,,Rutgers,W (48-10),13,28,46.4,217,1,38,209,5.5,5,66,426,6.5,9,6,0,15,5,40,0,2,2
11152,10,2015-11-07,wisconsin,@,Maryland,W (31-24),15,24,62.5,188,1,40,117,2.9,2,64,305,4.8,10,5,3,18,7,54,0,1,1
11153,11,2015-11-21,wisconsin,,Northwestern,L (7-13),20,36,55.6,229,0,26,-26,-1.0,1,62,203,3.3,11,3,0,14,2,25,3,2,5
11154,12,2015-11-28,wisconsin,@,Minnesota,W (31-21),9,17,52.9,79,0,62,257,4.1,4,79,336,4.3,6,13,1,20,6,59,0,1,1
11155,13,2015-12-30,wisconsin,N,Southern California*,W (23-21),18,29,62.1,217,1,46,177,3.8,1,75,394,5.3,14,6,2,22,5,36,0,0,0
11156,,13 Games,wisconsin,,,,252,419,60.1,2968,14,512,1954,3.8,27,931,4922,5.3,157,95,24,276,75,689,5,13,18
11157,1,2016-09-03,wisconsin,N,Louisiana State,W (16-14),19,31,61.3,205,0,42,134,3.2,1,73,339,4.6,11,8,2,21,5,55,1,2,3
11158,2,2016-09-10,wisconsin,,Akron,W (54-10),20,27,74.1,292,3,55,294,5.3,4,82,586,7.1,18,12,2,32,3,40,0,0,0
11159,3,2016-09-17,wisconsin,,Georgia State,W (23-17),18,30,60.0,213,1,49,187,3.8,1,79,400,5.1,13,11,1,25,0,0,1,1,2
11160,4,2016-09-24,wisconsin,@,Michigan State,W (30-6),16,26,61.5,195,1,41,122,3.0,2,67,317,4.7,9,5,1,15,7,67,1,1,2
11161,5,2016-10-01,wisconsin,@,Michigan,L (7-14),9,25,36.0,88,1,28,71,2.5,0,53,159,3.0,4,4,0,8,3,30,0,3,3
11162,6,2016-10-15,wisconsin,,Ohio State,L (23-30),16,28,57.1,214,1,46,236,5.1,1,74,450,6.1,9,13,0,22,4,35,0,1,1
11163,7,2016-10-22,wisconsin,@,Iowa,W (17-9),15,25,60.0,256,1,48,167,3.5,1,73,423,5.8,10,9,1,20,0,0,1,0,1
11164,8,2016-10-29,wisconsin,,Nebraska,W (23-17),14,23,60.9,114,1,38,223,5.9,2,61,337,5.5,7,9,0,16,1,5,0,2,2
11165,9,2016-11-05,wisconsin,@,Northwestern,W (21-7),13,22,59.1,143,0,57,190,3.3,2,79,333,4.2,8,11,1,20,1,10,0,0,0
11166,10,2016-11-12,wisconsin,,Illinois,W (48-3),8,14,57.1,92,2,64,363,5.7,4,78,455,5.8,5,18,0,23,4,34,0,0,0
11167,11,2016-11-19,wisconsin,@,Purdue,W (49-20),12,15,80.0,191,2,56,221,3.9,4,71,412,5.8,10,12,1,23,8,69,1,0,1
11168,12,2016-11-26,wisconsin,,Minnesota,W (31-17),13,22,59.1,152,0,47,210,4.5,4,69,362,5.2,8,10,1,19,3,35,1,0,1
11169,13,2016-12-03,wisconsin,N,Penn State,L (31-38),16,21,76.2,174,0,49,241,4.9,3,70,415,5.9,9,11,2,22,4,40,0,0,0
11170,14,2017-01-02,wisconsin,N,Western Michigan*,W (24-16),13,14,92.9,178,1,38,184,4.8,2,52,362,7.0,9,9,0,18,5,35,0,0,0
11171,,14 Games,wisconsin,,,,202,323,62.5,2507,14,658,2843,4.3,31,981,5350,5.5,130,142,12,284,48,455,6,10,16
11172,1,2017-09-01,wisconsin,,Utah State,W (59-10),15,23,65.2,244,3,45,234,5.2,4,68,478,7.0,12,9,4,25,9,73,2,0,2
11173,2,2017-09-09,wisconsin,,Florida Atlantic,W (31-14),17,30,56.7,207,1,54,357,6.6,3,84,564,6.7,10,18,1,29,1,10,1,1,2
11174,3,2017-09-16,wisconsin,@,Brigham Young,W (40-6),18,19,94.7,256,4,49,235,4.8,1,68,491,7.2,9,19,0,28,6,56,0,0,0
11175,4,2017-09-30,wisconsin,,Northwestern,W (33-24),11,20,55.0,197,1,37,109,2.9,2,57,306,5.4,6,7,0,13,5,47,1,2,3
11176,5,2017-10-07,wisconsin,@,Nebraska,W (38-17),9,17,52.9,113,1,49,353,7.2,3,66,466,7.1,4,14,1,19,8,78,0,1,1
11177,6,2017-10-14,wisconsin,,Purdue,W (17-9),13,18,72.2,199,1,50,299,6.0,1,68,498,7.3,10,13,1,24,8,65,1,2,3
11178,7,2017-10-21,wisconsin,,Maryland,W (38-13),16,24,66.7,225,2,41,215,5.2,2,65,440,6.8,12,10,1,23,6,49,1,1,2
11179,8,2017-10-28,wisconsin,@,Illinois,W (24-10),10,19,52.6,135,0,45,168,3.7,3,64,303,4.7,8,9,2,19,4,50,0,1,1
11180,9,2017-11-04,wisconsin,@,Indiana,W (45-17),15,22,68.2,170,2,52,237,4.6,4,74,407,5.5,9,12,3,24,6,62,0,1,1
11181,10,2017-11-11,wisconsin,,Iowa,W (38-14),11,18,61.1,135,2,49,247,5.0,2,67,382,5.7,8,8,2,18,6,54,1,3,4
11182,11,2017-11-18,wisconsin,,Michigan,W (24-10),9,19,47.4,143,1,40,182,4.6,1,59,325,5.5,5,7,2,14,4,35,0,1,1
11183,12,2017-11-25,wisconsin,@,Minnesota,W (31-0),17,21,81.0,169,3,39,287,7.4,1,60,456,7.6,10,10,0,20,3,34,1,0,1
11184,13,2017-12-02,wisconsin,N,Ohio State,L (21-27),20,41,48.8,238,0,32,60,1.9,1,73,298,4.1,10,5,1,16,6,55,0,2,2
11185,14,2017-12-30,wisconsin,@,Miami (FL)*,W (34-24),23,34,67.6,258,4,44,142,3.2,0,78,400,5.1,15,7,2,24,3,35,1,0,1
11186,,14 Games,wisconsin,,,,204,325,62.8,2689,25,626,3125,5.0,28,951,5814,6.1,128,148,20,296,75,703,9,15,24
11187,1,2018-08-31,wisconsin,,Western Kentucky,W (34-3),17,31,54.8,257,2,39,234,6.0,2,70,491,7.0,14,9,1,24,8,70,1,0,1
11188,2,2018-09-08,wisconsin,,New Mexico,W (45-14),9,13,69.2,151,2,59,417,7.1,4,72,568,7.9,5,24,0,29,4,39,1,1,2
11189,3,2018-09-15,wisconsin,,Brigham Young,L (21-24),18,28,64.3,190,0,43,204,4.7,3,71,394,5.5,9,13,1,23,6,33,0,1,1
11190,4,2018-09-22,wisconsin,@,Iowa,W (28-17),17,22,77.3,205,3,44,210,4.8,1,66,415,6.3,8,11,0,19,8,68,0,0,0
11191,5,2018-10-06,wisconsin,,Nebraska,W (41-24),13,24,54.2,163,1,48,370,7.7,4,72,533,7.4,9,15,2,26,5,50,1,0,1
11192,6,2018-10-13,wisconsin,@,Michigan,L (13-38),7,20,35.0,100,1,29,183,6.3,1,49,283,5.8,4,7,0,11,3,30,0,2,2
11193,7,2018-10-20,wisconsin,,Illinois,W (49-20),13,22,59.1,188,3,54,357,6.6,4,76,545,7.2,10,20,1,31,5,50,0,2,2
11194,8,2018-10-27,wisconsin,@,Northwestern,L (17-31),20,33,60.6,158,1,32,165,5.2,1,65,323,5.0,6,11,0,17,5,54,3,0,3
11195,9,2018-11-03,wisconsin,,Rutgers,W (31-17),12,23,52.2,156,1,46,317,6.9,3,69,473,6.9,9,16,1,26,4,19,0,2,2
11196,10,2018-11-10,wisconsin,@,Penn State,L (10-22),9,20,45.0,60,0,37,209,5.6,1,57,269,4.7,4,7,1,12,6,50,2,2,4
11197,11,2018-11-17,wisconsin,@,Purdue,W (47-44),16,24,66.7,206,2,51,385,7.5,4,75,591,7.9,7,16,1,24,13,171,1,0,1
11198,,11 Games,wisconsin,,,,151,260,58.1,1834,16,482,3051,6.3,28,742,4885,6.6,85,149,8,242,67,634,9,10,19
11199,1,2014-08-30,illinois,,Youngstown State,W (28-17),24,38,63.2,285,4,22,78,3.5,0,60,363,6.1,12,2,0,14,7,55,1,0,1
11200,2,2014-09-06,illinois,,Western Kentucky,W (42-34),35,50,70.0,456,3,35,64,1.8,2,85,520,6.1,19,6,3,28,9,69,2,1,3
11201,3,2014-09-13,illinois,@,Washington,L (19-44),20,30,66.7,279,2,26,72,2.8,0,56,351,6.3,9,5,1,15,11,110,2,1,3
11202,4,2014-09-20,illinois,,Texas State,W (42-35),25,39,64.1,266,2,27,219,8.1,3,66,485,7.3,12,7,2,21,4,19,0,1,1
11203,5,2014-09-27,illinois,@,Nebraska,L (14-45),17,38,44.7,261,1,24,78,3.3,1,62,339,5.5,10,4,2,16,7,53,0,3,3
11204,6,2014-10-04,illinois,,Purdue,L (27-38),36,53,67.9,450,2,25,65,2.6,2,78,515,6.6,16,6,4,26,2,20,1,1,2
11205,7,2014-10-11,illinois,@,Wisconsin,L (28-38),14,24,58.3,135,2,39,153,3.9,2,63,288,4.6,5,11,4,20,4,50,0,1,1
11206,8,2014-10-25,illinois,,Minnesota,W (28-24),15,23,65.2,140,1,41,123,3.0,2,64,263,4.1,7,8,1,16,4,36,1,0,1
11207,9,2014-11-01,illinois,@,Ohio State,L (14-55),13,27,48.1,137,1,42,106,2.5,1,69,243,3.5,5,6,4,15,5,50,2,2,4
11208,10,2014-11-15,illinois,,Iowa,L (14-30),17,31,54.8,147,2,25,88,3.5,0,56,235,4.2,8,4,0,12,8,59,0,0,0
11209,11,2014-11-22,illinois,,Penn State,W (16-14),26,42,61.9,215,1,27,68,2.5,0,69,283,4.1,8,5,3,16,3,30,0,0,0
11210,12,2014-11-29,illinois,@,Northwestern,W (47-33),17,28,60.7,147,3,47,291,6.2,2,75,438,5.8,6,14,3,23,6,50,0,1,1
11211,13,2014-12-26,illinois,N,Louisiana Tech*,L (18-35),28,47,59.6,329,1,33,122,3.7,1,80,451,5.6,18,6,2,26,9,68,1,1,2
11212,,13 Games,illinois,,,,287,470,61.1,3247,25,413,1527,3.7,16,883,4774,5.4,135,84,29,248,79,669,10,12,22
11213,1,2015-09-05,illinois,,Kent State,W (52-3),14,29,48.3,208,5,36,134,3.7,2,65,342,5.3,9,7,3,19,8,80,0,1,1
11214,2,2015-09-12,illinois,,Western Illinois,W (44-0),38,54,70.4,353,2,40,147,3.7,2,94,500,5.3,19,7,1,27,3,25,3,1,4
11215,3,2015-09-19,illinois,@,North Carolina,L (14-48),19,38,50.0,172,0,45,227,5.0,2,83,399,4.8,10,10,2,22,8,75,0,1,1
11216,4,2015-09-26,illinois,,Middle Tennessee State,W (27-25),29,49,59.2,238,1,39,140,3.6,1,88,378,4.3,11,11,3,25,6,55,0,0,0
11217,5,2015-10-03,illinois,,Nebraska,W (14-13),23,45,51.1,251,2,32,131,4.1,0,77,382,5.0,11,4,2,17,3,35,0,0,0
11218,6,2015-10-10,illinois,@,Iowa,L (20-29),25,43,58.1,317,1,24,46,1.9,1,67,363,5.4,14,2,4,20,5,45,1,1,2
11219,7,2015-10-24,illinois,,Wisconsin,L (13-24),22,43,51.2,278,0,13,55,4.2,1,56,333,5.9,13,1,1,15,7,50,1,1,2
11220,8,2015-10-31,illinois,@,Penn State,L (0-39),17,44,38.6,130,0,27,37,1.4,0,71,167,2.4,8,4,0,12,8,60,0,1,1
11221,9,2015-11-07,illinois,@,Purdue,W (48-14),21,38,55.3,213,3,41,382,9.3,3,79,595,7.5,10,17,2,29,8,69,0,0,0
11222,10,2015-11-14,illinois,,Ohio State,L (3-28),23,47,48.9,241,0,25,20,0.8,0,72,261,3.6,10,4,1,15,2,10,2,0,2
11223,11,2015-11-21,illinois,@,Minnesota,L (23-32),34,48,70.8,279,2,35,154,4.4,0,83,433,5.2,15,11,2,28,3,30,2,1,3
11224,12,2015-11-28,illinois,N,Northwestern,L (14-24),20,41,48.8,241,0,31,78,2.5,1,72,319,4.4,11,5,0,16,5,55,0,1,1
11225,,12 Games,illinois,,,,285,519,54.9,2921,16,388,1551,4.0,13,907,4472,4.9,141,83,21,245,66,589,9,8,17
11226,1,2016-09-03,illinois,,Murray State,W (52-3),16,24,66.7,228,3,40,287,7.2,4,64,515,8.0,9,10,2,21,7,55,0,0,0
11227,2,2016-09-10,illinois,,North Carolina,L (23-48),17,35,48.6,127,2,36,182,5.1,1,71,309,4.4,5,8,2,15,13,99,1,0,1
11228,3,2016-09-17,illinois,,Western Michigan,L (10-34),29,42,69.0,312,1,15,3,0.2,0,57,315,5.5,14,1,0,15,7,48,1,1,2
11229,4,2016-10-01,illinois,@,Nebraska,L (16-31),14,23,60.9,146,0,21,124,5.9,1,44,270,6.1,7,4,1,12,7,48,0,0,0
11230,5,2016-10-08,illinois,,Purdue,L (31-34),14,23,60.9,184,0,46,315,6.8,3,69,499,7.2,9,12,3,24,12,125,1,0,1
11231,6,2016-10-15,illinois,@,Rutgers,W (24-7),6,14,42.9,92,1,43,228,5.3,1,57,320,5.6,1,9,0,10,6,60,0,1,1
11232,7,2016-10-22,illinois,@,Michigan,L (8-41),4,15,26.7,95,1,23,77,3.3,0,38,172,4.5,2,3,1,6,5,45,1,1,2
11233,8,2016-10-29,illinois,,Minnesota,L (17-40),16,34,47.1,156,1,34,89,2.6,1,68,245,3.6,7,7,3,17,3,33,3,0,3
11234,9,2016-11-05,illinois,,Michigan State,W (31-27),13,29,44.8,140,2,24,164,6.8,2,53,304,5.7,7,5,2,14,2,10,0,0,0
11235,10,2016-11-12,illinois,@,Wisconsin,L (3-48),7,24,29.2,101,0,21,99,4.7,0,45,200,4.4,5,5,1,11,5,46,0,4,4
11236,11,2016-11-19,illinois,,Iowa,L (0-28),19,41,46.3,137,0,24,61,2.5,0,65,198,3.0,7,3,0,10,2,10,1,1,2
11237,12,2016-11-26,illinois,@,Northwestern,L (21-42),28,54,51.9,377,2,26,57,2.2,1,80,434,5.4,18,6,1,25,6,60,3,1,4
11238,,12 Games,illinois,,,,183,358,51.1,2095,13,353,1686,4.8,14,711,3781,5.3,91,73,16,180,75,639,11,9,20
11239,1,2017-09-02,illinois,,Ball State,W (24-21),10,19,52.6,145,1,30,71,2.4,2,49,216,4.4,8,5,1,14,3,30,0,1,1
11240,2,2017-09-09,illinois,,Western Kentucky,W (20-7),14,25,56.0,107,0,50,193,3.9,1,75,300,4.0,5,12,2,19,9,95,0,1,1
11241,3,2017-09-15,illinois,@,South Florida,L (23-47),20,40,50.0,287,1,15,67,4.5,2,55,354,6.4,8,3,4,15,15,138,0,3,3
11242,4,2017-09-29,illinois,,Nebraska,L (6-28),10,16,62.5,106,0,37,93,2.5,0,53,199,3.8,7,6,2,15,5,49,0,1,1
11243,5,2017-10-07,illinois,@,Iowa,L (16-45),22,45,48.9,246,0,30,200,6.7,1,75,446,5.9,9,10,1,20,5,50,1,3,4
11244,6,2017-10-14,illinois,,Rutgers,L (24-35),20,38,52.6,308,2,29,86,3.0,1,67,394,5.9,13,4,1,18,8,68,1,2,3
11245,7,2017-10-21,illinois,@,Minnesota,L (17-24),20,27,74.1,161,1,36,121,3.4,1,63,282,4.5,8,7,0,15,5,45,1,1,2
11246,8,2017-10-28,illinois,,Wisconsin,L (10-24),9,31,29.0,152,0,33,134,4.1,1,64,286,4.5,6,8,3,17,5,40,1,2,3
11247,9,2017-11-04,illinois,@,Purdue,L (10-29),12,27,44.4,170,1,35,80,2.3,0,62,250,4.0,4,8,3,15,9,66,0,1,1
11248,10,2017-11-11,illinois,,Indiana,L (14-24),13,26,50.0,261,2,30,33,1.1,0,56,294,5.3,8,1,1,10,8,73,1,2,3
11249,11,2017-11-18,illinois,@,Ohio State,L (14-52),4,14,28.6,16,0,28,89,3.2,1,42,105,2.5,1,3,1,5,7,55,1,0,1
11250,12,2017-11-25,illinois,,Northwestern,L (7-42),14,31,45.2,139,0,33,100,3.0,1,64,239,3.7,6,5,0,11,6,59,1,2,3
11251,,12 Games,illinois,,,,168,339,49.6,2098,8,386,1267,3.3,11,725,3365,4.6,83,72,19,174,85,768,7,19,26
11252,1,2018-09-01,illinois,,Kent State,W (31-24),13,23,56.5,190,0,47,284,6.0,4,70,474,6.8,10,12,0,22,3,25,1,0,1
11253,2,2018-09-08,illinois,,Western Illinois,W (34-14),14,23,60.9,138,2,47,238,5.1,1,70,376,5.4,8,9,3,20,14,145,0,0,0
11254,3,2018-09-15,illinois,N,South Florida,L (19-25),20,31,64.5,168,0,48,212,4.4,1,79,380,4.8,8,10,3,21,6,65,1,0,1
11255,4,2018-09-21,illinois,,Penn State,L (24-63),18,31,58.1,166,2,45,245,5.4,1,76,411,5.4,11,12,3,26,7,81,0,2,2
11256,5,2018-10-06,illinois,@,Rutgers,W (38-17),10,19,52.6,89,1,43,330,7.7,4,62,419,6.8,4,11,2,17,7,80,0,0,0
11257,6,2018-10-13,illinois,,Purdue,L (7-46),15,29,51.7,181,0,31,69,2.2,1,60,250,4.2,7,7,0,14,7,57,0,1,1
11258,7,2018-10-20,illinois,@,Wisconsin,L (20-49),9,21,42.9,90,0,36,210,5.8,2,57,300,5.3,2,9,2,13,3,25,2,3,5
11259,8,2018-10-27,illinois,@,Maryland,L (33-63),14,32,43.8,261,2,35,232,6.6,1,67,493,7.4,8,11,1,20,2,25,0,1,1
11260,9,2018-11-03,illinois,,Minnesota,W (55-31),18,25,72.0,216,2,35,430,12.3,5,60,646,10.8,9,11,0,20,7,70,2,1,3
11261,10,2018-11-10,illinois,@,Nebraska,L (35-54),11,25,44.0,126,0,48,384,8.0,5,73,510,7.0,7,16,2,25,7,66,3,2,5
11262,11,2018-11-17,illinois,,Iowa,L (0-63),12,30,40.0,82,0,43,149,3.5,0,73,231,3.2,3,8,0,11,6,68,1,3,4
11263,,11 Games,illinois,,,,154,289,53.3,1707,9,458,2783,6.1,25,747,4490,6.0,77,116,16,209,69,707,10,13,23
11264,1,2014-08-30,northwestern,,California,L (24-31),24,44,54.5,246,2,36,108,3.0,1,80,354,4.4,10,11,1,22,1,0,0,2,2
11265,2,2014-09-06,northwestern,,Northern Illinois,L (15-23),28,43,65.1,322,2,37,72,1.9,0,80,394,4.9,15,4,2,21,9,93,0,1,1
11266,3,2014-09-20,northwestern,,Western Illinois,W (24-7),15,25,60.0,117,0,41,166,4.0,3,66,283,4.3,7,7,1,15,5,35,2,0,2
11267,4,2014-09-27,northwestern,@,Penn State,W (29-6),21,37,56.8,258,0,38,103,2.7,3,75,361,4.8,14,3,0,17,8,75,0,1,1
11268,5,2014-10-04,northwestern,,Wisconsin,W (20-14),15,29,51.7,182,1,46,203,4.4,1,75,385,5.1,11,10,1,22,4,20,0,0,0
11269,6,2014-10-11,northwestern,@,Minnesota,L (17-24),32,50,64.0,269,1,34,124,3.6,1,84,393,4.7,16,9,3,28,6,41,0,1,1
11270,7,2014-10-18,northwestern,,Nebraska,L (17-38),18,39,46.2,173,0,34,117,3.4,2,73,290,4.0,9,8,4,21,8,65,0,1,1
11271,8,2014-11-01,northwestern,@,Iowa,L (7-48),9,24,37.5,75,0,43,105,2.4,1,67,180,2.7,6,7,0,13,5,53,1,0,1
11272,9,2014-11-08,northwestern,,Michigan,L (9-10),32,49,65.3,273,1,35,-9,-0.3,0,84,264,3.1,14,3,1,18,3,101,1,2,3
11273,10,2014-11-15,northwestern,@,Notre Dame,W (43-40),30,48,62.5,284,1,48,263,5.5,3,96,547,5.7,12,14,2,28,5,62,2,2,4
11274,11,2014-11-22,northwestern,@,Purdue,W (38-14),13,24,54.2,181,1,56,233,4.2,3,80,414,5.2,10,8,2,20,4,35,1,1,2
11275,12,2014-11-29,northwestern,,Illinois,L (33-47),24,42,57.1,218,1,38,154,4.1,2,80,372,4.7,11,7,1,19,4,48,2,3,5
11276,,12 Games,northwestern,,,,261,454,57.5,2598,10,486,1639,3.4,20,940,4237,4.5,135,91,18,244,62,628,9,14,23
11277,1,2015-09-05,northwestern,,Stanford,W (16-6),12,25,48.0,105,0,54,225,4.2,1,79,330,4.2,8,9,0,17,5,57,0,0,0
11278,2,2015-09-12,northwestern,,Eastern Illinois,W (41-0),11,16,68.8,152,1,69,344,5.0,3,85,496,5.8,9,18,1,28,3,26,1,0,1
11279,3,2015-09-19,northwestern,@,Duke,W (19-10),9,23,39.1,70,0,54,201,3.7,1,77,271,3.5,4,11,0,15,2,10,0,2,2
11280,4,2015-09-26,northwestern,,Ball State,W (24-19),18,31,58.1,256,3,57,290,5.1,0,88,546,6.2,11,12,0,23,8,57,2,1,3
11281,5,2015-10-03,northwestern,,Minnesota,W (27-0),14,19,73.7,128,0,51,184,3.6,2,70,312,4.5,9,7,0,16,3,20,0,0,0
11282,6,2015-10-10,northwestern,@,Michigan,L (0-38),15,33,45.5,130,0,25,38,1.5,0,58,168,2.9,9,3,1,13,5,39,0,1,1
11283,7,2015-10-17,northwestern,,Iowa,L (10-40),20,43,46.5,147,1,26,51,2.0,0,69,198,2.9,6,5,2,13,5,55,2,1,3
11284,8,2015-10-24,northwestern,@,Nebraska,W (30-28),13,28,46.4,177,1,28,156,5.6,1,56,333,5.9,8,5,2,15,5,58,0,0,0
11285,9,2015-11-07,northwestern,,Penn State,W (23-21),16,32,50.0,169,1,47,227,4.8,1,79,396,5.0,12,8,2,22,7,80,0,1,1
11286,10,2015-11-14,northwestern,,Purdue,W (21-14),11,24,45.8,132,0,48,250,5.2,3,72,382,5.3,7,11,3,21,4,23,1,2,3
11287,11,2015-11-21,northwestern,@,Wisconsin,W (13-7),9,20,45.0,60,0,50,149,3.0,1,70,209,3.0,6,5,1,12,7,46,0,0,0
11288,12,2015-11-28,northwestern,N,Illinois,W (24-14),12,25,48.0,146,1,54,204,3.8,2,79,350,4.4,7,8,3,18,1,10,1,1,2
11289,13,2016-01-01,northwestern,N,Tennessee*,L (6-45),14,33,42.4,129,0,37,132,3.6,1,70,261,3.7,5,10,3,18,3,35,0,4,4
11290,,13 Games,northwestern,,,,174,352,49.4,1801,8,600,2451,4.1,16,952,4252,4.5,101,112,18,231,58,516,7,13,20
11291,1,2016-09-03,northwestern,,Western Michigan,L (21-22),15,22,68.2,196,0,31,123,4.0,3,53,319,6.0,8,7,0,15,2,20,1,0,1
11292,2,2016-09-10,northwestern,,Illinois State,L (7-9),17,41,41.5,191,1,31,86,2.8,0,72,277,3.8,10,4,2,16,6,70,0,0,0
11293,3,2016-09-17,northwestern,,Duke,W (24-13),18,39,46.2,320,3,44,86,2.0,0,83,406,4.9,11,7,4,22,5,37,0,2,2
11294,4,2016-09-24,northwestern,,Nebraska,L (13-24),25,38,65.8,251,1,32,137,4.3,1,70,388,5.5,12,9,2,23,4,36,0,2,2
11295,5,2016-10-01,northwestern,@,Iowa,W (38-31),18,30,60.0,164,3,42,198,4.7,2,72,362,5.0,9,8,3,20,1,5,1,0,1
11296,6,2016-10-15,northwestern,@,Michigan State,W (54-40),27,35,77.1,281,3,51,209,4.1,3,86,490,5.7,12,13,1,26,4,25,0,1,1
11297,7,2016-10-22,northwestern,,Indiana,W (24-14),24,44,54.5,285,3,44,123,2.8,0,88,408,4.6,16,8,2,26,6,43,0,0,0
11298,8,2016-10-29,northwestern,@,Ohio State,L (20-24),23,44,52.3,258,1,29,148,5.1,1,73,406,5.6,15,6,0,21,2,20,0,1,1
11299,9,2016-11-05,northwestern,,Wisconsin,L (7-21),28,52,53.8,277,1,19,39,2.1,0,71,316,4.5,12,2,0,14,5,28,1,0,1
11300,10,2016-11-12,northwestern,@,Purdue,W (45-17),23,37,62.2,352,3,46,253,5.5,3,83,605,7.3,14,14,0,28,0,0,0,2,2
11301,11,2016-11-19,northwestern,@,Minnesota,L (12-29),28,45,62.2,276,1,33,63,1.9,1,78,339,4.3,13,6,2,21,3,20,2,0,2
11302,12,2016-11-26,northwestern,,Illinois,W (42-21),13,20,65.0,121,1,49,278,5.7,5,69,399,5.8,9,10,3,22,5,50,1,0,1
11303,13,2016-12-28,northwestern,N,Pittsburgh*,W (31-24),23,36,63.9,214,1,50,248,5.0,3,86,462,5.4,15,10,2,27,4,35,1,1,2
11304,,13 Games,northwestern,,,,282,483,58.4,3186,22,501,1991,4.0,22,984,5177,5.3,156,104,21,281,47,389,7,9,16
11305,1,2017-09-02,northwestern,,Nevada,W (31-20),28,38,73.7,352,2,50,156,3.1,2,88,508,5.8,14,9,4,26,8,90,1,1,2
11306,2,2017-09-09,northwestern,@,Duke,L (17-41),14,33,42.4,169,1,21,22,1.0,1,54,191,3.5,10,3,2,15,3,26,1,2,3
11307,3,2017-09-16,northwestern,,Bowling Green State,W (49-7),24,31,77.4,375,2,43,303,7.0,5,74,678,9.2,15,15,0,30,4,23,2,0,2
11308,4,2017-09-30,northwestern,@,Wisconsin,L (24-33),29,45,64.4,219,3,34,25,0.7,0,79,244,3.1,14,4,2,20,5,50,0,2,2
11309,5,2017-10-07,northwestern,,Penn State,L (7-31),23,43,53.5,198,0,30,67,2.2,1,73,265,3.6,9,6,0,15,8,74,1,2,3
11310,6,2017-10-14,northwestern,@,Maryland,W (37-21),27,49,55.1,293,1,44,238,5.4,3,93,531,5.7,15,14,1,30,7,90,0,2,2
11311,7,2017-10-21,northwestern,,Iowa,W (17-10),21,36,58.3,192,0,46,147,3.2,2,82,339,4.1,8,12,1,21,5,40,0,0,0
11312,8,2017-10-28,northwestern,,Michigan State,W (39-31),34,49,69.4,368,3,28,64,2.3,2,77,432,5.6,21,4,3,28,1,9,1,0,1
11313,9,2017-11-04,northwestern,@,Nebraska,W (31-24),19,35,54.3,243,0,45,232,5.2,4,80,475,5.9,9,14,3,26,6,65,0,2,2
11314,10,2017-11-11,northwestern,,Purdue,W (23-13),26,46,56.5,296,1,38,94,2.5,1,84,390,4.6,17,4,1,22,4,40,0,0,0
11315,11,2017-11-18,northwestern,,Minnesota,W (39-0),9,13,69.2,86,3,55,277,5.0,3,68,363,5.3,7,14,1,22,3,30,0,0,0
11316,12,2017-11-25,northwestern,@,Illinois,W (42-7),13,21,61.9,140,1,47,306,6.5,4,68,446,6.6,6,13,2,21,3,30,0,1,1
11317,13,2017-12-29,northwestern,N,Kentucky*,W (24-23),9,21,42.9,109,0,56,333,5.9,2,77,442,5.7,5,13,2,20,7,70,0,0,0
11318,,13 Games,northwestern,,,,276,460,60.0,3040,17,537,2264,4.2,30,997,5304,5.3,150,125,22,296,64,637,6,12,18
11319,1,2018-08-30,northwestern,@,Purdue,W (31-27),23,37,62.2,235,0,42,166,4.0,4,79,401,5.1,11,7,4,22,6,56,0,0,0
11320,2,2018-09-08,northwestern,,Duke,L (7-21),31,56,55.4,282,0,32,99,3.1,1,88,381,4.3,16,5,3,24,2,20,0,2,2
11321,3,2018-09-15,northwestern,,Akron,L (34-39),37,58,63.8,405,3,36,86,2.4,2,94,491,5.2,19,7,4,30,3,35,1,2,3
11322,4,2018-09-29,northwestern,,Michigan,L (17-20),16,29,55.2,174,0,34,28,0.8,2,63,202,3.2,7,5,3,15,2,25,0,0,0
11323,5,2018-10-06,northwestern,@,Michigan State,W (29-19),31,47,66.0,373,3,20,8,0.4,1,67,381,5.7,14,3,2,19,3,35,0,2,2
11324,6,2018-10-13,northwestern,,Nebraska,W (34-31),41,64,64.1,455,3,23,32,1.4,0,87,487,5.6,21,4,5,30,1,5,0,2,2
11325,7,2018-10-20,northwestern,@,Rutgers,W (18-15),17,34,50.0,150,0,47,128,2.7,2,81,278,3.4,8,8,4,20,6,49,1,0,1
11326,8,2018-10-27,northwestern,,Wisconsin,W (31-17),17,30,56.7,167,1,49,182,3.7,3,79,349,4.4,8,9,2,19,3,20,0,3,3
11327,9,2018-11-03,northwestern,,Notre Dame,L (21-31),16,29,55.2,141,1,40,108,2.7,2,69,249,3.6,10,5,1,16,0,0,0,0,0
11328,10,2018-11-10,northwestern,@,Iowa,W (14-10),15,30,50.0,122,1,46,184,4.0,1,76,306,4.0,6,12,1,19,5,40,0,2,2
11329,11,2018-11-17,northwestern,@,Minnesota,W (24-14),15,21,71.4,230,0,39,95,2.4,3,60,325,5.4,11,4,1,16,2,20,0,0,0
11330,,11 Games,northwestern,,,,259,435,59.5,2734,12,408,1116,2.7,21,843,3850,4.6,131,69,30,230,33,305,2,13,15
11331,1,2014-08-30,miami-oh,,Marshall,L (27-42),24,49,49.0,318,3,36,100,2.8,0,85,418,4.9,11,7,4,22,12,107,0,1,1
11332,2,2014-09-06,miami-oh,,Eastern Kentucky,L (10-17),25,52,48.1,359,1,38,60,1.6,0,90,419,4.7,14,7,4,25,9,61,3,3,6
11333,3,2014-09-13,miami-oh,@,Michigan,L (10-34),12,26,46.2,165,1,24,33,1.4,0,50,198,4.0,7,1,0,8,7,40,0,1,1
11334,4,2014-09-20,miami-oh,N,Cincinnati,L (24-31),13,26,50.0,262,2,44,102,2.3,1,70,364,5.2,8,11,0,19,6,38,2,1,3
11335,5,2014-09-27,miami-oh,@,Buffalo,L (27-35),12,38,31.6,238,3,22,133,6.0,1,60,371,6.2,8,4,1,13,6,55,0,0,0
11336,6,2014-10-04,miami-oh,,Massachusetts,W (42-41),32,58,55.2,437,4,27,120,4.4,2,85,557,6.6,23,6,2,31,10,95,1,0,1
11337,7,2014-10-11,miami-oh,@,Akron,L (19-29),24,41,58.5,352,3,23,60,2.6,0,64,412,6.4,19,3,1,23,12,102,2,1,3
11338,8,2014-10-18,miami-oh,@,Northern Illinois,L (41-51),23,42,54.8,346,2,30,168,5.6,4,72,514,7.1,16,8,2,26,8,56,0,0,0
11339,9,2014-10-25,miami-oh,,Kent State,W (10-3),11,28,39.3,120,0,33,167,5.1,1,61,287,4.7,5,8,2,15,8,62,0,0,0
11340,10,2014-11-01,miami-oh,,Western Michigan,L (10-41),11,29,37.9,149,1,29,87,3.0,0,58,236,4.1,7,7,4,18,5,40,0,2,2
11341,11,2014-11-15,miami-oh,@,Central Michigan,L (27-34),24,41,58.5,369,2,27,102,3.8,1,68,471,6.9,18,6,4,28,5,37,1,0,1
11342,12,2014-11-25,miami-oh,,Ohio,L (21-24),15,38,39.5,218,1,25,99,4.0,1,63,317,5.0,12,6,0,18,7,46,1,1,2
11343,,12 Games,miami-oh,,,,226,468,48.3,3333,23,358,1231,3.4,11,826,4564,5.5,148,74,24,246,95,739,10,10,20
11344,1,2015-09-05,miami-oh,,Presbyterian,W (26-7),17,23,73.9,261,2,40,205,5.1,2,63,466,7.4,7,9,2,18,13,162,2,0,2
11345,2,2015-09-12,miami-oh,@,Wisconsin,L (0-58),13,34,38.2,160,0,24,-3,-0.1,0,58,157,2.7,8,0,1,9,7,72,1,3,4
11346,3,2015-09-19,miami-oh,,Cincinnati,L (33-37),14,34,41.2,228,4,41,220,5.4,0,75,448,6.0,7,9,1,17,6,50,0,1,1
11347,4,2015-09-26,miami-oh,@,Western Kentucky,L (14-56),15,28,53.6,168,2,40,123,3.1,0,68,291,4.3,9,5,1,15,6,36,1,3,4
11348,5,2015-10-03,miami-oh,@,Kent State,L (14-20),21,51,41.2,325,1,36,91,2.5,1,87,416,4.8,13,8,3,24,10,83,0,4,4
11349,6,2015-10-10,miami-oh,@,Ohio,L (3-34),9,25,36.0,166,0,24,87,3.6,0,49,253,5.2,7,3,2,12,6,47,0,4,4
11350,7,2015-10-17,miami-oh,,Northern Illinois,L (12-45),16,33,48.5,156,1,41,153,3.7,0,74,309,4.2,6,9,2,17,9,75,1,1,2
11351,8,2015-10-24,miami-oh,@,Western Michigan,L (13-35),14,27,51.9,218,0,27,58,2.1,1,54,276,5.1,9,3,0,12,8,64,2,0,2
11352,9,2015-10-29,miami-oh,,Buffalo,L (24-29),13,36,36.1,224,2,31,124,4.0,0,67,348,5.2,10,6,3,19,6,53,1,0,1
11353,10,2015-11-07,miami-oh,,Eastern Michigan,W (28-13),13,18,72.2,150,2,47,291,6.2,2,65,441,6.8,7,12,2,21,4,30,1,1,2
11354,11,2015-11-14,miami-oh,,Akron,L (28-37),20,42,47.6,316,3,31,68,2.2,0,73,384,5.3,12,4,2,18,10,70,2,2,4
11355,12,2015-11-21,miami-oh,@,Massachusetts,W (20-13),12,23,52.2,160,1,46,139,3.0,1,69,299,4.3,10,7,1,18,4,30,1,0,1
11356,,12 Games,miami-oh,,,,177,374,47.3,2532,18,428,1556,3.6,7,802,4088,5.1,105,75,20,200,89,772,12,19,31
11357,1,2016-09-03,miami-oh,@,Iowa,L (21-45),19,29,65.5,266,2,41,158,3.9,1,70,424,6.1,11,13,1,25,5,22,3,0,3
11358,2,2016-09-10,miami-oh,,Eastern Illinois,L (17-21),13,22,59.1,250,2,43,147,3.4,0,65,397,6.1,10,10,2,22,12,89,0,1,1
11359,3,2016-09-17,miami-oh,,Western Kentucky,L (24-31),20,41,48.8,339,2,38,85,2.2,1,79,424,5.4,13,5,5,23,11,87,1,0,1
11360,4,2016-09-24,miami-oh,@,Cincinnati,L (20-27),13,24,54.2,248,2,29,67,2.3,0,53,315,5.9,8,5,1,14,12,107,1,1,2
11361,5,2016-10-01,miami-oh,,Ohio,L (7-17),18,34,52.9,205,1,32,33,1.0,0,66,238,3.6,12,4,2,18,10,99,2,2,4
11362,6,2016-10-08,miami-oh,@,Akron,L (13-35),14,28,50.0,153,1,34,107,3.1,0,62,260,4.2,9,6,0,15,6,50,1,2,3
11363,7,2016-10-15,miami-oh,,Kent State,W (18-14),10,21,47.6,181,2,37,79,2.1,0,58,260,4.5,7,6,1,14,4,28,1,0,1
11364,8,2016-10-22,miami-oh,@,Bowling Green State,W (40-26),22,35,62.9,215,3,44,218,5.0,2,79,433,5.5,12,9,3,24,10,106,1,0,1
11365,9,2016-10-29,miami-oh,@,Eastern Michigan,W (28-15),15,23,65.2,175,1,43,230,5.3,3,66,405,6.1,9,12,2,23,2,15,1,0,1
11366,10,2016-11-04,miami-oh,,Central Michigan,W (37-17),13,21,61.9,218,4,41,218,5.3,1,62,436,7.0,10,10,1,21,3,25,0,0,0
11367,11,2016-11-12,miami-oh,@,Buffalo,W (35-24),7,14,50.0,105,2,39,204,5.2,1,53,309,5.8,3,7,1,11,6,42,1,0,1
11368,12,2016-11-22,miami-oh,,Ball State,W (21-20),26,35,74.3,380,3,25,62,2.5,0,60,442,7.4,14,5,1,20,4,25,0,0,0
11369,13,2016-12-26,miami-oh,N,Mississippi State*,L (16-17),22,31,71.0,263,2,35,170,4.9,0,66,433,6.6,11,12,1,24,3,30,1,1,2
11370,,13 Games,miami-oh,,,,212,358,59.2,2998,27,481,1778,3.7,9,839,4776,5.7,129,104,21,254,88,725,13,7,20
11371,1,2017-09-02,miami-oh,@,Marshall,L (26-31),23,44,52.3,298,2,42,131,3.1,1,86,429,5.0,17,7,1,25,5,51,1,1,2
11372,2,2017-09-09,miami-oh,,Austin Peay,W (31-10),11,22,50.0,145,3,49,150,3.1,1,71,295,4.2,6,12,0,18,3,20,3,0,3
11373,3,2017-09-16,miami-oh,,Cincinnati,L (17-21),16,31,51.6,221,1,32,70,2.2,1,63,291,4.6,7,5,2,14,9,77,0,1,1
11374,4,2017-09-23,miami-oh,@,Central Michigan,W (31-14),11,19,57.9,217,2,40,177,4.4,2,59,394,6.7,9,7,4,20,10,90,0,0,0
11375,5,2017-09-30,miami-oh,@,Notre Dame,L (17-52),19,37,51.4,262,2,33,115,3.5,0,70,377,5.4,11,6,2,19,9,90,1,1,2
11376,6,2017-10-07,miami-oh,,Bowling Green State,L (29-37),24,43,55.8,374,2,44,238,5.4,1,87,612,7.0,18,14,5,37,7,62,1,1,2
11377,7,2017-10-14,miami-oh,@,Kent State,L (14-17),12,30,40.0,174,2,34,161,4.7,0,64,335,5.2,9,8,2,19,8,40,0,2,2
11378,8,2017-10-21,miami-oh,,Buffalo,W (24-14),13,20,65.0,177,0,43,172,4.0,3,63,349,5.5,8,6,2,16,9,102,0,0,0
11379,9,2017-10-31,miami-oh,@,Ohio,L (28-45),28,51,54.9,350,3,23,98,4.3,1,74,448,6.1,15,5,1,21,10,95,0,2,2
11380,10,2017-11-07,miami-oh,,Akron,W (24-14),19,32,59.4,235,3,31,189,6.1,0,63,424,6.7,13,10,3,26,4,40,0,2,2
11381,11,2017-11-15,miami-oh,,Eastern Michigan,L (24-27),22,32,68.8,251,1,38,141,3.7,2,70,392,5.6,14,5,0,19,11,75,1,1,2
11382,12,2017-11-21,miami-oh,@,Ball State,W (28-7),15,27,55.6,148,3,29,125,4.3,0,56,273,4.9,8,3,3,14,2,15,0,0,0
11383,,12 Games,miami-oh,,,,213,388,54.9,2852,24,438,1767,4.0,12,826,4619,5.6,135,88,25,248,87,757,7,11,18
11384,1,2018-09-01,miami-oh,,Marshall,L (28-35),25,46,54.3,357,3,27,87,3.2,1,73,444,6.1,16,5,2,23,8,71,0,0,0
11385,2,2018-09-08,miami-oh,,Cincinnati,L (0-21),22,41,53.7,139,0,19,59,3.1,0,60,198,3.3,9,1,1,11,4,45,0,1,1
11386,3,2018-09-15,miami-oh,@,Minnesota,L (3-26),11,23,47.8,108,0,31,91,2.9,0,54,199,3.7,5,3,2,10,6,55,2,1,3
11387,4,2018-09-22,miami-oh,@,Bowling Green State,W (38-23),10,15,66.7,119,2,52,289,5.6,3,67,408,6.1,6,10,1,17,8,85,0,0,0
11388,5,2018-09-29,miami-oh,,Western Michigan,L (39-40),22,32,68.8,294,3,27,55,2.0,1,59,349,5.9,11,6,3,20,8,45,0,0,0
11389,6,2018-10-06,miami-oh,@,Akron,W (41-17),24,33,72.7,214,1,38,208,5.5,3,71,422,5.9,10,9,0,19,6,60,1,1,2
11390,7,2018-10-13,miami-oh,,Kent State,W (31-6),16,25,64.0,209,1,51,295,5.8,3,76,504,6.6,9,13,3,25,6,40,1,0,1
11391,8,2018-10-20,miami-oh,@,Army,L (30-31),30,53,56.6,329,4,27,77,2.9,0,80,406,5.1,17,6,0,23,8,56,0,0,0
11392,9,2018-10-30,miami-oh,@,Buffalo,L (42-51),20,35,57.1,313,1,41,140,3.4,5,76,453,6.0,12,9,2,23,13,139,1,0,1
11393,10,2018-11-07,miami-oh,,Ohio,W (30-28),20,32,62.5,199,1,34,160,4.7,3,66,359,5.4,11,8,0,19,6,45,0,0,0
11394,11,2018-11-14,miami-oh,@,Northern Illinois,W (13-7),15,24,62.5,107,0,41,94,2.3,0,65,201,3.1,9,4,3,16,2,15,0,0,0
11395,,11 Games,miami-oh,,,,215,359,59.9,2388,16,388,1555,4.0,19,747,3943,5.3,115,74,17,206,75,656,5,3,8
11396,1,2014-08-30,toledo,,New Hampshire,W (54-20),25,35,71.4,360,4,45,306,6.8,3,80,666,8.3,18,15,1,34,3,37,0,0,0
11397,2,2014-09-06,toledo,,Missouri,L (24-49),23,44,52.3,256,0,32,154,4.8,3,76,410,5.4,11,7,0,18,9,60,1,1,2
11398,3,2014-09-12,toledo,@,Cincinnati,L (34-58),28,43,65.1,323,3,39,240,6.2,1,82,563,6.9,16,10,1,27,7,65,1,0,1
11399,4,2014-09-20,toledo,,Ball State,W (34-23),13,22,59.1,152,1,47,318,6.8,4,69,470,6.8,7,15,1,23,4,37,1,1,2
11400,5,2014-09-27,toledo,,Central Michigan,W (42-28),23,34,67.6,339,2,38,204,5.4,3,72,543,7.5,16,11,2,29,6,47,1,1,2
11401,6,2014-10-04,toledo,@,Western Michigan,W (20-19),13,27,48.1,210,1,36,234,6.5,1,63,444,7.0,10,9,0,19,4,26,2,1,3
11402,7,2014-10-11,toledo,@,Iowa State,L (30-37),22,36,61.1,189,1,41,236,5.8,2,77,425,5.5,9,12,4,25,6,56,0,0,0
11403,8,2014-10-25,toledo,,Massachusetts,W (42-35),20,34,58.8,225,3,49,295,6.0,3,83,520,6.3,11,14,5,30,9,81,0,2,2
11404,9,2014-11-04,toledo,@,Kent State,W (30-20),18,32,56.3,201,3,47,221,4.7,0,79,422,5.3,10,10,4,24,7,73,1,0,1
11405,10,2014-11-11,toledo,@,Northern Illinois,L (24-27),12,23,52.2,209,1,49,263,5.4,2,72,472,6.6,6,14,0,20,3,20,0,0,0
11406,11,2014-11-19,toledo,,Bowling Green State,W (27-20),9,20,45.0,63,0,53,325,6.1,4,73,388,5.3,5,13,1,19,8,59,1,2,3
11407,12,2014-11-28,toledo,@,Eastern Michigan,W (52-16),16,20,80.0,341,5,47,172,3.7,2,67,513,7.7,11,12,0,23,7,63,0,0,0
11408,13,2015-01-04,toledo,N,Arkansas State*,W (63-44),21,27,77.8,176,0,53,365,6.9,7,80,541,6.8,7,20,3,30,5,45,0,1,1
11409,,13 Games,toledo,,,,243,397,61.2,3044,24,576,3333,5.8,35,973,6377,6.6,137,162,22,321,78,669,8,9,17
11410,1,2015-09-12,toledo,N,Arkansas,W (16-12),21,38,55.3,237,1,24,81,3.4,1,62,318,5.1,10,4,1,15,8,55,0,0,0
11411,2,2015-09-19,toledo,,Iowa State,W (30-23),11,28,39.3,138,1,34,171,5.0,1,62,309,5.0,6,6,4,16,8,57,0,1,1
11412,3,2015-09-26,toledo,,Arkansas State,W (37-7),25,52,48.1,308,0,46,169,3.7,3,98,477,4.9,15,11,3,29,8,80,0,1,1
11413,4,2015-10-03,toledo,@,Ball State,W (24-10),16,22,72.7,164,2,48,280,5.8,1,70,444,6.3,8,12,1,21,14,135,0,2,2
11414,5,2015-10-10,toledo,,Kent State,W (38-7),20,33,60.6,230,2,46,288,6.3,3,79,518,6.6,12,11,4,27,9,84,1,0,1
11415,6,2015-10-17,toledo,,Eastern Michigan,W (63-20),22,33,66.7,373,5,29,238,8.2,3,62,611,9.9,14,9,0,23,6,46,1,0,1
11416,7,2015-10-24,toledo,@,Massachusetts,W (51-35),26,47,55.3,355,5,58,265,4.6,1,105,620,5.9,16,14,3,33,10,81,0,3,3
11417,8,2015-11-03,toledo,,Northern Illinois,L (27-32),15,33,45.5,136,1,50,291,5.8,2,83,427,5.1,7,12,2,21,4,33,1,2,3
11418,9,2015-11-10,toledo,@,Central Michigan,W (28-23),23,39,59.0,322,2,34,169,5.0,2,73,491,6.7,16,7,0,23,7,65,0,0,0
11419,10,2015-11-17,toledo,@,Bowling Green State,W (44-28),16,24,66.7,208,1,50,198,4.0,4,74,406,5.5,11,9,0,20,8,84,0,1,1
11420,11,2015-11-27,toledo,,Western Michigan,L (30-35),16,33,48.5,280,2,39,201,5.2,2,72,481,6.7,10,10,2,22,5,35,1,0,1
11421,12,2015-12-22,toledo,N,Temple*,W (32-17),20,29,69.0,285,2,33,150,4.5,2,62,435,7.0,13,5,0,18,9,63,0,0,0
11422,,12 Games,toledo,,,,231,411,56.2,3036,24,491,2501,5.1,25,902,5537,6.1,138,110,20,268,96,818,4,10,14
11423,1,2016-09-02,toledo,@,Arkansas State,W (31-10),23,31,74.2,371,3,45,185,4.1,1,76,556,7.3,14,9,1,24,6,58,2,0,2
11424,2,2016-09-10,toledo,,Maine,W (45-3),13,27,48.1,329,4,33,187,5.7,1,60,516,8.6,8,9,0,17,8,68,1,1,2
11425,3,2016-09-17,toledo,,Fresno State,W (52-17),16,28,57.1,301,5,55,318,5.8,2,83,619,7.5,10,15,2,27,6,45,0,0,0
11426,4,2016-09-30,toledo,@,Brigham Young,L (53-55),30,38,78.9,505,5,41,187,4.6,2,79,692,8.8,19,10,4,33,8,81,0,2,2
11427,5,2016-10-08,toledo,@,Eastern Michigan,W (35-20),25,31,80.6,247,4,51,220,4.3,1,82,467,5.7,15,13,2,30,6,60,0,0,0
11428,6,2016-10-15,toledo,,Bowling Green State,W (42-35),23,30,76.7,322,4,43,219,5.1,2,73,541,7.4,14,8,3,25,7,73,0,1,1
11429,7,2016-10-22,toledo,,Central Michigan,W (31-17),23,32,71.9,264,4,37,140,3.8,0,69,404,5.9,13,6,4,23,7,67,0,0,0
11430,8,2016-10-27,toledo,,Ohio,L (26-31),32,46,69.6,438,3,29,122,4.2,0,75,560,7.5,15,8,1,24,9,66,1,1,2
11431,9,2016-11-02,toledo,@,Akron,W (48-17),27,38,71.1,332,3,48,290,6.0,3,86,622,7.2,16,15,2,33,8,63,0,0,0
11432,10,2016-11-09,toledo,N,Northern Illinois,W (31-24),23,33,69.7,286,3,40,134,3.4,1,73,420,5.8,14,7,1,22,6,48,0,1,1
11433,11,2016-11-16,toledo,,Ball State,W (37-19),25,39,64.1,325,3,32,179,5.6,0,71,504,7.1,13,8,2,23,4,34,0,1,1
11434,12,2016-11-25,toledo,@,Western Michigan,L (35-55),13,24,54.2,229,3,30,227,7.6,2,54,456,8.4,8,9,3,20,9,71,1,2,3
11435,13,2016-12-17,toledo,N,Appalachian State*,L (28-31),18,26,69.2,247,2,28,127,4.5,2,54,374,6.9,9,5,0,14,7,62,0,0,0
11436,,13 Games,toledo,,,,291,423,68.8,4196,46,512,2535,5.0,17,935,6731,7.2,168,122,25,315,91,796,5,9,14
11437,1,2017-08-31,toledo,,Elon,W (47-13),19,34,55.9,314,0,41,239,5.8,4,75,553,7.4,13,11,1,25,2,20,1,1,2
11438,2,2017-09-09,toledo,@,Nevada,W (37-24),19,27,70.4,232,2,60,194,3.2,2,87,426,4.9,11,12,5,28,14,110,0,0,0
11439,3,2017-09-16,toledo,,Tulsa,W (54-51),22,33,66.7,458,6,33,221,6.7,1,66,679,10.3,16,9,4,29,15,150,0,1,1
11440,4,2017-09-23,toledo,@,Miami (FL),L (30-52),29,50,58.0,344,3,34,102,3.0,0,84,446,5.3,16,6,1,23,10,77,1,0,1
11441,5,2017-10-07,toledo,,Eastern Michigan,W (20-15),23,34,67.6,289,0,42,130,3.1,2,76,419,5.5,15,5,4,24,9,85,0,0,0
11442,6,2017-10-14,toledo,@,Central Michigan,W (30-10),10,18,55.6,89,0,56,310,5.5,4,74,399,5.4,5,12,0,17,4,30,0,0,0
11443,7,2017-10-21,toledo,,Akron,W (48-21),18,28,64.3,323,5,43,303,7.0,1,71,626,8.8,15,20,0,35,11,104,0,1,1
11444,8,2017-10-26,toledo,@,Ball State,W (58-17),8,18,44.4,267,3,33,335,10.2,4,51,602,11.8,6,10,0,16,8,90,1,0,1
11445,9,2017-11-02,toledo,,Northern Illinois,W (27-17),23,31,74.2,361,0,40,166,4.2,3,71,527,7.4,14,7,2,23,4,35,1,0,1
11446,10,2017-11-08,toledo,@,Ohio,L (10-38),24,35,68.6,263,1,23,53,2.3,0,58,316,5.4,11,2,1,14,6,48,2,0,2
11447,11,2017-11-15,toledo,@,Bowling Green State,W (66-37),14,20,70.0,248,2,53,389,7.3,7,73,637,8.7,12,17,3,32,8,74,0,0,0
11448,12,2017-11-24,toledo,,Western Michigan,W (37-10),19,29,65.5,300,2,38,155,4.1,2,67,455,6.8,12,9,1,22,6,50,0,1,1
11449,13,2017-12-02,toledo,N,Akron,W (45-28),23,37,62.2,307,4,39,254,6.5,2,76,561,7.4,14,11,1,26,4,43,3,2,5
11450,14,2017-12-23,toledo,N,Appalachian State*,L (0-34),16,29,55.2,124,0,21,22,1.0,0,50,146,2.9,6,2,0,8,5,35,1,3,4
11451,,14 Games,toledo,,,,267,423,63.1,3919,28,556,2873,5.2,32,979,6792,6.9,166,133,23,322,106,951,10,9,19
11452,1,2018-09-01,toledo,,Virginia Military Institute,W (66-3),22,32,68.8,390,3,45,213,4.7,5,77,603,7.8,16,14,0,30,5,50,0,0,0
11453,2,2018-09-15,toledo,,Miami (FL),L (24-49),13,23,56.5,222,2,36,112,3.1,1,59,334,5.7,9,8,0,17,5,38,0,1,1
11454,3,2018-09-22,toledo,,Nevada,W (63-44),16,25,64.0,230,5,46,230,5.0,2,71,460,6.5,11,10,2,23,6,65,1,0,1
11455,4,2018-09-29,toledo,@,Fresno State,L (27-49),16,31,51.6,238,3,40,137,3.4,0,71,375,5.3,11,7,3,21,3,25,0,1,1
11456,5,2018-10-06,toledo,,Bowling Green State,W (52-36),17,35,48.6,184,3,44,288,6.5,4,79,472,6.0,10,13,6,29,10,79,0,0,0
11457,6,2018-10-13,toledo,@,Eastern Michigan,L (26-28),12,27,44.4,147,1,52,229,4.4,2,79,376,4.8,6,14,5,25,16,130,0,1,1
11458,7,2018-10-20,toledo,,Buffalo,L (17-31),7,21,33.3,137,1,29,158,5.4,1,50,295,5.9,2,4,2,8,12,148,2,2,4
11459,8,2018-10-25,toledo,@,Western Michigan,W (51-24),18,32,56.3,247,5,35,268,7.7,1,67,515,7.7,13,10,2,25,7,56,0,0,0
11460,9,2018-10-31,toledo,,Ball State,W (45-13),25,35,71.4,327,2,38,204,5.4,3,73,531,7.3,16,8,3,27,6,45,0,5,5
11461,10,2018-11-07,toledo,@,Northern Illinois,L (15-38),26,47,55.3,264,1,42,167,4.0,1,89,431,4.8,13,8,3,24,5,30,0,0,0
11462,11,2018-11-15,toledo,@,Kent State,W (56-34),12,18,66.7,133,2,49,384,7.8,4,67,517,7.7,6,13,2,21,12,140,0,0,0
11463,,11 Games,toledo,,,,184,326,56.4,2519,28,456,2390,5.2,24,782,4909,6.3,113,109,28,250,87,806,3,10,13
11464,1,2014-08-29,bowling-green-state,@,Western Kentucky,L (31-59),25,36,69.4,313,1,35,152,4.3,3,71,465,6.5,17,7,2,26,11,90,0,0,0
11465,2,2014-09-06,bowling-green-state,,Virginia Military Institute,W (48-7),25,34,73.5,266,1,37,260,7.0,4,71,526,7.4,11,15,0,26,7,87,1,1,2
11466,3,2014-09-13,bowling-green-state,,Indiana,W (45-42),46,73,63.0,395,3,40,176,4.4,2,113,571,5.1,22,10,7,39,4,42,1,1,2
11467,4,2014-09-20,bowling-green-state,@,Wisconsin,L (17-68),15,33,45.5,178,0,29,93,3.2,2,62,271,4.4,7,2,2,11,7,36,1,1,2
11468,5,2014-09-27,bowling-green-state,@,Massachusetts,W (47-42),38,60,63.3,443,3,48,225,4.7,3,108,668,6.2,15,14,1,30,13,112,0,3,3
11469,6,2014-10-04,bowling-green-state,,Buffalo,W (36-35),20,39,51.3,321,1,37,187,5.1,3,76,508,6.7,11,11,4,26,11,82,2,1,3
11470,7,2014-10-11,bowling-green-state,@,Ohio,W (31-13),20,39,51.3,260,2,27,95,3.5,2,66,355,5.4,11,5,3,19,8,75,0,1,1
11471,8,2014-10-18,bowling-green-state,,Western Michigan,L (14-26),20,33,60.6,139,0,31,135,4.4,2,64,274,4.3,7,6,1,14,5,40,1,1,2
11472,9,2014-11-04,bowling-green-state,@,Akron,W (27-10),17,34,50.0,170,1,51,219,4.3,1,85,389,4.6,7,11,3,21,9,61,1,0,1
11473,10,2014-11-12,bowling-green-state,,Kent State,W (30-20),22,36,61.1,315,1,60,207,3.5,2,96,522,5.4,12,12,3,27,10,66,1,1,2
11474,11,2014-11-19,bowling-green-state,@,Toledo,L (20-27),12,37,32.4,167,1,38,104,2.7,1,75,271,3.6,8,7,2,17,9,61,0,0,0
11475,12,2014-11-28,bowling-green-state,,Ball State,L (24-41),18,27,66.7,140,0,39,314,8.1,2,66,454,6.9,8,9,1,18,6,36,0,0,0
11476,13,2014-12-05,bowling-green-state,N,Northern Illinois,L (17-51),13,25,52.0,163,1,35,124,3.5,1,60,287,4.8,8,4,1,13,2,5,1,3,4
11477,14,2014-12-20,bowling-green-state,N,South Alabama*,W (33-28),26,41,63.4,369,2,49,131,2.7,2,90,500,5.6,14,7,3,24,8,79,1,0,1
11478,,14 Games,bowling-green-state,,,,317,547,58.0,3639,17,556,2422,4.4,30,1103,6061,5.5,158,120,33,311,110,872,10,13,23
11479,1,2015-09-05,bowling-green-state,N,Tennessee,L (30-59),29,51,56.9,433,2,34,124,3.6,1,85,557,6.6,16,7,1,24,12,128,1,0,1
11480,2,2015-09-12,bowling-green-state,@,Maryland,W (48-27),36,55,65.5,491,6,50,201,4.0,1,105,692,6.6,19,13,3,35,10,80,0,1,1
11481,3,2015-09-19,bowling-green-state,,Memphis,L (41-44),28,45,62.2,443,4,29,136,4.7,2,74,579,7.8,14,8,2,24,10,92,0,0,0
11482,4,2015-09-26,bowling-green-state,@,Purdue,W (35-28),43,59,72.9,402,1,33,137,4.2,4,92,539,5.9,22,12,5,39,10,98,1,1,2
11483,5,2015-10-03,bowling-green-state,@,Buffalo,W (28-22),23,29,79.3,324,1,42,212,5.0,3,71,536,7.5,12,11,2,25,7,70,0,0,0
11484,6,2015-10-10,bowling-green-state,,Massachusetts,W (62-38),37,45,82.2,519,5,46,206,4.5,3,91,725,8.0,22,12,3,37,10,113,0,1,1
11485,7,2015-10-17,bowling-green-state,,Akron,W (59-10),27,33,81.8,412,5,42,120,2.9,3,75,532,7.1,16,9,2,27,7,64,0,0,0
11486,8,2015-10-24,bowling-green-state,@,Kent State,W (48-0),29,45,64.4,449,5,46,153,3.3,1,91,602,6.6,18,10,3,31,8,85,0,0,0
11487,9,2015-11-04,bowling-green-state,,Ohio,W (62-24),29,39,74.4,399,5,30,182,6.1,3,69,581,8.4,16,11,2,29,9,66,0,0,0
11488,10,2015-11-11,bowling-green-state,@,Western Michigan,W (41-27),23,41,56.1,269,3,41,236,5.8,3,82,505,6.2,13,14,1,28,6,38,0,1,1
11489,11,2015-11-17,bowling-green-state,,Toledo,L (28-44),28,46,60.9,274,3,30,94,3.1,1,76,368,4.8,13,10,5,28,8,85,3,2,5
11490,12,2015-11-24,bowling-green-state,@,Ball State,W (48-10),26,35,74.3,239,2,37,337,9.1,5,72,576,8.0,10,11,1,22,6,45,0,0,0
11491,13,2015-12-04,bowling-green-state,N,Northern Illinois,W (34-14),25,37,67.6,235,2,53,266,5.0,3,90,501,5.6,10,13,2,25,13,110,0,2,2
11492,14,2015-12-23,bowling-green-state,N,Georgia Southern*,L (27-58),15,34,44.1,246,3,29,116,4.0,1,63,362,5.7,10,3,2,15,7,59,2,0,2
11493,,14 Games,bowling-green-state,,,,398,594,67.0,5135,47,542,2520,4.6,34,1136,7655,6.7,211,144,34,389,123,1133,7,8,15
11494,1,2016-09-03,bowling-green-state,@,Ohio State,L (10-77),21,44,47.7,175,0,28,69,2.5,0,72,244,3.4,10,4,2,16,5,45,0,3,3
11495,2,2016-09-10,bowling-green-state,,North Dakota,W (27-26),24,42,57.1,327,3,33,90,2.7,1,75,417,5.6,12,9,1,22,5,40,0,3,3
11496,3,2016-09-17,bowling-green-state,,Middle Tennessee State,L (21-41),18,32,56.3,129,0,61,304,5.0,3,93,433,4.7,6,17,1,24,8,79,2,2,4
11497,4,2016-09-24,bowling-green-state,@,Memphis,L (3-77),24,48,50.0,203,0,28,91,3.3,0,76,294,3.9,9,3,2,14,4,59,0,4,4
11498,5,2016-10-01,bowling-green-state,,Eastern Michigan,L (25-28),23,47,48.9,250,1,42,206,4.9,2,89,456,5.1,14,11,4,29,4,48,0,1,1
11499,6,2016-10-08,bowling-green-state,@,Ohio,L (24-30),22,38,57.9,253,2,39,114,2.9,1,77,367,4.8,12,9,3,24,7,71,1,3,4
11500,7,2016-10-15,bowling-green-state,@,Toledo,L (35-42),25,38,65.8,335,5,34,167,4.9,0,72,502,7.0,12,10,2,24,10,83,0,1,1
11501,8,2016-10-22,bowling-green-state,,Miami (OH),L (26-40),30,49,61.2,389,3,23,57,2.5,0,72,446,6.2,16,4,6,26,10,104,1,3,4
11502,9,2016-11-01,bowling-green-state,@,Northern Illinois,L (20-45),21,43,48.8,224,3,35,90,2.6,0,78,314,4.0,14,6,2,20,9,84,0,2,2
11503,10,2016-11-09,bowling-green-state,@,Akron,W (38-28),11,23,47.8,105,0,46,218,4.7,4,69,323,4.7,13,4,1,18,4,43,1,1,2
11504,11,2016-11-15,bowling-green-state,,Kent State,W (42-7),12,24,50.0,177,2,66,420,6.4,4,90,597,6.6,10,22,3,35,4,40,1,2,3
11505,12,2016-11-25,bowling-green-state,,Buffalo,W (27-19),12,21,57.1,146,0,67,346,5.2,3,88,492,5.6,10,17,0,27,0,0,2,0,2
11506,,12 Games,bowling-green-state,,,,243,449,54.1,2713,19,502,2172,4.3,18,951,4885,5.1,138,116,27,279,70,696,8,25,33
11507,1,2017-09-02,bowling-green-state,@,Michigan State,L (10-35),10,31,32.3,145,0,24,67,2.8,0,55,212,3.9,6,3,0,9,4,20,0,1,1
11508,2,2017-09-09,bowling-green-state,,South Dakota,L (27-35),20,49,40.8,311,2,34,161,4.7,0,83,472,5.7,13,7,3,23,14,155,2,1,3
11509,3,2017-09-16,bowling-green-state,@,Northwestern,L (7-49),27,44,61.4,256,0,30,96,3.2,1,74,352,4.8,14,6,1,21,3,15,1,0,1
11510,4,2017-09-23,bowling-green-state,@,Middle Tennessee State,L (13-24),21,35,60.0,283,1,29,41,1.4,0,64,324,5.1,11,3,0,14,6,50,0,0,0
11511,5,2017-09-30,bowling-green-state,,Akron,L (23-34),25,39,64.1,195,2,41,181,4.4,1,80,376,4.7,6,11,0,17,8,77,2,2,4
11512,6,2017-10-07,bowling-green-state,@,Miami (OH),W (37-29),12,26,46.2,230,3,41,275,6.7,1,67,505,7.5,7,14,5,26,10,95,0,1,1
11513,7,2017-10-14,bowling-green-state,,Ohio,L (30-48),17,43,39.5,192,1,47,229,4.9,2,90,421,4.7,10,10,2,22,5,55,2,2,4
11514,8,2017-10-21,bowling-green-state,,Northern Illinois,L (17-48),13,23,56.5,175,1,44,192,4.4,1,67,367,5.5,8,9,1,18,6,53,2,3,5
11515,9,2017-10-31,bowling-green-state,@,Kent State,W (44-16),14,19,73.7,174,2,46,227,4.9,3,65,401,6.2,7,10,1,18,10,73,0,0,0
11516,10,2017-11-07,bowling-green-state,@,Buffalo,L (28-38),28,43,65.1,294,3,30,100,3.3,1,73,394,5.4,11,8,2,21,6,54,3,0,3
11517,11,2017-11-15,bowling-green-state,,Toledo,L (37-66),18,31,58.1,309,4,33,82,2.5,1,64,391,6.1,13,4,3,21,9,102,0,1,1
11518,12,2017-11-21,bowling-green-state,@,Eastern Michigan,L (31-34),21,34,61.8,256,2,31,209,6.7,2,65,465,7.2,11,8,3,22,8,78,1,1,2
11519,,12 Games,bowling-green-state,,,,226,417,54.2,2820,21,430,1860,4.3,13,847,4680,5.5,117,93,21,232,89,827,13,12,25
11520,1,2018-09-01,bowling-green-state,@,Oregon,L (24-58),22,38,57.9,253,3,49,155,3.2,0,87,408,4.7,14,8,0,22,5,50,1,2,3
11521,2,2018-09-08,bowling-green-state,,Maryland,L (14-45),17,27,63.0,143,2,28,15,0.5,0,55,158,2.9,6,4,3,13,10,66,0,1,1
11522,3,2018-09-15,bowling-green-state,,Eastern Kentucky,W (42-35),28,40,70.0,258,3,40,130,3.3,2,80,388,4.9,15,7,4,26,8,69,0,1,1
11523,4,2018-09-22,bowling-green-state,,Miami (OH),L (23-38),33,50,66.0,300,3,34,85,2.5,0,84,385,4.6,15,10,4,29,7,57,1,0,1
11524,5,2018-09-29,bowling-green-state,@,Georgia Tech,L (17-63),29,49,59.2,330,1,38,63,1.7,1,87,393,4.5,17,7,1,25,5,26,1,2,3
11525,6,2018-10-06,bowling-green-state,@,Toledo,L (36-52),18,34,52.9,289,3,29,192,6.6,2,63,481,7.6,10,7,3,20,14,129,1,0,1
11526,7,2018-10-13,bowling-green-state,,Western Michigan,L (35-42),21,35,60.0,379,3,21,132,6.3,2,56,511,9.1,13,3,3,19,9,85,2,2,4
11527,8,2018-10-20,bowling-green-state,@,Ohio,L (14-49),19,24,79.2,214,2,26,100,3.8,0,50,314,6.3,9,4,0,13,7,78,1,1,2
11528,9,2018-10-30,bowling-green-state,,Kent State,L (28-35),21,38,55.3,231,3,39,86,2.2,0,77,317,4.1,11,5,2,18,11,85,0,1,1
11529,10,2018-11-10,bowling-green-state,@,Central Michigan,W (24-13),14,24,58.3,142,1,51,178,3.5,1,75,320,4.3,9,8,0,17,5,31,0,1,1
11530,11,2018-11-17,bowling-green-state,@,Akron,W (21-6),19,27,70.4,178,2,41,221,5.4,1,68,399,5.9,7,12,3,22,8,72,1,1,2
11531,,11 Games,bowling-green-state,,,,241,386,62.4,2717,26,396,1357,3.4,9,782,4074,5.2,126,75,23,224,89,748,8,12,20
11532,1,2014-08-28,northern-illinois,,Presbyterian,W (55-3),19,32,59.4,211,2,77,424,5.5,5,109,635,5.8,10,26,0,36,6,55,0,0,0
11533,2,2014-09-06,northern-illinois,@,Northwestern,W (23-15),13,23,56.5,180,2,55,221,4.0,1,78,401,5.1,7,10,3,20,8,75,0,0,0
11534,3,2014-09-13,northern-illinois,@,Nevada-Las Vegas,W (48-34),18,28,64.3,285,3,69,331,4.8,3,97,616,6.4,15,20,0,35,8,95,1,0,1
11535,4,2014-09-20,northern-illinois,@,Arkansas,L (14-52),19,31,61.3,180,2,32,123,3.8,0,63,303,4.8,8,8,1,17,9,67,1,0,1
11536,5,2014-10-04,northern-illinois,,Kent State,W (17-14),15,25,60.0,198,0,39,181,4.6,2,64,379,5.9,5,8,2,15,9,81,0,1,1
11537,6,2014-10-11,northern-illinois,,Central Michigan,L (17-34),18,33,54.5,231,2,33,110,3.3,0,66,341,5.2,10,7,2,19,3,34,0,1,1
11538,7,2014-10-18,northern-illinois,,Miami (OH),W (51-41),16,22,72.7,225,1,55,433,7.9,6,77,658,8.5,9,20,1,30,5,43,1,0,1
11539,8,2014-10-25,northern-illinois,@,Eastern Michigan,W (28-17),10,17,58.8,54,0,44,332,7.5,4,61,386,6.3,2,14,2,18,3,37,0,0,0
11540,9,2014-11-05,northern-illinois,@,Ball State,W (35-21),18,31,58.1,149,0,62,236,3.8,4,93,385,4.1,11,12,1,24,8,85,2,0,2
11541,10,2014-11-11,northern-illinois,,Toledo,W (27-24),14,22,63.6,190,1,46,226,4.9,2,68,416,6.1,7,10,0,17,5,34,0,0,0
11542,11,2014-11-18,northern-illinois,@,Ohio,W (21-14),16,24,66.7,184,2,41,141,3.4,1,65,325,5.0,8,10,1,19,6,85,1,0,1
11543,12,2014-11-28,northern-illinois,@,Western Michigan,W (31-21),9,20,45.0,159,1,34,196,5.8,3,54,355,6.6,5,10,0,15,3,22,2,0,2
11544,13,2014-12-05,northern-illinois,N,Bowling Green State,W (51-17),29,49,59.2,218,2,51,334,6.5,4,100,552,5.5,12,17,0,29,5,40,1,1,2
11545,14,2014-12-23,northern-illinois,N,Marshall*,L (23-52),15,28,53.6,225,1,50,200,4.0,1,78,425,5.4,12,11,2,25,4,41,0,0,0
11546,,14 Games,northern-illinois,,,,229,385,59.5,2689,19,688,3488,5.1,36,1073,6177,5.8,121,183,15,319,82,794,9,3,12
11547,1,2015-09-05,northern-illinois,,Nevada-Las Vegas,W (38-30),21,26,80.8,360,2,42,185,4.4,3,68,545,8.0,13,11,0,24,7,55,0,0,0
11548,2,2015-09-12,northern-illinois,,Murray State,W (57-26),31,41,75.6,389,4,43,254,5.9,3,84,643,7.7,18,11,1,30,5,58,2,0,2
11549,3,2015-09-19,northern-illinois,@,Ohio State,L (13-20),14,31,45.2,80,0,43,110,2.6,1,74,190,2.6,4,6,0,10,5,31,0,2,2
11550,4,2015-09-26,northern-illinois,@,Boston College,L (14-17),11,25,44.0,81,0,31,72,2.3,1,56,153,2.7,4,4,2,10,7,45,1,1,2
11551,5,2015-10-03,northern-illinois,@,Central Michigan,L (19-29),12,30,40.0,105,0,59,211,3.6,2,89,316,3.6,6,11,0,17,8,69,3,1,4
11552,6,2015-10-10,northern-illinois,,Ball State,W (59-41),29,32,90.6,363,2,59,273,4.6,6,91,636,7.0,18,16,1,35,5,86,1,0,1
11553,7,2015-10-17,northern-illinois,@,Miami (OH),W (45-12),17,26,65.4,203,1,37,311,8.4,5,63,514,8.2,9,12,0,21,2,32,2,0,2
11554,8,2015-10-24,northern-illinois,,Eastern Michigan,W (49-21),24,38,63.2,267,4,59,324,5.5,3,97,591,6.1,11,20,3,34,8,70,0,0,0
11555,9,2015-11-03,northern-illinois,@,Toledo,W (32-27),16,25,64.0,277,2,54,124,2.3,1,79,401,5.1,8,9,1,18,6,55,1,1,2
11556,10,2015-11-11,northern-illinois,@,Buffalo,W (41-30),15,24,62.5,190,2,67,334,5.0,3,91,524,5.8,8,16,0,24,6,59,1,1,2
11557,11,2015-11-18,northern-illinois,,Western Michigan,W (27-19),11,23,47.8,158,2,43,289,6.7,2,66,447,6.8,8,9,2,19,5,39,0,1,1
11558,12,2015-11-24,northern-illinois,,Ohio,L (21-26),20,34,58.8,255,2,38,73,1.9,1,72,328,4.6,9,9,0,18,6,50,1,0,1
11559,13,2015-12-04,northern-illinois,N,Bowling Green State,L (14-34),12,28,42.9,152,1,38,107,2.8,0,66,259,3.9,6,9,2,17,6,49,2,3,5
11560,14,2015-12-23,northern-illinois,N,Boise State*,L (7-55),7,21,33.3,38,0,30,-5,-0.2,0,51,33,0.6,3,2,2,7,5,30,3,0,3
11561,,14 Games,northern-illinois,,,,240,404,59.4,2918,22,643,2662,4.1,31,1047,5580,5.3,125,145,14,284,81,728,17,10,27
11562,1,2016-09-03,northern-illinois,@,Wyoming,L (34-40),24,39,61.5,329,3,37,133,3.6,2,76,462,6.1,12,6,1,19,12,106,1,0,1
11563,2,2016-09-10,northern-illinois,@,South Florida,L (17-48),22,35,62.9,161,1,41,157,3.8,1,76,318,4.2,8,9,2,19,4,50,0,0,0
11564,3,2016-09-17,northern-illinois,,San Diego State,L (28-42),17,35,48.6,213,3,39,155,4.0,1,74,368,5.0,6,10,5,21,8,103,0,2,2
11565,4,2016-09-24,northern-illinois,,Western Illinois,L (23-28),25,37,67.6,251,2,41,301,7.3,1,78,552,7.1,9,13,3,25,10,93,0,1,1
11566,5,2016-10-01,northern-illinois,@,Ball State,W (31-24),26,41,63.4,298,2,46,355,7.7,2,87,653,7.5,16,13,1,30,6,60,2,1,3
11567,6,2016-10-08,northern-illinois,@,Western Michigan,L (30-45),15,31,48.4,233,1,42,251,6.0,2,73,484,6.6,9,13,3,25,6,64,0,2,2
11568,7,2016-10-15,northern-illinois,,Central Michigan,L (28-34),18,30,60.0,165,3,37,174,4.7,1,67,339,5.1,8,7,1,16,3,26,0,2,2
11569,8,2016-10-22,northern-illinois,,Buffalo,W (44-7),16,30,53.3,199,1,51,312,6.1,4,81,511,6.3,11,15,2,28,3,22,0,1,1
11570,9,2016-11-01,northern-illinois,,Bowling Green State,W (45-20),21,31,67.7,193,0,49,286,5.8,6,80,479,6.0,9,21,2,29,11,91,0,1,1
11571,10,2016-11-09,northern-illinois,N,Toledo,L (24-31),24,43,55.8,227,3,43,214,5.0,0,86,441,5.1,13,9,1,23,8,85,0,1,1
11572,11,2016-11-16,northern-illinois,@,Eastern Michigan,W (31-24),11,25,44.0,161,1,52,324,6.2,3,77,485,6.3,8,11,1,20,9,95,0,1,1
11573,12,2016-11-25,northern-illinois,@,Kent State,W (31-21),13,23,56.5,258,0,71,215,3.0,4,94,473,5.0,12,12,3,27,4,45,1,1,2
11574,,12 Games,northern-illinois,,,,232,400,58.0,2688,20,549,2877,5.2,27,949,5565,5.9,121,139,25,282,84,840,4,13,17
11575,1,2017-09-01,northern-illinois,,Boston College,L (20-23),16,39,41.0,203,2,35,164,4.7,0,74,367,5.0,10,5,3,18,8,70,0,1,1
11576,2,2017-09-09,northern-illinois,,Eastern Illinois,W (38-10),24,35,68.6,269,3,47,230,4.9,2,82,499,6.1,11,12,3,26,15,194,2,1,3
11577,3,2017-09-16,northern-illinois,@,Nebraska,W (21-17),15,23,65.2,128,0,27,108,4.0,1,50,236,4.7,5,7,1,13,3,25,1,0,1
11578,4,2017-09-30,northern-illinois,@,San Diego State,L (28-34),23,38,60.5,262,3,44,156,3.5,1,82,418,5.1,11,9,3,23,4,42,1,3,4
11579,5,2017-10-07,northern-illinois,,Kent State,W (24-3),13,22,59.1,114,3,50,152,3.0,0,72,266,3.7,7,9,0,15,7,59,1,2,3
11580,6,2017-10-14,northern-illinois,@,Buffalo,W (14-13),20,31,64.5,224,1,55,219,4.0,1,86,443,5.2,11,15,2,28,3,35,2,0,2
11581,7,2017-10-21,northern-illinois,@,Bowling Green State,W (48-17),21,34,61.8,239,3,55,338,6.1,2,89,577,6.5,13,16,0,29,6,39,1,0,1
11582,8,2017-10-26,northern-illinois,,Eastern Michigan,W (30-27),23,40,57.5,278,2,36,114,3.2,2,76,392,5.2,10,6,2,18,9,72,1,0,1
11583,9,2017-11-02,northern-illinois,@,Toledo,L (17-27),24,44,54.5,245,0,40,185,4.6,2,84,430,5.1,12,11,2,25,7,45,0,2,2
11584,10,2017-11-09,northern-illinois,,Ball State,W (63-17),11,24,45.8,211,5,45,222,4.9,2,69,433,6.3,9,9,2,20,1,5,1,0,1
11585,11,2017-11-15,northern-illinois,,Western Michigan,W (35-31),6,11,54.5,64,1,49,248,5.1,3,60,312,5.2,2,13,2,17,7,65,3,0,3
11586,12,2017-11-24,northern-illinois,@,Central Michigan,L (24-31),20,36,55.6,128,1,40,137,3.4,1,76,265,3.5,8,9,2,19,7,60,0,2,2
11587,13,2017-12-26,northern-illinois,N,Duke*,L (14-36),15,28,53.6,234,1,29,65,2.2,1,57,299,5.2,6,5,2,13,3,11,0,0,0
11588,,13 Games,northern-illinois,,,,231,405,57.0,2599,25,552,2338,4.2,18,957,4937,5.2,115,126,24,264,80,722,13,11,24
11589,1,2018-09-01,northern-illinois,@,Iowa,L (7-33),15,26,57.7,110,1,36,101,2.8,0,62,211,3.4,6,8,1,15,7,65,1,1,2
11590,2,2018-09-08,northern-illinois,,Utah,L (6-17),18,33,54.5,111,0,43,117,2.7,0,76,228,3.0,6,8,1,15,4,43,1,1,2
11591,3,2018-09-15,northern-illinois,,Central Michigan,W (24-16),12,20,60.0,104,3,48,180,3.8,0,68,284,4.2,5,8,2,15,4,44,0,1,1
11592,4,2018-09-22,northern-illinois,@,Florida State,L (19-37),20,41,48.8,215,2,20,6,0.3,1,61,221,3.6,9,3,1,13,3,15,0,0,0
11593,5,2018-09-29,northern-illinois,@,Eastern Michigan,W (26-23),20,35,57.1,121,1,62,235,3.8,2,97,356,3.7,5,17,2,24,8,68,1,2,3
11594,6,2018-10-06,northern-illinois,@,Ball State,W (24-16),18,29,62.1,143,1,43,227,5.3,2,72,370,5.1,10,13,0,23,6,38,0,1,1
11595,7,2018-10-13,northern-illinois,,Ohio,W (24-21),17,33,51.5,145,0,46,255,5.5,3,79,400,5.1,10,13,2,25,12,109,0,0,0
11596,8,2018-10-27,northern-illinois,@,Brigham Young,W (7-6),10,21,47.6,115,0,36,89,2.5,1,57,204,3.6,5,4,2,11,10,80,0,0,0
11597,9,2018-11-01,northern-illinois,@,Akron,W (36-26),21,28,75.0,188,1,61,296,4.9,2,89,484,5.4,12,20,2,34,7,85,1,0,1
11598,10,2018-11-07,northern-illinois,,Toledo,W (38-15),13,19,68.4,131,1,44,296,6.7,3,63,427,6.8,7,13,0,20,5,58,1,1,2
11599,11,2018-11-14,northern-illinois,,Miami (OH),L (7-13),15,33,45.5,157,0,37,212,5.7,1,70,369,5.3,6,8,1,15,9,90,1,1,2
11600,,11 Games,northern-illinois,,,,179,318,56.3,1540,10,476,2014,4.2,15,794,3554,4.5,81,115,14,210,75,695,6,8,14
11601,1,2014-08-30,western-michigan,@,Purdue,L (34-43),23,41,56.1,243,2,32,213,6.7,3,73,456,6.2,13,10,1,24,5,35,0,1,1
11602,2,2014-09-13,western-michigan,@,Idaho,W (45-33),10,15,66.7,241,3,44,243,5.5,3,59,484,8.2,8,11,3,22,10,93,0,0,0
11603,3,2014-09-20,western-michigan,,Murray State,W (45-14),20,29,69.0,228,1,54,377,7.0,5,83,605,7.3,13,17,0,30,7,50,0,1,1
11604,4,2014-09-27,western-michigan,@,Virginia Tech,L (17-35),18,33,54.5,212,0,24,19,0.8,2,57,231,4.1,6,3,1,10,7,85,1,1,2
11605,5,2014-10-04,western-michigan,,Toledo,L (19-20),31,38,81.6,388,1,32,62,1.9,1,70,450,6.4,16,4,0,20,3,30,0,0,0
11606,6,2014-10-11,western-michigan,@,Ball State,W (42-38),20,29,69.0,290,3,30,208,6.9,3,59,498,8.4,12,7,1,20,4,45,1,1,2
11607,7,2014-10-18,western-michigan,@,Bowling Green State,W (26-14),15,24,62.5,166,2,50,195,3.9,1,74,361,4.9,6,13,1,20,5,49,0,0,0
11608,8,2014-10-25,western-michigan,,Ohio,W (42-21),22,28,78.6,344,2,42,186,4.4,3,70,530,7.6,11,11,2,24,3,36,1,2,3
11609,9,2014-11-01,western-michigan,@,Miami (OH),W (41-10),18,23,78.3,217,1,47,282,6.0,4,70,499,7.1,9,13,1,23,5,65,1,0,1
11610,10,2014-11-15,western-michigan,,Eastern Michigan,W (51-7),18,20,90.0,360,4,42,137,3.3,2,62,497,8.0,11,9,1,21,1,10,0,0,0
11611,11,2014-11-22,western-michigan,@,Central Michigan,W (32-20),16,21,76.2,233,3,37,129,3.5,1,58,362,6.2,9,7,1,17,6,67,1,2,3
11612,12,2014-11-28,western-michigan,,Northern Illinois,L (21-31),23,33,69.7,256,1,43,91,2.1,1,76,347,4.6,12,8,1,21,4,30,4,2,6
11613,13,2014-12-20,western-michigan,N,Air Force*,L (24-38),19,38,50.0,297,3,26,79,3.0,0,64,376,5.9,12,4,1,17,9,70,1,0,1
11614,,13 Games,western-michigan,,,,253,372,68.0,3475,26,503,2221,4.4,29,875,5696,6.5,138,117,14,269,69,665,10,10,20
11615,1,2015-09-04,western-michigan,,Michigan State,L (24-37),33,50,66.0,365,2,23,18,0.8,0,73,383,5.2,18,2,2,22,8,77,0,2,2
11616,2,2015-09-12,western-michigan,@,Georgia Southern,L (17-43),24,36,66.7,227,2,26,25,1.0,0,62,252,4.1,14,5,0,19,6,37,1,3,4
11617,3,2015-09-19,western-michigan,,Murray State,W (52-20),28,33,84.8,391,4,42,237,5.6,2,75,628,8.4,16,16,1,33,6,69,2,0,2
11618,4,2015-09-26,western-michigan,@,Ohio State,L (12-38),18,33,54.5,169,2,41,169,4.1,0,74,338,4.6,7,11,2,20,8,74,0,1,1
11619,5,2015-10-10,western-michigan,,Central Michigan,W (41-39),15,22,68.2,262,4,41,215,5.2,1,63,477,7.6,11,11,2,24,5,46,1,0,1
11620,6,2015-10-17,western-michigan,@,Ohio,W (49-14),14,20,70.0,137,3,44,430,9.8,4,64,567,8.9,6,16,1,23,6,70,0,0,0
11621,7,2015-10-24,western-michigan,,Miami (OH),W (35-13),25,32,78.1,278,3,47,143,3.0,2,79,421,5.3,14,9,2,25,5,38,0,0,0
11622,8,2015-10-29,western-michigan,@,Eastern Michigan,W (58-28),18,24,75.0,316,1,36,279,7.8,6,60,595,9.9,13,13,0,26,3,27,0,0,0
11623,9,2015-11-05,western-michigan,,Ball State,W (54-7),20,27,74.1,353,3,56,358,6.4,4,83,711,8.6,15,15,1,31,6,62,1,0,1
11624,10,2015-11-11,western-michigan,,Bowling Green State,L (27-41),24,40,60.0,282,0,45,205,4.6,3,85,487,5.7,12,15,0,27,5,45,1,1,2
11625,11,2015-11-18,western-michigan,@,Northern Illinois,L (19-27),22,39,56.4,353,2,44,139,3.2,0,83,492,5.9,14,10,0,24,8,81,1,1,2
11626,12,2015-11-27,western-michigan,@,Toledo,W (35-30),13,21,61.9,268,2,40,148,3.7,2,61,416,6.8,8,6,2,16,6,65,1,0,1
11627,13,2015-12-24,western-michigan,N,Middle Tennessee State*,W (45-31),19,27,70.4,331,2,41,282,6.9,4,68,613,9.0,8,10,0,18,9,62,0,1,1
11628,,13 Games,western-michigan,,,,273,404,67.6,3732,30,526,2648,5.0,28,930,6380,6.9,156,139,13,308,81,753,8,9,17
11629,1,2016-09-03,western-michigan,@,Northwestern,W (22-21),26,36,72.2,218,1,48,198,4.1,1,84,416,5.0,12,15,0,27,3,30,0,0,0
11630,2,2016-09-10,western-michigan,,North Carolina Central,W (70-21),15,23,65.2,255,4,61,359,5.9,5,84,614,7.3,8,22,1,31,7,82,0,0,0
11631,3,2016-09-17,western-michigan,@,Illinois,W (34-10),9,13,69.2,150,0,54,287,5.3,4,67,437,6.5,6,11,3,20,5,36,0,0,0
11632,4,2016-09-24,western-michigan,,Georgia Southern,W (49-31),18,27,66.7,270,4,37,137,3.7,1,64,407,6.4,9,10,2,21,7,68,0,0,0
11633,5,2016-10-01,western-michigan,@,Central Michigan,W (49-10),15,21,71.4,170,3,41,254,6.2,3,62,424,6.8,7,13,2,22,3,30,0,0,0
11634,6,2016-10-08,western-michigan,,Northern Illinois,W (45-30),18,24,75.0,327,3,50,246,4.9,3,74,573,7.7,11,15,2,28,6,62,0,0,0
11635,7,2016-10-15,western-michigan,@,Akron,W (41-0),21,31,67.7,207,2,56,378,6.8,4,87,585,6.7,10,20,1,31,4,41,1,0,1
11636,8,2016-10-22,western-michigan,,Eastern Michigan,W (45-31),29,35,82.9,398,3,38,163,4.3,3,73,561,7.7,18,10,1,29,6,65,1,1,2
11637,9,2016-11-01,western-michigan,@,Ball State,W (52-20),23,34,67.6,367,3,28,186,6.6,3,62,553,8.9,16,10,0,26,2,10,0,0,0
11638,10,2016-11-08,western-michigan,@,Kent State,W (37-21),6,13,46.2,83,0,64,329,5.1,4,77,412,5.4,4,20,2,26,4,24,1,0,1
11639,11,2016-11-19,western-michigan,,Buffalo,W (38-0),29,37,78.4,445,4,34,181,5.3,1,71,626,8.8,17,11,1,29,3,20,1,0,1
11640,12,2016-11-25,western-michigan,,Toledo,W (55-35),19,25,76.0,196,3,48,249,5.2,3,73,445,6.1,12,11,2,25,7,88,0,0,0
11641,13,2016-12-02,western-michigan,N,Ohio,W (29-23),19,31,61.3,290,2,44,114,2.6,0,75,404,5.4,10,10,0,20,10,76,0,2,2
11642,14,2017-01-02,western-michigan,N,Wisconsin*,L (16-24),16,28,57.1,157,1,31,123,4.0,1,59,280,4.7,9,9,0,18,2,15,0,1,1
11643,,14 Games,western-michigan,,,,263,378,69.6,3533,33,634,3204,5.1,36,1012,6737,6.7,149,187,17,353,69,647,4,4,8
11644,1,2017-09-02,western-michigan,@,Southern California,L (31-49),12,23,52.2,94,1,48,263,5.5,2,71,357,5.0,5,15,4,24,6,34,0,1,1
11645,2,2017-09-09,western-michigan,@,Michigan State,L (14-28),12,27,44.4,79,0,36,116,3.2,0,63,195,3.1,4,7,0,11,3,20,0,1,1
11646,3,2017-09-16,western-michigan,,Idaho,W (37-28),21,31,67.7,212,1,42,135,3.2,3,73,347,4.8,10,10,0,20,6,70,1,0,1
11647,4,2017-09-23,western-michigan,,Wagner,W (49-14),11,12,91.7,165,3,51,362,7.1,4,63,527,8.4,6,16,1,23,10,92,2,0,2
11648,5,2017-09-30,western-michigan,,Ball State,W (55-3),15,21,71.4,245,3,43,169,3.9,3,64,414,6.5,12,9,0,21,5,50,0,0,0
11649,6,2017-10-07,western-michigan,@,Buffalo,W (71-68),24,31,77.4,269,6,68,376,5.5,4,99,645,6.5,13,20,0,33,10,95,0,2,2
11650,7,2017-10-15,western-michigan,,Akron,L (13-14),17,29,58.6,182,1,53,244,4.6,0,82,426,5.2,7,17,2,26,6,62,0,1,1
11651,8,2017-10-21,western-michigan,@,Eastern Michigan,W (20-17),18,27,66.7,202,1,42,220,5.2,1,69,422,6.1,12,10,3,25,6,47,2,0,2
11652,9,2017-11-01,western-michigan,,Central Michigan,L (28-35),6,18,33.3,42,0,54,315,5.8,4,72,357,5.0,2,14,1,17,6,54,3,1,4
11653,10,2017-11-08,western-michigan,,Kent State,W (48-20),8,19,42.1,97,0,50,292,5.8,3,69,389,5.6,7,9,2,18,3,29,1,0,1
11654,11,2017-11-15,western-michigan,@,Northern Illinois,L (31-35),15,27,55.6,211,2,44,110,2.5,2,71,321,4.5,7,9,1,17,3,35,1,0,1
11655,12,2017-11-24,western-michigan,@,Toledo,L (10-37),13,29,44.8,180,1,31,95,3.1,0,60,275,4.6,9,5,1,15,4,53,0,2,2
11656,,12 Games,western-michigan,,,,172,294,58.5,1978,19,562,2697,4.8,26,856,4675,5.5,94,141,15,250,68,641,10,8,18
11657,1,2018-08-31,western-michigan,,Syracuse,L (42-55),19,36,52.8,379,3,28,242,8.6,3,64,621,9.7,14,7,3,24,6,45,0,2,2
11658,2,2018-09-08,western-michigan,@,Michigan,L (3-49),16,34,47.1,85,0,40,123,3.1,0,74,208,2.8,5,9,3,17,4,30,0,1,1
11659,3,2018-09-15,western-michigan,,Delaware State,W (68-0),23,33,69.7,286,2,41,241,5.9,4,74,527,7.1,14,13,4,31,6,65,0,0,0
11660,4,2018-09-22,western-michigan,@,Georgia State,W (34-15),20,25,80.0,234,3,45,294,6.5,1,70,528,7.5,12,12,1,25,5,50,0,0,0
11661,5,2018-09-29,western-michigan,@,Miami (OH),W (40-39),27,42,64.3,439,5,37,123,3.3,1,79,562,7.1,20,7,4,31,9,96,2,0,2
11662,6,2018-10-06,western-michigan,,Eastern Michigan,W (27-24),16,27,59.3,235,1,41,152,3.7,3,68,387,5.7,10,8,0,18,10,67,1,1,2
11663,7,2018-10-13,western-michigan,@,Bowling Green State,W (42-35),22,37,59.5,286,2,54,282,5.2,4,91,568,6.2,11,18,4,33,5,67,0,2,2
11664,8,2018-10-20,western-michigan,@,Central Michigan,W (35-10),5,9,55.6,51,0,55,305,5.5,5,64,356,5.6,2,12,2,16,5,55,0,0,0
11665,9,2018-10-25,western-michigan,,Toledo,L (24-51),25,32,78.1,307,2,34,125,3.7,1,66,432,6.5,11,4,2,17,8,76,1,0,1
11666,10,2018-11-01,western-michigan,,Ohio,L (14-59),10,19,52.6,152,1,40,118,3.0,1,59,270,4.6,4,7,2,13,6,51,4,2,6
11667,11,2018-11-13,western-michigan,@,Ball State,L (41-42),20,29,69.0,187,1,67,361,5.4,4,96,548,5.7,11,19,3,33,6,50,1,0,1
11668,,11 Games,western-michigan,,,,203,323,62.8,2641,20,482,2366,4.9,27,805,5007,6.2,114,116,28,258,70,652,9,8,17
11669,1,2014-08-28,central-michigan,,Chattanooga,W (20-16),15,26,57.7,173,2,46,148,3.2,1,72,321,4.5,8,9,2,20,7,55,1,0,1
11670,2,2014-09-06,central-michigan,@,Purdue,W (38-17),11,16,68.8,172,2,43,161,3.7,2,59,333,5.6,5,12,2,19,1,5,0,1,1
11671,3,2014-09-13,central-michigan,,Syracuse,L (3-40),18,34,52.9,183,0,23,34,1.5,0,57,217,3.8,10,3,1,14,5,49,2,0,2
11672,4,2014-09-20,central-michigan,@,Kansas,L (10-24),18,26,69.2,178,0,35,101,2.9,1,61,279,4.6,10,6,2,18,5,43,2,1,3
11673,5,2014-09-27,central-michigan,@,Toledo,L (28-42),24,31,77.4,291,2,26,95,3.7,2,57,386,6.8,13,6,1,20,3,35,1,1,2
11674,6,2014-10-04,central-michigan,,Ohio,W (28-10),17,27,63.0,233,2,52,234,4.5,2,79,467,5.9,8,16,1,25,7,62,1,0,1
11675,7,2014-10-11,central-michigan,@,Northern Illinois,W (34-17),20,31,64.5,269,2,46,283,6.2,2,77,552,7.2,16,12,2,30,3,29,0,1,1
11676,8,2014-10-18,central-michigan,,Ball State,L (29-32),20,32,62.5,245,3,37,181,4.9,1,69,426,6.2,12,10,2,24,10,91,3,2,5
11677,9,2014-10-25,central-michigan,@,Buffalo,W (20-14),14,24,58.3,231,1,49,110,2.2,2,73,341,4.7,11,8,2,21,8,49,1,1,2
11678,10,2014-11-01,central-michigan,@,Eastern Michigan,W (38-7),18,23,78.3,223,1,55,278,5.1,4,78,501,6.4,13,14,0,27,5,41,1,1,2
11679,11,2014-11-15,central-michigan,,Miami (OH),W (34-27),16,23,69.6,218,3,40,209,5.2,2,63,427,6.8,10,12,1,23,5,38,1,1,2
11680,12,2014-11-22,central-michigan,,Western Michigan,L (20-32),24,44,54.5,248,2,23,70,3.0,0,67,318,4.7,12,3,4,19,3,30,1,3,4
11681,13,2014-12-24,central-michigan,N,Western Kentucky*,L (48-49),28,45,62.2,493,7,29,114,3.9,0,74,607,8.2,20,6,2,28,8,77,0,1,1
11682,,13 Games,central-michigan,,,,243,382,63.6,3157,27,504,2018,4.0,19,886,5175,5.8,148,117,22,288,70,604,14,13,27
11683,1,2015-09-03,central-michigan,,Oklahoma State,L (13-24),29,42,69.0,265,0,28,78,2.8,1,70,343,4.9,12,5,1,18,6,30,0,1,1
11684,2,2015-09-12,central-michigan,,Monmouth,W (31-10),25,36,69.4,328,3,34,74,2.2,1,70,402,5.7,15,6,1,22,7,75,0,1,1
11685,3,2015-09-19,central-michigan,@,Syracuse,L (27-30),37,51,72.5,430,2,40,90,2.3,1,91,520,5.7,19,9,2,30,5,44,1,1,2
11686,4,2015-09-26,central-michigan,@,Michigan State,L (10-30),26,39,66.7,285,1,26,55,2.1,0,65,340,5.2,12,2,3,17,9,70,1,0,1
11687,5,2015-10-03,central-michigan,,Northern Illinois,W (29-19),16,32,50.0,182,2,34,93,2.7,1,66,275,4.2,10,4,1,15,1,5,0,1,1
11688,6,2015-10-10,central-michigan,@,Western Michigan,L (39-41),23,32,71.9,321,4,31,161,5.2,1,63,482,7.7,14,9,1,24,8,75,1,1,2
11689,7,2015-10-17,central-michigan,,Buffalo,W (51-14),23,30,76.7,313,4,45,150,3.3,3,75,463,6.2,16,7,2,25,9,87,0,1,1
11690,8,2015-10-24,central-michigan,@,Ball State,W (23-21),30,39,76.9,316,2,31,118,3.8,0,70,434,6.2,13,5,2,20,10,55,1,1,2
11691,9,2015-10-31,central-michigan,@,Akron,W (14-6),23,37,62.2,226,2,24,39,1.6,0,61,265,4.3,11,3,2,16,5,44,0,1,1
11692,10,2015-11-10,central-michigan,,Toledo,L (23-28),33,53,62.3,354,2,20,59,3.0,0,73,413,5.7,14,5,2,21,5,63,0,1,1
11693,11,2015-11-18,central-michigan,@,Kent State,W (27-14),20,34,58.8,337,1,44,105,2.4,2,78,442,5.7,15,6,0,21,2,20,0,0,0
11694,12,2015-11-27,central-michigan,,Eastern Michigan,W (35-28),26,40,65.0,408,2,35,175,5.0,3,75,583,7.8,17,10,1,28,11,105,1,1,2
11695,13,2015-12-28,central-michigan,N,Minnesota*,L (14-21),15,30,50.0,145,0,28,104,3.7,2,58,249,4.3,7,10,0,17,3,25,0,1,1
11696,,13 Games,central-michigan,,,,326,495,65.9,3910,25,420,1301,3.1,15,915,5211,5.7,175,81,18,274,81,698,5,11,16
11697,1,2016-09-01,central-michigan,,Presbyterian,W (49-3),16,27,59.3,237,1,38,255,6.7,5,65,492,7.6,8,12,3,23,7,56,0,2,2
11698,2,2016-09-10,central-michigan,@,Oklahoma State,W (30-27),31,43,72.1,368,4,26,50,1.9,0,69,418,6.1,15,6,2,23,5,60,1,1,2
11699,3,2016-09-17,central-michigan,,Nevada-Las Vegas,W (44-21),20,35,57.1,352,6,34,147,4.3,0,69,499,7.2,15,5,3,23,4,40,1,0,1
11700,4,2016-09-24,central-michigan,@,Virginia,L (35-49),25,45,55.6,402,2,34,93,2.7,2,79,495,6.3,17,4,1,22,4,50,0,1,1
11701,5,2016-10-01,central-michigan,,Western Michigan,L (10-49),17,29,58.6,178,1,33,99,3.0,0,62,277,4.5,9,9,0,18,5,60,1,1,2
11702,6,2016-10-08,central-michigan,,Ball State,W (24-21),21,32,65.6,269,1,37,153,4.1,1,69,422,6.1,12,4,2,18,7,68,0,0,0
11703,7,2016-10-15,central-michigan,@,Northern Illinois,W (34-28),19,35,54.3,254,3,50,230,4.6,2,85,484,5.7,11,13,1,25,4,50,1,2,3
11704,8,2016-10-22,central-michigan,@,Toledo,L (17-31),19,33,57.6,247,1,23,97,4.2,1,56,344,6.1,11,5,2,18,6,77,1,1,2
11705,9,2016-10-29,central-michigan,,Kent State,L (24-27),20,43,46.5,244,2,30,105,3.5,0,73,349,4.8,10,9,0,19,4,45,1,3,4
11706,10,2016-11-04,central-michigan,@,Miami (OH),L (17-37),21,32,65.6,242,0,23,50,2.2,2,55,292,5.3,9,4,2,15,4,45,1,1,2
11707,11,2016-11-15,central-michigan,,Ohio,W (27-20),25,32,78.1,268,2,31,18,0.6,1,63,286,4.5,11,4,1,16,5,48,1,0,1
11708,12,2016-11-22,central-michigan,@,Eastern Michigan,L (21-26),21,35,60.0,256,0,26,127,4.9,3,61,383,6.3,11,7,1,19,2,10,0,1,1
11709,13,2016-12-19,central-michigan,N,Tulsa*,L (10-55),25,50,50.0,272,0,22,83,3.8,1,72,355,4.9,14,4,1,19,5,40,0,3,3
11710,,13 Games,central-michigan,,,,280,471,59.4,3589,23,407,1507,3.7,18,878,5096,5.8,153,86,19,258,62,649,8,16,24
11711,1,2017-08-31,central-michigan,,Rhode Island,W (30-27),28,54,51.9,253,1,50,246,4.9,2,104,499,4.8,11,10,3,24,9,87,3,1,4
11712,2,2017-09-09,central-michigan,@,Kansas,W (45-27),28,37,75.7,467,5,35,123,3.5,1,72,590,8.2,16,7,3,26,9,80,1,0,1
11713,3,2017-09-16,central-michigan,@,Syracuse,L (17-41),23,46,50.0,277,2,34,105,3.1,0,80,382,4.8,11,7,4,22,5,38,1,2,3
11714,4,2017-09-23,central-michigan,,Miami (OH),L (14-31),20,39,51.3,228,1,38,117,3.1,1,77,345,4.5,10,6,3,19,6,80,0,2,2
11715,5,2017-09-30,central-michigan,@,Boston College,L (8-28),22,43,51.2,180,0,33,116,3.5,1,76,296,3.9,10,7,1,18,6,53,0,3,3
11716,6,2017-10-07,central-michigan,@,Ohio,W (26-23),25,35,71.4,249,2,30,69,2.3,1,65,318,4.9,12,3,3,18,8,78,0,1,1
11717,7,2017-10-14,central-michigan,,Toledo,L (10-30),17,38,44.7,182,1,21,62,3.0,0,59,244,4.1,9,3,0,12,2,18,0,2,2
11718,8,2017-10-21,central-michigan,@,Ball State,W (56-9),16,23,69.6,199,4,45,256,5.7,3,68,455,6.7,5,14,3,22,4,50,1,0,1
11719,9,2017-11-01,central-michigan,@,Western Michigan,W (35-28),12,31,38.7,243,2,32,175,5.5,3,63,418,6.6,7,6,2,15,6,57,2,0,2
11720,10,2017-11-08,central-michigan,,Eastern Michigan,W (42-30),11,18,61.1,155,3,42,177,4.2,2,60,332,5.5,5,7,0,12,5,55,1,0,1
11721,11,2017-11-14,central-michigan,@,Kent State,W (42-23),15,23,65.2,298,2,30,152,5.1,3,53,450,8.5,10,4,2,16,7,60,1,1,2
11722,12,2017-11-24,central-michigan,,Northern Illinois,W (31-24),20,39,51.3,247,3,33,139,4.2,1,72,386,5.4,10,4,2,16,9,87,0,1,1
11723,13,2017-12-22,central-michigan,N,Wyoming*,L (14-37),26,43,60.5,346,1,27,18,0.7,1,70,364,5.2,12,3,3,18,7,61,4,4,8
11724,,13 Games,central-michigan,,,,263,469,56.1,3324,27,450,1755,3.9,19,919,5079,5.5,128,81,29,238,83,804,14,17,31
11725,1,2018-09-01,central-michigan,@,Kentucky,L (20-35),17,27,63.0,137,0,39,118,3.0,1,66,255,3.9,3,7,1,11,12,106,0,0,0
11726,2,2018-09-08,central-michigan,,Kansas,L (7-31),18,32,56.3,177,1,28,103,3.7,0,60,280,4.7,7,5,0,12,6,52,2,4,6
11727,3,2018-09-15,central-michigan,@,Northern Illinois,L (16-24),18,33,54.5,158,1,46,164,3.6,1,79,322,4.1,11,10,0,21,4,31,1,1,2
11728,4,2018-09-22,central-michigan,,Maine,W (17-5),7,16,43.8,82,1,41,95,2.3,1,57,177,3.1,2,5,5,12,9,83,1,1,2
11729,5,2018-09-29,central-michigan,@,Michigan State,L (20-31),20,35,57.1,182,2,22,63,2.9,0,57,245,4.3,8,2,3,13,7,64,0,2,2
11730,6,2018-10-06,central-michigan,,Buffalo,L (24-34),14,33,42.4,172,2,35,168,4.8,1,68,340,5.0,9,8,2,19,10,60,0,4,4
11731,7,2018-10-13,central-michigan,,Ball State,L (23-24),11,23,47.8,127,1,50,261,5.2,1,73,388,5.3,5,15,3,23,11,115,0,0,0
11732,8,2018-10-20,central-michigan,,Western Michigan,L (10-35),11,28,39.3,122,0,44,147,3.3,1,72,269,3.7,5,9,1,15,7,59,1,2,3
11733,9,2018-10-27,central-michigan,@,Akron,L (10-17),19,39,48.7,169,0,49,131,2.7,1,88,300,3.4,9,9,0,18,7,75,1,0,1
11734,10,2018-11-03,central-michigan,@,Eastern Michigan,L (7-17),12,32,37.5,61,0,32,77,2.4,0,64,138,2.2,4,4,2,10,7,61,2,2,4
11735,11,2018-11-10,central-michigan,,Bowling Green State,L (13-24),11,21,52.4,94,1,29,72,2.5,1,50,166,3.3,6,4,1,11,2,13,1,1,2
11736,,11 Games,central-michigan,,,,158,319,49.5,1481,9,415,1399,3.4,8,734,2880,3.9,69,78,18,165,82,719,9,17,26
11737,1,2014-08-30,ball-state,,Colgate,W (30-10),20,32,62.5,203,2,53,311,5.9,1,85,514,6.0,11,15,3,29,5,60,0,1,1
11738,2,2014-09-06,ball-state,@,Iowa,L (13-17),15,30,50.0,129,0,36,90,2.5,0,66,219,3.3,5,6,2,13,6,45,1,0,1
11739,3,2014-09-13,ball-state,,Indiana State,L (20-27),24,46,52.2,266,1,37,95,2.6,1,83,361,4.3,13,7,0,20,5,58,1,0,1
11740,4,2014-09-20,ball-state,@,Toledo,L (23-34),15,27,55.6,176,2,42,175,4.2,0,69,351,5.1,11,10,2,23,4,40,0,0,0
11741,5,2014-10-04,ball-state,@,Army,L (24-33),18,26,69.2,173,1,25,157,6.3,2,51,330,6.5,10,4,1,15,4,36,1,1,2
11742,6,2014-10-11,ball-state,,Western Michigan,L (38-42),26,44,59.1,326,4,39,145,3.7,1,83,471,5.7,17,5,1,23,5,55,0,0,0
11743,7,2014-10-18,ball-state,@,Central Michigan,W (32-29),21,38,55.3,198,1,38,89,2.3,2,76,287,3.8,12,6,6,24,4,25,1,0,1
11744,8,2014-10-25,ball-state,,Akron,W (35-21),18,36,50.0,225,0,40,155,3.9,3,76,380,5.0,7,11,4,22,3,20,0,0,0
11745,9,2014-11-05,ball-state,,Northern Illinois,L (21-35),16,39,41.0,174,1,31,133,4.3,2,70,307,4.4,9,8,1,18,2,24,2,3,5
11746,10,2014-11-12,ball-state,@,Massachusetts,L (10-24),24,38,63.2,217,1,30,69,2.3,0,68,286,4.2,9,4,1,14,4,46,2,2,4
11747,11,2014-11-22,ball-state,,Eastern Michigan,W (45-30),15,24,62.5,217,3,38,223,5.9,2,62,440,7.1,10,8,1,19,5,55,0,0,0
11748,12,2014-11-28,ball-state,@,Bowling Green State,W (41-24),20,29,69.0,286,3,39,199,5.1,2,68,485,7.1,11,12,1,24,3,25,0,0,0
11749,,12 Games,ball-state,,,,232,409,56.7,2590,19,448,1841,4.1,16,857,4431,5.2,125,96,23,244,50,489,8,7,15
11750,1,2015-09-03,ball-state,,Virginia Military Institute,W (48-36),34,53,64.2,338,1,42,229,5.5,5,95,567,6.0,21,11,1,33,6,55,0,1,1
11751,2,2015-09-12,ball-state,@,Texas A&M,L (23-56),12,27,44.4,121,0,38,240,6.3,2,65,361,5.6,6,10,3,19,3,15,0,1,1
11752,3,2015-09-19,ball-state,@,Eastern Michigan,W (28-17),24,33,72.7,194,1,52,278,5.3,3,85,472,5.6,9,15,2,26,3,30,1,0,1
11753,4,2015-09-26,ball-state,@,Northwestern,L (19-24),14,35,40.0,178,2,34,181,5.3,0,69,359,5.2,7,8,2,17,2,10,1,0,1
11754,5,2015-10-03,ball-state,,Toledo,L (10-24),23,37,62.2,236,1,30,26,0.9,0,67,262,3.9,9,4,6,19,3,35,1,0,1
11755,6,2015-10-10,ball-state,@,Northern Illinois,L (41-59),31,53,58.5,393,4,35,110,3.1,1,88,503,5.7,19,9,2,30,3,40,0,1,1
11756,7,2015-10-17,ball-state,,Georgia State,L (19-31),28,48,58.3,218,2,40,154,3.9,0,88,372,4.2,11,12,1,24,6,65,0,1,1
11757,8,2015-10-24,ball-state,,Central Michigan,L (21-23),25,40,62.5,187,1,29,112,3.9,1,69,299,4.3,9,7,1,17,5,50,1,0,1
11758,9,2015-10-31,ball-state,,Massachusetts,W (20-10),20,32,62.5,275,1,44,152,3.5,1,76,427,5.6,14,7,3,24,3,25,1,1,2
11759,10,2015-11-05,ball-state,@,Western Michigan,L (7-54),12,27,44.4,78,1,25,74,3.0,0,52,152,2.9,2,4,1,7,4,45,0,1,1
11760,11,2015-11-17,ball-state,@,Ohio,L (31-48),16,34,47.1,247,2,30,174,5.8,2,64,421,6.6,8,9,1,18,5,45,1,0,1
11761,12,2015-11-24,ball-state,,Bowling Green State,L (10-48),24,40,60.0,154,1,38,110,2.9,0,78,264,3.4,7,7,1,15,1,10,0,3,3
11762,,12 Games,ball-state,,,,263,459,57.3,2619,17,437,1840,4.2,15,896,4459,5.0,122,103,24,249,44,425,6,9,15
11763,1,2016-09-02,ball-state,@,Georgia State,W (31-21),15,29,51.7,130,0,52,325,6.3,4,81,455,5.6,8,14,0,22,5,39,0,2,2
11764,2,2016-09-10,ball-state,@,Indiana,L (20-30),15,30,50.0,231,1,38,140,3.7,0,68,371,5.5,9,7,2,18,4,25,2,1,3
11765,3,2016-09-17,ball-state,,Eastern Kentucky,W (41-14),28,39,71.8,238,2,54,193,3.6,3,93,431,4.6,11,13,4,28,4,35,1,0,1
11766,4,2016-09-24,ball-state,@,Florida Atlantic,W (31-27),24,39,61.5,262,2,41,226,5.5,2,80,488,6.1,15,12,1,28,1,5,0,1,1
11767,5,2016-10-01,ball-state,,Northern Illinois,L (24-31),23,41,56.1,276,0,44,151,3.4,3,85,427,5.0,16,9,2,27,2,19,0,1,1
11768,6,2016-10-08,ball-state,@,Central Michigan,L (21-24),18,30,60.0,174,1,39,166,4.3,2,69,340,4.9,10,8,0,18,3,35,0,2,2
11769,7,2016-10-15,ball-state,@,Buffalo,W (31-21),12,22,54.5,212,0,59,356,6.0,4,81,568,7.0,9,14,2,25,5,45,1,2,3
11770,8,2016-10-22,ball-state,,Akron,L (25-35),23,34,67.6,187,1,44,256,5.8,2,78,443,5.7,8,20,0,28,4,40,0,1,1
11771,9,2016-11-01,ball-state,,Western Michigan,L (20-52),20,38,52.6,199,1,42,298,7.1,1,80,497,6.2,13,12,0,25,6,55,1,2,3
11772,10,2016-11-08,ball-state,,Eastern Michigan,L (41-48),30,51,58.8,393,3,34,149,4.4,3,85,542,6.4,16,9,1,26,6,49,3,2,5
11773,11,2016-11-16,ball-state,@,Toledo,L (19-37),33,49,67.3,260,2,32,133,4.2,0,81,393,4.9,15,7,1,23,4,45,1,0,1
11774,12,2016-11-22,ball-state,@,Miami (OH),L (20-21),22,34,64.7,188,1,40,247,6.2,1,74,435,5.9,9,16,1,26,4,34,0,1,1
11775,,12 Games,ball-state,,,,263,436,60.3,2750,14,519,2640,5.1,25,955,5390,5.6,139,141,14,294,48,426,9,15,24
11776,1,2017-09-02,ball-state,@,Illinois,L (21-24),21,34,61.8,204,1,51,171,3.4,2,85,375,4.4,8,12,1,21,2,25,1,1,2
11777,2,2017-09-09,ball-state,,Alabama-Birmingham,W (51-31),23,35,65.7,217,2,41,168,4.1,4,76,385,5.1,14,7,3,24,4,36,0,0,0
11778,3,2017-09-16,ball-state,,Tennessee Tech,W (28-13),23,31,74.2,238,3,33,228,6.9,1,64,466,7.3,14,6,0,20,4,45,1,2,3
11779,4,2017-09-23,ball-state,@,Western Kentucky,L (21-33),18,36,50.0,267,0,31,107,3.5,3,67,374,5.6,12,5,0,17,4,35,1,2,3
11780,5,2017-09-30,ball-state,@,Western Michigan,L (3-55),23,43,53.5,175,0,30,63,2.1,0,73,238,3.3,8,6,1,15,7,70,1,1,2
11781,6,2017-10-07,ball-state,@,Akron,L (3-31),24,46,52.2,221,0,44,155,3.5,0,90,376,4.2,11,11,0,22,1,15,0,3,3
11782,7,2017-10-21,ball-state,,Central Michigan,L (9-56),20,34,58.8,127,0,41,81,2.0,0,75,208,2.8,5,7,2,14,5,60,1,0,1
11783,8,2017-10-26,ball-state,,Toledo,L (17-58),18,37,48.6,105,0,46,204,4.4,2,83,309,3.7,6,6,4,16,3,25,0,0,0
11784,9,2017-11-02,ball-state,@,Eastern Michigan,L (14-56),11,21,52.4,169,2,41,157,3.8,0,62,326,5.3,7,10,2,19,7,53,1,1,2
11785,10,2017-11-09,ball-state,@,Northern Illinois,L (17-63),19,30,63.3,162,1,43,83,1.9,1,73,245,3.4,9,7,0,16,4,50,0,1,1
11786,11,2017-11-16,ball-state,,Buffalo,L (24-40),15,29,51.7,143,2,37,194,5.2,1,66,337,5.1,7,10,1,18,2,10,0,1,1
11787,12,2017-11-21,ball-state,,Miami (OH),L (7-28),13,29,44.8,98,0,56,293,5.2,1,85,391,4.6,6,17,0,23,6,55,1,2,3
11788,,12 Games,ball-state,,,,228,405,56.3,2126,11,494,1904,3.9,15,899,4030,4.5,107,104,14,225,49,479,7,14,21
11789,1,2018-08-30,ball-state,,Central Connecticut State,W (42-6),28,36,77.8,336,3,47,318,6.8,3,83,654,7.9,10,19,2,31,6,70,1,0,1
11790,2,2018-09-08,ball-state,@,Notre Dame,L (16-24),23,50,46.0,180,1,47,169,3.6,0,97,349,3.6,13,11,0,24,3,10,0,2,2
11791,3,2018-09-15,ball-state,@,Indiana,L (10-38),14,28,50.0,143,0,39,204,5.2,1,67,347,5.2,7,11,0,18,8,75,0,1,1
11792,4,2018-09-22,ball-state,,Western Kentucky,L (20-28),27,45,60.0,285,1,29,120,4.1,1,74,405,5.5,14,8,2,24,10,120,0,0,0
11793,5,2018-09-29,ball-state,,Kent State,W (52-24),32,52,61.5,446,4,42,160,3.8,3,94,606,6.4,19,7,6,32,11,91,1,1,2
11794,6,2018-10-06,ball-state,,Northern Illinois,L (16-24),32,56,57.1,260,0,40,131,3.3,1,96,391,4.1,17,6,3,26,2,16,1,0,1
11795,7,2018-10-13,ball-state,@,Central Michigan,W (24-23),20,27,74.1,202,1,51,157,3.1,2,78,359,4.6,10,11,5,26,8,80,1,0,1
11796,8,2018-10-20,ball-state,,Eastern Michigan,L (20-42),21,39,53.8,157,1,32,227,7.1,2,71,384,5.4,9,8,4,21,9,108,1,1,2
11797,9,2018-10-25,ball-state,@,Ohio,L (14-52),16,32,50.0,162,1,23,80,3.5,1,55,242,4.4,5,6,0,11,6,54,2,1,3
11798,10,2018-10-31,ball-state,@,Toledo,L (13-45),30,48,62.5,343,1,35,94,2.7,1,83,437,5.3,14,11,1,26,10,100,3,2,5
11799,11,2018-11-13,ball-state,,Western Michigan,W (42-41),22,27,81.5,282,3,26,71,2.7,3,53,353,6.7,14,7,1,22,6,49,0,2,2
11800,,11 Games,ball-state,,,,265,440,60.2,2796,16,411,1731,4.2,18,851,4527,5.3,132,105,24,261,79,773,10,10,20
11801,1,2014-08-30,ohio,@,Kent State,W (17-14),18,24,75.0,262,2,44,175,4.0,0,68,437,6.4,13,6,1,20,1,5,4,0,4
11802,2,2014-09-06,ohio,@,Kentucky,L (3-20),14,32,43.8,149,0,28,74,2.6,0,60,223,3.7,5,7,1,13,5,46,1,0,1
11803,3,2014-09-13,ohio,@,Marshall,L (14-44),22,38,57.9,236,2,32,141,4.4,0,70,377,5.4,11,10,1,22,8,75,1,1,2
11804,4,2014-09-20,ohio,,Idaho,W (36-24),12,19,63.2,233,1,47,272,5.8,3,66,505,7.7,8,10,1,19,9,64,1,0,1
11805,5,2014-09-27,ohio,,Eastern Illinois,W (34-19),17,31,54.8,158,0,41,229,5.6,4,72,387,5.4,6,11,3,20,6,60,0,2,2
11806,6,2014-10-04,ohio,@,Central Michigan,L (10-28),7,21,33.3,98,0,23,89,3.9,1,44,187,4.3,4,3,1,8,2,18,0,0,0
11807,7,2014-10-11,ohio,,Bowling Green State,L (13-31),34,64,53.1,386,0,46,127,2.8,1,110,513,4.7,18,7,4,29,16,153,2,0,2
11808,8,2014-10-18,ohio,,Akron,W (23-20),17,37,45.9,197,2,39,159,4.1,0,76,356,4.7,8,8,3,19,11,120,1,1,2
11809,9,2014-10-25,ohio,@,Western Michigan,L (21-42),20,36,55.6,284,1,36,88,2.4,2,72,372,5.2,11,6,1,18,6,48,1,1,2
11810,10,2014-11-05,ohio,,Buffalo,W (37-14),8,19,42.1,156,0,55,233,4.2,4,74,389,5.3,6,11,2,19,1,5,2,0,2
11811,11,2014-11-18,ohio,,Northern Illinois,L (14-21),19,28,67.9,141,1,39,203,5.2,1,67,344,5.1,6,15,3,24,4,30,1,1,2
11812,12,2014-11-25,ohio,@,Miami (OH),W (24-21),14,26,53.8,174,2,40,179,4.5,0,66,353,5.3,7,12,3,22,3,24,0,3,3
11813,,12 Games,ohio,,,,202,375,53.9,2474,11,470,1969,4.2,16,845,4443,5.3,103,106,24,233,72,648,14,9,23
11814,1,2015-09-03,ohio,@,Idaho,W (45-28),20,25,80.0,284,3,38,205,5.4,2,63,489,7.8,10,11,2,23,10,92,1,0,1
11815,2,2015-09-12,ohio,,Marshall,W (21-10),15,28,53.6,156,1,51,229,4.5,2,79,385,4.9,8,11,3,22,11,120,1,1,2
11816,3,2015-09-19,ohio,,Southeastern Louisiana,W (35-14),18,27,66.7,346,2,31,115,3.7,3,58,461,7.9,11,5,2,18,9,94,0,1,1
11817,4,2015-09-26,ohio,@,Minnesota,L (24-27),17,27,63.0,194,2,38,151,4.0,1,65,345,5.3,9,9,0,18,9,51,0,0,0
11818,5,2015-10-03,ohio,@,Akron,W (14-12),18,29,62.1,179,1,32,48,1.5,1,61,227,3.7,7,6,4,17,8,99,0,1,1
11819,6,2015-10-10,ohio,,Miami (OH),W (34-3),25,40,62.5,278,1,37,150,4.1,2,77,428,5.6,15,8,2,25,5,61,0,1,1
11820,7,2015-10-17,ohio,,Western Michigan,L (14-49),22,40,55.0,255,1,30,99,3.3,1,70,354,5.1,14,4,2,20,3,28,0,0,0
11821,8,2015-10-24,ohio,@,Buffalo,L (17-41),33,54,61.1,368,0,34,54,1.6,2,88,422,4.8,16,3,3,22,7,58,0,4,4
11822,9,2015-11-04,ohio,@,Bowling Green State,L (24-62),21,41,51.2,244,0,56,299,5.3,3,97,543,5.6,17,14,3,34,7,75,0,2,2
11823,10,2015-11-10,ohio,,Kent State,W (27-0),8,14,57.1,114,1,57,333,5.8,0,71,447,6.3,3,17,2,22,7,80,0,0,0
11824,11,2015-11-17,ohio,,Ball State,W (48-31),15,22,68.2,275,3,56,332,5.9,3,78,607,7.8,9,19,2,30,6,75,0,0,0
11825,12,2015-11-24,ohio,@,Northern Illinois,W (26-21),14,29,48.3,168,2,50,230,4.6,0,79,398,5.0,6,11,1,18,2,20,1,1,2
11826,13,2015-12-19,ohio,N,Appalachian State*,L (29-31),15,29,51.7,165,0,36,107,3.0,1,65,272,4.2,8,5,2,15,7,85,1,2,3
11827,,13 Games,ohio,,,,241,405,59.5,3026,17,546,2352,4.3,21,951,5378,5.7,133,123,28,284,91,938,4,13,17
11828,1,2016-09-03,ohio,,Texas State,L (54-56),28,46,60.9,393,4,51,237,4.6,2,97,630,6.5,12,11,2,25,13,141,2,0,2
11829,2,2016-09-10,ohio,@,Kansas,W (37-21),19,36,52.8,167,1,57,329,5.8,2,93,496,5.3,8,17,2,27,6,57,0,1,1
11830,3,2016-09-17,ohio,@,Tennessee,L (19-28),23,46,50.0,230,1,30,88,2.9,0,76,318,4.2,10,3,4,17,5,30,0,0,0
11831,4,2016-09-24,ohio,,Gardner-Webb,W (37-21),25,38,65.8,310,3,45,221,4.9,2,83,531,6.4,14,16,1,31,4,35,0,1,1
11832,5,2016-10-01,ohio,@,Miami (OH),W (17-7),7,18,38.9,56,0,49,141,2.9,1,67,197,2.9,3,10,5,18,3,29,0,1,1
11833,6,2016-10-08,ohio,,Bowling Green State,W (30-24),21,29,72.4,203,1,37,183,4.9,3,66,386,5.8,13,7,2,22,9,108,0,1,1
11834,7,2016-10-15,ohio,,Eastern Michigan,L (20-27),26,43,60.5,291,1,30,124,4.1,1,73,415,5.7,16,8,1,25,4,40,1,1,2
11835,8,2016-10-22,ohio,@,Kent State,W (14-10),11,19,57.9,127,0,36,208,5.8,2,55,335,6.1,3,10,0,13,8,83,2,1,3
11836,9,2016-10-27,ohio,@,Toledo,W (31-26),11,22,50.0,243,3,48,269,5.6,1,70,512,7.3,9,12,2,23,5,55,1,0,1
11837,10,2016-11-03,ohio,,Buffalo,W (34-10),12,22,54.5,216,2,39,156,4.0,2,61,372,6.1,7,10,1,18,5,59,0,0,0
11838,11,2016-11-15,ohio,@,Central Michigan,L (20-27),16,36,44.4,208,1,36,149,4.1,1,72,357,5.0,8,7,4,19,2,20,3,1,4
11839,12,2016-11-22,ohio,,Akron,W (9-3),14,25,56.0,169,0,35,132,3.8,0,60,301,5.0,7,8,2,17,8,66,1,0,1
11840,13,2016-12-02,ohio,N,Western Michigan,L (23-29),14,31,45.2,214,3,22,37,1.7,0,53,251,4.7,9,3,2,14,2,16,2,1,3
11841,14,2016-12-23,ohio,N,Troy*,L (23-28),23,47,48.9,315,2,30,78,2.6,0,77,393,5.1,12,6,5,23,5,33,1,4,5
11842,,14 Games,ohio,,,,250,458,54.6,3142,22,545,2352,4.3,17,1003,5494,5.5,131,128,33,292,79,772,13,12,25
11843,1,2017-09-02,ohio,,Hampton,W (59-0),13,19,68.4,172,1,53,248,4.7,7,72,420,5.8,6,14,2,22,6,54,0,1,1
11844,2,2017-09-08,ohio,@,Purdue,L (21-44),17,29,58.6,223,1,38,173,4.6,2,67,396,5.9,14,8,1,23,3,30,2,0,2
11845,3,2017-09-16,ohio,,Kansas,W (42-30),16,22,72.7,254,3,41,196,4.8,2,63,450,7.1,10,9,2,21,7,61,0,1,1
11846,4,2017-09-23,ohio,@,Eastern Michigan,W (27-20),19,31,61.3,197,2,46,171,3.7,0,77,368,4.8,8,9,2,19,4,36,2,0,2
11847,5,2017-09-30,ohio,@,Massachusetts,W (58-50),13,24,54.2,181,2,40,292,7.3,5,64,473,7.4,8,14,3,25,7,69,0,0,0
11848,6,2017-10-07,ohio,,Central Michigan,L (23-26),17,31,54.8,160,0,39,190,4.9,3,70,350,5.0,9,12,1,22,5,28,3,1,4
11849,7,2017-10-14,ohio,@,Bowling Green State,W (48-30),7,22,31.8,105,1,43,335,7.8,5,65,440,6.8,4,12,2,18,6,58,0,2,2
11850,8,2017-10-21,ohio,,Kent State,W (48-3),9,20,45.0,138,2,42,336,8.0,4,62,474,7.6,4,15,4,23,5,40,1,0,1
11851,9,2017-10-31,ohio,,Miami (OH),W (45-28),21,33,63.6,294,3,36,149,4.1,3,69,443,6.4,12,8,6,26,6,50,0,0,0
11852,10,2017-11-08,ohio,,Toledo,W (38-10),7,15,46.7,139,1,56,393,7.0,4,71,532,7.5,5,16,2,23,5,45,2,1,3
11853,11,2017-11-14,ohio,@,Akron,L (34-37),10,23,43.5,113,1,43,282,6.6,3,66,395,6.0,5,12,6,23,2,19,1,2,3
11854,12,2017-11-24,ohio,@,Buffalo,L (24-31),15,30,50.0,265,1,43,159,3.7,2,73,424,5.8,10,8,2,20,4,30,1,1,2
11855,13,2017-12-22,ohio,N,Alabama-Birmingham*,W (41-6),14,22,63.6,210,2,32,249,7.8,4,54,459,8.5,9,11,4,24,6,70,0,0,0
11856,,13 Games,ohio,,,,178,321,55.5,2451,20,552,3173,5.7,44,873,5624,6.4,104,148,37,289,66,590,12,9,21
11857,1,2018-09-01,ohio,,Howard,W (38-32),19,33,57.6,277,2,39,148,3.8,2,72,425,5.9,11,10,1,22,5,50,0,0,0
11858,2,2018-09-15,ohio,N,Virginia,L (31-45),16,31,51.6,246,2,30,118,3.9,2,61,364,6.0,9,4,0,13,5,35,2,0,2
11859,3,2018-09-22,ohio,@,Cincinnati,L (30-34),12,27,44.4,178,1,45,234,5.2,2,72,412,5.7,7,10,8,25,8,85,1,1,2
11860,4,2018-09-29,ohio,,Massachusetts,W (58-42),23,32,71.9,270,3,44,394,9.0,4,76,664,8.7,15,16,3,34,4,45,0,1,1
11861,5,2018-10-06,ohio,@,Kent State,W (27-26),18,20,90.0,284,1,38,130,3.4,3,58,414,7.1,13,8,4,25,6,61,3,1,4
11862,6,2018-10-13,ohio,@,Northern Illinois,L (21-24),15,23,65.2,275,2,32,46,1.4,1,55,321,5.8,9,3,7,19,6,59,2,1,3
11863,7,2018-10-20,ohio,,Bowling Green State,W (49-14),9,13,69.2,205,4,50,392,7.8,3,63,597,9.5,8,24,0,32,4,29,1,0,1
11864,8,2018-10-25,ohio,,Ball State,W (52-14),12,22,54.5,143,1,57,411,7.2,6,79,554,7.0,7,21,2,30,3,20,0,1,1
11865,9,2018-11-01,ohio,@,Western Michigan,W (59-14),13,19,68.4,164,3,41,256,6.2,4,60,420,7.0,10,13,1,24,8,75,0,0,0
11866,10,2018-11-07,ohio,@,Miami (OH),L (28-30),16,28,57.1,163,2,32,201,6.3,1,60,364,6.1,8,7,1,16,3,43,1,0,1
11867,11,2018-11-14,ohio,,Buffalo,W (52-17),17,27,63.0,209,3,56,437,7.8,4,83,646,7.8,8,23,1,32,4,55,0,1,1
11868,,11 Games,ohio,,,,170,275,61.8,2414,24,464,2767,6.0,32,739,5181,7.0,105,139,28,272,56,557,10,6,16
11869,1,2014-08-28,akron,,Howard,W (41-0),27,43,62.8,396,5,29,117,4.0,1,72,513,7.1,7,15,2,24,7,70,0,0,0
11870,2,2014-09-06,akron,@,Penn State,L (3-21),24,46,52.2,208,0,25,69,2.8,0,71,277,3.9,12,4,1,17,7,64,0,0,0
11871,3,2014-09-20,akron,,Marshall,L (17-48),25,52,48.1,251,1,23,92,4.0,1,75,343,4.6,10,8,7,25,10,94,2,2,4
11872,4,2014-09-27,akron,@,Pittsburgh,W (21-10),17,35,48.6,213,1,36,169,4.7,2,71,382,5.4,11,9,0,20,10,64,0,1,1
11873,5,2014-10-04,akron,,Eastern Michigan,W (31-6),33,50,66.0,355,2,31,197,6.4,2,81,552,6.8,17,10,0,27,15,124,0,0,0
11874,6,2014-10-11,akron,,Miami (OH),W (29-19),20,36,55.6,167,0,37,151,4.1,3,73,318,4.4,11,8,5,24,9,128,2,0,2
11875,7,2014-10-18,akron,@,Ohio,L (20-23),23,46,50.0,268,2,25,84,3.4,0,71,352,5.0,11,4,3,18,10,83,1,2,3
11876,8,2014-10-25,akron,@,Ball State,L (21-35),21,39,53.8,200,1,34,125,3.7,2,73,325,4.5,9,11,0,20,7,45,1,4,5
11877,9,2014-11-04,akron,,Bowling Green State,L (10-27),31,63,49.2,304,0,27,94,3.5,1,90,398,4.4,16,9,1,26,7,55,2,3,5
11878,10,2014-11-11,akron,@,Buffalo,L (24-55),19,35,54.3,161,0,30,68,2.3,2,65,229,3.5,7,8,0,15,9,98,2,0,2
11879,11,2014-11-18,akron,,Massachusetts,W (30-6),26,40,65.0,277,2,37,134,3.6,1,77,411,5.3,14,9,4,27,4,40,2,0,2
11880,12,2014-11-28,akron,@,Kent State,L (24-27),17,42,40.5,191,0,30,188,6.3,3,72,379,5.3,7,8,2,17,6,59,0,2,2
11881,,12 Games,akron,,,,283,527,53.7,2991,14,364,1488,4.1,18,891,4479,5.0,132,103,25,260,101,924,12,14,26
11882,1,2015-09-05,akron,@,Oklahoma,L (3-41),6,26,23.1,88,0,44,138,3.1,0,70,226,3.2,5,4,1,10,9,62,1,0,1
11883,2,2015-09-12,akron,,Pittsburgh,L (7-24),7,22,31.8,63,0,24,47,2.0,1,46,110,2.4,3,4,1,8,9,85,1,0,1
11884,3,2015-09-19,akron,,Savannah State,W (52-9),18,33,54.5,335,2,47,291,6.2,5,80,626,7.8,13,15,3,31,4,51,0,2,2
11885,4,2015-09-26,akron,@,Louisiana,W (35-14),13,29,44.8,238,2,42,220,5.2,3,71,458,6.5,7,11,4,22,11,92,0,1,1
11886,5,2015-10-03,akron,,Ohio,L (12-14),18,38,47.4,231,0,35,88,2.5,0,73,319,4.4,13,5,2,20,10,79,0,1,1
11887,6,2015-10-10,akron,@,Eastern Michigan,W (47-21),14,22,63.6,222,4,53,278,5.2,2,75,500,6.7,10,15,3,28,8,54,0,0,0
11888,7,2015-10-17,akron,@,Bowling Green State,L (10-59),15,30,50.0,104,1,42,167,4.0,0,72,271,3.8,6,9,1,16,9,85,2,2,4
11889,8,2015-10-31,akron,,Central Michigan,L (6-14),22,36,61.1,252,1,25,25,1.0,0,61,277,4.5,11,3,1,15,5,34,0,1,1
11890,9,2015-11-07,akron,@,Massachusetts,W (17-13),15,27,55.6,174,1,41,155,3.8,1,68,329,4.8,9,8,1,18,6,65,1,2,3
11891,10,2015-11-14,akron,@,Miami (OH),W (37-28),13,28,46.4,221,1,45,193,4.3,4,73,414,5.7,9,10,1,20,9,80,0,2,2
11892,11,2015-11-21,akron,,Buffalo,W (42-21),17,30,56.7,258,4,45,217,4.8,2,75,475,6.3,10,13,2,25,7,73,0,0,0
11893,12,2015-11-27,akron,,Kent State,W (20-0),11,19,57.9,140,1,51,229,4.5,1,70,369,5.3,11,11,4,26,7,60,1,0,1
11894,13,2015-12-22,akron,N,Utah State*,W (23-21),15,30,50.0,182,1,42,100,2.4,1,72,282,3.9,9,6,2,17,5,34,0,1,1
11895,,13 Games,akron,,,,184,370,49.7,2508,18,536,2148,4.0,20,906,4656,5.1,116,114,26,256,99,854,6,12,18
11896,1,2016-09-03,akron,,Virginia Military Institute,W (47-24),25,38,65.8,425,6,29,151,5.2,1,67,576,8.6,16,7,1,24,13,111,1,1,2
11897,2,2016-09-10,akron,@,Wisconsin,L (10-54),14,25,56.0,136,0,21,88,4.2,0,46,224,4.9,4,4,2,10,8,66,1,1,2
11898,3,2016-09-17,akron,@,Marshall,W (65-38),21,32,65.6,379,4,30,145,4.8,2,62,524,8.5,15,5,6,26,13,136,1,0,1
11899,4,2016-09-24,akron,,Appalachian State,L (38-45),31,43,72.1,353,3,26,133,5.1,2,69,486,7.0,18,9,3,30,9,72,0,2,2
11900,5,2016-10-01,akron,@,Kent State,W (31-27),11,28,39.3,237,2,32,141,4.4,2,60,378,6.3,11,6,1,18,6,64,1,2,3
11901,6,2016-10-08,akron,,Miami (OH),W (35-13),15,29,51.7,174,3,35,125,3.6,2,64,299,4.7,8,6,2,16,1,5,0,0,0
11902,7,2016-10-15,akron,,Western Michigan,L (0-41),13,31,41.9,153,0,28,130,4.6,0,59,283,4.8,6,10,1,17,9,47,0,2,2
11903,8,2016-10-22,akron,@,Ball State,W (35-25),28,41,68.3,352,3,30,177,5.9,2,71,529,7.5,14,9,3,26,8,51,1,0,1
11904,9,2016-10-27,akron,@,Buffalo,L (20-41),18,42,42.9,178,1,42,128,3.0,0,84,306,3.6,7,9,2,18,4,40,0,1,1
11905,10,2016-11-02,akron,,Toledo,L (17-48),18,36,50.0,348,2,25,96,3.8,0,61,444,7.3,12,8,1,21,5,63,0,2,2
11906,11,2016-11-09,akron,,Bowling Green State,L (28-38),11,24,45.8,197,1,50,177,3.5,2,74,374,5.1,8,5,1,14,8,85,3,3,6
11907,12,2016-11-22,akron,@,Ohio,L (3-9),12,27,44.4,131,0,32,95,3.0,0,59,226,3.8,7,5,2,14,7,67,0,0,0
11908,,12 Games,akron,,,,217,396,54.8,3063,25,380,1586,4.2,13,776,4649,6.0,126,83,25,234,91,807,8,14,22
11909,1,2017-09-02,akron,@,Penn State,L (0-52),14,29,48.3,86,0,34,73,2.1,0,63,159,2.5,7,4,1,12,9,84,0,1,1
11910,2,2017-09-09,akron,,Arkansas-Pine Bluff,W (52-3),17,26,65.4,197,1,44,267,6.1,5,70,464,6.6,9,15,3,27,11,130,0,0,0
11911,3,2017-09-16,akron,,Iowa State,L (14-41),27,44,61.4,293,2,24,38,1.6,0,68,331,4.9,13,4,2,19,7,79,1,2,3
11912,4,2017-09-23,akron,@,Troy,L (17-22),20,40,50.0,268,1,35,99,2.8,1,75,367,4.9,12,7,4,23,12,100,1,2,3
11913,5,2017-09-30,akron,@,Bowling Green State,W (34-23),14,25,56.0,183,2,40,178,4.5,2,65,361,5.6,7,10,2,19,1,5,2,1,3
11914,6,2017-10-07,akron,,Ball State,W (31-3),18,31,58.1,249,2,31,134,4.3,1,62,383,6.2,13,6,0,19,2,15,0,0,0
11915,7,2017-10-15,akron,@,Western Michigan,W (14-13),13,24,54.2,127,1,31,88,2.8,1,55,215,3.9,8,3,3,14,9,93,0,1,1
11916,8,2017-10-21,akron,@,Toledo,L (21-48),23,40,57.5,291,3,24,42,1.8,0,64,333,5.2,16,2,5,23,0,0,1,1,2
11917,9,2017-10-28,akron,,Buffalo,W (21-20),21,29,72.4,286,3,25,81,3.2,0,54,367,6.8,12,7,0,19,4,49,0,1,1
11918,10,2017-11-07,akron,@,Miami (OH),L (14-24),19,38,50.0,218,1,30,55,1.8,1,68,273,4.0,10,6,2,18,5,57,0,0,0
11919,11,2017-11-14,akron,,Ohio,W (37-34),22,38,57.9,322,4,32,121,3.8,1,70,443,6.3,11,7,0,18,16,167,0,0,0
11920,12,2017-11-21,akron,,Kent State,W (24-14),6,20,30.0,69,1,39,122,3.1,1,59,191,3.2,4,8,3,15,5,20,0,1,1
11921,13,2017-12-02,akron,N,Toledo,L (28-45),18,42,42.9,283,3,33,113,3.4,1,75,396,5.3,12,6,2,20,3,25,1,1,2
11922,14,2017-12-19,akron,@,Florida Atlantic*,L (3-50),10,21,47.6,77,0,37,69,1.9,0,58,146,2.5,3,5,4,12,4,49,0,0,0
11923,,14 Games,akron,,,,242,447,54.1,2949,24,459,1480,3.2,14,906,4429,4.9,137,90,31,258,88,873,6,11,17
11924,1,2018-09-08,akron,,Morgan State,W (41-7),18,31,58.1,237,3,39,200,5.1,2,70,437,6.2,9,13,4,26,6,73,1,2,3
11925,2,2018-09-15,akron,@,Northwestern,W (39-34),17,28,60.7,277,2,36,90,2.5,0,64,367,5.7,7,6,2,15,15,140,0,0,0
11926,3,2018-09-22,akron,@,Iowa State,L (13-26),12,28,42.9,153,1,31,91,2.9,0,59,244,4.1,8,4,3,15,6,45,0,1,1
11927,4,2018-10-06,akron,,Miami (OH),L (17-41),19,35,54.3,203,1,28,56,2.0,0,63,259,4.1,9,5,2,16,8,86,2,3,5
11928,5,2018-10-13,akron,@,Buffalo,L (6-24),12,29,41.4,115,0,32,120,3.8,0,61,235,3.9,5,7,1,13,5,46,0,1,1
11929,6,2018-10-20,akron,@,Kent State,W (24-23),19,35,54.3,219,1,39,143,3.7,2,74,362,4.9,13,5,1,19,7,65,0,1,1
11930,7,2018-10-27,akron,,Central Michigan,W (17-10),10,27,37.0,149,1,37,154,4.2,1,64,303,4.7,6,8,2,16,4,37,4,0,4
11931,8,2018-11-01,akron,,Northern Illinois,L (26-36),21,38,55.3,326,3,28,35,1.3,0,66,361,5.5,14,1,4,19,7,50,0,2,2
11932,9,2018-11-10,akron,@,Eastern Michigan,L (7-27),4,15,26.7,29,0,30,72,2.4,0,45,101,2.2,1,4,1,6,2,25,1,3,4
11933,10,2018-11-17,akron,,Bowling Green State,L (6-21),12,28,42.9,148,0,28,79,2.8,0,56,227,4.1,7,6,2,15,8,61,0,0,0
11934,,10 Games,akron,,,,144,294,49.0,1856,12,328,1040,3.2,5,622,2896,4.7,79,59,22,160,68,628,8,13,21
11935,1,2014-08-30,buffalo,,Duquesne,W (38-28),25,36,69.4,298,3,49,174,3.6,2,85,472,5.6,14,10,2,26,3,31,1,1,2
11936,2,2014-09-06,buffalo,@,Army,L (39-47),34,50,68.0,396,5,29,153,5.3,0,79,549,6.9,21,8,4,33,7,59,0,3,3
11937,3,2014-09-12,buffalo,,Baylor,L (21-63),18,31,58.1,255,2,39,139,3.6,1,70,394,5.6,8,5,2,15,8,59,1,0,1
11938,4,2014-09-20,buffalo,,Norfolk State,W (36-7),15,29,51.7,262,4,44,169,3.8,1,73,431,5.9,10,9,3,22,4,55,0,0,0
11939,5,2014-09-27,buffalo,,Miami (OH),W (35-27),29,39,74.4,302,2,49,273,5.6,3,88,575,6.5,14,14,1,29,5,58,0,0,0
11940,6,2014-10-04,buffalo,@,Bowling Green State,L (35-36),16,24,66.7,134,1,47,234,5.0,4,71,368,5.2,9,11,3,23,6,70,0,1,1
11941,7,2014-10-11,buffalo,@,Eastern Michigan,L (27-37),27,45,60.0,383,3,36,154,4.3,0,81,537,6.6,12,7,3,22,7,60,1,2,3
11942,8,2014-10-25,buffalo,,Central Michigan,L (14-20),21,37,56.8,233,2,22,38,1.7,0,59,271,4.6,10,3,2,15,3,40,0,2,2
11943,9,2014-11-05,buffalo,@,Ohio,L (14-37),12,25,48.0,106,1,25,28,1.1,0,50,134,2.7,5,2,0,7,3,21,2,2,4
11944,10,2014-11-11,buffalo,,Akron,W (55-24),17,23,73.9,226,5,54,310,5.7,3,77,536,7.0,9,16,4,29,7,75,1,1,2
11945,11,2014-11-28,buffalo,@,Massachusetts,W (41-21),20,27,74.1,255,4,49,293,6.0,2,76,548,7.2,10,12,1,23,5,55,0,0,0
11946,,11 Games,buffalo,,,,234,366,63.9,2850,32,443,1965,4.4,16,809,4815,6.0,122,97,25,244,58,583,6,12,18
11947,1,2015-09-05,buffalo,,Albany,W (51-14),22,29,75.9,255,2,43,212,4.9,4,72,467,6.5,11,10,3,24,7,56,0,0,0
11948,2,2015-09-12,buffalo,@,Penn State,L (14-27),24,35,68.6,205,2,33,69,2.1,0,68,274,4.0,10,4,1,15,14,107,0,1,1
11949,3,2015-09-19,buffalo,@,Florida Atlantic,W (33-15),10,20,50.0,105,0,45,185,4.1,1,65,290,4.5,5,8,0,13,8,75,0,1,1
11950,4,2015-09-26,buffalo,,Nevada,L (21-24),28,46,60.9,338,2,35,149,4.3,0,81,487,6.0,15,7,1,23,9,90,1,2,3
11951,5,2015-10-03,buffalo,,Bowling Green State,L (22-28),35,59,59.3,348,1,37,152,4.1,1,96,500,5.2,21,11,2,34,8,85,0,1,1
11952,6,2015-10-17,buffalo,@,Central Michigan,L (14-51),14,28,50.0,149,1,29,92,3.2,0,57,241,4.2,7,5,1,13,5,63,2,2,4
11953,7,2015-10-24,buffalo,,Ohio,W (41-17),21,32,65.6,212,0,34,161,4.7,3,66,373,5.7,10,8,1,19,8,65,0,0,0
11954,8,2015-10-29,buffalo,@,Miami (OH),W (29-24),22,29,75.9,289,2,40,144,3.6,2,69,433,6.3,11,6,1,18,6,65,0,1,1
11955,9,2015-11-05,buffalo,@,Kent State,W (18-17),25,39,64.1,190,2,35,116,3.3,1,74,306,4.1,10,8,2,20,3,26,0,1,1
11956,10,2015-11-11,buffalo,,Northern Illinois,L (30-41),31,47,66.0,354,2,23,78,3.4,1,70,432,6.2,15,5,3,23,5,26,0,3,3
11957,11,2015-11-21,buffalo,@,Akron,L (21-42),32,51,62.7,262,1,28,130,4.6,2,79,392,5.0,16,5,2,23,6,64,1,2,3
11958,12,2015-11-27,buffalo,,Massachusetts,L (26-31),19,40,47.5,287,1,43,160,3.7,2,83,447,5.4,11,9,1,21,5,46,0,2,2
11959,,12 Games,buffalo,,,,283,455,62.2,2994,16,425,1648,3.9,17,880,4642,5.3,142,86,18,246,84,768,4,16,20
11960,1,2016-09-02,buffalo,,Albany,L (16-22),17,34,50.0,177,1,48,226,4.7,0,82,403,4.9,10,11,2,23,9,83,1,3,4
11961,2,2016-09-17,buffalo,@,Nevada,L (14-38),7,23,30.4,130,1,35,231,6.6,1,58,361,6.2,4,13,0,17,4,24,0,0,0
11962,3,2016-09-24,buffalo,,Army,W (23-20),20,31,64.5,178,1,33,87,2.6,2,64,265,4.1,7,5,1,13,5,35,0,1,1
11963,4,2016-10-01,buffalo,@,Boston College,L (3-35),10,23,43.5,41,0,19,26,1.4,0,42,67,1.6,3,1,1,5,5,39,1,0,1
11964,5,2016-10-08,buffalo,,Kent State,L (20-44),21,40,52.5,256,1,37,116,3.1,1,77,372,4.8,11,8,1,20,2,18,1,0,1
11965,6,2016-10-15,buffalo,,Ball State,L (21-31),28,46,60.9,306,3,37,153,4.1,0,83,459,5.5,16,7,1,24,6,49,0,0,0
11966,7,2016-10-22,buffalo,@,Northern Illinois,L (7-44),25,41,61.0,203,0,29,135,4.7,1,70,338,4.8,12,7,1,20,6,53,0,4,4
11967,8,2016-10-27,buffalo,,Akron,W (41-20),7,21,33.3,140,1,42,378,9.0,4,63,518,8.2,4,15,0,19,6,66,0,1,1
11968,9,2016-11-03,buffalo,@,Ohio,L (10-34),24,40,60.0,308,1,38,105,2.8,0,78,413,5.3,12,6,1,19,8,66,1,1,2
11969,10,2016-11-12,buffalo,,Miami (OH),L (24-35),21,40,52.5,193,0,46,187,4.1,2,86,380,4.4,12,12,3,27,5,36,1,1,2
11970,11,2016-11-19,buffalo,@,Western Michigan,L (0-38),12,22,54.5,140,0,30,128,4.3,0,52,268,5.2,6,6,1,13,4,32,1,0,1
11971,12,2016-11-25,buffalo,@,Bowling Green State,L (19-27),20,36,55.6,334,2,32,67,2.1,1,68,401,5.9,15,5,0,20,3,16,2,0,2
11972,,12 Games,buffalo,,,,212,397,53.4,2406,11,426,1839,4.3,12,823,4245,5.2,112,96,12,220,63,517,8,11,19
11973,1,2017-08-31,buffalo,@,Minnesota,L (7-17),22,42,52.4,211,1,22,51,2.3,0,64,262,4.1,10,2,1,13,4,35,0,1,1
11974,2,2017-09-09,buffalo,@,Army,L (17-21),9,16,56.3,193,1,23,119,5.2,1,39,312,8.0,8,3,0,11,3,25,2,0,2
11975,3,2017-09-16,buffalo,,Colgate,W (33-10),9,16,56.3,184,1,58,302,5.2,3,74,486,6.6,7,17,2,26,7,70,0,0,0
11976,4,2017-09-23,buffalo,,Florida Atlantic,W (34-31),18,27,66.7,254,1,57,204,3.6,3,84,458,5.5,15,9,4,28,7,52,0,0,0
11977,5,2017-09-30,buffalo,@,Kent State,W (27-13),11,18,61.1,142,1,44,235,5.3,3,62,377,6.1,6,7,5,18,6,56,0,1,1
11978,6,2017-10-07,buffalo,,Western Michigan,L (68-71),35,61,57.4,597,7,33,86,2.6,2,94,683,7.3,19,6,5,30,8,64,2,0,2
11979,7,2017-10-14,buffalo,,Northern Illinois,L (13-14),21,34,61.8,344,1,27,39,1.4,0,61,383,6.3,11,2,2,15,8,77,0,1,1
11980,8,2017-10-21,buffalo,@,Miami (OH),L (14-24),17,41,41.5,202,2,25,69,2.8,0,66,271,4.1,10,2,2,14,5,50,1,1,2
11981,9,2017-10-28,buffalo,@,Akron,L (20-21),34,50,68.0,313,0,34,141,4.1,2,84,454,5.4,17,9,2,28,4,31,0,1,1
11982,10,2017-11-07,buffalo,,Bowling Green State,W (38-28),23,37,62.2,406,3,40,176,4.4,2,77,582,7.6,16,8,2,26,6,51,2,0,2
11983,11,2017-11-16,buffalo,@,Ball State,W (40-24),16,28,57.1,350,4,39,215,5.5,1,67,565,8.4,14,11,1,26,5,47,0,1,1
11984,12,2017-11-24,buffalo,,Ohio,W (31-24),19,30,63.3,294,2,26,56,2.2,1,56,350,6.3,12,3,1,16,4,39,0,0,0
11985,,12 Games,buffalo,,,,234,400,58.5,3490,24,428,1693,4.0,18,828,5183,6.3,145,79,27,251,67,597,7,6,13
11986,1,2018-09-01,buffalo,,Delaware State,W (48-10),19,29,65.5,200,6,37,154,4.2,1,66,354,5.4,9,9,3,21,5,42,0,0,0
11987,2,2018-09-08,buffalo,@,Temple,W (36-29),26,45,57.8,275,3,41,152,3.7,2,86,427,5.0,17,7,3,27,4,29,0,1,1
11988,3,2018-09-15,buffalo,,Eastern Michigan,W (35-28),21,26,80.8,325,3,41,164,4.0,2,67,489,7.3,10,6,2,18,7,47,1,0,1
11989,4,2018-09-22,buffalo,@,Rutgers,W (42-13),14,28,50.0,263,3,36,182,5.1,3,64,445,7.0,10,5,4,19,3,25,0,2,2
11990,5,2018-09-29,buffalo,,Army,L (13-42),10,24,41.7,152,1,31,103,3.3,1,55,255,4.6,5,5,4,14,7,78,0,0,0
11991,6,2018-10-06,buffalo,@,Central Michigan,W (34-24),10,20,50.0,127,1,48,295,6.1,3,68,422,6.2,8,12,1,21,4,38,0,1,1
11992,7,2018-10-13,buffalo,,Akron,W (24-6),16,30,53.3,212,1,46,223,4.8,2,76,435,5.7,9,10,1,20,5,45,0,1,1
11993,8,2018-10-20,buffalo,@,Toledo,W (31-17),25,46,54.3,326,2,50,137,2.7,2,96,463,4.8,14,10,8,32,5,44,0,3,3
11994,9,2018-10-30,buffalo,,Miami (OH),W (51-42),20,35,57.1,358,3,37,149,4.0,4,72,507,7.0,11,10,5,26,11,100,0,0,0
11995,10,2018-11-06,buffalo,,Kent State,W (48-14),9,21,42.9,120,1,57,358,6.3,6,78,478,6.1,6,15,1,22,3,20,1,0,1
11996,11,2018-11-14,buffalo,@,Ohio,L (17-52),10,23,43.5,120,0,22,157,7.1,2,45,277,6.2,4,7,2,13,3,20,2,3,5
11997,,11 Games,buffalo,,,,180,327,55.0,2478,24,446,2074,4.7,28,773,4552,5.9,103,96,34,233,57,488,4,11,15
11998,1,2014-08-30,kent-state,,Ohio,L (14-17),30,41,73.2,264,2,22,31,1.4,0,63,295,4.7,16,1,0,17,8,44,0,0,0
11999,2,2014-09-06,kent-state,,South Alabama,L (13-23),17,40,42.5,213,2,28,64,2.3,0,68,277,4.1,10,4,1,15,6,45,0,1,1
12000,3,2014-09-13,kent-state,@,Ohio State,L (0-66),15,34,44.1,79,0,23,47,2.0,0,57,126,2.2,3,3,4,10,8,62,0,3,3
12001,4,2014-09-27,kent-state,@,Virginia,L (13-45),17,35,48.6,246,1,33,34,1.0,0,68,280,4.1,13,2,3,18,7,60,2,3,5
12002,5,2014-10-04,kent-state,@,Northern Illinois,L (14-17),20,38,52.6,244,0,37,83,2.2,1,75,327,4.4,12,7,3,22,3,27,0,0,0
12003,6,2014-10-11,kent-state,,Massachusetts,L (17-40),22,42,52.4,191,1,27,150,5.6,1,69,341,4.9,8,8,3,19,6,80,0,1,1
12004,7,2014-10-18,kent-state,,Army,W (39-17),27,40,67.5,360,3,24,107,4.5,1,64,467,7.3,15,5,1,21,5,53,0,1,1
12005,8,2014-10-25,kent-state,@,Miami (OH),L (3-10),22,40,55.0,206,0,27,79,2.9,0,67,285,4.3,12,5,1,18,3,17,0,1,1
12006,9,2014-11-04,kent-state,,Toledo,L (20-30),19,41,46.3,163,2,19,171,9.0,1,60,334,5.6,9,6,2,17,7,74,1,2,3
12007,10,2014-11-12,kent-state,@,Bowling Green State,L (20-30),27,47,57.4,306,3,14,22,1.6,0,61,328,5.4,15,3,3,21,6,62,1,4,5
12008,11,2014-11-28,kent-state,,Akron,W (27-24),28,45,62.2,298,2,23,112,4.9,2,68,410,6.0,13,5,2,20,6,50,0,1,1
12009,,11 Games,kent-state,,,,244,443,55.1,2570,16,277,900,3.2,6,720,3470,4.8,126,49,23,198,65,574,4,17,21
12010,1,2015-09-05,kent-state,@,Illinois,L (3-52),19,40,47.5,186,0,39,59,1.5,0,79,245,3.1,8,6,1,15,11,82,1,3,4
12011,2,2015-09-12,kent-state,,Delaware State,W (45-13),18,26,69.2,214,3,65,278,4.3,2,91,492,5.4,9,15,1,25,12,114,3,0,3
12012,3,2015-09-19,kent-state,@,Minnesota,L (7-10),10,28,35.7,63,0,31,79,2.5,0,59,142,2.4,3,3,2,8,7,89,0,0,0
12013,4,2015-09-26,kent-state,,Marshall,L (29-36),13,34,38.2,189,2,55,247,4.5,2,89,436,4.9,7,10,3,20,11,82,1,0,1
12014,5,2015-10-03,kent-state,,Miami (OH),W (20-14),12,21,57.1,136,1,41,214,5.2,1,62,350,5.6,6,7,0,13,7,57,1,0,1
12015,6,2015-10-10,kent-state,@,Toledo,L (7-38),14,32,43.8,134,0,32,123,3.8,0,64,257,4.0,4,8,1,13,9,83,0,1,1
12016,7,2015-10-17,kent-state,@,Massachusetts,W (15-10),20,25,80.0,135,1,50,192,3.8,0,75,327,4.4,8,9,1,18,9,103,0,1,1
12017,8,2015-10-24,kent-state,,Bowling Green State,L (0-48),12,25,48.0,111,0,26,55,2.1,0,51,166,3.3,4,4,2,10,8,69,0,2,2
12018,9,2015-11-05,kent-state,,Buffalo,L (17-18),19,31,61.3,155,1,31,106,3.4,0,62,261,4.2,7,8,2,17,3,45,0,1,1
12019,10,2015-11-10,kent-state,@,Ohio,L (0-27),16,31,51.6,111,0,25,80,3.2,0,56,191,3.4,5,22,1,8,7,63,0,2,2
12020,11,2015-11-18,kent-state,,Central Michigan,L (14-27),9,26,34.6,98,1,32,180,5.6,1,58,278,4.8,6,9,0,15,2,20,2,0,2
12021,12,2015-11-27,kent-state,@,Akron,L (0-20),13,24,54.2,125,0,20,10,0.5,0,44,135,3.1,4,2,1,7,7,65,3,0,3
12022,,12 Games,kent-state,,,,175,343,51.0,1657,9,447,1623,3.6,6,790,3280,4.2,71,103,15,169,93,872,11,10,21
12023,1,2016-09-03,kent-state,@,Penn State,L (13-33),14,28,50.0,129,0,41,150,3.7,0,69,279,4.0,6,8,2,16,6,47,1,2,3
12024,2,2016-09-10,kent-state,,North Carolina A&T,L (36-39),17,32,53.1,182,3,46,93,2.0,1,78,275,3.5,11,4,0,15,10,82,1,1,2
12025,3,2016-09-17,kent-state,,Monmouth,W (27-7),15,20,75.0,108,2,46,235,5.1,1,66,343,5.2,4,12,1,17,6,55,1,0,1
12026,4,2016-09-24,kent-state,@,Alabama,L (0-48),7,16,43.8,84,0,30,82,2.7,0,46,166,3.6,2,2,1,5,0,0,1,0,1
12027,5,2016-10-01,kent-state,,Akron,L (27-31),19,36,52.8,285,2,41,138,3.4,1,77,423,5.5,11,8,1,20,8,75,0,0,0
12028,6,2016-10-08,kent-state,@,Buffalo,W (44-20),7,13,53.8,89,0,45,341,7.6,4,58,430,7.4,4,12,1,17,2,12,0,0,0
12029,7,2016-10-15,kent-state,@,Miami (OH),L (14-18),8,14,57.1,99,0,48,163,3.4,2,62,262,4.2,2,11,1,14,5,39,0,2,2
12030,8,2016-10-22,kent-state,,Ohio,L (10-14),12,29,41.4,101,0,49,163,3.3,1,78,264,3.4,6,9,3,18,2,20,0,0,0
12031,9,2016-10-29,kent-state,@,Central Michigan,W (27-24),10,18,55.6,102,1,42,228,5.4,2,60,330,5.5,6,8,0,14,5,44,1,1,2
12032,10,2016-11-08,kent-state,,Western Michigan,L (21-37),9,21,42.9,73,0,34,220,6.5,2,55,293,5.3,5,12,0,17,5,50,0,1,1
12033,11,2016-11-15,kent-state,@,Bowling Green State,L (7-42),15,28,53.6,245,1,22,9,0.4,0,50,254,5.1,8,2,0,10,8,58,0,0,0
12034,12,2016-11-25,kent-state,,Northern Illinois,L (21-31),14,37,37.8,203,2,29,188,6.5,1,66,391,5.9,8,5,2,15,6,57,0,1,1
12035,,12 Games,kent-state,,,,147,292,50.3,1700,11,473,2010,4.2,15,765,3710,4.8,73,93,12,178,63,539,5,8,13
12036,1,2017-09-02,kent-state,@,Clemson,L (3-56),1,5,20.0,1,0,44,119,2.7,0,49,120,2.4,0,4,1,5,11,79,0,0,0
12037,2,2017-09-09,kent-state,,Howard,W (38-31),8,16,50.0,105,2,53,294,5.5,3,69,399,5.8,5,12,0,17,13,132,2,0,2
12038,3,2017-09-16,kent-state,@,Marshall,L (0-21),7,17,41.2,117,0,44,142,3.2,0,61,259,4.2,5,8,1,14,8,80,0,1,1
12039,4,2017-09-23,kent-state,@,Louisville,L (3-42),2,5,40.0,11,0,54,139,2.6,0,59,150,2.5,0,10,1,11,5,45,2,1,3
12040,5,2017-09-30,kent-state,,Buffalo,L (13-27),19,31,61.3,320,1,40,124,3.1,0,71,444,6.3,12,9,3,24,10,99,0,1,1
12041,6,2017-10-07,kent-state,@,Northern Illinois,L (3-24),6,17,35.3,29,0,43,102,2.4,0,60,131,2.2,1,7,1,9,5,43,1,3,4
12042,7,2017-10-14,kent-state,,Miami (OH),W (17-14),10,18,55.6,161,2,44,167,3.8,0,62,328,5.3,5,7,0,12,3,39,0,0,0
12043,8,2017-10-21,kent-state,@,Ohio,L (3-48),7,17,41.2,64,0,35,102,2.9,0,52,166,3.2,1,5,1,7,9,74,1,1,2
12044,9,2017-10-31,kent-state,,Bowling Green State,L (16-44),16,35,45.7,140,0,32,144,4.5,2,67,284,4.2,7,10,3,20,5,55,1,3,4
12045,10,2017-11-08,kent-state,@,Western Michigan,L (20-48),13,24,54.2,119,0,37,162,4.4,3,61,281,4.6,5,7,0,12,6,56,2,2,4
12046,11,2017-11-14,kent-state,,Central Michigan,L (23-42),16,30,53.3,320,2,47,174,3.7,1,77,494,6.4,12,12,1,25,10,109,1,1,2
12047,12,2017-11-21,kent-state,@,Akron,L (14-24),9,19,47.4,85,1,45,161,3.6,1,64,246,3.8,4,8,1,13,9,84,1,2,3
12048,,12 Games,kent-state,,,,114,234,48.7,1472,8,518,1830,3.5,10,752,3302,4.4,57,99,13,169,94,895,11,15,26
12049,1,2018-09-01,kent-state,@,Illinois,L (24-31),28,41,68.3,270,2,42,184,4.4,1,83,454,5.5,12,12,0,24,5,38,0,2,2
12050,2,2018-09-08,kent-state,,Howard,W (54-14),13,29,44.8,156,1,52,355,6.8,6,81,511,6.3,8,16,2,26,15,150,3,1,4
12051,3,2018-09-15,kent-state,@,Penn State,L (10-63),21,40,52.5,180,1,37,41,1.1,0,77,221,2.9,8,7,3,18,10,83,0,0,0
12052,4,2018-09-22,kent-state,@,Mississippi,L (17-38),25,43,58.1,242,1,41,148,3.6,1,84,390,4.6,9,11,3,23,7,55,1,1,2
12053,5,2018-09-29,kent-state,@,Ball State,L (24-52),30,44,68.2,314,1,41,147,3.6,2,85,461,5.4,16,6,2,24,17,142,2,1,3
12054,6,2018-10-06,kent-state,,Ohio,L (26-27),27,35,77.1,271,2,36,201,5.6,0,71,472,6.6,12,10,3,25,11,100,1,2,3
12055,7,2018-10-13,kent-state,@,Miami (OH),L (6-31),15,29,51.7,149,0,31,125,4.0,1,60,274,4.6,7,6,1,14,10,70,0,1,1
12056,8,2018-10-20,kent-state,,Akron,L (23-24),17,31,54.8,198,1,43,173,4.0,2,74,371,5.0,8,8,2,18,6,46,0,0,0
12057,9,2018-10-30,kent-state,@,Bowling Green State,W (35-28),14,24,58.3,157,2,50,225,4.5,3,74,382,5.2,6,13,2,21,11,86,1,0,1
12058,10,2018-11-06,kent-state,@,Buffalo,L (14-48),14,28,50.0,83,1,40,100,2.5,1,68,183,2.7,5,7,0,12,4,35,0,0,0
12059,11,2018-11-15,kent-state,,Toledo,L (34-56),24,41,58.5,314,2,35,183,5.2,2,76,497,6.5,11,6,6,23,8,69,0,1,1
12060,,11 Games,kent-state,,,,228,385,59.2,2334,14,448,1882,4.2,19,833,4216,5.1,102,102,24,228,104,874,8,9,17
12061,1,2014-08-30,eastern-michigan,,Morgan State,W (31-28),18,30,60.0,99,0,56,292,5.2,3,86,391,4.5,8,20,2,30,4,30,0,0,0
12062,2,2014-09-06,eastern-michigan,@,Florida,L (0-65),9,21,42.9,45,0,34,80,2.4,0,55,125,2.3,2,3,2,7,4,40,4,1,5
12063,3,2014-09-13,eastern-michigan,@,Old Dominion,L (3-17),12,24,50.0,72,0,48,143,3.0,0,72,215,3.0,4,10,0,14,5,47,2,0,2
12064,4,2014-09-20,eastern-michigan,@,Michigan State,L (14-73),10,29,34.5,115,2,19,20,1.1,0,48,135,2.8,3,2,0,5,4,38,5,1,6
12065,5,2014-10-04,eastern-michigan,@,Akron,L (6-31),17,30,56.7,185,1,37,94,2.5,0,67,279,4.2,8,8,2,18,7,60,2,2,4
12066,6,2014-10-11,eastern-michigan,,Buffalo,W (37-27),10,18,55.6,147,1,49,337,6.9,4,67,484,7.2,7,11,0,18,7,62,1,0,1
12067,7,2014-10-18,eastern-michigan,N,Massachusetts,L (14-36),10,21,47.6,147,2,32,133,4.2,0,53,280,5.3,5,6,0,11,10,92,0,1,1
12068,8,2014-10-25,eastern-michigan,,Northern Illinois,L (17-28),16,34,47.1,124,0,48,257,5.4,2,82,381,4.6,8,15,2,25,8,80,0,1,1
12069,9,2014-11-01,eastern-michigan,,Central Michigan,L (7-38),7,19,36.8,76,1,29,21,0.7,0,48,97,2.0,2,2,1,5,4,19,1,1,2
12070,10,2014-11-15,eastern-michigan,@,Western Michigan,L (7-51),14,22,63.6,283,1,37,87,2.4,0,59,370,6.3,10,4,0,14,8,70,1,2,3
12071,11,2014-11-22,eastern-michigan,@,Ball State,L (30-45),36,49,73.5,409,3,36,94,2.6,0,85,503,5.9,16,13,1,30,6,46,3,0,3
12072,12,2014-11-28,eastern-michigan,,Toledo,L (16-52),8,23,34.8,119,2,34,96,2.8,0,57,215,3.8,6,4,2,12,2,14,0,2,2
12073,,12 Games,eastern-michigan,,,,167,320,52.2,1821,13,459,1654,3.6,9,779,3475,4.5,79,98,12,189,69,598,19,11,30
12074,1,2015-09-05,eastern-michigan,,Old Dominion,L (34-38),22,36,61.1,192,2,47,252,5.4,2,83,444,5.3,11,13,3,27,7,78,1,2,3
12075,2,2015-09-12,eastern-michigan,@,Wyoming,W (48-29),18,25,72.0,330,3,37,176,4.8,3,62,506,8.2,12,8,1,21,4,45,0,0,0
12076,3,2015-09-19,eastern-michigan,,Ball State,L (17-28),19,39,48.7,196,0,22,123,5.6,2,61,319,5.2,8,4,0,12,4,45,0,2,2
12077,4,2015-09-26,eastern-michigan,,Army,L (36-58),27,39,69.2,280,2,25,193,7.7,3,64,473,7.4,16,7,1,24,10,77,1,1,2
12078,5,2015-10-03,eastern-michigan,@,Louisiana State,L (22-44),17,24,70.8,161,1,33,94,2.8,2,57,255,4.5,8,7,1,16,7,70,0,3,3
12079,6,2015-10-10,eastern-michigan,,Akron,L (21-47),24,35,68.6,252,3,31,161,5.2,0,66,413,6.3,9,9,2,20,9,90,2,1,3
12080,7,2015-10-17,eastern-michigan,@,Toledo,L (20-63),23,37,62.2,176,0,48,282,5.9,2,85,458,5.4,8,14,1,23,6,45,1,1,2
12081,8,2015-10-24,eastern-michigan,@,Northern Illinois,L (21-49),26,43,60.5,219,0,44,157,3.6,3,87,376,4.3,11,14,1,26,7,75,0,1,1
12082,9,2015-10-29,eastern-michigan,,Western Michigan,L (28-58),18,30,60.0,263,3,39,226,5.8,1,69,489,7.1,13,12,1,26,3,20,2,2,4
12083,10,2015-11-07,eastern-michigan,@,Miami (OH),L (13-28),7,20,35.0,89,0,39,103,2.6,1,59,192,3.3,5,5,0,10,9,54,1,1,2
12084,11,2015-11-14,eastern-michigan,,Massachusetts,L (17-28),27,43,62.8,256,2,26,59,2.3,0,69,315,4.6,16,4,3,23,6,47,1,0,1
12085,12,2015-11-27,eastern-michigan,@,Central Michigan,L (28-35),19,36,52.8,217,2,32,113,3.5,1,68,330,4.9,7,5,2,14,9,55,2,0,2
12086,,12 Games,eastern-michigan,,,,247,407,60.7,2631,18,423,1939,4.6,20,830,4570,5.5,124,102,16,242,81,701,11,14,25
12087,1,2016-09-02,eastern-michigan,,Mississippi Valley State,W (61-14),17,24,70.8,198,3,44,281,6.4,5,68,479,7.0,9,14,1,24,6,68,0,1,1
12088,2,2016-09-10,eastern-michigan,@,Missouri,L (21-61),23,45,51.1,287,1,46,141,3.1,2,91,428,4.7,12,7,2,21,8,61,0,2,2
12089,3,2016-09-17,eastern-michigan,@,UNC Charlotte,W (37-19),24,31,77.4,285,2,30,72,2.4,1,61,357,5.9,13,4,0,17,7,90,0,1,1
12090,4,2016-09-23,eastern-michigan,,Wyoming,W (27-24),17,34,50.0,261,1,47,239,5.1,2,81,500,6.2,10,13,1,24,5,55,0,4,4
12091,5,2016-10-01,eastern-michigan,@,Bowling Green State,W (28-25),21,30,70.0,262,3,45,212,4.7,1,75,474,6.3,8,13,3,24,5,56,1,1,2
12092,6,2016-10-08,eastern-michigan,,Toledo,L (20-35),20,38,52.6,255,1,20,62,3.1,1,58,317,5.5,11,4,1,16,5,51,1,1,2
12093,7,2016-10-15,eastern-michigan,@,Ohio,W (27-20),29,39,74.4,347,3,32,88,2.8,0,71,435,6.1,12,8,0,20,5,55,1,0,1
12094,8,2016-10-22,eastern-michigan,@,Western Michigan,L (31-45),29,45,64.4,319,1,30,142,4.7,3,75,461,6.1,17,5,1,23,7,50,1,1,2
12095,9,2016-10-29,eastern-michigan,,Miami (OH),L (15-28),23,39,59.0,328,2,23,33,1.4,0,62,361,5.8,13,3,0,16,7,67,0,1,1
12096,10,2016-11-08,eastern-michigan,@,Ball State,W (48-41),37,72,51.4,468,3,37,154,4.2,3,109,622,5.7,23,10,2,35,4,30,2,1,3
12097,11,2016-11-16,eastern-michigan,,Northern Illinois,L (24-31),17,38,44.7,184,1,56,291,5.2,2,94,475,5.1,9,18,5,32,7,68,0,2,2
12098,12,2016-11-22,eastern-michigan,,Central Michigan,W (26-21),26,37,70.3,355,2,32,183,5.7,1,69,538,7.8,14,8,1,23,7,75,0,1,1
12099,13,2016-12-23,eastern-michigan,N,Old Dominion*,L (20-24),26,47,55.3,300,2,38,170,4.5,0,85,470,5.5,16,8,4,28,3,15,0,1,1
12100,,13 Games,eastern-michigan,,,,309,519,59.5,3849,25,480,2068,4.3,21,999,5917,5.9,167,115,21,303,76,741,6,17,23
12101,1,2017-09-01,eastern-michigan,,UNC Charlotte,W (24-7),22,31,71.0,267,0,41,126,3.1,2,72,393,5.5,10,8,1,19,10,70,1,1,2
12102,2,2017-09-09,eastern-michigan,@,Rutgers,W (16-13),19,37,51.4,260,1,35,114,3.3,0,72,374,5.2,13,4,2,19,9,93,1,0,1
12103,3,2017-09-23,eastern-michigan,,Ohio,L (20-27),29,49,59.2,305,1,27,45,1.7,1,76,350,4.6,12,3,0,15,8,85,0,1,1
12104,4,2017-09-30,eastern-michigan,@,Kentucky,L (20-24),27,47,57.4,299,2,27,13,0.5,1,74,312,4.2,17,2,1,20,5,50,1,2,3
12105,5,2017-10-07,eastern-michigan,@,Toledo,L (15-20),24,40,60.0,253,2,23,73,3.2,0,63,326,5.2,13,6,2,21,7,86,0,2,2
12106,6,2017-10-14,eastern-michigan,@,Army,L (27-28),19,27,70.4,229,4,26,135,5.2,0,53,364,6.9,13,7,1,21,6,34,0,1,1
12107,7,2017-10-21,eastern-michigan,,Western Michigan,L (17-20),28,44,63.6,308,1,38,153,4.0,1,82,461,5.6,14,10,3,27,8,65,2,1,3
12108,8,2017-10-26,eastern-michigan,@,Northern Illinois,L (27-30),23,45,51.1,307,2,33,96,2.9,0,78,403,5.2,11,2,2,15,6,69,0,0,0
12109,9,2017-11-02,eastern-michigan,,Ball State,W (56-14),15,22,68.2,263,3,40,225,5.6,4,62,488,7.9,12,10,2,24,3,30,1,0,1
12110,10,2017-11-08,eastern-michigan,@,Central Michigan,L (30-42),23,39,59.0,204,2,36,124,3.4,1,75,328,4.4,9,10,3,22,4,25,0,5,5
12111,11,2017-11-15,eastern-michigan,@,Miami (OH),W (27-24),15,27,55.6,269,2,40,196,4.9,1,67,465,6.9,9,7,2,18,4,28,1,1,2
12112,12,2017-11-21,eastern-michigan,,Bowling Green State,W (34-31),13,27,48.1,124,1,53,266,5.0,3,80,390,4.9,7,15,0,22,4,55,0,1,1
12113,,12 Games,eastern-michigan,,,,257,435,59.1,3088,21,419,1566,3.7,14,854,4654,5.4,140,84,19,243,74,690,7,15,22
12114,1,2018-08-31,eastern-michigan,,Monmouth,W (51-17),22,27,81.5,302,5,39,171,4.4,2,66,473,7.2,15,9,3,27,7,65,0,0,0
12115,2,2018-09-08,eastern-michigan,@,Purdue,W (20-19),22,34,64.7,347,1,31,69,2.2,1,65,416,6.4,13,3,3,19,10,71,0,1,1
12116,3,2018-09-15,eastern-michigan,@,Buffalo,L (28-35),25,38,65.8,348,2,43,142,3.3,2,81,490,6.0,12,8,2,22,11,98,1,0,1
12117,4,2018-09-22,eastern-michigan,@,San Diego State,L (20-23),17,27,63.0,236,1,39,119,3.1,1,66,355,5.4,7,6,1,14,6,45,1,1,2
12118,5,2018-09-29,eastern-michigan,,Northern Illinois,L (23-26),17,41,41.5,180,1,33,62,1.9,1,74,242,3.3,9,5,2,16,11,85,1,0,1
12119,6,2018-10-06,eastern-michigan,@,Western Michigan,L (24-27),18,31,58.1,206,2,48,178,3.7,1,79,384,4.9,11,10,2,23,4,31,1,0,1
12120,7,2018-10-13,eastern-michigan,,Toledo,W (28-26),17,23,73.9,183,0,38,229,6.0,4,61,412,6.8,8,10,0,18,11,138,0,0,0
12121,8,2018-10-20,eastern-michigan,@,Ball State,W (42-20),22,28,78.6,257,3,49,163,3.3,3,77,420,5.5,11,10,2,23,5,65,1,0,1
12122,9,2018-10-27,eastern-michigan,,Army,L (22-37),19,29,65.5,201,2,11,34,3.1,1,40,235,5.9,7,1,2,10,8,75,1,0,1
12123,10,2018-11-03,eastern-michigan,,Central Michigan,W (17-7),21,33,63.6,212,1,43,137,3.2,1,76,349,4.6,10,7,1,18,8,81,2,1,3
12124,11,2018-11-10,eastern-michigan,,Akron,W (27-7),16,24,66.7,132,0,50,261,5.2,2,74,393,5.3,7,12,1,20,7,65,1,0,1
12125,,11 Games,eastern-michigan,,,,216,335,64.5,2604,18,424,1565,3.7,19,759,4169,5.5,110,81,19,210,88,819,9,3,12
12126,1,2014-08-30,massachusetts,N,Boston College,L (7-30),9,22,40.9,147,1,22,55,2.5,0,44,202,4.6,4,4,1,9,4,23,0,1,1
12127,2,2014-09-06,massachusetts,N,Colorado,L (38-41),20,38,52.6,267,3,30,104,3.5,2,68,371,5.5,11,7,5,23,7,85,0,1,1
12128,3,2014-09-13,massachusetts,@,Vanderbilt,L (31-34),18,35,51.4,258,2,39,88,2.3,2,74,346,4.7,13,4,3,20,2,10,1,0,1
12129,4,2014-09-20,massachusetts,@,Penn State,L (7-48),17,33,51.5,263,1,28,3,0.1,0,61,266,4.4,7,5,1,13,4,30,1,0,1
12130,5,2014-09-27,massachusetts,,Bowling Green State,L (42-47),36,61,59.0,589,5,31,49,1.6,1,92,638,6.9,23,3,3,29,4,30,3,1,4
12131,6,2014-10-04,massachusetts,@,Miami (OH),L (41-42),35,62,56.5,389,4,34,165,4.9,1,96,554,5.8,17,9,6,32,7,60,2,2,4
12132,7,2014-10-11,massachusetts,@,Kent State,W (40-17),23,38,60.5,286,3,35,196,5.6,1,73,482,6.6,12,9,3,24,10,105,0,0,0
12133,8,2014-10-18,massachusetts,N,Eastern Michigan,W (36-14),28,51,54.9,337,0,43,225,5.2,5,94,562,6.0,19,11,4,34,9,55,2,1,3
12134,9,2014-10-25,massachusetts,@,Toledo,L (35-42),29,58,50.0,445,5,20,52,2.6,0,78,497,6.4,18,6,2,26,9,75,0,2,2
12135,10,2014-11-12,massachusetts,,Ball State,W (24-10),28,44,63.6,424,0,40,145,3.6,3,84,569,6.8,16,8,3,27,7,49,0,2,2
12136,11,2014-11-18,massachusetts,@,Akron,L (6-30),13,21,61.9,168,1,30,67,2.2,0,51,235,4.6,6,5,0,11,5,45,1,3,4
12137,12,2014-11-28,massachusetts,,Buffalo,L (21-41),13,29,44.8,168,2,35,162,4.6,1,64,330,5.2,9,8,1,18,5,50,0,0,0
12138,,12 Games,massachusetts,,,,269,492,54.7,3741,27,387,1311,3.4,16,879,5052,5.7,155,79,32,266,73,617,10,13,23
12139,1,2015-09-12,massachusetts,@,Colorado,L (14-48),24,42,57.1,250,1,29,147,5.1,1,71,397,5.6,11,6,3,20,4,50,1,1,2
12140,2,2015-09-19,massachusetts,,Temple,L (23-25),29,55,52.7,393,3,25,45,1.8,0,80,438,5.5,14,2,4,20,12,106,1,1,2
12141,3,2015-09-26,massachusetts,@,Notre Dame,L (27-62),28,48,58.3,302,1,29,148,5.1,3,77,450,5.8,13,4,5,22,4,35,0,1,1
12142,4,2015-10-03,massachusetts,,Florida International,W (24-14),32,43,74.4,363,3,39,132,3.4,0,82,495,6.0,16,9,4,29,10,72,2,0,2
12143,5,2015-10-10,massachusetts,@,Bowling Green State,L (38-62),37,61,60.7,486,4,15,30,2.0,0,76,516,6.8,25,1,4,30,7,78,1,1,2
12144,6,2015-10-17,massachusetts,,Kent State,L (10-15),17,33,51.5,171,0,27,86,3.2,1,60,257,4.3,6,6,4,16,9,76,0,1,1
12145,7,2015-10-24,massachusetts,,Toledo,L (35-51),27,49,55.1,240,4,24,148,6.2,1,73,388,5.3,12,6,1,19,15,134,0,1,1
12146,8,2015-10-31,massachusetts,@,Ball State,L (10-20),32,44,72.7,259,1,36,189,5.3,0,80,448,5.6,14,11,1,26,12,87,0,1,1
12147,9,2015-11-07,massachusetts,,Akron,L (13-17),19,44,43.2,173,0,32,88,2.8,1,76,261,3.4,9,8,2,19,2,27,0,2,2
12148,10,2015-11-14,massachusetts,@,Eastern Michigan,W (28-17),10,20,50.0,109,1,57,330,5.8,3,77,439,5.7,6,16,2,24,6,56,0,1,1
12149,11,2015-11-21,massachusetts,,Miami (OH),L (13-20),17,34,50.0,181,0,30,69,2.3,1,64,250,3.9,9,3,1,13,4,25,0,1,1
12150,12,2015-11-27,massachusetts,@,Buffalo,W (31-26),9,22,40.9,163,0,49,295,6.0,4,71,458,6.5,6,11,1,18,4,21,1,2,3
12151,,12 Games,massachusetts,,,,281,495,56.8,3090,18,392,1707,4.4,15,887,4797,5.4,141,83,32,256,89,767,6,13,19
12152,1,2016-09-03,massachusetts,@,Florida,L (7-24),9,17,52.9,141,0,35,46,1.3,1,52,187,3.6,5,3,4,12,7,25,0,0,0
12153,2,2016-09-10,massachusetts,,Boston College,L (7-26),11,28,39.3,145,1,33,-23,-0.7,0,61,122,2.0,6,1,1,8,5,37,2,1,3
12154,3,2016-09-17,massachusetts,,Florida International,W (21-13),28,42,66.7,278,3,36,116,3.2,0,78,394,5.1,16,4,1,21,9,72,0,1,1
12155,4,2016-09-24,massachusetts,,Mississippi State,L (35-47),24,41,58.5,273,4,28,138,4.9,1,69,411,6.0,16,5,1,22,7,35,0,3,3
12156,5,2016-10-01,massachusetts,,Tulane,L (24-31),16,30,53.3,181,2,24,131,5.5,1,54,312,5.8,7,8,1,16,7,65,1,1,2
12157,6,2016-10-07,massachusetts,@,Old Dominion,L (16-36),16,33,48.5,237,1,32,169,5.3,1,65,406,6.2,11,10,1,22,10,85,0,2,2
12158,7,2016-10-15,massachusetts,,Louisiana Tech,L (28-56),29,40,72.5,268,3,33,131,4.0,1,73,399,5.5,14,11,0,25,7,73,1,1,2
12159,8,2016-10-22,massachusetts,@,South Carolina,L (28-34),20,42,47.6,247,3,37,142,3.8,1,79,389,4.9,13,8,2,23,8,77,2,2,4
12160,9,2016-10-29,massachusetts,,Wagner,W (34-10),26,41,63.4,364,3,24,143,6.0,1,65,507,7.8,15,7,2,24,7,60,0,1,1
12161,10,2016-11-05,massachusetts,@,Troy,L (31-52),23,44,52.3,316,3,28,44,1.6,1,72,360,5.0,13,5,0,18,8,76,1,1,2
12162,11,2016-11-19,massachusetts,@,Brigham Young,L (9-51),27,40,67.5,288,1,20,40,2.0,0,60,328,5.5,10,3,1,14,9,94,2,2,4
12163,12,2016-11-26,massachusetts,@,Hawaii,L (40-46),24,38,63.2,342,3,34,117,3.4,2,72,459,6.4,12,10,3,25,9,85,1,0,1
12164,,12 Games,massachusetts,,,,253,436,58.0,3080,27,364,1194,3.3,10,800,4274,5.3,138,75,17,230,93,784,10,15,25
12165,1,2017-08-26,massachusetts,,Hawaii,L (35-38),22,34,64.7,298,2,41,115,2.8,3,75,413,5.5,13,6,1,20,5,55,1,1,2
12166,2,2017-09-02,massachusetts,@,Coastal Carolina,L (28-38),27,45,60.0,362,1,26,79,3.0,3,71,441,6.2,17,5,1,23,7,64,2,0,2
12167,3,2017-09-09,massachusetts,,Old Dominion,L (7-17),22,37,59.5,253,1,36,79,2.2,0,73,332,4.5,10,9,1,20,3,40,0,0,0
12168,4,2017-09-15,massachusetts,@,Temple,L (21-29),23,39,59.0,377,2,33,81,2.5,1,72,458,6.4,18,5,2,25,6,48,1,0,1
12169,5,2017-09-23,massachusetts,@,Tennessee,L (13-17),13,22,59.1,137,1,37,144,3.9,1,59,281,4.8,7,6,1,14,7,43,0,0,0
12170,6,2017-09-30,massachusetts,,Ohio,L (50-58),33,58,56.9,403,5,37,147,4.0,1,95,550,5.8,17,9,4,30,5,39,1,1,2
12171,7,2017-10-21,massachusetts,,Georgia Southern,W (55-20),21,28,75.0,350,4,44,320,7.3,4,72,670,9.3,15,13,5,33,8,70,2,0,2
12172,8,2017-10-28,massachusetts,,Appalachian State,W (30-27),20,33,60.6,190,0,39,209,5.4,3,72,399,5.5,9,6,1,16,11,82,2,2,4
12173,9,2017-11-04,massachusetts,@,Mississippi State,L (23-34),15,28,53.6,223,1,32,127,4.0,0,60,350,5.8,3,6,3,12,5,55,0,1,1
12174,10,2017-11-11,massachusetts,N,Maine,W (44-31),21,39,53.8,355,4,36,100,2.8,1,75,455,6.1,14,5,4,23,13,96,0,0,0
12175,11,2017-11-18,massachusetts,@,Brigham Young,W (16-10),21,35,60.0,230,1,33,69,2.1,0,68,299,4.4,14,4,0,18,3,30,0,0,0
12176,12,2017-12-02,massachusetts,@,Florida International,L (45-63),34,49,69.4,392,4,24,156,6.5,2,73,548,7.5,17,8,1,26,6,57,2,1,3
12177,,12 Games,massachusetts,,,,272,447,60.9,3570,26,418,1626,3.9,19,865,5196,6.0,154,82,24,260,79,679,11,6,17
12178,1,2018-08-25,massachusetts,,Duquesne,W (63-15),19,28,67.9,290,4,38,284,7.5,4,66,574,8.7,12,11,1,24,4,30,1,0,1
12179,2,2018-09-01,massachusetts,@,Boston College,L (21-55),21,34,61.8,249,1,34,66,1.9,2,68,315,4.6,12,5,1,18,2,8,1,2,3
12180,3,2018-09-08,massachusetts,@,Georgia Southern,L (13-34),23,36,63.9,216,0,24,108,4.5,1,60,324,5.4,12,6,1,19,8,55,1,1,2
12181,4,2018-09-15,massachusetts,@,Florida International,L (24-63),15,32,46.9,224,1,34,199,5.9,2,66,423,6.4,11,11,2,24,5,40,1,2,3
12182,5,2018-09-22,massachusetts,,UNC Charlotte,W (49-31),12,19,63.2,189,2,35,142,4.1,4,54,331,6.1,9,5,2,16,6,59,1,0,1
12183,6,2018-09-29,massachusetts,@,Ohio,L (42-58),30,43,69.8,410,5,22,41,1.9,0,65,451,6.9,19,3,1,23,8,77,0,1,1
12184,7,2018-10-06,massachusetts,,South Florida,L (42-58),33,52,63.5,401,5,34,85,2.5,1,86,486,5.7,19,6,4,29,8,80,4,1,5
12185,8,2018-10-20,massachusetts,,Coastal Carolina,L (13-24),25,43,58.1,390,1,22,63,2.9,0,65,453,7.0,18,4,0,22,8,70,2,0,2
12186,9,2018-10-27,massachusetts,@,Connecticut,W (22-17),8,15,53.3,197,2,53,247,4.7,1,68,444,6.5,7,12,1,20,2,15,1,1,2
12187,10,2018-11-03,massachusetts,,Liberty,W (62-59),29,44,65.9,540,4,54,237,4.4,4,98,777,7.9,17,15,2,34,9,79,2,1,3
12188,11,2018-11-10,massachusetts,,Brigham Young,L (16-35),23,33,69.7,183,0,36,102,2.8,2,69,285,4.1,9,5,1,15,1,10,0,0,0
12189,12,2018-11-17,massachusetts,@,Georgia,L (27-66),24,32,75.0,287,2,22,103,4.7,1,54,390,7.2,10,5,1,16,7,59,0,1,1
12190,,12 Games,massachusetts,,,,262,411,63.7,3576,27,408,1677,4.1,22,819,5253,6.4,155,88,17,260,68,582,14,10,24
12191,1,2014-08-28,temple,@,Vanderbilt,W (37-7),23,36,63.9,207,2,45,144,3.2,1,81,351,4.3,9,9,0,17,3,23,2,0,2
12192,2,2014-09-06,temple,,Navy,L (24-31),29,50,58.0,240,2,34,156,4.6,0,84,396,4.7,10,14,1,25,6,56,1,1,2
12193,3,2014-09-20,temple,,Delaware State,W (59-0),16,21,76.2,179,2,40,172,4.3,3,61,351,5.8,8,11,0,19,8,69,0,2,2
12194,4,2014-09-27,temple,@,Connecticut,W (36-10),20,31,64.5,231,1,24,41,1.7,1,55,272,4.9,13,2,0,15,5,57,1,0,1
12195,5,2014-10-11,temple,,Tulsa,W (35-24),15,31,48.4,294,2,35,203,5.8,3,66,497,7.5,10,6,5,21,5,30,1,1,2
12196,6,2014-10-17,temple,@,Houston,L (10-31),12,29,41.4,259,1,20,98,4.9,0,49,357,7.3,6,4,1,11,11,93,1,3,4
12197,7,2014-10-25,temple,@,Central Florida,L (14-34),20,38,52.6,150,1,20,32,1.6,0,58,182,3.1,5,4,2,11,8,68,1,3,4
12198,8,2014-11-01,temple,,East Carolina,W (20-10),7,19,36.8,70,0,37,65,1.8,2,56,135,2.4,4,2,4,10,7,65,0,0,0
12199,9,2014-11-07,temple,,Memphis,L (13-16),16,37,43.2,140,0,32,158,4.9,1,69,298,4.3,6,8,2,16,4,36,1,1,2
12200,10,2014-11-15,temple,@,Penn State,L (13-30),17,38,44.7,187,1,20,61,3.1,0,58,248,4.3,4,4,0,8,10,69,1,4,5
12201,11,2014-11-29,temple,,Cincinnati,L (6-14),19,35,54.3,196,0,32,71,2.2,0,67,267,4.0,8,6,0,14,3,26,2,0,2
12202,12,2014-12-06,temple,@,Tulane,W (10-3),20,38,52.6,255,1,30,92,3.1,0,68,347,5.1,10,6,0,16,8,67,0,1,1
12203,,12 Games,temple,,,,214,403,53.1,2408,13,369,1293,3.5,11,772,3701,4.8,93,76,15,183,78,659,11,16,27
12204,1,2015-09-05,temple,,Penn State,W (27-10),16,21,76.2,168,0,43,149,3.5,3,64,317,5.0,7,6,2,15,5,35,1,0,1
12205,2,2015-09-12,temple,@,Cincinnati,W (34-26),13,20,65.0,81,2,36,215,6.0,1,56,296,5.3,5,8,0,13,12,112,1,0,1
12206,3,2015-09-19,temple,@,Massachusetts,W (25-23),28,49,57.1,391,1,37,67,1.8,1,86,458,5.3,19,4,1,24,7,70,1,2,3
12207,4,2015-10-02,temple,@,UNC Charlotte,W (37-3),11,23,47.8,116,2,45,206,4.6,2,68,322,4.7,6,11,2,19,2,25,1,0,1
12208,5,2015-10-10,temple,,Tulane,W (49-10),14,18,77.8,223,3,46,122,2.7,3,64,345,5.4,12,7,4,23,7,55,2,0,2
12209,6,2015-10-17,temple,,Central Florida,W (30-16),15,27,55.6,149,1,41,212,5.2,3,68,361,5.3,8,10,2,20,8,84,3,1,4
12210,7,2015-10-22,temple,@,East Carolina,W (24-14),19,36,52.8,250,1,25,72,2.9,2,61,322,5.3,9,5,3,17,12,114,0,0,0
12211,8,2015-10-31,temple,,Notre Dame,L (20-24),13,30,43.3,188,1,32,107,3.3,1,62,295,4.8,7,7,2,16,6,79,0,1,1
12212,9,2015-11-06,temple,@,Southern Methodist,W (60-40),18,25,72.0,268,4,37,268,7.2,3,62,536,8.6,9,9,2,20,7,81,0,0,0
12213,10,2015-11-14,temple,@,South Florida,L (23-44),20,48,41.7,259,1,31,121,3.9,1,79,380,4.8,12,7,3,22,5,48,0,1,1
12214,11,2015-11-21,temple,,Memphis,W (31-12),14,26,53.8,261,2,46,200,4.3,2,72,461,6.4,11,10,4,25,1,10,1,1,2
12215,12,2015-11-28,temple,,Connecticut,W (27-3),19,29,65.5,160,1,39,161,4.1,2,68,321,4.7,9,6,3,18,3,15,0,0,0
12216,13,2015-12-05,temple,@,Houston,L (13-24),26,44,59.1,287,1,27,98,3.6,0,71,385,5.4,13,5,1,19,2,15,1,1,2
12217,14,2015-12-22,temple,N,Toledo*,L (17-32),23,42,54.8,236,0,33,99,3.0,1,75,335,4.5,9,9,3,21,4,30,0,1,1
12218,,14 Games,temple,,,,249,438,56.8,3037,20,518,2097,4.0,25,956,5134,5.4,136,104,32,272,81,773,11,8,19
12219,1,2016-09-02,temple,,Army,L (13-28),12,26,46.2,168,0,28,83,3.0,1,54,251,4.6,10,5,1,16,5,35,0,3,3
12220,2,2016-09-10,temple,,Stony Brook,W (38-0),11,25,44.0,124,3,39,177,4.5,2,64,301,4.7,6,8,0,14,2,20,0,1,1
12221,3,2016-09-17,temple,@,Penn State,L (27-34),25,34,73.5,286,0,28,38,1.4,3,62,324,5.2,9,2,2,13,13,118,0,1,1
12222,4,2016-09-24,temple,,UNC Charlotte,W (48-20),17,32,53.1,297,2,34,210,6.2,4,66,507,7.7,11,12,3,26,5,31,0,0,0
12223,5,2016-10-01,temple,,Southern Methodist,W (45-20),7,18,38.9,124,1,45,244,5.4,4,63,368,5.8,5,11,1,17,3,25,1,2,3
12224,6,2016-10-06,temple,@,Memphis,L (27-34),36,59,61.0,445,2,29,86,3.0,1,88,531,6.0,19,6,2,27,7,61,1,2,3
12225,7,2016-10-15,temple,@,Central Florida,W (26-25),12,24,50.0,167,2,51,197,3.9,1,75,364,4.9,9,11,4,24,10,69,1,1,2
12226,8,2016-10-21,temple,,South Florida,W (46-30),14,21,66.7,209,1,48,322,6.7,4,69,531,7.7,8,16,2,26,8,75,0,0,0
12227,9,2016-10-29,temple,,Cincinnati,W (34-13),12,19,63.2,199,2,60,275,4.6,2,79,474,6.0,7,16,2,25,3,25,1,0,1
12228,10,2016-11-04,temple,@,Connecticut,W (21-0),12,18,66.7,215,3,46,216,4.7,0,64,431,6.7,9,13,0,22,4,25,1,2,3
12229,11,2016-11-19,temple,@,Tulane,W (31-0),18,33,54.5,337,2,48,196,4.1,2,81,533,6.6,12,12,2,26,7,55,0,0,0
12230,12,2016-11-26,temple,,East Carolina,W (37-10),12,20,60.0,158,0,46,256,5.6,5,66,414,6.3,9,12,2,23,0,0,0,0,0
12231,13,2016-12-03,temple,@,Navy,W (34-10),16,25,64.0,199,2,36,189,5.3,2,61,388,6.4,8,10,0,18,4,30,0,0,0
12232,14,2016-12-27,temple,N,Wake Forest*,L (26-34),28,49,57.1,396,2,23,-20,-0.9,0,72,376,5.2,14,5,2,21,4,35,1,1,2
12233,,14 Games,temple,,,,232,403,57.6,3324,22,561,2469,4.4,31,964,5793,6.0,136,139,23,298,75,604,6,13,19
12234,1,2017-09-02,temple,@,Notre Dame,L (16-49),19,35,54.3,245,2,37,85,2.3,0,72,330,4.6,13,4,1,18,6,42,1,0,1
12235,2,2017-09-09,temple,,Villanova,W (16-13),20,34,58.8,274,0,27,79,2.9,1,61,353,5.8,10,5,2,17,8,59,0,0,0
12236,3,2017-09-15,temple,,Massachusetts,W (29-21),24,39,61.5,268,3,34,119,3.5,0,73,387,5.3,14,5,1,20,7,74,0,0,0
12237,4,2017-09-21,temple,@,South Florida,L (7-43),7,25,28.0,89,0,33,-4,-0.1,0,58,85,1.5,4,2,1,7,6,51,2,4,6
12238,5,2017-09-30,temple,,Houston,L (13-20),20,42,47.6,182,1,37,142,3.8,0,79,324,4.1,9,11,2,22,10,83,0,3,3
12239,6,2017-10-07,temple,@,East Carolina,W (34-10),21,33,63.6,344,2,46,179,3.9,2,79,523,6.6,14,6,4,24,8,65,0,1,1
12240,7,2017-10-14,temple,,Connecticut,L (24-28),33,55,60.0,356,1,29,117,4.0,2,84,473,5.6,18,7,3,28,12,117,1,1,2
12241,8,2017-10-21,temple,@,Army,L (28-31),21,31,67.7,289,1,37,217,5.9,3,68,506,7.4,13,10,1,24,8,45,0,0,0
12242,9,2017-11-02,temple,,Navy,W (34-26),22,30,73.3,289,4,28,104,3.7,0,58,393,6.8,14,4,2,20,6,50,0,1,1
12243,10,2017-11-10,temple,@,Cincinnati,W (35-24),19,30,63.3,224,1,43,205,4.8,2,73,429,5.9,11,12,2,25,4,50,1,1,2
12244,11,2017-11-18,temple,,Central Florida,L (19-45),17,42,40.5,201,2,35,196,5.6,0,77,397,5.2,8,10,1,19,6,57,1,4,5
12245,12,2017-11-25,temple,@,Tulsa,W (43-22),21,29,72.4,258,3,34,193,5.7,2,63,451,7.2,13,6,1,20,10,123,0,0,0
12246,13,2017-12-21,temple,N,Florida International*,W (28-3),18,28,64.3,254,1,41,141,3.4,3,69,395,5.7,11,7,2,20,10,86,1,0,1
12247,,13 Games,temple,,,,262,453,57.8,3273,21,461,1773,3.8,15,914,5046,5.5,152,89,23,264,101,902,7,15,22
12248,1,2018-09-01,temple,,Villanova,L (17-19),19,33,57.6,205,1,22,46,2.1,0,55,251,4.6,10,5,1,16,6,56,0,2,2
12249,2,2018-09-08,temple,,Buffalo,L (29-36),17,38,44.7,240,3,29,115,4.0,0,67,355,5.3,10,6,0,16,6,65,1,2,3
12250,3,2018-09-15,temple,@,Maryland,W (35-14),16,28,57.1,264,2,52,165,3.2,2,80,429,5.4,11,9,1,21,4,50,0,1,1
12251,4,2018-09-20,temple,,Tulsa,W (31-17),8,21,38.1,109,0,36,191,5.3,2,57,300,5.3,4,11,1,16,6,47,0,2,2
12252,5,2018-09-29,temple,@,Boston College,L (35-45),21,47,44.7,261,0,34,191,5.6,4,81,452,5.6,15,7,2,24,11,95,1,2,3
12253,6,2018-10-06,temple,,East Carolina,W (49-6),25,30,83.3,297,4,48,173,3.6,2,78,470,6.0,14,11,1,26,6,66,0,1,1
12254,7,2018-10-13,temple,@,Navy,W (24-17),23,32,71.9,300,1,34,109,3.2,2,66,409,6.2,11,8,2,21,7,63,1,1,2
12255,8,2018-10-20,temple,,Cincinnati,W (24-17),20,42,47.6,237,3,30,80,2.7,0,72,317,4.4,11,3,2,16,6,60,0,3,3
12256,9,2018-11-01,temple,@,Central Florida,L (40-52),31,52,59.6,444,4,46,226,4.9,1,98,670,6.8,21,12,2,35,14,149,0,2,2
12257,10,2018-11-10,temple,@,Houston,W (59-49),15,23,65.2,225,0,55,317,5.8,8,78,542,6.9,11,15,2,28,15,114,1,0,1
12258,11,2018-11-17,temple,,South Florida,W (27-17),20,35,57.1,264,0,39,74,1.9,1,74,338,4.6,15,2,1,18,7,61,1,1,2
12259,,11 Games,temple,,,,215,381,56.4,2846,18,425,1687,4.0,22,806,4533,5.6,133,89,15,237,88,826,5,17,22
12260,1,2014-08-30,marshall,@,Miami (OH),W (42-27),20,32,62.5,261,3,36,171,4.8,3,68,432,6.4,13,4,3,20,9,98,1,0,1
12261,2,2014-09-06,marshall,,Rhode Island,W (48-7),18,35,51.4,292,2,46,432,9.4,4,81,724,8.9,11,18,0,29,8,64,3,0,3
12262,3,2014-09-13,marshall,,Ohio,W (44-14),20,33,60.6,448,4,46,257,5.6,1,79,705,8.9,14,16,1,31,7,60,0,1,1
12263,4,2014-09-20,marshall,@,Akron,W (48-17),20,38,52.6,242,1,38,284,7.5,5,76,526,6.9,11,13,4,28,20,188,0,1,1
12264,5,2014-10-04,marshall,@,Old Dominion,W (56-14),21,27,77.8,237,2,50,354,7.1,5,77,591,7.7,13,15,0,28,6,54,1,2,3
12265,6,2014-10-11,marshall,,Middle Tennessee State,W (49-24),17,33,51.5,337,3,52,252,4.8,4,85,589,6.9,12,12,4,28,8,101,1,1,2
12266,7,2014-10-18,marshall,@,Florida International,W (45-13),15,27,55.6,214,4,26,243,9.3,1,53,457,8.6,10,6,2,18,9,65,0,1,1
12267,8,2014-10-25,marshall,,Florida Atlantic,W (35-16),13,24,54.2,218,1,35,328,9.4,4,59,546,9.3,9,9,2,20,6,60,0,0,0
12268,9,2014-11-08,marshall,@,Southern Mississippi,W (63-17),13,19,68.4,186,2,38,335,8.8,7,57,521,9.1,10,13,2,25,7,80,0,0,0
12269,10,2014-11-15,marshall,,Rice,W (41-14),23,37,62.2,297,4,44,284,6.5,1,81,581,7.2,17,13,0,30,7,70,1,1,2
12270,11,2014-11-22,marshall,@,Alabama-Birmingham,W (23-18),20,39,51.3,284,2,39,231,5.9,0,78,515,6.6,13,9,2,24,11,90,1,1,2
12271,12,2014-11-28,marshall,,Western Kentucky,L (66-67),29,46,63.0,417,7,36,291,8.1,2,82,708,8.6,19,17,1,37,6,59,0,4,4
12272,13,2014-12-06,marshall,,Louisiana Tech,W (26-23),25,46,54.3,308,2,35,121,3.5,0,81,429,5.3,16,4,0,20,9,75,3,1,4
12273,14,2014-12-23,marshall,N,Northern Illinois*,W (52-23),25,37,67.6,281,3,38,224,5.9,3,75,505,6.7,15,12,1,28,6,60,0,0,0
12274,,14 Games,marshall,,,,279,473,59.0,4022,40,559,3807,6.8,40,1032,7829,7.6,183,161,22,366,119,1124,11,13,24
12275,1,2015-09-06,marshall,,Purdue,W (41-31),23,36,63.9,234,2,29,163,5.6,1,65,397,6.1,11,5,4,20,6,57,2,1,3
12276,2,2015-09-12,marshall,@,Ohio,L (10-21),16,33,48.5,106,0,25,157,6.3,1,58,263,4.5,5,4,1,10,16,150,2,2,4
12277,3,2015-09-19,marshall,,Norfolk State,W (45-7),25,34,73.5,279,4,43,216,5.0,2,77,495,6.4,15,14,0,29,5,60,1,1,2
12278,4,2015-09-26,marshall,@,Kent State,W (36-29),14,36,38.9,151,2,44,126,2.9,2,80,277,3.5,9,5,3,17,4,45,1,2,3
12279,5,2015-10-03,marshall,,Old Dominion,W (27-7),21,35,60.0,212,2,40,112,2.8,1,75,324,4.3,9,7,1,17,7,77,2,0,2
12280,6,2015-10-09,marshall,,Southern Mississippi,W (31-10),11,21,52.4,163,2,35,114,3.3,1,56,277,4.9,6,7,1,14,8,96,0,1,1
12281,7,2015-10-17,marshall,@,Florida Atlantic,W (33-17),17,28,60.7,174,1,47,326,6.9,3,75,500,6.7,11,13,2,26,3,15,0,1,1
12282,8,2015-10-24,marshall,,North Texas,W (30-13),19,34,55.9,189,1,43,213,5.0,2,77,402,5.2,7,11,3,21,4,50,0,0,0
12283,9,2015-10-31,marshall,@,UNC Charlotte,W (34-10),35,53,66.0,494,2,39,136,3.5,2,92,630,6.8,21,8,2,31,14,100,0,0,0
12284,10,2015-11-07,marshall,@,Middle Tennessee State,L (24-27),35,58,60.3,376,3,45,139,3.1,0,103,515,5.0,18,9,3,30,11,86,0,1,1
12285,11,2015-11-14,marshall,,Florida International,W (52-0),17,26,65.4,174,3,39,289,7.4,3,65,463,7.1,8,16,2,26,3,14,1,1,2
12286,12,2015-11-27,marshall,@,Western Kentucky,L (28-49),20,41,48.8,242,2,25,31,1.2,1,66,273,4.1,11,3,2,16,6,65,2,2,4
12287,13,2015-12-26,marshall,N,Connecticut*,W (16-10),23,36,63.9,218,1,41,171,4.2,0,77,389,5.1,13,10,1,24,4,45,0,1,1
12288,,13 Games,marshall,,,,276,471,58.6,3012,25,495,2193,4.4,19,966,5205,5.4,144,112,25,281,91,860,11,13,24
12289,1,2016-09-10,marshall,,Morgan State,W (62-0),14,22,63.6,313,6,40,217,5.4,1,62,530,8.5,10,10,1,21,8,70,1,0,1
12290,2,2016-09-17,marshall,,Akron,L (38-65),33,59,55.9,446,4,38,114,3.0,1,97,560,5.8,17,8,6,31,17,180,1,3,4
12291,3,2016-09-24,marshall,,Louisville,L (28-59),9,21,42.9,59,2,43,148,3.4,1,64,207,3.2,2,10,4,16,9,95,1,1,2
12292,4,2016-10-01,marshall,@,Pittsburgh,L (27-43),20,32,62.5,240,2,30,104,3.5,2,62,344,5.5,7,9,2,18,5,67,0,1,1
12293,5,2016-10-08,marshall,@,North Texas,L (21-38),20,42,47.6,258,1,28,13,0.5,1,70,271,3.9,12,2,2,16,6,70,0,1,1
12294,6,2016-10-15,marshall,,Florida Atlantic,W (27-21),27,39,69.2,330,1,42,106,2.5,2,81,436,5.4,16,6,3,25,4,40,0,1,1
12295,7,2016-10-22,marshall,,UNC Charlotte,L (24-27),32,46,69.6,262,2,24,88,3.7,1,70,350,5.0,13,5,4,22,12,115,1,1,2
12296,8,2016-10-29,marshall,@,Southern Mississippi,L (14-24),20,34,58.8,166,1,25,60,2.4,1,59,226,3.8,8,2,1,11,5,65,0,0,0
12297,9,2016-11-05,marshall,@,Old Dominion,L (14-38),20,29,69.0,138,2,20,76,3.8,0,49,214,4.4,5,5,0,10,5,39,0,0,0
12298,10,2016-11-12,marshall,,Middle Tennessee State,W (42-17),21,37,56.8,246,4,41,207,5.0,2,78,453,5.8,13,13,3,29,3,35,0,0,0
12299,11,2016-11-19,marshall,@,Florida International,L (14-31),29,42,69.0,301,2,26,78,3.0,0,68,379,5.6,18,5,1,24,5,55,0,2,2
12300,12,2016-11-26,marshall,,Western Kentucky,L (6-60),19,35,54.3,143,1,39,87,2.2,0,74,230,3.1,4,10,4,18,11,90,0,2,2
12301,,12 Games,marshall,,,,264,438,60.3,2902,28,396,1298,3.3,12,834,4200,5.0,125,85,31,241,90,921,4,12,16
12302,1,2017-09-02,marshall,,Miami (OH),W (31-26),20,30,66.7,208,1,25,59,2.4,0,55,267,4.9,8,5,2,15,6,43,1,1,2
12303,2,2017-09-09,marshall,@,North Carolina State,L (20-37),26,43,60.5,350,2,25,101,4.0,0,68,451,6.6,13,5,0,18,9,86,1,1,2
12304,3,2017-09-16,marshall,,Kent State,W (21-0),23,43,53.5,223,1,33,158,4.8,2,76,381,5.0,11,10,2,23,8,75,0,1,1
12305,4,2017-09-30,marshall,@,Cincinnati,W (38-21),21,34,61.8,233,4,44,133,3.0,1,78,366,4.7,12,5,5,22,6,85,1,0,1
12306,5,2017-10-07,marshall,@,UNC Charlotte,W (14-3),19,28,67.9,192,2,42,212,5.0,0,70,404,5.8,11,10,2,23,5,30,2,0,2
12307,6,2017-10-14,marshall,,Old Dominion,W (35-3),12,23,52.2,176,3,40,195,4.9,1,63,371,5.9,7,8,3,18,3,25,0,0,0
12308,7,2017-10-20,marshall,@,Middle Tennessee State,W (38-10),16,24,66.7,168,0,43,202,4.7,4,67,370,5.5,9,10,2,21,7,63,0,0,0
12309,8,2017-10-28,marshall,,Florida International,L (30-41),33,52,63.5,363,3,29,142,4.9,1,81,505,6.2,19,8,2,29,3,35,1,2,3
12310,9,2017-11-03,marshall,@,Florida Atlantic,L (25-30),20,39,51.3,253,2,41,128,3.1,1,80,381,4.8,11,6,4,21,7,37,0,4,4
12311,10,2017-11-11,marshall,,Western Kentucky,W (30-23),17,28,60.7,190,0,49,144,2.9,2,77,334,4.3,10,11,1,22,7,69,0,1,1
12312,11,2017-11-18,marshall,@,Texas-San Antonio,L (7-9),16,23,69.6,189,1,23,40,1.7,0,46,229,5.0,9,2,1,12,7,70,1,1,2
12313,12,2017-11-25,marshall,,Southern Mississippi,L (27-28),26,44,59.1,308,4,26,74,2.8,0,70,382,5.5,12,6,5,23,6,52,2,1,3
12314,13,2017-12-16,marshall,N,Colorado State*,W (31-28),17,32,53.1,262,2,33,239,7.2,2,65,501,7.7,10,8,0,18,11,107,0,2,2
12315,,13 Games,marshall,,,,266,443,60.0,3115,25,453,1827,4.0,14,896,4942,5.5,142,94,29,265,85,777,9,14,23
12316,1,2018-09-01,marshall,@,Miami (OH),W (35-28),24,37,64.9,272,2,38,171,4.5,3,75,443,5.9,11,11,2,24,7,62,0,0,0
12317,2,2018-09-08,marshall,,Eastern Kentucky,W (32-16),23,39,59.0,278,3,28,89,3.2,1,67,367,5.5,10,6,1,17,8,70,3,1,4
12318,3,2018-09-22,marshall,,North Carolina State,L (20-37),22,43,51.2,270,1,22,54,2.5,0,65,324,5.0,11,3,1,15,4,20,1,2,3
12319,4,2018-09-29,marshall,@,Western Kentucky,W (20-17),18,39,46.2,288,2,33,113,3.4,0,72,401,5.6,11,6,0,17,6,70,1,3,4
12320,5,2018-10-05,marshall,,Middle Tennessee State,L (24-34),17,35,48.6,173,2,53,209,3.9,1,88,382,4.3,9,14,5,28,6,59,2,1,3
12321,6,2018-10-13,marshall,@,Old Dominion,W (42-20),18,29,62.1,182,1,45,319,7.1,5,74,501,6.8,9,13,2,24,8,101,0,1,1
12322,7,2018-10-20,marshall,,Florida Atlantic,W (31-7),13,24,54.2,102,2,48,233,4.9,2,72,335,4.7,4,14,0,18,5,55,0,0,0
12323,8,2018-11-03,marshall,@,Southern Mississippi,L (24-26),17,38,44.7,218,1,22,31,1.4,1,60,249,4.2,9,4,2,15,7,79,3,2,5
12324,9,2018-11-10,marshall,,UNC Charlotte,W (30-13),15,26,57.7,178,1,38,147,3.9,2,64,325,5.1,8,8,0,16,3,20,1,0,1
12325,10,2018-11-17,marshall,,Texas-San Antonio,W (23-0),19,36,52.8,387,2,37,118,3.2,0,73,505,6.9,14,6,2,22,6,49,0,0,0
12326,,10 Games,marshall,,,,186,346,53.8,2348,17,364,1484,4.1,15,710,3832,5.4,96,85,15,196,60,585,11,10,21
12327,1,2014-08-28,boise-state,N,Mississippi,L (13-35),36,48,75.0,264,1,37,135,3.6,0,85,399,4.7,12,10,4,26,9,72,0,4,4
12328,2,2014-09-06,boise-state,,Colorado State,W (37-24),22,33,66.7,352,2,56,324,5.8,3,89,676,7.6,15,19,1,35,10,101,0,1,1
12329,3,2014-09-13,boise-state,@,Connecticut,W (38-21),20,29,69.0,240,3,27,52,1.9,0,56,292,5.2,11,1,1,13,7,65,1,0,1
12330,4,2014-09-20,boise-state,,Louisiana,W (34-9),24,31,77.4,237,0,48,262,5.5,4,79,499,6.3,10,14,0,24,8,60,0,0,0
12331,5,2014-09-27,boise-state,@,Air Force,L (14-28),30,58,51.7,370,2,29,97,3.3,0,87,467,5.4,16,6,2,24,9,80,2,5,7
12332,6,2014-10-04,boise-state,@,Nevada,W (51-46),26,31,83.9,346,2,48,224,4.7,4,79,570,7.2,17,6,2,25,5,63,2,1,3
12333,7,2014-10-17,boise-state,,Fresno State,W (37-27),23,32,71.9,228,2,51,264,5.2,2,83,492,5.9,13,10,1,24,6,30,1,0,1
12334,8,2014-10-24,boise-state,,Brigham Young,W (55-30),24,31,77.4,410,4,48,227,4.7,3,79,637,8.1,15,13,0,28,8,70,0,1,1
12335,9,2014-11-08,boise-state,@,New Mexico,W (60-49),21,32,65.6,367,4,48,291,6.1,4,80,658,8.2,16,17,1,34,3,24,0,0,0
12336,10,2014-11-15,boise-state,,San Diego State,W (38-29),19,28,67.9,187,1,47,212,4.5,4,75,399,5.3,10,10,2,22,5,37,0,2,2
12337,11,2014-11-22,boise-state,@,Wyoming,W (63-14),13,19,68.4,246,3,49,312,6.4,4,68,558,8.2,9,15,0,24,2,20,1,0,1
12338,12,2014-11-29,boise-state,,Utah State,W (50-19),19,28,67.9,215,2,54,283,5.2,5,82,498,6.1,11,14,1,26,7,60,1,0,1
12339,13,2014-12-06,boise-state,,Fresno State,W (28-14),9,16,56.3,155,0,33,149,4.5,3,49,304,6.2,4,7,0,11,7,47,0,0,0
12340,14,2014-12-31,boise-state,N,Arizona*,W (38-30),24,35,68.6,309,1,34,162,4.8,3,69,471,6.8,14,6,2,22,6,72,1,1,2
12341,,14 Games,boise-state,,,,310,451,68.7,3926,27,609,2994,4.9,39,1060,6920,6.5,173,148,17,338,92,801,9,15,24
12342,1,2015-09-04,boise-state,,Washington,W (16-13),17,27,63.0,152,0,53,185,3.5,2,80,337,4.2,9,11,1,21,7,71,1,1,2
12343,2,2015-09-12,boise-state,@,Brigham Young,L (24-35),25,38,65.8,297,1,31,64,2.1,2,69,361,5.2,0,0,0,17,11,76,0,3,3
12344,3,2015-09-18,boise-state,,Idaho State,W (52-0),22,28,78.6,254,1,58,344,5.9,6,86,598,7.0,15,17,0,32,5,25,0,0,0
12345,4,2015-09-25,boise-state,@,Virginia,W (56-14),25,38,65.8,358,3,31,89,2.9,1,69,447,6.5,13,5,1,19,4,25,0,0,0
12346,5,2015-10-03,boise-state,,Hawaii,W (55-0),20,29,69.0,275,3,59,279,4.7,4,88,554,6.3,11,16,2,29,8,80,0,0,0
12347,6,2015-10-10,boise-state,@,Colorado State,W (41-10),24,37,64.9,396,2,44,201,4.6,3,81,597,7.4,17,8,2,27,6,65,0,1,1
12348,7,2015-10-16,boise-state,@,Utah State,L (26-52),25,50,50.0,299,0,30,34,1.1,3,80,333,4.2,12,5,3,20,3,30,5,3,8
12349,8,2015-10-24,boise-state,,Wyoming,W (34-14),22,28,78.6,211,3,47,207,4.4,1,75,418,5.6,11,12,1,24,8,74,1,0,1
12350,9,2015-10-31,boise-state,@,Nevada-Las Vegas,W (55-27),36,53,67.9,473,3,37,232,6.3,4,90,705,7.8,21,10,3,34,8,51,1,0,1
12351,10,2015-11-14,boise-state,,New Mexico,L (24-31),40,74,54.1,503,2,40,135,3.4,1,114,638,5.6,25,8,7,40,4,39,1,3,4
12352,11,2015-11-20,boise-state,,Air Force,L (30-37),23,48,47.9,237,1,32,141,4.4,2,80,378,4.7,11,5,4,20,4,45,0,0,0
12353,12,2015-11-27,boise-state,@,San Jose State,W (40-23),25,34,73.5,197,2,35,300,8.6,3,69,497,7.2,11,13,2,26,6,50,0,0,0
12354,13,2015-12-23,boise-state,N,Northern Illinois*,W (55-7),29,40,72.5,377,3,56,277,4.9,4,96,654,6.8,19,16,0,35,8,65,1,1,2
12355,,13 Games,boise-state,,,,333,524,63.5,4029,24,553,2488,4.5,36,1077,6517,6.1,175,126,26,344,82,696,10,12,22
12356,1,2016-09-03,boise-state,@,Louisiana,W (45-10),24,35,68.6,426,3,38,158,4.2,3,73,584,8.0,18,9,1,28,7,60,0,0,0
12357,2,2016-09-10,boise-state,,Washington State,W (31-28),19,35,54.3,299,1,26,121,4.7,2,61,420,6.9,14,6,1,21,3,35,0,3,3
12358,3,2016-09-24,boise-state,@,Oregon State,W (38-24),20,37,54.1,238,1,42,274,6.5,3,79,512,6.5,13,14,0,27,6,55,2,0,2
12359,4,2016-10-01,boise-state,,Utah State,W (21-10),17,26,65.4,230,3,40,154,3.9,0,66,384,5.8,9,8,2,19,8,101,1,0,1
12360,5,2016-10-07,boise-state,@,New Mexico,W (49-21),21,30,70.0,391,5,29,65,2.2,2,59,456,7.7,16,2,4,22,2,15,0,0,0
12361,6,2016-10-15,boise-state,,Colorado State,W (28-23),17,25,68.0,218,2,48,226,4.7,2,73,444,6.1,10,11,0,21,3,19,0,0,0
12362,7,2016-10-20,boise-state,,Brigham Young,W (28-27),25,39,64.1,442,3,35,129,3.7,1,74,571,7.7,18,6,0,24,8,65,3,2,5
12363,8,2016-10-29,boise-state,@,Wyoming,L (28-30),23,36,63.9,328,1,27,159,5.9,3,63,487,7.7,16,8,0,24,4,24,1,1,2
12364,9,2016-11-04,boise-state,,San Jose State,W (45-31),16,21,76.2,219,3,54,298,5.5,3,75,517,6.9,12,15,3,30,2,10,0,0,0
12365,10,2016-11-12,boise-state,@,Hawaii,W (52-16),20,24,83.3,357,4,44,246,5.6,3,68,603,8.9,11,11,3,25,6,55,0,0,0
12366,11,2016-11-18,boise-state,,Nevada-Las Vegas,W (42-25),10,21,47.6,109,0,47,271,5.8,6,68,380,5.6,6,14,2,22,1,10,1,0,1
12367,12,2016-11-25,boise-state,@,Air Force,L (20-27),9,26,34.6,316,1,25,84,3.4,1,51,400,7.8,8,3,1,12,3,27,1,0,1
12368,13,2016-12-27,boise-state,N,Baylor*,L (12-31),32,51,62.7,305,1,38,83,2.2,0,89,388,4.4,16,8,1,25,3,15,1,2,3
12369,,13 Games,boise-state,,,,253,406,62.3,3878,28,493,2268,4.6,29,899,6146,6.8,167,115,18,300,56,491,10,8,18
12370,1,2017-09-02,boise-state,,Troy,W (24-13),19,32,59.4,210,1,44,147,3.3,1,76,357,4.7,11,7,1,19,7,47,1,1,2
12371,2,2017-09-09,boise-state,@,Washington State,L (44-47),19,28,67.9,237,2,42,168,4.0,2,70,405,5.8,10,9,0,19,5,34,3,1,4
12372,3,2017-09-14,boise-state,,New Mexico,W (28-14),15,19,78.9,137,2,32,127,4.0,2,51,264,5.2,7,5,0,12,8,73,0,0,0
12373,4,2017-09-22,boise-state,,Virginia,L (23-42),28,53,52.8,353,1,24,30,1.3,2,77,383,5.0,16,3,3,22,9,64,0,1,1
12374,5,2017-10-06,boise-state,@,Brigham Young,W (24-7),13,20,65.0,142,1,47,158,3.4,2,67,300,4.5,8,10,1,19,1,5,0,1,1
12375,6,2017-10-14,boise-state,@,San Diego State,W (31-14),14,23,60.9,125,1,34,186,5.5,1,57,311,5.5,4,10,1,15,3,35,0,0,0
12376,7,2017-10-21,boise-state,,Wyoming,W (24-14),18,24,75.0,177,1,43,166,3.9,2,67,343,5.1,9,11,1,21,3,35,0,0,0
12377,8,2017-10-28,boise-state,@,Utah State,W (41-14),24,34,70.6,370,5,45,163,3.6,0,79,533,6.7,17,7,3,27,9,72,0,0,0
12378,9,2017-11-04,boise-state,,Nevada,W (41-14),25,34,73.5,339,2,35,140,4.0,3,69,479,6.9,15,8,1,24,6,60,0,0,0
12379,10,2017-11-11,boise-state,@,Colorado State,W (59-52),23,45,51.1,331,4,39,310,7.9,4,84,641,7.6,18,14,1,33,6,54,1,1,2
12380,11,2017-11-18,boise-state,,Air Force,W (44-19),18,26,69.2,338,3,29,90,3.1,1,55,428,7.8,11,4,4,19,6,53,0,0,0
12381,12,2017-11-25,boise-state,@,Fresno State,L (17-28),25,36,69.4,294,1,31,107,3.5,1,67,401,6.0,11,7,1,19,6,48,0,0,0
12382,13,2017-12-02,boise-state,,Fresno State,W (17-14),17,32,53.1,255,0,38,109,2.9,2,70,364,5.2,11,6,2,19,9,70,0,0,0
12383,14,2017-12-16,boise-state,N,Oregon*,W (38-28),23,43,53.5,369,2,47,112,2.4,2,90,481,5.3,16,8,4,28,4,50,1,2,3
12384,,14 Games,boise-state,,,,281,449,62.6,3677,26,530,2013,3.8,25,979,5690,5.8,164,109,23,296,82,700,6,7,13
12385,1,2018-09-01,boise-state,@,Troy,W (56-20),20,28,71.4,305,4,29,111,3.8,2,57,416,7.3,10,6,0,16,4,27,1,0,1
12386,2,2018-09-08,boise-state,,Connecticut,W (62-7),25,33,75.8,418,4,45,400,8.9,4,78,818,10.5,18,19,1,38,7,71,0,0,0
12387,3,2018-09-15,boise-state,@,Oklahoma State,L (21-44),39,56,69.6,380,3,31,34,1.1,0,87,414,4.8,21,2,0,23,5,40,1,0,1
12388,4,2018-09-29,boise-state,@,Wyoming,W (34-14),29,43,67.4,345,2,46,161,3.5,2,89,506,5.7,14,11,4,29,9,71,0,0,0
12389,5,2018-10-06,boise-state,,San Diego State,L (13-19),22,44,50.0,178,0,36,51,1.4,2,80,229,2.9,8,7,1,16,6,52,0,3,3
12390,6,2018-10-13,boise-state,@,Nevada,W (31-27),28,38,73.7,299,2,40,207,5.2,1,78,506,6.5,14,9,1,24,9,108,1,3,4
12391,7,2018-10-19,boise-state,,Colorado State,W (56-28),23,27,85.2,322,4,37,150,4.1,2,64,472,7.4,16,8,2,26,5,40,0,0,0
12392,8,2018-10-27,boise-state,@,Air Force,W (48-38),22,36,61.1,409,5,33,121,3.7,1,69,530,7.7,16,9,1,26,1,15,0,0,0
12393,9,2018-11-03,boise-state,,Brigham Young,W (21-16),23,35,65.7,214,1,37,113,3.1,2,72,327,4.5,10,10,0,20,7,81,1,1,2
12394,10,2018-11-09,boise-state,,Fresno State,W (24-17),24,30,80.0,269,1,44,179,4.1,2,74,448,6.1,11,12,1,24,4,45,0,1,1
12395,11,2018-11-16,boise-state,@,New Mexico,W (45-14),17,27,63.0,222,3,41,227,5.5,2,68,449,6.6,14,14,2,30,5,30,0,0,0
12396,,11 Games,boise-state,,,,272,397,68.5,3361,29,419,1754,4.2,20,816,5115,6.3,152,107,13,272,62,580,4,8,12
12397,1,2014-08-31,utah-state,@,Tennessee,L (7-38),18,35,51.4,144,1,24,100,4.2,0,59,244,4.1,6,4,1,11,5,42,1,2,3
12398,2,2014-09-06,utah-state,,Idaho State,W (40-20),13,30,43.3,116,0,45,311,6.9,3,75,427,5.7,5,14,2,21,14,160,1,1,2
12399,3,2014-09-13,utah-state,,Wake Forest,W (36-24),32,44,72.7,331,3,35,60,1.7,0,79,391,4.9,13,5,5,23,8,65,1,2,3
12400,4,2014-09-20,utah-state,@,Arkansas State,L (14-21),27,47,57.4,268,2,37,145,3.9,0,84,413,4.9,6,12,1,19,11,100,0,1,1
12401,5,2014-10-03,utah-state,@,Brigham Young,W (35-20),19,25,76.0,321,3,46,136,3.0,2,71,457,6.4,12,7,3,22,12,105,1,0,1
12402,6,2014-10-11,utah-state,,Air Force,W (34-16),22,31,71.0,311,2,28,77,2.8,2,59,388,6.6,9,5,0,14,3,43,1,0,1
12403,7,2014-10-18,utah-state,@,Colorado State,L (13-16),19,31,61.3,160,0,19,100,5.3,1,50,260,5.2,6,3,2,11,6,45,0,1,1
12404,8,2014-10-25,utah-state,,Nevada-Las Vegas,W (34-20),16,29,55.2,266,3,47,178,3.8,1,76,444,5.8,7,10,1,18,7,60,1,0,1
12405,9,2014-11-01,utah-state,@,Hawaii,W (35-14),15,16,93.8,230,4,50,235,4.7,0,66,465,7.0,6,13,2,21,12,96,0,0,0
12406,10,2014-11-07,utah-state,@,Wyoming,W (20-3),13,17,76.5,150,0,33,206,6.2,1,50,356,7.1,3,8,1,12,6,75,1,0,1
12407,11,2014-11-15,utah-state,,New Mexico,W (28-21),13,21,61.9,150,1,36,272,7.6,3,57,422,7.4,9,10,0,19,3,25,0,1,1
12408,12,2014-11-21,utah-state,,San Jose State,W (41-7),15,23,65.2,108,1,42,313,7.5,5,65,421,6.5,8,10,2,20,5,40,0,1,1
12409,13,2014-11-29,utah-state,@,Boise State,L (19-50),16,28,57.1,159,0,30,109,3.6,1,58,268,4.6,7,7,2,16,7,52,2,1,3
12410,14,2014-12-20,utah-state,N,Texas-El Paso*,W (21-6),5,12,41.7,68,0,40,279,7.0,3,52,347,6.7,2,12,2,16,2,10,1,1,2
12411,,14 Games,utah-state,,,,243,389,62.5,2782,20,512,2521,4.9,22,901,5303,5.9,99,120,24,243,101,918,10,11,21
12412,1,2015-09-03,utah-state,,Southern Utah,W (12-9),16,33,48.5,110,0,35,140,4.0,0,68,250,3.7,5,7,3,15,11,123,0,1,1
12413,2,2015-09-11,utah-state,@,Utah,L (14-24),22,35,62.9,256,2,32,117,3.7,0,67,373,5.6,12,8,1,21,6,61,1,2,3
12414,3,2015-09-19,utah-state,@,Washington,L (17-31),17,33,51.5,171,0,30,83,2.8,1,63,254,4.0,8,4,1,13,5,25,0,2,2
12415,4,2015-10-03,utah-state,,Colorado State,W (33-18),12,21,57.1,137,1,45,298,6.6,2,66,435,6.6,6,11,4,21,12,125,0,0,0
12416,5,2015-10-10,utah-state,@,Fresno State,W (56-14),19,27,70.4,281,1,43,201,4.7,7,70,482,6.9,11,9,1,21,7,59,1,0,1
12417,6,2015-10-16,utah-state,,Boise State,W (52-26),17,24,70.8,157,3,43,177,4.1,3,67,334,5.0,9,5,1,15,11,104,1,0,1
12418,7,2015-10-23,utah-state,@,San Diego State,L (14-48),9,20,45.0,95,1,36,144,4.0,1,56,239,4.3,4,8,4,16,5,55,3,1,4
12419,8,2015-10-30,utah-state,,Wyoming,W (58-27),16,19,84.2,296,4,43,296,6.9,3,62,592,9.5,13,18,3,34,3,25,1,0,1
12420,9,2015-11-07,utah-state,@,New Mexico,L (13-14),14,25,56.0,216,1,37,78,2.1,0,62,294,4.7,8,3,2,13,2,8,2,0,2
12421,10,2015-11-14,utah-state,@,Air Force,L (28-35),25,47,53.2,364,4,23,75,3.3,0,70,439,6.3,14,5,0,19,2,21,0,1,1
12422,11,2015-11-21,utah-state,,Nevada,W (31-27),14,29,48.3,109,0,42,204,4.9,2,71,313,4.4,5,12,2,19,3,30,1,2,3
12423,12,2015-11-28,utah-state,,Brigham Young,L (28-51),20,45,44.4,243,1,43,202,4.7,3,88,445,5.1,10,12,1,23,8,70,2,0,2
12424,13,2015-12-22,utah-state,N,Akron*,L (21-23),28,45,62.2,237,3,29,131,4.5,0,74,368,5.0,13,7,2,22,8,60,2,1,3
12425,,13 Games,utah-state,,,,229,403,56.8,2672,21,481,2146,4.5,22,884,4818,5.5,118,109,25,252,83,766,14,10,24
12426,1,2016-09-01,utah-state,,Weber State,W (45-6),11,17,64.7,100,0,44,428,9.7,6,61,528,8.7,7,16,0,23,4,30,0,0,0
12427,2,2016-09-10,utah-state,@,Southern California,L (7-45),25,39,64.1,204,1,26,49,1.9,0,65,253,3.9,10,1,2,13,5,38,0,1,1
12428,3,2016-09-16,utah-state,,Arkansas State,W (34-20),11,25,44.0,136,1,47,198,4.2,3,72,334,4.6,7,9,2,18,6,54,0,1,1
12429,4,2016-09-24,utah-state,,Air Force,L (20-27),30,48,62.5,372,1,32,42,1.3,1,80,414,5.2,15,4,3,22,7,46,1,1,2
12430,5,2016-10-01,utah-state,@,Boise State,L (10-21),29,51,56.9,287,1,25,71,2.8,0,76,358,4.7,10,4,4,18,12,90,0,0,0
12431,6,2016-10-08,utah-state,@,Colorado State,L (24-31),20,35,57.1,210,0,39,251,6.4,3,74,461,6.2,8,11,4,23,9,71,1,1,2
12432,7,2016-10-22,utah-state,,Fresno State,W (38-20),17,29,58.6,188,3,38,208,5.5,1,67,396,5.9,9,13,2,24,5,40,0,0,0
12433,8,2016-10-28,utah-state,,San Diego State,L (13-40),11,26,42.3,181,1,28,71,2.5,1,54,252,4.7,6,4,2,12,4,39,1,1,2
12434,9,2016-11-05,utah-state,@,Wyoming,L (28-52),24,45,53.3,303,1,24,111,4.6,3,69,414,6.0,11,4,6,21,7,58,1,1,2
12435,10,2016-11-12,utah-state,,New Mexico,L (21-24),21,27,77.8,263,1,28,128,4.6,2,55,391,7.1,10,7,4,21,7,75,0,1,1
12436,11,2016-11-19,utah-state,@,Nevada,L (37-38),10,18,55.6,127,0,50,396,7.9,4,68,523,7.7,6,15,0,21,9,74,1,1,2
12437,12,2016-11-26,utah-state,@,Brigham Young,L (10-28),12,23,52.2,103,0,28,97,3.5,1,51,200,3.9,6,4,1,11,11,94,1,1,2
12438,,12 Games,utah-state,,,,221,383,57.7,2474,10,409,2050,5.0,25,792,4524,5.7,105,92,30,227,86,709,6,9,15
12439,1,2017-09-01,utah-state,@,Wisconsin,L (10-59),25,41,61.0,219,0,27,85,3.1,1,68,304,4.5,11,3,2,16,9,93,1,3,4
12440,2,2017-09-07,utah-state,,Idaho State,W (51-13),27,32,84.4,341,2,49,255,5.2,3,81,596,7.4,17,12,1,30,9,48,1,1,2
12441,3,2017-09-16,utah-state,@,Wake Forest,L (10-46),15,37,40.5,225,1,31,42,1.4,0,68,267,3.9,7,4,0,11,4,39,0,1,1
12442,4,2017-09-23,utah-state,@,San Jose State,W (61-10),28,41,68.3,271,3,57,318,5.6,3,98,589,6.0,16,12,1,29,7,60,1,2,3
12443,5,2017-09-29,utah-state,,Brigham Young,W (40-24),16,30,53.3,176,2,44,112,2.5,1,74,288,3.9,6,7,1,14,4,38,0,1,1
12444,6,2017-10-07,utah-state,,Colorado State,L (14-27),18,34,52.9,149,1,29,63,2.2,0,63,212,3.4,5,5,3,14,7,73,0,0,0
12445,7,2017-10-14,utah-state,,Wyoming,L (23-28),20,39,51.3,232,1,37,131,3.5,1,76,363,4.8,12,9,2,23,4,50,2,3,5
12446,8,2017-10-21,utah-state,@,Nevada-Las Vegas,W (52-28),20,29,69.0,323,2,47,265,5.6,5,76,588,7.7,10,15,0,25,6,55,2,0,2
12447,9,2017-10-28,utah-state,,Boise State,L (14-41),18,34,52.9,186,1,27,93,3.4,1,61,279,4.6,7,4,2,13,7,72,0,0,0
12448,10,2017-11-04,utah-state,@,New Mexico,W (24-10),13,24,54.2,114,0,24,129,5.4,2,48,243,5.1,7,4,1,12,5,50,1,1,2
12449,11,2017-11-18,utah-state,,Hawaii,W (38-0),12,20,60.0,164,2,39,311,8.0,3,59,475,8.1,8,12,0,20,2,10,0,1,1
12450,12,2017-11-25,utah-state,@,Air Force,L (35-38),17,30,56.7,284,2,29,237,8.2,3,59,521,8.8,13,6,0,19,8,67,1,0,1
12451,13,2017-12-29,utah-state,N,New Mexico State*,L (20-26),25,44,56.8,254,0,45,187,4.2,1,89,441,5.0,12,8,2,22,8,73,2,0,2
12452,,13 Games,utah-state,,,,254,435,58.4,2938,17,485,2228,4.6,24,920,5166,5.6,131,101,15,248,80,728,11,13,24
12453,1,2018-08-31,utah-state,@,Michigan State,L (31-38),29,44,65.9,319,0,25,25,1.0,3,69,344,5.0,18,2,2,22,7,49,0,2,2
12454,2,2018-09-08,utah-state,,New Mexico State,W (60-13),17,31,54.8,172,1,46,274,6.0,3,77,446,5.8,8,11,3,22,10,91,1,1,2
12455,3,2018-09-13,utah-state,,Tennessee Tech,W (73-12),30,35,85.7,291,2,42,330,7.9,7,77,621,8.1,14,15,2,31,6,60,2,0,2
12456,4,2018-09-22,utah-state,,Air Force,W (42-32),26,38,68.4,356,2,24,133,5.5,4,62,489,7.9,19,3,0,22,5,35,2,0,2
12457,5,2018-10-05,utah-state,@,Brigham Young,W (45-20),18,28,64.3,165,4,42,223,5.3,1,70,388,5.5,8,10,1,19,12,125,0,0,0
12458,6,2018-10-13,utah-state,,Nevada-Las Vegas,W (59-28),22,31,71.0,377,5,38,221,5.8,2,69,598,8.7,14,9,1,24,5,55,1,0,1
12459,7,2018-10-20,utah-state,@,Wyoming,W (24-16),12,28,42.9,53,0,33,141,4.3,2,61,194,3.2,1,8,2,11,6,52,0,1,1
12460,8,2018-10-27,utah-state,,New Mexico,W (61-19),30,42,71.4,516,4,49,188,3.8,2,91,704,7.7,19,11,0,30,6,43,3,0,3
12461,9,2018-11-03,utah-state,@,Hawaii,W (56-17),19,24,79.2,175,1,54,426,7.9,7,78,601,7.7,11,17,1,29,12,105,1,0,1
12462,10,2018-11-10,utah-state,,San Jose State,W (62-24),35,50,70.0,510,5,39,296,7.6,3,89,806,9.1,19,11,3,33,10,82,0,0,0
12463,11,2018-11-17,utah-state,@,Colorado State,W (29-24),15,24,62.5,169,1,28,141,5.0,0,52,310,6.0,7,9,0,16,7,71,1,0,1
12464,,11 Games,utah-state,,,,253,375,67.5,3103,25,420,2398,5.7,34,795,5501,6.9,138,106,15,259,86,768,11,4,15
12465,1,2014-08-30,air-force,,Nicholls State,W (44-16),3,6,50.0,19,0,73,539,7.4,6,79,558,7.1,1,26,0,27,9,109,0,0,0
12466,2,2014-09-06,air-force,@,Wyoming,L (13-17),17,32,53.1,226,0,52,151,2.9,1,84,377,4.5,12,9,0,21,4,25,2,0,2
12467,3,2014-09-13,air-force,@,Georgia State,W (48-38),12,15,80.0,224,2,65,315,4.8,4,80,539,6.7,11,18,2,31,2,20,0,0,0
12468,4,2014-09-27,air-force,,Boise State,W (28-14),5,12,41.7,48,1,60,287,4.8,2,72,335,4.7,2,12,2,16,5,47,2,0,2
12469,5,2014-10-04,air-force,,Navy,W (30-21),12,17,70.6,166,4,48,198,4.1,0,65,364,5.6,5,12,1,18,6,65,0,0,0
12470,6,2014-10-11,air-force,@,Utah State,L (16-34),15,29,51.7,224,0,51,155,3.0,1,80,379,4.7,10,6,2,18,4,30,2,2,4
12471,7,2014-10-18,air-force,,New Mexico,W (35-31),5,9,55.6,159,1,74,269,3.6,4,83,428,5.2,4,19,0,23,1,5,1,0,1
12472,8,2014-11-01,air-force,@,Army,W (23-6),8,12,66.7,141,2,62,242,3.9,0,74,383,5.2,6,13,2,21,1,5,0,1,1
12473,9,2014-11-08,air-force,@,Nevada-Las Vegas,W (48-21),6,7,85.7,156,1,78,386,4.9,5,85,542,6.4,4,21,1,26,2,30,1,0,1
12474,10,2014-11-15,air-force,,Nevada,W (45-38),11,15,73.3,129,3,65,342,5.3,3,80,471,5.9,6,20,2,28,5,48,0,0,0
12475,11,2014-11-21,air-force,@,San Diego State,L (14-30),12,27,44.4,189,1,41,140,3.4,1,68,329,4.8,5,11,0,16,3,20,3,1,4
12476,12,2014-11-28,air-force,,Colorado State,W (27-24),6,15,40.0,135,0,63,242,3.8,3,78,377,4.8,5,16,1,22,1,15,1,0,1
12477,13,2014-12-20,air-force,N,Western Michigan*,W (38-24),5,10,50.0,77,0,64,284,4.4,4,74,361,4.9,3,15,2,20,3,41,1,0,1
12478,,13 Games,air-force,,,,117,206,56.8,1893,15,796,3550,4.5,34,1002,5443,5.4,74,198,15,287,46,460,13,4,17
12479,1,2015-09-05,air-force,,Morgan State,W (63-7),4,7,57.1,119,2,63,394,6.3,5,70,513,7.3,4,22,3,29,6,57,0,0,0
12480,2,2015-09-12,air-force,,San Jose State,W (37-16),3,11,27.3,24,0,69,428,6.2,5,80,452,5.7,0,0,0,23,5,48,0,1,1
12481,3,2015-09-19,air-force,@,Michigan State,L (21-35),6,9,66.7,149,1,51,279,5.5,2,60,428,7.1,5,16,3,24,7,95,2,1,3
12482,4,2015-10-03,air-force,@,Navy,L (11-33),5,12,41.7,73,0,56,204,3.6,1,68,277,4.1,3,12,0,15,3,25,3,1,4
12483,5,2015-10-10,air-force,,Wyoming,W (31-17),5,10,50.0,80,1,58,299,5.2,3,68,379,5.6,2,14,0,16,2,30,1,1,2
12484,6,2015-10-17,air-force,@,Colorado State,L (23-38),10,16,62.5,137,0,56,269,4.8,3,72,406,5.6,5,14,2,21,5,45,1,1,2
12485,7,2015-10-24,air-force,,Fresno State,W (42-14),6,11,54.5,128,1,79,458,5.8,5,90,586,6.5,5,21,0,26,5,38,1,0,1
12486,8,2015-10-31,air-force,@,Hawaii,W (58-7),3,9,33.3,80,0,83,496,6.0,7,92,576,6.3,3,27,2,32,3,30,0,0,0
12487,9,2015-11-07,air-force,,Army,W (20-3),7,10,70.0,156,2,47,196,4.2,0,57,352,6.2,5,9,0,14,2,20,0,0,0
12488,10,2015-11-14,air-force,,Utah State,W (35-28),11,17,64.7,271,1,64,309,4.8,4,81,580,7.2,10,15,2,27,4,20,0,0,0
12489,11,2015-11-20,air-force,@,Boise State,W (37-30),9,16,56.3,279,2,54,328,6.1,2,70,607,8.7,8,15,0,23,4,58,1,3,4
12490,12,2015-11-28,air-force,@,New Mexico,L (35-47),6,16,37.5,167,3,38,222,5.8,2,54,389,7.2,4,9,1,14,1,14,0,3,3
12491,13,2015-12-05,air-force,@,San Diego State,L (24-27),5,11,45.5,35,0,46,305,6.6,3,57,340,6.0,3,11,0,14,2,9,0,0,0
12492,14,2015-12-29,air-force,N,California*,L (36-55),7,15,46.7,149,2,53,285,5.4,3,68,434,6.4,7,14,2,23,4,47,2,1,3
12493,,14 Games,air-force,,,,87,170,51.2,1847,15,817,4472,5.5,45,987,6319,6.4,64,199,15,301,53,536,11,12,23
12494,1,2016-09-03,air-force,,Abilene Christian,W (37-21),6,11,54.5,201,3,66,407,6.2,2,77,608,7.9,5,22,2,29,7,57,2,0,2
12495,2,2016-09-10,air-force,,Georgia State,W (48-14),3,9,33.3,67,0,83,464,5.6,5,92,531,5.8,2,28,0,30,2,30,0,0,0
12496,3,2016-09-24,air-force,@,Utah State,W (27-20),5,13,38.5,113,1,52,213,4.1,2,65,326,5.0,3,13,1,17,8,66,0,0,0
12497,4,2016-10-01,air-force,,Navy,W (28-14),8,15,53.3,257,2,53,173,3.3,1,68,430,6.3,8,10,0,18,5,70,0,1,1
12498,5,2016-10-08,air-force,@,Wyoming,L (26-35),6,19,31.6,188,2,39,149,3.8,1,58,337,5.8,6,6,0,12,4,45,1,3,4
12499,6,2016-10-15,air-force,N,New Mexico,L (40-45),12,24,50.0,280,2,49,251,5.1,3,73,531,7.3,11,12,1,24,4,41,0,0,0
12500,7,2016-10-22,air-force,,Hawaii,L (27-34),1,10,10.0,20,0,87,389,4.5,3,97,409,4.2,1,24,2,27,4,35,2,1,3
12501,8,2016-10-28,air-force,@,Fresno State,W (31-21),5,9,55.6,97,1,73,327,4.5,2,82,424,5.2,4,19,0,23,6,47,1,0,1
12502,9,2016-11-05,air-force,@,Army,W (31-12),6,9,66.7,195,1,52,249,4.8,3,61,444,7.3,6,12,2,20,9,99,1,0,1
12503,10,2016-11-12,air-force,,Colorado State,W (49-46),3,8,37.5,49,0,68,485,7.1,7,76,534,7.0,2,22,2,26,3,36,1,1,2
12504,11,2016-11-19,air-force,@,San Jose State,W (41-38),3,7,42.9,33,1,63,458,7.3,4,70,491,7.0,1,25,1,27,7,85,1,1,2
12505,12,2016-11-25,air-force,,Boise State,W (27-20),3,6,50.0,45,0,77,314,4.1,2,83,359,4.3,1,23,1,25,3,30,0,1,1
12506,13,2016-12-30,air-force,N,South Alabama*,W (45-21),7,10,70.0,207,1,60,257,4.3,4,70,464,6.6,6,14,4,24,5,25,0,0,0
12507,,13 Games,air-force,,,,68,150,45.3,1752,14,822,4136,5.0,39,972,5888,6.1,56,230,16,302,67,666,9,8,17
12508,1,2017-09-02,air-force,,Virginia Military Institute,W (62-0),10,14,71.4,190,2,67,457,6.8,7,81,647,8.0,6,26,0,32,5,53,0,0,0
12509,2,2017-09-16,air-force,@,Michigan,L (13-29),1,9,11.1,64,1,49,168,3.4,0,58,232,4.0,1,10,4,15,3,29,0,1,1
12510,3,2017-09-23,air-force,,San Diego State,L (24-28),2,6,33.3,33,0,60,220,3.7,3,66,253,3.8,1,13,0,14,5,52,0,1,1
12511,4,2017-09-30,air-force,@,New Mexico,L (38-56),9,18,50.0,158,3,63,238,3.8,2,81,396,4.9,8,15,3,26,2,15,2,0,2
12512,5,2017-10-07,air-force,@,Navy,L (45-48),10,17,58.8,281,2,55,340,6.2,4,72,621,8.6,8,18,1,27,3,25,2,0,2
12513,6,2017-10-14,air-force,,Nevada-Las Vegas,W (34-30),4,8,50.0,72,0,78,401,5.1,5,86,473,5.5,3,25,2,30,5,56,4,0,4
12514,7,2017-10-20,air-force,@,Nevada,W (45-42),4,7,57.1,41,0,89,552,6.2,6,96,593,6.2,3,32,1,36,5,58,1,1,2
12515,8,2017-10-28,air-force,@,Colorado State,W (45-28),2,4,50.0,64,1,74,413,5.6,4,78,477,6.1,1,26,3,30,4,28,0,1,1
12516,9,2017-11-04,air-force,,Army,L (0-21),6,13,46.2,95,0,34,95,2.8,0,47,190,4.0,4,8,0,12,3,21,0,0,0
12517,10,2017-11-11,air-force,,Wyoming,L (14-28),10,22,45.5,175,1,61,203,3.3,1,83,378,4.6,9,11,2,22,5,55,2,1,3
12518,11,2017-11-18,air-force,@,Boise State,L (19-44),7,13,53.8,115,0,51,181,3.5,2,64,296,4.6,5,12,1,18,6,63,3,0,3
12519,12,2017-11-25,air-force,,Utah State,W (38-35),4,12,33.3,33,0,82,407,5.0,4,94,440,4.7,3,23,2,28,2,10,0,1,1
12520,,12 Games,air-force,,,,69,143,48.3,1321,10,763,3675,4.8,38,906,4996,5.5,52,219,19,290,48,465,14,6,20
12521,1,2018-09-01,air-force,,Stony Brook,W (38-0),2,8,25.0,29,0,77,333,4.3,4,85,362,4.3,2,19,2,23,3,30,2,0,2
12522,2,2018-09-08,air-force,@,Florida Atlantic,L (27-33),8,13,61.5,164,1,56,209,3.7,2,69,373,5.4,5,11,3,19,5,50,0,1,1
12523,3,2018-09-22,air-force,@,Utah State,L (32-42),11,21,52.4,148,0,86,323,3.8,3,107,471,4.4,5,21,1,27,7,65,1,0,1
12524,4,2018-09-29,air-force,,Nevada,L (25-28),8,19,42.1,96,1,51,154,3.0,1,70,250,3.6,5,10,1,16,5,40,2,0,2
12525,5,2018-10-06,air-force,,Navy,W (35-7),6,10,60.0,142,1,55,257,4.7,4,65,399,6.1,6,10,1,17,3,32,0,0,0
12526,6,2018-10-12,air-force,@,San Diego State,L (17-21),8,17,47.1,62,0,51,214,4.2,2,68,276,4.1,4,9,1,14,5,56,0,1,1
12527,7,2018-10-19,air-force,@,Nevada-Las Vegas,W (41-35),9,11,81.8,217,1,52,355,6.8,4,63,572,9.1,7,17,2,26,9,76,2,0,2
12528,8,2018-10-27,air-force,,Boise State,L (38-48),11,16,68.8,242,3,51,201,3.9,2,67,443,6.6,9,13,1,23,4,25,0,0,0
12529,9,2018-11-03,air-force,@,Army,L (14-17),12,22,54.5,197,0,35,125,3.6,2,57,322,5.6,8,7,2,17,5,55,0,1,1
12530,10,2018-11-10,air-force,,New Mexico,W (42-24),5,6,83.3,145,2,67,478,7.1,4,73,623,8.5,4,23,0,27,2,11,3,0,3
12531,11,2018-11-17,air-force,@,Wyoming,L (27-35),5,9,55.6,53,0,65,362,5.6,3,74,415,5.6,3,22,0,25,5,66,0,2,2
12532,,11 Games,air-force,,,,85,152,55.9,1495,9,646,3011,4.7,31,798,4506,5.6,58,162,14,234,53,506,10,5,15
12533,1,2014-08-30,fresno-state,@,Southern California,L (13-52),18,36,50.0,160,0,33,157,4.8,2,69,317,4.6,8,6,3,17,5,47,0,4,4
12534,2,2014-09-06,fresno-state,@,Utah,L (27-59),24,40,60.0,283,3,40,55,1.4,1,80,338,4.2,11,6,7,24,6,55,1,0,1
12535,3,2014-09-13,fresno-state,,Nebraska,L (19-55),30,59,50.8,241,1,28,105,3.8,1,87,346,4.0,13,5,2,20,5,55,0,0,0
12536,4,2014-09-20,fresno-state,,Southern Utah,W (56-16),22,38,57.9,291,4,54,389,7.2,3,92,680,7.4,10,18,1,29,6,38,0,1,1
12537,5,2014-09-26,fresno-state,@,New Mexico,W (35-24),28,42,66.7,321,3,45,272,6.0,2,87,593,6.8,13,14,3,30,4,27,1,1,2
12538,6,2014-10-03,fresno-state,,San Diego State,W (24-13),14,28,50.0,143,0,43,172,4.0,3,71,315,4.4,5,7,4,16,4,37,1,1,2
12539,7,2014-10-10,fresno-state,@,Nevada-Las Vegas,L (27-30),25,44,56.8,310,3,33,177,5.4,1,77,487,6.3,12,7,2,21,6,80,1,2,3
12540,8,2014-10-17,fresno-state,@,Boise State,L (27-37),13,25,52.0,127,1,34,186,5.5,2,59,313,5.3,6,6,0,12,2,20,0,1,1
12541,9,2014-11-01,fresno-state,,Wyoming,L (17-45),14,29,48.3,149,1,31,167,5.4,1,60,316,5.3,7,8,1,16,3,20,0,2,2
12542,10,2014-11-08,fresno-state,,San Jose State,W (38-24),20,26,76.9,207,3,53,232,4.4,1,79,439,5.6,10,13,0,23,2,20,1,1,2
12543,11,2014-11-22,fresno-state,@,Nevada,W (40-20),25,47,53.2,313,4,52,238,4.6,1,99,551,5.6,13,14,2,29,2,20,1,1,2
12544,12,2014-11-29,fresno-state,,Hawaii,W (28-21),19,32,59.4,162,1,37,171,4.6,3,69,333,4.8,8,12,3,23,9,69,0,2,2
12545,13,2014-12-06,fresno-state,@,Boise State,L (14-28),30,46,65.2,332,1,41,70,1.7,1,87,402,4.6,17,3,1,21,4,43,0,3,3
12546,14,2014-12-24,fresno-state,N,Rice*,L (6-30),17,38,44.7,93,0,42,162,3.9,0,80,255,3.2,6,7,2,15,1,15,0,2,2
12547,,14 Games,fresno-state,,,,299,530,56.4,3132,25,566,2553,4.5,22,1096,5685,5.2,139,126,31,296,59,546,6,21,27
12548,1,2015-09-03,fresno-state,,Abilene Christian,W (34-13),22,45,48.9,217,4,39,225,5.8,0,84,442,5.3,10,14,2,26,2,20,1,2,3
12549,2,2015-09-12,fresno-state,@,Mississippi,L (21-73),15,24,62.5,153,2,52,163,3.1,0,76,316,4.2,5,8,4,17,6,45,1,3,4
12550,3,2015-09-19,fresno-state,,Utah,L (24-45),17,35,48.6,241,3,29,124,4.3,0,64,365,5.7,9,7,0,16,4,45,2,0,2
12551,4,2015-09-26,fresno-state,@,San Jose State,L (23-49),19,33,57.6,159,2,29,88,3.0,1,62,247,4.0,8,5,0,13,3,30,0,1,1
12552,5,2015-10-03,fresno-state,@,San Diego State,L (7-21),12,25,48.0,77,1,22,12,0.5,0,47,89,1.9,2,3,1,6,6,47,0,0,0
12553,6,2015-10-10,fresno-state,,Utah State,L (14-56),10,20,50.0,112,1,42,82,2.0,1,62,194,3.1,5,5,0,10,5,30,0,3,3
12554,7,2015-10-16,fresno-state,,Nevada-Las Vegas,W (31-28),19,31,61.3,193,0,38,217,5.7,4,69,410,5.9,11,11,1,23,4,47,1,0,1
12555,8,2015-10-24,fresno-state,@,Air Force,L (14-42),14,39,35.9,177,0,17,134,7.9,2,56,311,5.6,9,3,0,12,5,39,0,1,1
12556,9,2015-11-05,fresno-state,,Nevada,L (16-30),17,35,48.6,154,1,29,126,4.3,1,64,280,4.4,9,6,3,18,9,58,1,3,4
12557,10,2015-11-14,fresno-state,@,Hawaii,W (42-14),20,35,57.1,285,6,51,170,3.3,0,86,455,5.3,11,11,7,29,6,50,0,0,0
12558,11,2015-11-21,fresno-state,@,Brigham Young,L (10-52),18,48,37.5,190,0,30,85,2.8,1,78,275,3.5,10,5,2,17,4,35,0,3,3
12559,12,2015-11-28,fresno-state,,Colorado State,L (31-34),19,33,57.6,182,0,45,216,4.8,4,78,398,5.1,8,12,0,20,5,25,0,0,0
12560,,12 Games,fresno-state,,,,202,403,50.1,2140,20,423,1642,3.9,14,826,3782,4.6,97,90,20,207,59,471,6,16,22
12561,1,2016-09-03,fresno-state,@,Nebraska,L (10-43),24,43,55.8,243,1,26,31,1.2,0,69,274,4.0,12,2,3,17,6,29,0,2,2
12562,2,2016-09-10,fresno-state,,Sacramento State,W (31-3),22,42,52.4,274,2,43,200,4.7,2,85,474,5.6,14,13,0,27,6,55,1,1,2
12563,3,2016-09-17,fresno-state,@,Toledo,L (17-52),13,26,50.0,203,2,27,51,1.9,0,53,254,4.8,5,2,0,7,12,138,0,0,0
12564,4,2016-09-24,fresno-state,,Tulsa,L (41-48),21,45,46.7,276,1,44,177,4.0,4,89,453,5.1,11,8,1,20,5,40,1,1,2
12565,5,2016-10-01,fresno-state,@,Nevada-Las Vegas,L (20-45),16,45,35.6,296,2,32,64,2.0,0,77,360,4.7,10,3,2,15,6,50,0,1,1
12566,6,2016-10-08,fresno-state,@,Nevada,L (22-27),16,28,57.1,197,1,48,255,5.3,1,76,452,5.9,9,15,1,25,5,57,2,0,2
12567,7,2016-10-14,fresno-state,,San Diego State,L (3-17),16,27,59.3,139,0,24,78,3.3,0,51,217,4.3,4,4,2,10,5,36,0,3,3
12568,8,2016-10-22,fresno-state,@,Utah State,L (20-38),27,44,61.4,205,1,39,114,2.9,1,83,319,3.8,10,9,4,23,10,80,0,0,0
12569,9,2016-10-28,fresno-state,,Air Force,L (21-31),19,38,50.0,312,3,30,37,1.2,0,68,349,5.1,10,4,4,18,8,55,0,4,4
12570,10,2016-11-05,fresno-state,@,Colorado State,L (0-37),12,25,48.0,155,0,34,77,2.3,0,59,232,3.9,7,3,2,12,4,35,0,1,1
12571,11,2016-11-19,fresno-state,,Hawaii,L (13-14),13,23,56.5,108,0,52,214,4.1,1,75,322,4.3,5,14,1,20,7,64,0,0,0
12572,12,2016-11-26,fresno-state,,San Jose State,L (14-16),11,19,57.9,149,0,41,96,2.3,2,60,245,4.1,5,6,1,12,2,30,1,0,1
12573,,12 Games,fresno-state,,,,210,405,51.9,2557,13,440,1394,3.2,11,845,3951,4.7,102,83,21,206,76,669,5,13,18
12574,1,2017-09-02,fresno-state,,Incarnate Word,W (66-0),23,37,62.2,414,4,40,199,5.0,4,77,613,8.0,13,12,1,26,3,15,0,0,0
12575,2,2017-09-09,fresno-state,@,Alabama,L (10-41),26,41,63.4,216,1,21,71,3.4,0,62,287,4.6,11,5,2,18,1,6,0,1,1
12576,3,2017-09-16,fresno-state,@,Washington,L (16-48),21,36,58.3,194,1,31,119,3.8,0,67,313,4.7,8,8,2,18,6,54,0,1,1
12577,4,2017-09-30,fresno-state,,Nevada,W (41-21),25,33,75.8,312,3,36,192,5.3,1,69,504,7.3,13,8,1,22,8,61,2,1,3
12578,5,2017-10-07,fresno-state,@,San Jose State,W (27-10),15,26,57.7,136,0,51,212,4.2,3,77,348,4.5,4,11,2,17,10,99,0,0,0
12579,6,2017-10-14,fresno-state,,New Mexico,W (38-0),13,23,56.5,299,3,36,227,6.3,2,59,526,8.9,7,9,1,17,2,25,1,0,1
12580,7,2017-10-21,fresno-state,@,San Diego State,W (27-3),10,16,62.5,176,0,38,199,5.2,3,54,375,6.9,6,9,0,15,5,40,0,0,0
12581,8,2017-10-28,fresno-state,,Nevada-Las Vegas,L (16-26),16,27,59.3,152,0,34,140,4.1,2,61,292,4.8,7,12,0,19,5,40,1,0,1
12582,9,2017-11-04,fresno-state,,Brigham Young,W (20-13),14,20,70.0,174,0,40,136,3.4,2,60,310,5.2,8,7,1,16,5,40,0,0,0
12583,10,2017-11-11,fresno-state,@,Hawaii,W (31-21),19,36,52.8,226,4,36,175,4.9,0,72,401,5.6,11,12,1,24,6,46,0,2,2
12584,11,2017-11-18,fresno-state,@,Wyoming,W (13-7),14,23,60.9,186,1,45,147,3.3,0,68,333,4.9,6,9,0,15,5,35,1,0,1
12585,12,2017-11-25,fresno-state,,Boise State,W (28-17),23,36,63.9,332,2,30,99,3.3,1,66,431,6.5,13,5,0,18,3,40,0,0,0
12586,13,2017-12-02,fresno-state,@,Boise State,L (14-17),16,34,47.1,172,0,35,137,3.9,2,69,309,4.5,9,8,2,19,8,57,0,1,1
12587,14,2017-12-24,fresno-state,N,Houston*,W (33-27),33,49,67.3,342,0,39,131,3.4,2,88,473,5.4,15,8,3,26,7,52,1,1,2
12588,,14 Games,fresno-state,,,,268,437,61.3,3331,19,512,2184,4.3,22,949,5515,5.8,131,123,16,270,74,610,6,7,13
12589,1,2018-09-01,fresno-state,,Idaho,W (79-13),21,29,72.4,247,1,42,241,5.7,7,71,488,6.9,11,13,0,24,3,27,0,0,0
12590,2,2018-09-08,fresno-state,@,Minnesota,L (14-21),24,34,70.6,212,2,24,87,3.6,0,58,299,5.2,9,3,1,13,4,40,0,2,2
12591,3,2018-09-15,fresno-state,@,UCLA,W (38-14),22,33,66.7,270,1,49,156,3.2,4,82,426,5.2,12,8,4,24,8,53,2,0,2
12592,4,2018-09-29,fresno-state,,Toledo,W (49-27),24,32,75.0,368,4,38,186,4.9,2,70,554,7.9,16,7,1,24,3,45,0,1,1
12593,5,2018-10-06,fresno-state,@,Nevada,W (21-3),20,28,71.4,241,2,24,30,1.3,1,52,271,5.2,9,3,0,12,4,30,1,0,1
12594,6,2018-10-13,fresno-state,,Wyoming,W (27-3),22,32,68.8,287,2,33,104,3.2,2,65,391,6.0,11,6,0,17,5,45,0,0,0
12595,7,2018-10-20,fresno-state,@,New Mexico,W (38-7),20,30,66.7,280,3,43,153,3.6,2,73,433,5.9,16,9,4,29,6,35,0,0,0
12596,8,2018-10-27,fresno-state,,Hawaii,W (50-20),26,38,68.4,348,4,33,214,6.5,1,71,562,7.9,14,10,0,24,8,69,0,0,0
12597,9,2018-11-03,fresno-state,@,Nevada-Las Vegas,W (48-3),26,35,74.3,274,2,34,192,5.6,4,69,466,6.8,16,8,1,25,5,40,0,1,1
12598,10,2018-11-09,fresno-state,@,Boise State,L (17-24),24,35,68.6,283,1,28,107,3.8,1,63,390,6.2,14,6,2,22,9,61,0,0,0
12599,11,2018-11-17,fresno-state,,San Diego State,W (23-14),17,24,70.8,267,1,43,123,2.9,2,67,390,5.8,6,9,2,17,3,40,0,0,0
12600,,11 Games,fresno-state,,,,246,350,70.3,3077,23,391,1593,4.1,26,741,4670,6.3,134,82,15,231,58,485,3,4,7
12601,1,2014-08-30,san-diego-state,,Northern Arizona,W (38-7),18,29,62.1,205,1,37,194,5.2,3,66,399,6.0,11,11,3,25,5,29,0,1,1
12602,2,2014-09-06,san-diego-state,@,North Carolina,L (27-31),23,39,59.0,341,1,35,168,4.8,2,74,509,6.9,13,7,3,23,9,65,0,3,3
12603,3,2014-09-20,san-diego-state,@,Oregon State,L (7-28),14,26,53.8,106,0,23,109,4.7,1,49,215,4.4,6,5,0,11,9,65,0,2,2
12604,4,2014-09-27,san-diego-state,,Nevada-Las Vegas,W (34-17),16,28,57.1,209,0,43,257,6.0,4,71,466,6.6,10,10,5,25,6,66,0,0,0
12605,5,2014-10-03,san-diego-state,@,Fresno State,L (13-24),9,24,37.5,84,1,45,186,4.1,0,69,270,3.9,6,11,0,17,7,64,1,2,3
12606,6,2014-10-10,san-diego-state,@,New Mexico,W (24-14),5,17,29.4,73,0,46,397,8.6,3,63,470,7.5,3,14,2,19,10,102,2,2,4
12607,7,2014-10-18,san-diego-state,,Hawaii,W (20-10),13,24,54.2,174,1,47,283,6.0,1,71,457,6.4,4,15,0,19,4,44,1,0,1
12608,8,2014-11-01,san-diego-state,@,Nevada,L (14-30),21,36,58.3,189,1,29,135,4.7,1,65,324,5.0,9,8,0,17,4,55,2,1,3
12609,9,2014-11-08,san-diego-state,,Idaho,W (35-21),14,22,63.6,249,3,39,156,4.0,2,61,405,6.6,11,6,1,18,4,51,0,0,0
12610,10,2014-11-15,san-diego-state,@,Boise State,L (29-38),18,30,60.0,188,1,36,169,4.7,2,66,357,5.4,7,7,2,16,8,75,0,1,1
12611,11,2014-11-21,san-diego-state,,Air Force,W (30-14),17,31,54.8,326,1,44,176,4.0,1,75,502,6.7,15,8,0,23,5,39,0,1,1
12612,12,2014-11-29,san-diego-state,,San Jose State,W (38-7),4,16,25.0,34,0,60,393,6.6,5,76,427,5.6,3,17,1,21,1,5,0,0,0
12613,13,2014-12-23,san-diego-state,N,Navy*,L (16-17),11,27,40.7,141,0,33,186,5.6,1,60,327,5.5,7,10,1,18,5,34,1,2,3
12614,,13 Games,san-diego-state,,,,183,349,52.4,2319,10,517,2809,5.4,26,866,5128,5.9,105,129,18,252,77,694,7,15,22
12615,1,2015-09-05,san-diego-state,,San Diego,W (37-3),11,23,47.8,139,0,36,166,4.6,1,59,305,5.2,5,10,0,15,8,58,0,1,1
12616,2,2015-09-12,san-diego-state,@,California,L (7-35),14,32,43.8,173,1,43,152,3.5,0,75,325,4.3,9,7,0,16,12,136,0,2,2
12617,3,2015-09-19,san-diego-state,,South Alabama,L (27-34),13,27,48.1,165,2,38,140,3.7,1,65,305,4.7,7,6,1,14,4,35,1,0,1
12618,4,2015-09-26,san-diego-state,@,Penn State,L (21-37),10,29,34.5,141,1,34,101,3.0,1,63,242,3.8,7,5,1,13,4,32,3,0,3
12619,5,2015-10-03,san-diego-state,,Fresno State,W (21-7),5,12,41.7,104,2,60,305,5.1,1,72,409,5.7,2,16,1,19,5,50,1,0,1
12620,6,2015-10-10,san-diego-state,@,Hawaii,W (28-14),11,15,73.3,184,1,57,218,3.8,3,72,402,5.6,8,8,3,19,11,70,1,0,1
12621,7,2015-10-17,san-diego-state,@,San Jose State,W (30-7),10,14,71.4,144,1,48,233,4.9,2,62,377,6.1,6,15,2,23,9,76,0,0,0
12622,8,2015-10-23,san-diego-state,,Utah State,W (48-14),6,10,60.0,93,1,61,336,5.5,5,71,429,6.0,4,12,3,19,6,60,0,0,0
12623,9,2015-10-31,san-diego-state,@,Colorado State,W (41-17),11,14,78.6,180,1,47,276,5.9,3,61,456,7.5,9,9,3,21,5,61,0,0,0
12624,10,2015-11-14,san-diego-state,,Wyoming,W (38-3),12,19,63.2,138,3,53,293,5.5,2,72,431,6.0,4,17,4,25,3,40,2,0,2
12625,11,2015-11-21,san-diego-state,@,Nevada-Las Vegas,W (52-14),11,18,61.1,107,1,48,286,6.0,5,66,393,6.0,8,11,1,20,6,70,0,0,0
12626,12,2015-11-28,san-diego-state,,Nevada,W (31-14),9,12,75.0,88,0,53,320,6.0,4,65,408,6.3,3,13,1,17,7,55,0,0,0
12627,13,2015-12-05,san-diego-state,,Air Force,W (27-24),9,14,64.3,203,1,46,233,5.1,2,60,436,7.3,6,11,0,17,5,39,1,0,1
12628,14,2015-12-24,san-diego-state,N,Cincinnati*,W (42-7),9,12,75.0,129,2,52,207,4.0,2,64,336,5.3,7,10,5,22,4,31,0,0,0
12629,,14 Games,san-diego-state,,,,141,251,56.2,1988,17,676,3266,4.8,32,927,5254,5.7,85,150,25,260,89,813,9,3,12
12630,1,2016-09-03,san-diego-state,,New Hampshire,W (31-0),17,26,65.4,291,2,41,170,4.1,2,67,461,6.9,11,7,1,19,9,70,0,0,0
12631,2,2016-09-10,san-diego-state,,California,W (45-40),14,23,60.9,129,1,47,334,7.1,3,70,463,6.6,8,13,1,22,14,105,1,1,2
12632,3,2016-09-17,san-diego-state,@,Northern Illinois,W (42-28),11,19,57.9,126,3,45,278,6.2,3,64,404,6.3,6,11,5,22,11,107,0,1,1
12633,4,2016-10-01,san-diego-state,@,South Alabama,L (24-42),13,22,59.1,159,1,41,157,3.8,2,63,316,5.0,8,12,0,20,10,85,2,0,2
12634,5,2016-10-08,san-diego-state,,Nevada-Las Vegas,W (26-7),15,20,75.0,215,1,54,245,4.5,2,74,460,6.2,8,14,0,22,7,75,1,0,1
12635,6,2016-10-14,san-diego-state,@,Fresno State,W (17-3),7,12,58.3,72,0,61,292,4.8,2,73,364,5.0,5,20,0,25,6,65,0,0,0
12636,7,2016-10-21,san-diego-state,,San Jose State,W (42-3),13,18,72.2,167,1,44,293,6.7,5,62,460,7.4,7,12,3,22,5,37,0,1,1
12637,8,2016-10-28,san-diego-state,@,Utah State,W (40-13),4,10,40.0,14,1,57,400,7.0,2,67,414,6.2,0,18,2,20,4,40,0,0,0
12638,9,2016-11-05,san-diego-state,,Hawaii,W (55-0),8,16,50.0,97,3,42,296,7.0,2,58,393,6.8,4,14,1,19,3,20,0,1,1
12639,10,2016-11-12,san-diego-state,@,Nevada,W (46-16),11,17,64.7,146,2,44,474,10.8,4,61,620,10.2,9,16,0,25,6,49,1,0,1
12640,11,2016-11-19,san-diego-state,@,Wyoming,L (33-34),15,27,55.6,211,2,31,178,5.7,0,58,389,6.7,9,7,1,17,7,53,1,0,1
12641,12,2016-11-26,san-diego-state,,Colorado State,L (31-63),11,19,57.9,183,2,38,195,5.1,2,57,378,6.6,9,4,3,16,6,50,1,1,2
12642,13,2016-12-03,san-diego-state,@,Wyoming,W (27-24),6,13,46.2,85,0,53,242,4.6,3,66,327,5.0,4,11,1,16,7,62,2,1,3
12643,14,2016-12-17,san-diego-state,N,Houston*,W (34-10),10,14,71.4,128,1,37,127,3.4,2,51,255,5.0,6,6,1,13,3,25,0,0,0
12644,,14 Games,san-diego-state,,,,155,256,60.5,2023,20,635,3681,5.8,34,891,5704,6.4,94,165,19,278,98,843,9,6,15
12645,1,2017-09-02,san-diego-state,,California-Davis,W (38-17),17,23,73.9,237,2,52,276,5.3,3,75,513,6.8,9,15,3,27,10,87,1,1,2
12646,2,2017-09-09,san-diego-state,@,Arizona State,W (30-20),9,18,50.0,73,1,43,279,6.5,1,61,352,5.8,3,10,1,14,12,95,0,0,0
12647,3,2017-09-16,san-diego-state,,Stanford,W (20-17),21,29,72.4,187,1,48,172,3.6,1,77,359,4.7,11,9,1,21,7,81,0,0,0
12648,4,2017-09-23,san-diego-state,@,Air Force,W (28-24),10,16,62.5,180,1,41,187,4.6,3,57,367,6.4,8,7,4,19,0,0,1,0,1
12649,5,2017-09-30,san-diego-state,,Northern Illinois,W (34-28),10,20,50.0,136,2,36,127,3.5,0,56,263,4.7,6,3,1,10,10,126,0,0,0
12650,6,2017-10-07,san-diego-state,@,Nevada-Las Vegas,W (41-10),14,24,58.3,172,0,46,302,6.6,5,70,474,6.8,10,15,2,27,4,19,1,0,1
12651,7,2017-10-14,san-diego-state,,Boise State,L (14-31),12,27,44.4,240,1,39,83,2.1,1,66,323,4.9,8,6,2,16,3,24,1,0,1
12652,8,2017-10-21,san-diego-state,,Fresno State,L (3-27),11,23,47.8,90,0,39,165,4.2,0,62,255,4.1,5,8,1,14,5,40,1,0,1
12653,9,2017-10-28,san-diego-state,@,Hawaii,W (28-7),5,11,45.5,83,1,53,334,6.3,3,64,417,6.5,4,14,3,21,8,90,0,1,1
12654,10,2017-11-04,san-diego-state,@,San Jose State,W (52-7),6,7,85.7,94,1,71,554,7.8,6,78,648,8.3,6,24,1,31,4,25,1,0,1
12655,11,2017-11-18,san-diego-state,,Nevada,W (42-23),15,23,65.2,205,1,48,289,6.0,3,71,494,7.0,11,13,1,25,7,75,1,0,1
12656,12,2017-11-24,san-diego-state,,New Mexico,W (35-10),14,21,66.7,198,2,37,265,7.2,3,58,463,8.0,8,9,2,19,5,35,1,1,2
12657,13,2017-12-23,san-diego-state,N,Army*,L (35-42),6,10,60.0,25,0,21,255,12.1,4,31,280,9.0,3,7,1,11,10,82,1,1,2
12658,,13 Games,san-diego-state,,,,150,252,59.5,1920,13,574,3288,5.7,33,826,5208,6.3,92,140,23,255,85,779,9,4,13
12659,1,2018-08-31,san-diego-state,@,Stanford,L (10-31),10,15,66.7,113,0,37,150,4.1,1,52,263,5.1,5,6,0,11,11,125,1,0,1
12660,2,2018-09-08,san-diego-state,,Sacramento State,W (28-14),17,28,60.7,271,0,45,158,3.5,3,73,429,5.9,15,8,2,25,8,53,0,2,2
12661,3,2018-09-15,san-diego-state,,Arizona State,W (28-21),12,24,50.0,129,1,58,311,5.4,2,82,440,5.4,7,18,2,27,9,85,1,0,1
12662,4,2018-09-22,san-diego-state,,Eastern Michigan,W (23-20),12,22,54.5,176,2,37,174,4.7,0,59,350,5.9,8,6,1,15,5,56,0,1,1
12663,5,2018-10-06,san-diego-state,@,Boise State,W (19-13),8,15,53.3,113,0,44,154,3.5,2,59,267,4.5,4,4,1,9,8,55,2,0,2
12664,6,2018-10-12,san-diego-state,,Air Force,W (21-17),9,25,36.0,213,1,34,84,2.5,1,59,297,5.0,8,5,0,13,8,55,0,1,1
12665,7,2018-10-20,san-diego-state,,San Jose State,W (16-13),7,11,63.6,86,0,47,207,4.4,1,58,293,5.1,4,10,2,16,8,67,1,0,1
12666,8,2018-10-27,san-diego-state,@,Nevada,L (24-28),20,41,48.8,283,3,36,173,4.8,0,77,456,5.9,14,7,3,24,8,68,2,0,2
12667,9,2018-11-03,san-diego-state,@,New Mexico,W (31-23),17,25,68.0,240,1,40,161,4.0,3,65,401,6.2,10,6,1,17,9,80,3,0,3
12668,10,2018-11-10,san-diego-state,,Nevada-Las Vegas,L (24-27),22,36,61.1,279,2,34,89,2.6,1,70,368,5.3,10,10,1,21,4,45,0,2,2
12669,11,2018-11-17,san-diego-state,@,Fresno State,L (14-23),8,21,38.1,218,2,27,64,2.4,0,48,282,5.9,5,2,1,8,6,41,0,0,0
12670,,11 Games,san-diego-state,,,,142,263,54.0,2121,12,439,1725,3.9,14,702,3846,5.5,90,82,14,186,84,730,10,6,16
12671,1,2014-08-29,colorado-state,N,Colorado,W (31-17),13,23,56.5,134,1,45,266,5.9,3,68,400,5.9,10,14,3,27,6,63,1,0,1
12672,2,2014-09-06,colorado-state,@,Boise State,L (24-37),31,58,53.4,434,3,23,28,1.2,0,81,462,5.7,20,2,1,23,2,20,1,2,3
12673,3,2014-09-13,colorado-state,,California-Davis,W (49-21),25,34,73.5,452,4,33,224,6.8,3,67,676,10.1,17,11,0,28,3,31,0,0,0
12674,4,2014-09-27,colorado-state,@,Boston College,W (24-21),27,41,65.9,268,2,24,162,6.8,1,65,430,6.6,18,6,1,25,7,69,0,2,2
12675,5,2014-10-04,colorado-state,,Tulsa,W (42-17),16,26,61.5,298,4,31,234,7.5,2,57,532,9.3,6,10,1,17,7,74,1,1,2
12676,6,2014-10-11,colorado-state,@,Nevada,W (31-24),26,36,72.2,326,3,34,119,3.5,1,70,445,6.4,15,6,0,21,2,25,1,0,1
12677,7,2014-10-18,colorado-state,,Utah State,W (16-13),20,32,62.5,243,0,39,75,1.9,1,71,318,4.5,8,7,4,19,11,116,0,0,0
12678,8,2014-10-25,colorado-state,,Wyoming,W (45-31),20,24,83.3,411,5,30,147,4.9,1,54,558,10.3,17,6,1,24,9,87,0,0,0
12679,9,2014-11-01,colorado-state,@,San Jose State,W (38-31),22,28,78.6,290,1,37,113,3.1,4,65,403,6.2,12,8,0,20,2,17,2,0,2
12680,10,2014-11-08,colorado-state,,Hawaii,W (49-22),16,28,57.1,287,4,43,293,6.8,3,71,580,8.2,11,14,1,26,7,46,1,0,1
12681,11,2014-11-22,colorado-state,,New Mexico,W (58-20),26,36,72.2,406,3,45,292,6.5,5,81,698,8.6,18,11,3,32,7,76,2,0,2
12682,12,2014-11-28,colorado-state,@,Air Force,L (24-27),23,46,50.0,366,3,32,106,3.3,0,78,472,6.1,15,8,1,24,2,14,0,1,1
12683,13,2014-12-20,colorado-state,N,Utah*,L (10-45),21,35,60.0,266,1,19,12,0.6,0,54,278,5.1,9,2,2,13,7,73,1,1,2
12684,,13 Games,colorado-state,,,,286,447,64.0,4181,34,435,2071,4.8,24,882,6252,7.1,176,105,18,299,72,711,10,7,17
12685,1,2015-09-05,colorado-state,,Savannah State,W (65-13),27,36,75.0,381,6,33,217,6.6,2,69,598,8.7,20,11,2,33,6,62,4,1,5
12686,2,2015-09-12,colorado-state,,Minnesota,L (20-23),16,32,50.0,142,1,41,172,4.2,1,73,314,4.3,5,8,1,14,10,86,2,2,4
12687,3,2015-09-19,colorado-state,N,Colorado,L (24-27),25,39,64.1,282,1,49,218,4.4,2,88,500,5.7,16,9,2,27,8,65,0,2,2
12688,4,2015-09-26,colorado-state,@,Texas-San Antonio,W (33-31),16,30,53.3,267,3,46,171,3.7,1,76,438,5.8,12,11,2,25,9,71,0,0,0
12689,5,2015-10-03,colorado-state,@,Utah State,L (18-33),21,46,45.7,252,1,31,109,3.5,1,77,361,4.7,12,9,3,24,12,110,2,1,3
12690,6,2015-10-10,colorado-state,,Boise State,L (10-41),14,30,46.7,151,1,37,105,2.8,0,67,256,3.8,6,7,1,14,9,93,1,2,3
12691,7,2015-10-17,colorado-state,,Air Force,W (38-23),23,30,76.7,296,3,37,160,4.3,2,67,456,6.8,14,7,1,22,9,87,0,1,1
12692,8,2015-10-31,colorado-state,,San Diego State,L (17-41),17,28,60.7,205,2,33,163,4.9,0,61,368,6.0,10,8,4,22,7,78,1,3,4
12693,9,2015-11-07,colorado-state,@,Wyoming,W (26-7),11,15,73.3,120,0,55,228,4.1,3,70,348,5.0,6,14,3,23,10,101,0,1,1
12694,10,2015-11-14,colorado-state,,Nevada-Las Vegas,W (49-35),13,19,68.4,209,4,46,325,7.1,3,65,534,8.2,7,15,2,24,3,35,1,1,2
12695,11,2015-11-21,colorado-state,@,New Mexico,W (28-21),16,23,69.6,264,1,45,221,4.9,2,68,485,7.1,12,13,1,26,4,29,0,0,0
12696,12,2015-11-28,colorado-state,@,Fresno State,W (34-31),11,21,52.4,85,1,40,261,6.5,1,61,346,5.7,4,14,0,18,4,45,0,1,1
12697,13,2015-12-29,colorado-state,N,Nevada*,L (23-28),22,42,52.4,310,0,42,222,5.3,2,84,532,6.3,17,12,1,30,7,65,1,0,1
12698,,13 Games,colorado-state,,,,232,391,59.3,2964,24,535,2572,4.8,20,926,5536,6.0,141,138,23,302,98,927,12,15,27
12699,1,2016-09-02,colorado-state,N,Colorado,L (7-44),12,29,41.4,63,1,35,162,4.6,0,64,225,3.5,5,7,0,12,2,15,2,2,4
12700,2,2016-09-10,colorado-state,,Texas-San Antonio,W (23-14),8,23,34.8,108,0,47,220,4.7,2,70,328,4.7,6,11,2,19,7,70,0,0,0
12701,3,2016-09-17,colorado-state,,Northern Colorado,W (47-21),22,28,78.6,324,4,43,245,5.7,2,71,569,8.0,13,12,4,29,8,80,1,0,1
12702,4,2016-09-24,colorado-state,@,Minnesota,L (24-31),16,31,51.6,211,1,48,158,3.3,2,79,369,4.7,9,12,3,24,3,25,1,1,2
12703,5,2016-10-01,colorado-state,,Wyoming,L (17-38),23,42,54.8,370,1,33,111,3.4,1,75,481,6.4,15,5,0,20,6,37,1,1,2
12704,6,2016-10-08,colorado-state,,Utah State,W (31-24),17,32,53.1,240,2,47,224,4.8,2,79,464,5.9,9,12,1,22,8,79,0,0,0
12705,7,2016-10-15,colorado-state,@,Boise State,L (23-28),17,31,54.8,189,2,36,184,5.1,1,67,373,5.6,6,13,0,19,6,30,0,0,0
12706,8,2016-10-22,colorado-state,@,Nevada-Las Vegas,W (42-23),21,28,75.0,237,2,50,230,4.6,4,78,467,6.0,11,15,0,26,4,21,1,0,1
12707,9,2016-11-05,colorado-state,,Fresno State,W (37-0),18,25,72.0,237,2,48,257,5.4,3,73,494,6.8,13,13,2,28,7,80,0,0,0
12708,10,2016-11-12,colorado-state,@,Air Force,L (46-49),22,29,75.9,374,2,35,185,5.3,3,64,559,8.7,12,9,1,22,3,35,1,1,2
12709,11,2016-11-19,colorado-state,,New Mexico,W (49-31),9,10,90.0,164,2,42,412,9.8,5,52,576,11.1,7,15,1,23,8,70,0,0,0
12710,12,2016-11-26,colorado-state,@,San Diego State,W (63-31),11,16,68.8,216,5,46,291,6.3,3,62,507,8.2,10,13,0,23,6,65,0,0,0
12711,13,2016-12-22,colorado-state,N,Idaho*,L (50-61),21,36,58.3,445,5,30,155,5.2,2,66,600,9.1,14,7,4,25,10,92,1,2,3
12712,,13 Games,colorado-state,,,,217,360,60.3,3178,29,540,2834,5.2,30,900,6012,6.7,130,144,18,292,78,699,8,7,15
12713,1,2017-08-26,colorado-state,,Oregon State,W (58-27),26,39,66.7,334,3,43,191,4.4,3,82,525,6.4,14,16,1,31,8,40,1,1,2
12714,2,2017-09-01,colorado-state,N,Colorado,L (3-17),24,47,51.1,309,0,33,88,2.7,0,80,397,5.0,15,7,1,23,10,120,1,2,3
12715,3,2017-09-09,colorado-state,,Abilene Christian,W (38-10),25,40,62.5,342,3,38,273,7.2,2,78,615,7.9,15,12,3,30,8,88,1,1,2
12716,4,2017-09-16,colorado-state,@,Alabama,L (23-41),21,38,55.3,247,2,40,144,3.6,1,78,391,5.0,11,8,3,22,3,14,0,2,2
12717,5,2017-09-30,colorado-state,@,Hawaii,W (51-21),18,22,81.8,351,4,37,259,7.0,3,59,610,10.3,13,11,1,25,3,25,0,0,0
12718,6,2017-10-07,colorado-state,@,Utah State,W (27-14),22,31,71.0,293,2,52,216,4.2,1,83,509,6.1,16,10,3,29,8,85,0,0,0
12719,7,2017-10-14,colorado-state,,Nevada,W (44-42),26,37,70.3,384,4,34,224,6.6,2,71,608,8.6,15,8,0,23,11,98,1,0,1
12720,8,2017-10-20,colorado-state,@,New Mexico,W (27-24),17,33,51.5,231,2,35,180,5.1,1,68,411,6.0,13,8,2,23,8,88,0,0,0
12721,9,2017-10-28,colorado-state,,Air Force,L (28-45),17,31,54.8,269,2,23,166,7.2,2,54,435,8.1,13,7,2,22,4,40,0,3,3
12722,10,2017-11-04,colorado-state,@,Wyoming,L (13-16),8,14,57.1,110,0,55,235,4.3,1,69,345,5.0,5,13,0,18,7,55,0,0,0
12723,11,2017-11-11,colorado-state,,Boise State,L (52-59),29,43,67.4,309,2,52,261,5.0,5,95,570,6.0,15,16,2,33,2,19,1,1,2
12724,12,2017-11-18,colorado-state,,San Jose State,W (42-14),26,32,81.3,305,3,45,301,6.7,3,77,606,7.9,14,12,0,26,6,54,1,0,1
12725,13,2017-12-16,colorado-state,N,Marshall*,L (28-31),25,52,48.1,320,2,31,70,2.3,2,83,390,4.7,15,6,5,26,3,15,0,0,0
12726,,13 Games,colorado-state,,,,284,459,61.9,3804,29,518,2608,5.0,26,977,6412,6.6,174,134,23,331,81,741,6,10,16
12727,1,2018-08-25,colorado-state,,Hawaii,L (34-43),34,50,68.0,537,5,25,116,4.6,0,75,653,8.7,22,5,2,29,12,120,0,1,1
12728,2,2018-08-31,colorado-state,N,Colorado,L (13-45),19,37,51.4,181,1,39,103,2.6,0,76,284,3.7,10,8,2,20,5,35,0,1,1
12729,3,2018-09-08,colorado-state,,Arkansas,W (34-27),32,50,64.0,389,2,23,40,1.7,1,73,429,5.9,14,5,2,21,6,54,1,1,2
12730,4,2018-09-15,colorado-state,@,Florida,L (10-48),23,41,56.1,240,1,41,73,1.8,0,82,313,3.8,11,8,3,22,6,33,3,0,3
12731,5,2018-09-22,colorado-state,,Illinois State,L (19-35),24,44,54.5,257,3,31,134,4.3,0,75,391,5.2,12,10,3,25,9,79,0,2,2
12732,6,2018-10-06,colorado-state,@,San Jose State,W (42-30),15,29,51.7,172,4,45,219,4.9,1,74,391,5.3,8,11,2,21,8,61,0,2,2
12733,7,2018-10-13,colorado-state,,New Mexico,W (20-18),24,42,57.1,311,1,41,112,2.7,1,83,423,5.1,12,10,2,24,10,65,0,0,0
12734,8,2018-10-19,colorado-state,@,Boise State,L (28-56),31,44,70.5,373,3,25,116,4.6,1,69,489,7.1,16,9,2,27,7,60,1,2,3
12735,9,2018-10-26,colorado-state,,Wyoming,L (21-34),34,54,63.0,333,0,20,20,1.0,3,74,353,4.8,19,3,1,23,3,26,1,2,3
12736,10,2018-11-10,colorado-state,@,Nevada,L (10-49),23,40,57.5,186,1,33,74,2.2,0,73,260,3.6,9,3,1,13,9,73,0,1,1
12737,11,2018-11-17,colorado-state,,Utah State,L (24-29),25,38,65.8,307,2,44,199,4.5,1,82,506,6.2,17,8,4,29,11,108,0,2,2
12738,,11 Games,colorado-state,,,,284,469,60.6,3286,23,367,1206,3.3,8,836,4492,5.4,150,80,24,254,86,714,6,14,20
12739,1,2014-08-30,nevada,,Southern Utah,W (28-19),30,41,73.2,303,1,55,244,4.4,3,96,547,5.7,16,14,0,30,4,19,1,1,2
12740,2,2014-09-05,nevada,,Washington State,W (24-13),12,21,57.1,110,0,56,214,3.8,3,77,324,4.2,4,10,3,17,9,90,0,0,0
12741,3,2014-09-13,nevada,@,Arizona,L (28-35),29,39,74.4,321,3,40,108,2.7,0,79,429,5.4,17,8,0,25,8,74,0,0,0
12742,4,2014-09-27,nevada,@,San Jose State,W (21-10),10,18,55.6,64,0,36,192,5.3,2,54,256,4.7,2,12,2,16,8,56,0,0,0
12743,5,2014-10-04,nevada,,Boise State,L (46-51),23,43,53.5,306,3,30,156,5.2,2,73,462,6.3,15,6,3,24,3,22,0,4,4
12744,6,2014-10-11,nevada,,Colorado State,L (24-31),27,50,54.0,297,2,36,160,4.4,1,86,457,5.3,16,8,1,25,3,45,0,1,1
12745,7,2014-10-18,nevada,@,Brigham Young,W (42-35),26,40,65.0,285,1,36,126,3.5,4,76,411,5.4,12,7,1,20,6,36,0,0,0
12746,8,2014-10-25,nevada,@,Hawaii,W (26-18),18,28,64.3,132,1,60,295,4.9,2,88,427,4.9,7,19,0,26,4,36,0,1,1
12747,9,2014-11-01,nevada,,San Diego State,W (30-14),10,24,41.7,109,1,47,229,4.9,2,71,338,4.8,6,9,2,17,5,44,0,1,1
12748,10,2014-11-15,nevada,@,Air Force,L (38-45),24,36,66.7,275,2,45,223,5.0,3,81,498,6.1,15,11,1,27,4,42,0,1,1
12749,11,2014-11-22,nevada,,Fresno State,L (20-40),11,24,45.8,126,1,38,227,6.0,2,62,353,5.7,4,9,0,13,7,90,3,1,4
12750,12,2014-11-29,nevada,@,Nevada-Las Vegas,W (49-27),5,13,38.5,46,3,53,408,7.7,3,66,454,6.9,2,18,1,21,11,87,0,1,1
12751,13,2014-12-20,nevada,N,Louisiana*,L (3-16),14,29,48.3,124,0,28,89,3.2,0,57,213,3.7,6,6,1,13,1,5,1,0,1
12752,,13 Games,nevada,,,,239,406,58.9,2498,18,560,2671,4.8,27,966,5169,5.4,122,137,15,274,73,646,5,11,16
12753,1,2015-09-03,nevada,,California-Davis,W (31-17),13,23,56.5,163,1,39,232,5.9,3,62,395,6.4,7,13,2,22,6,50,0,0,0
12754,2,2015-09-12,nevada,,Arizona,L (20-44),18,34,52.9,159,2,42,168,4.0,0,76,327,4.3,7,8,0,15,9,105,0,1,1
12755,3,2015-09-19,nevada,@,Texas A&M,L (27-44),16,29,55.2,206,2,45,153,3.4,1,74,359,4.9,10,6,3,19,3,29,0,1,1
12756,4,2015-09-26,nevada,@,Buffalo,W (24-21),12,21,57.1,90,0,39,289,7.4,3,60,379,6.3,4,10,1,15,9,95,0,0,0
12757,5,2015-10-03,nevada,,Nevada-Las Vegas,L (17-23),20,44,45.5,202,1,35,141,4.0,1,79,343,4.3,13,8,3,24,6,53,0,1,1
12758,6,2015-10-10,nevada,,New Mexico,W (35-17),16,19,84.2,166,2,54,351,6.5,3,73,517,7.1,10,18,2,30,1,5,2,0,2
12759,7,2015-10-17,nevada,@,Wyoming,L (21-28),25,41,61.0,287,2,30,118,3.9,1,71,405,5.7,15,10,2,27,5,41,0,0,0
12760,8,2015-10-24,nevada,,Hawaii,W (30-20),12,23,52.2,128,1,56,244,4.4,2,79,372,4.7,6,13,1,20,4,35,0,1,1
12761,9,2015-11-05,nevada,@,Fresno State,W (30-16),12,17,70.6,206,1,50,292,5.8,1,67,498,7.4,7,11,0,18,10,78,0,1,1
12762,10,2015-11-14,nevada,,San Jose State,W (37-34),16,26,61.5,174,3,49,235,4.8,2,75,409,5.5,10,12,1,23,2,5,0,0,0
12763,11,2015-11-21,nevada,@,Utah State,L (27-31),8,18,44.4,55,0,46,209,4.5,3,64,264,4.1,3,11,1,15,3,32,2,0,2
12764,12,2015-11-28,nevada,@,San Diego State,L (14-31),12,23,52.2,228,0,31,35,1.1,1,54,263,4.9,8,2,0,10,7,60,1,2,3
12765,13,2015-12-29,nevada,N,Colorado State*,W (28-23),6,13,46.2,74,0,40,271,6.8,2,53,345,6.5,5,12,1,18,3,20,0,0,0
12766,,13 Games,nevada,,,,186,331,56.2,2138,15,556,2738,4.9,23,887,4876,5.5,105,134,17,256,68,608,5,7,12
12767,1,2016-09-02,nevada,,Cal Poly,W (30-27),17,24,70.8,189,2,34,174,5.1,2,58,363,6.3,9,8,1,18,4,40,0,0,0
12768,2,2016-09-10,nevada,@,Notre Dame,L (10-39),12,26,46.2,201,0,30,99,3.3,1,56,300,5.4,5,7,4,16,11,88,0,1,1
12769,3,2016-09-17,nevada,,Buffalo,W (38-14),17,25,68.0,169,1,64,352,5.5,4,89,521,5.9,12,18,2,32,5,35,0,0,0
12770,4,2016-09-24,nevada,@,Purdue,L (14-24),23,33,69.7,185,2,33,68,2.1,0,66,253,3.8,10,8,0,18,1,10,0,0,0
12771,5,2016-10-01,nevada,@,Hawaii,L (17-38),19,33,57.6,203,1,42,194,4.6,1,75,397,5.3,7,14,2,23,9,95,0,0,0
12772,6,2016-10-08,nevada,,Fresno State,W (27-22),14,23,60.9,163,3,49,226,4.6,1,72,389,5.4,6,15,2,23,3,35,1,0,1
12773,7,2016-10-15,nevada,@,San Jose State,L (10-14),9,22,40.9,144,1,34,113,3.3,0,56,257,4.6,5,7,1,13,3,35,0,2,2
12774,8,2016-10-22,nevada,,Wyoming,L (34-42),31,48,64.6,347,1,32,132,4.1,3,80,479,6.0,19,10,3,32,7,75,0,1,1
12775,9,2016-11-05,nevada,@,New Mexico,L (26-35),19,34,55.9,301,3,23,108,4.7,1,57,409,7.2,11,7,1,19,5,25,0,2,2
12776,10,2016-11-12,nevada,,San Diego State,L (16-46),21,37,56.8,276,1,34,90,2.6,0,71,366,5.2,11,7,1,19,2,20,0,3,3
12777,11,2016-11-19,nevada,,Utah State,W (38-37),13,26,50.0,127,1,50,214,4.3,3,76,341,4.5,5,16,1,22,1,10,1,0,1
12778,12,2016-11-26,nevada,@,Nevada-Las Vegas,W (45-10),15,23,65.2,193,1,49,318,6.5,4,72,511,7.1,10,16,1,27,1,14,0,0,0
12779,,12 Games,nevada,,,,210,354,59.3,2498,17,474,2088,4.4,20,828,4586,5.5,110,133,19,262,52,482,2,9,11
12780,1,2017-09-02,nevada,@,Northwestern,L (20-31),16,37,43.2,199,2,26,142,5.5,0,63,341,5.4,9,8,2,19,6,65,1,1,2
12781,2,2017-09-09,nevada,,Toledo,L (24-37),19,37,51.4,277,2,24,109,4.5,1,61,386,6.3,10,7,5,22,9,75,1,1,2
12782,3,2017-09-16,nevada,,Idaho State,L (28-30),19,33,57.6,205,3,56,218,3.9,1,89,423,4.8,9,12,4,25,7,62,2,1,3
12783,4,2017-09-23,nevada,@,Washington State,L (7-45),14,30,46.7,105,0,24,46,1.9,1,54,151,2.8,5,5,3,13,5,53,0,3,3
12784,5,2017-09-30,nevada,@,Fresno State,L (21-41),31,49,63.3,253,2,23,61,2.7,1,72,314,4.4,12,3,1,16,4,20,0,3,3
12785,6,2017-10-07,nevada,,Hawaii,W (35-21),26,34,76.5,298,4,38,268,7.1,1,72,566,7.9,12,11,3,26,6,39,0,1,1
12786,7,2017-10-14,nevada,@,Colorado State,L (42-44),25,42,59.5,508,5,31,56,1.8,1,73,564,7.7,16,4,3,23,3,30,0,0,0
12787,8,2017-10-20,nevada,,Air Force,L (42-45),18,35,51.4,267,3,20,157,7.9,2,55,424,7.7,10,9,2,21,3,25,0,0,0
12788,9,2017-11-04,nevada,@,Boise State,L (14-41),24,37,64.9,160,1,29,142,4.9,1,66,302,4.6,8,7,2,17,2,25,0,3,3
12789,10,2017-11-11,nevada,,San Jose State,W (59-14),20,28,71.4,265,3,44,176,4.0,2,72,441,6.1,9,8,3,20,8,70,0,0,0
12790,11,2017-11-18,nevada,@,San Diego State,L (23-42),33,55,60.0,414,3,18,34,1.9,0,73,448,6.1,15,3,0,18,2,20,1,1,2
12791,12,2017-11-25,nevada,,Nevada-Las Vegas,W (23-16),25,34,73.5,294,2,29,117,4.0,1,63,411,6.5,11,7,0,18,4,67,1,1,2
12792,,12 Games,nevada,,,,270,451,59.9,3245,30,362,1526,4.2,12,813,4771,5.9,126,84,28,238,59,551,6,15,21
12793,1,2018-08-31,nevada,,Portland State,W (72-19),18,28,64.3,420,4,35,216,6.2,4,63,636,10.1,12,12,1,25,9,106,0,1,1
12794,2,2018-09-08,nevada,@,Vanderbilt,L (10-41),22,39,56.4,216,1,25,34,1.4,0,64,250,3.9,8,6,0,14,6,67,2,2,4
12795,3,2018-09-15,nevada,,Oregon State,W (37-35),18,37,48.6,201,2,30,156,5.2,2,67,357,5.3,10,6,1,17,5,60,0,1,1
12796,4,2018-09-22,nevada,@,Toledo,L (44-63),29,50,58.0,320,1,35,262,7.5,5,85,582,6.8,14,11,2,27,10,70,1,1,2
12797,5,2018-09-29,nevada,@,Air Force,W (28-25),24,33,72.7,259,4,34,177,5.2,0,67,436,6.5,12,7,0,19,13,103,1,1,2
12798,6,2018-10-06,nevada,,Fresno State,L (3-21),22,43,51.2,195,0,43,132,3.1,0,86,327,3.8,13,7,1,21,1,5,0,3,3
12799,7,2018-10-13,nevada,,Boise State,L (27-31),24,42,57.1,304,2,24,82,3.4,1,66,386,5.8,11,7,5,23,4,20,2,1,3
12800,8,2018-10-20,nevada,@,Hawaii,W (40-22),23,31,74.2,261,1,36,220,6.1,4,67,481,7.2,11,12,2,25,5,55,3,0,3
12801,9,2018-10-27,nevada,,San Diego State,W (28-24),23,43,53.5,235,2,23,62,2.7,1,66,297,4.5,10,3,1,14,5,75,0,0,0
12802,10,2018-11-10,nevada,,Colorado State,W (49-10),28,36,77.8,404,4,35,235,6.7,3,71,639,9.0,20,8,1,29,6,61,1,1,2
12803,11,2018-11-17,nevada,@,San Jose State,W (21-12),19,32,59.4,314,1,47,149,3.2,2,79,463,5.9,13,10,1,24,3,15,1,1,2
12804,,11 Games,nevada,,,,250,414,60.4,3129,22,367,1725,4.7,22,781,4854,6.2,134,89,15,238,67,637,11,12,23
12805,1,2014-08-30,new-mexico,,Texas-El Paso,L (24-31),5,9,55.6,67,0,52,410,7.9,3,61,477,7.8,3,17,0,20,3,25,2,1,3
12806,2,2014-09-06,new-mexico,,Arizona State,L (23-58),7,11,63.6,130,1,57,207,3.6,2,68,337,5.0,6,11,2,19,8,73,3,0,3
12807,3,2014-09-20,new-mexico,@,New Mexico State,W (38-35),8,14,57.1,67,2,49,432,8.8,3,63,499,7.9,4,19,1,24,6,57,1,0,1
12808,4,2014-09-26,new-mexico,,Fresno State,L (24-35),4,8,50.0,97,1,56,280,5.0,2,64,377,5.9,4,14,0,18,5,59,0,0,0
12809,5,2014-10-04,new-mexico,@,Texas-San Antonio,W (21-9),9,14,64.3,87,0,48,283,5.9,3,62,370,6.0,4,10,1,15,2,30,0,0,0
12810,6,2014-10-10,new-mexico,,San Diego State,L (14-24),11,24,45.8,111,1,38,152,4.0,1,62,263,4.2,4,8,3,15,6,57,0,1,1
12811,7,2014-10-18,new-mexico,@,Air Force,L (31-35),4,10,40.0,23,0,52,367,7.1,3,62,390,6.3,1,13,0,14,1,15,2,0,2
12812,8,2014-11-01,new-mexico,@,Nevada-Las Vegas,W (31-28),2,7,28.6,5,0,61,301,4.9,4,68,306,4.5,0,17,1,18,5,30,1,0,1
12813,9,2014-11-08,new-mexico,,Boise State,L (49-60),9,16,56.3,122,0,49,505,10.3,6,65,627,9.6,6,12,0,18,5,50,0,0,0
12814,10,2014-11-15,new-mexico,@,Utah State,L (21-28),8,18,44.4,154,1,49,246,5.0,2,67,400,6.0,6,12,0,18,3,16,0,1,1
12815,11,2014-11-22,new-mexico,@,Colorado State,L (20-58),3,11,27.3,55,0,40,301,7.5,3,51,356,7.0,1,13,1,15,5,58,2,2,4
12816,12,2014-11-29,new-mexico,,Wyoming,W (36-30),6,7,85.7,141,1,32,241,7.5,2,39,382,9.8,2,8,0,10,4,50,1,1,2
12817,,12 Games,new-mexico,,,,76,149,51.0,1059,7,583,3725,6.4,34,732,4784,6.5,41,154,9,204,53,520,12,6,18
12818,1,2015-09-05,new-mexico,,Mississippi Valley State,W (66-0),11,18,61.1,151,0,51,370,7.3,8,69,521,7.6,8,17,1,26,6,55,0,0,0
12819,2,2015-09-12,new-mexico,,Tulsa,L (21-40),11,21,52.4,166,1,47,224,4.8,2,68,390,5.7,0,0,0,18,14,154,1,1,2
12820,3,2015-09-18,new-mexico,@,Arizona State,L (10-34),12,29,41.4,111,0,47,184,3.9,1,76,295,3.9,5,9,1,15,5,35,0,1,1
12821,4,2015-09-26,new-mexico,@,Wyoming,W (38-28),5,8,62.5,107,1,47,302,6.4,4,55,409,7.4,3,12,0,15,6,69,0,0,0
12822,5,2015-10-03,new-mexico,,New Mexico State,W (38-29),5,17,29.4,45,0,61,401,6.6,4,78,446,5.7,2,18,1,21,4,27,1,1,2
12823,6,2015-10-10,new-mexico,@,Nevada,L (17-35),19,24,79.2,138,0,37,135,3.6,1,61,273,4.5,5,9,0,14,5,60,1,1,2
12824,7,2015-10-17,new-mexico,,Hawaii,W (28-27),15,26,57.7,195,2,53,197,3.7,1,79,392,5.0,8,16,4,28,9,64,2,0,2
12825,8,2015-10-24,new-mexico,@,San Jose State,L (21-31),8,20,40.0,130,0,32,205,6.4,3,52,335,6.4,4,9,2,15,3,34,1,1,2
12826,9,2015-11-07,new-mexico,,Utah State,W (14-13),4,12,33.3,104,1,48,132,2.8,1,60,236,3.9,2,8,0,10,7,67,0,1,1
12827,10,2015-11-14,new-mexico,@,Boise State,W (31-24),9,13,69.2,218,0,39,195,5.0,4,52,413,7.9,4,6,1,11,16,135,1,1,2
12828,11,2015-11-21,new-mexico,,Colorado State,L (21-28),4,10,40.0,58,0,50,268,5.4,3,60,326,5.4,3,16,1,20,3,15,0,3,3
12829,12,2015-11-28,new-mexico,,Air Force,W (47-35),4,9,44.4,135,0,56,377,6.7,6,65,512,7.9,4,13,0,17,3,25,0,1,1
12830,13,2015-12-19,new-mexico,N,Arizona*,L (37-45),10,22,45.5,189,1,69,319,4.6,4,91,508,5.6,6,19,0,25,8,103,0,3,3
12831,,13 Games,new-mexico,,,,117,229,51.1,1747,6,637,3309,5.2,42,866,5056,5.8,54,152,11,235,89,843,7,14,21
12832,1,2016-09-01,new-mexico,,South Dakota,W (48-21),13,19,68.4,187,2,49,428,8.7,3,68,615,9.0,9,15,0,24,4,30,1,0,1
12833,2,2016-09-10,new-mexico,@,New Mexico State,L (31-32),12,23,52.2,115,0,45,221,4.9,4,68,336,4.9,7,13,3,23,5,55,1,1,2
12834,3,2016-09-17,new-mexico,@,Rutgers,L (28-37),13,24,54.2,169,1,56,293,5.2,3,80,462,5.8,8,12,1,21,7,65,1,1,2
12835,4,2016-10-01,new-mexico,,San Jose State,W (48-41),4,8,50.0,45,0,64,446,7.0,5,72,491,6.8,2,19,1,22,8,70,0,1,1
12836,5,2016-10-07,new-mexico,,Boise State,L (21-49),4,15,26.7,39,1,61,382,6.3,2,76,421,5.5,2,21,0,23,12,88,0,1,1
12837,6,2016-10-15,new-mexico,N,Air Force,W (45-40),3,8,37.5,70,2,55,373,6.8,4,63,443,7.0,3,14,1,18,3,25,0,0,0
12838,7,2016-10-22,new-mexico,,Louisiana-Monroe,W (59-17),7,11,63.6,146,1,51,476,9.3,5,62,622,10.0,3,18,2,23,7,70,3,0,3
12839,8,2016-10-29,new-mexico,@,Hawaii,W (28-21),11,15,73.3,84,0,40,237,5.9,3,55,321,5.8,4,11,0,15,8,79,0,1,1
12840,9,2016-11-05,new-mexico,,Nevada,W (35-26),8,12,66.7,100,1,64,373,5.8,4,76,473,6.2,5,18,0,23,6,41,1,1,2
12841,10,2016-11-12,new-mexico,@,Utah State,W (24-21),8,17,47.1,154,0,57,249,4.4,2,74,403,5.4,5,16,1,22,6,64,0,0,0
12842,11,2016-11-19,new-mexico,@,Colorado State,L (31-49),6,16,37.5,81,2,48,285,5.9,2,64,366,5.7,5,13,1,19,8,68,0,0,0
12843,12,2016-11-26,new-mexico,,Wyoming,W (56-35),4,5,80.0,122,1,46,568,12.3,7,51,690,13.5,4,17,0,21,6,52,1,0,1
12844,13,2016-12-17,new-mexico,N,Texas-San Antonio*,W (23-20),3,6,50.0,77,0,52,219,4.2,3,58,296,5.1,3,13,1,17,2,30,0,0,0
12845,,13 Games,new-mexico,,,,96,179,53.6,1389,11,688,4550,6.6,47,867,5939,6.9,60,200,11,271,82,737,8,6,14
12846,1,2017-09-02,new-mexico,,Abilene Christian,W (38-14),12,18,66.7,222,1,40,259,6.5,3,58,481,8.3,9,10,2,21,4,29,2,0,2
12847,2,2017-09-09,new-mexico,,New Mexico State,L (28-30),20,38,52.6,254,2,37,176,4.8,1,75,430,5.7,11,7,3,21,13,104,2,2,4
12848,3,2017-09-14,new-mexico,@,Boise State,L (14-28),8,16,50.0,79,1,51,198,3.9,1,67,277,4.1,6,10,2,18,1,5,1,1,2
12849,4,2017-09-23,new-mexico,@,Tulsa,W (16-13),9,14,64.3,108,0,59,338,5.7,1,73,446,6.1,6,15,4,25,6,49,2,1,3
12850,5,2017-09-30,new-mexico,,Air Force,W (56-38),4,9,44.4,146,2,41,363,8.9,6,50,509,10.2,3,12,1,16,7,65,0,0,0
12851,6,2017-10-14,new-mexico,@,Fresno State,L (0-38),15,30,50.0,213,0,37,109,2.9,0,67,322,4.8,8,6,0,14,3,35,1,1,2
12852,7,2017-10-20,new-mexico,,Colorado State,L (24-27),7,19,36.8,132,1,47,320,6.8,2,66,452,6.8,4,13,4,21,12,105,1,0,1
12853,8,2017-10-28,new-mexico,@,Wyoming,L (3-42),10,25,40.0,69,0,40,115,2.9,0,65,184,2.8,3,9,1,13,6,55,2,5,7
12854,9,2017-11-04,new-mexico,,Utah State,L (10-24),12,22,54.5,75,0,57,265,4.6,1,79,340,4.3,3,17,1,21,9,63,4,0,4
12855,10,2017-11-11,new-mexico,@,Texas A&M,L (14-55),7,17,41.2,24,0,42,120,2.9,1,59,144,2.4,0,8,3,11,2,19,0,1,1
12856,11,2017-11-17,new-mexico,,Nevada-Las Vegas,L (35-38),0,4,0.0,0,0,56,482,8.6,5,60,482,8.0,0,19,0,19,5,49,0,1,1
12857,12,2017-11-24,new-mexico,@,San Diego State,L (10-35),16,30,53.3,167,1,34,82,2.4,0,64,249,3.9,6,4,1,11,5,35,0,2,2
12858,,12 Games,new-mexico,,,,120,242,49.6,1489,8,541,2827,5.2,21,783,4316,5.5,59,130,22,211,73,613,15,14,29
12859,1,2018-09-01,new-mexico,,Incarnate Word,W (62-30),15,25,60.0,361,5,66,319,4.8,4,91,680,7.5,10,19,3,32,7,48,1,1,2
12860,2,2018-09-08,new-mexico,@,Wisconsin,L (14-45),14,24,58.3,134,2,30,77,2.6,0,54,211,3.9,8,5,1,14,1,10,1,2,3
12861,3,2018-09-15,new-mexico,@,New Mexico State,W (42-25),12,19,63.2,127,0,62,198,3.2,5,81,325,4.0,6,14,2,22,15,133,1,1,2
12862,4,2018-09-29,new-mexico,,Liberty,L (43-52),21,41,51.2,369,4,37,211,5.7,2,78,580,7.4,13,10,1,24,6,57,0,4,4
12863,5,2018-10-06,new-mexico,@,Nevada-Las Vegas,W (50-14),13,21,61.9,250,4,60,252,4.2,3,81,502,6.2,9,14,2,25,3,40,1,0,1
12864,6,2018-10-13,new-mexico,@,Colorado State,L (18-20),12,20,60.0,165,2,35,134,3.8,0,55,299,5.4,7,7,1,15,5,45,1,0,1
12865,7,2018-10-20,new-mexico,,Fresno State,L (7-38),15,32,46.9,132,1,33,148,4.5,0,65,280,4.3,8,9,2,19,8,110,0,1,1
12866,8,2018-10-27,new-mexico,@,Utah State,L (19-61),18,37,48.6,220,1,30,71,2.4,0,67,291,4.3,10,3,0,13,3,35,1,4,5
12867,9,2018-11-03,new-mexico,,San Diego State,L (23-31),9,20,45.0,41,2,37,101,2.7,0,57,142,2.5,3,7,1,11,2,30,0,1,1
12868,10,2018-11-10,new-mexico,@,Air Force,L (24-42),13,18,72.2,186,0,36,119,3.3,2,54,305,5.6,5,9,0,14,0,0,1,1,2
12869,11,2018-11-16,new-mexico,,Boise State,L (14-45),8,14,57.1,103,0,45,159,3.5,1,59,262,4.4,5,10,0,15,4,41,2,1,3
12870,,11 Games,new-mexico,,,,150,271,55.4,2088,21,471,1789,3.8,17,742,3877,5.2,84,107,13,204,54,549,9,16,25
12871,1,2014-08-30,wyoming,,Montana,W (17-12),13,21,61.9,92,0,46,209,4.5,2,67,301,4.5,6,10,2,18,1,4,1,1,2
12872,2,2014-09-06,wyoming,,Air Force,W (17-13),23,37,62.2,282,2,26,51,2.0,0,63,333,5.3,14,1,0,15,2,15,0,0,0
12873,3,2014-09-13,wyoming,@,Oregon,L (14-48),19,33,57.6,284,2,41,155,3.8,0,74,439,5.9,16,7,1,24,5,48,1,2,3
12874,4,2014-09-20,wyoming,,Florida Atlantic,W (20-19),10,23,43.5,161,0,41,173,4.2,2,64,334,5.2,5,10,2,17,4,36,1,0,1
12875,5,2014-09-27,wyoming,@,Michigan State,L (14-56),16,24,66.7,188,1,27,98,3.6,1,51,286,5.6,6,5,0,11,5,43,2,1,3
12876,6,2014-10-11,wyoming,@,Hawaii,L (28-38),19,30,63.3,221,2,33,101,3.1,1,63,322,5.1,9,7,1,17,5,40,0,2,2
12877,7,2014-10-18,wyoming,,San Jose State,L (20-27),11,28,39.3,119,0,30,158,5.3,1,58,277,4.8,5,6,0,11,7,72,0,0,0
12878,8,2014-10-25,wyoming,@,Colorado State,L (31-45),24,38,63.2,335,2,38,119,3.1,2,76,454,6.0,13,8,4,25,7,53,0,0,0
12879,9,2014-11-01,wyoming,@,Fresno State,W (45-17),19,28,67.9,320,2,43,374,8.7,4,71,694,9.8,14,10,0,24,8,64,1,0,1
12880,10,2014-11-07,wyoming,,Utah State,L (3-20),20,40,50.0,212,0,35,151,4.3,0,75,363,4.8,10,7,1,18,10,95,0,2,2
12881,11,2014-11-22,wyoming,,Boise State,L (14-63),16,29,55.2,147,0,38,80,2.1,2,67,227,3.4,7,5,0,12,3,20,2,1,3
12882,12,2014-11-29,wyoming,@,New Mexico,L (30-36),21,43,48.8,366,1,51,175,3.4,2,94,541,5.8,19,7,3,29,6,30,0,1,1
12883,,12 Games,wyoming,,,,211,374,56.4,2727,12,449,1844,4.1,17,823,4571,5.6,124,83,14,221,63,520,8,10,18
12884,1,2015-09-05,wyoming,,North Dakota,L (13-24),20,39,51.3,289,2,19,41,2.2,0,58,330,5.7,10,3,1,14,8,96,0,0,0
12885,2,2015-09-12,wyoming,,Eastern Michigan,L (29-48),6,17,35.3,32,0,58,430,7.4,4,75,462,6.2,3,22,4,29,4,30,1,0,1
12886,3,2015-09-19,wyoming,@,Washington State,L (14-31),25,36,69.4,296,2,40,113,2.8,0,76,409,5.4,10,11,1,22,8,57,1,1,2
12887,4,2015-09-26,wyoming,,New Mexico,L (28-38),30,42,71.4,366,4,30,42,1.4,0,72,408,5.7,16,5,5,26,10,98,0,2,2
12888,5,2015-10-03,wyoming,@,Appalachian State,L (13-31),14,19,73.7,155,1,51,218,4.3,1,70,373,5.3,7,11,0,18,7,65,2,1,3
12889,6,2015-10-10,wyoming,@,Air Force,L (17-31),15,29,51.7,192,2,35,115,3.3,0,64,307,4.8,8,9,2,19,1,10,2,2,4
12890,7,2015-10-17,wyoming,,Nevada,W (28-21),18,20,90.0,213,3,51,272,5.3,1,71,485,6.8,9,15,1,25,7,71,0,0,0
12891,8,2015-10-24,wyoming,@,Boise State,L (14-34),12,21,57.1,123,1,33,110,3.3,1,54,233,4.3,6,6,4,16,5,35,0,1,1
12892,9,2015-10-30,wyoming,@,Utah State,L (27-58),10,18,55.6,83,2,49,270,5.5,2,67,353,5.3,7,14,1,22,4,33,0,0,0
12893,10,2015-11-07,wyoming,,Colorado State,L (7-26),10,21,47.6,109,0,34,130,3.8,1,55,239,4.3,6,8,1,15,9,66,3,1,4
12894,11,2015-11-14,wyoming,@,San Diego State,L (3-38),9,21,42.9,129,0,32,62,1.9,0,53,191,3.6,5,5,2,12,7,63,1,2,3
12895,12,2015-11-28,wyoming,,Nevada-Las Vegas,W (35-28),14,25,56.0,248,3,46,290,6.3,2,71,538,7.6,8,14,1,23,5,57,0,1,1
12896,,12 Games,wyoming,,,,183,308,59.4,2235,20,478,2093,4.4,12,786,4328,5.5,95,123,23,241,75,681,10,11,21
12897,1,2016-09-03,wyoming,,Northern Illinois,W (40-34),19,29,65.5,245,2,56,243,4.3,3,85,488,5.7,13,9,6,28,10,100,0,0,0
12898,2,2016-09-10,wyoming,@,Nebraska,L (17-52),16,32,50.0,189,1,31,131,4.2,1,63,320,5.1,8,5,3,16,5,42,1,5,6
12899,3,2016-09-17,wyoming,,California-Davis,W (45-22),11,15,73.3,198,3,48,274,5.7,3,63,472,7.5,10,12,0,22,5,41,1,0,1
12900,4,2016-09-23,wyoming,@,Eastern Michigan,L (24-27),19,29,65.5,234,0,38,79,2.1,1,67,313,4.7,12,4,3,19,3,35,2,1,3
12901,5,2016-10-01,wyoming,@,Colorado State,W (38-17),7,18,38.9,165,1,49,269,5.5,3,67,434,6.5,7,12,0,19,4,30,0,0,0
12902,6,2016-10-08,wyoming,,Air Force,W (35-26),15,27,55.6,173,3,48,189,3.9,1,75,362,4.8,10,9,2,21,5,50,1,0,1
12903,7,2016-10-22,wyoming,@,Nevada,W (42-34),10,14,71.4,149,1,54,393,7.3,5,68,542,8.0,6,20,1,27,6,67,0,0,0
12904,8,2016-10-29,wyoming,,Boise State,W (30-28),18,31,58.1,274,3,49,215,4.4,0,80,489,6.1,12,13,0,25,0,0,0,1,1
12905,9,2016-11-05,wyoming,,Utah State,W (52-28),16,26,61.5,261,4,46,267,5.8,3,72,528,7.3,10,14,1,25,7,70,0,1,1
12906,10,2016-11-12,wyoming,@,Nevada-Las Vegas,L (66-69),14,34,41.2,334,4,32,151,4.7,3,66,485,7.3,11,8,1,20,2,12,2,2,4
12907,11,2016-11-19,wyoming,,San Diego State,W (34-33),16,31,51.6,282,2,53,205,3.9,2,84,487,5.8,12,15,2,29,2,20,0,1,1
12908,12,2016-11-26,wyoming,@,New Mexico,L (35-56),18,28,64.3,248,0,45,201,4.5,5,73,449,6.2,11,12,2,25,4,44,1,0,1
12909,13,2016-12-03,wyoming,,San Diego State,L (24-27),14,31,45.2,248,3,31,95,3.1,0,62,343,5.5,10,3,0,13,6,45,1,2,3
12910,14,2016-12-21,wyoming,N,Brigham Young*,L (21-24),17,33,51.5,207,2,45,186,4.1,1,78,393,5.0,9,10,3,22,7,59,0,2,2
12911,,14 Games,wyoming,,,,210,378,55.6,3207,29,625,2898,4.6,31,1003,6105,6.1,141,146,24,311,66,615,9,15,24
12912,1,2017-09-02,wyoming,@,Iowa,L (3-24),23,40,57.5,174,0,30,59,2.0,0,70,233,3.3,10,4,1,15,5,40,0,2,2
12913,2,2017-09-09,wyoming,,Gardner-Webb,W (27-0),22,32,68.8,328,2,28,65,2.3,1,60,393,6.6,15,3,1,19,4,45,0,0,0
12914,3,2017-09-16,wyoming,,Oregon,L (13-49),10,25,40.0,66,0,32,117,3.7,1,57,183,3.2,2,6,2,10,6,62,1,1,2
12915,4,2017-09-23,wyoming,,Hawaii,W (28-21),9,19,47.4,92,1,29,177,6.1,2,48,269,5.6,3,8,0,11,4,51,0,0,0
12916,5,2017-09-30,wyoming,,Texas State,W (45-10),15,26,57.7,249,3,35,84,2.4,0,61,333,5.5,12,5,1,18,4,33,1,0,1
12917,6,2017-10-14,wyoming,@,Utah State,W (28-23),18,26,69.2,208,1,36,85,2.4,1,62,293,4.7,8,5,1,14,8,75,0,1,1
12918,7,2017-10-21,wyoming,@,Boise State,L (14-24),12,27,44.4,131,1,34,111,3.3,1,61,242,4.0,6,7,2,15,1,12,0,2,2
12919,8,2017-10-28,wyoming,,New Mexico,W (42-3),16,28,57.1,234,4,32,75,2.3,2,60,309,5.2,12,3,3,18,5,50,0,0,0
12920,9,2017-11-04,wyoming,,Colorado State,W (16-13),10,20,50.0,138,0,34,156,4.6,1,54,294,5.4,9,8,1,18,1,5,1,0,1
12921,10,2017-11-11,wyoming,@,Air Force,W (28-14),11,15,73.3,129,1,43,100,2.3,3,58,229,3.9,6,8,2,16,5,50,1,0,1
12922,11,2017-11-18,wyoming,,Fresno State,L (7-13),20,33,60.6,231,1,28,77,2.8,0,61,308,5.0,9,3,0,12,3,15,2,0,2
12923,12,2017-11-25,wyoming,@,San Jose State,L (17-20),18,38,47.4,170,1,43,187,4.3,1,81,357,4.4,5,10,2,17,4,35,0,2,2
12924,13,2017-12-22,wyoming,N,Central Michigan*,W (37-14),11,19,57.9,154,3,42,121,2.9,0,61,275,4.5,8,6,1,15,5,49,0,0,0
12925,,13 Games,wyoming,,,,195,348,56.0,2304,18,446,1414,3.2,13,794,3718,4.7,105,76,17,198,55,522,6,8,14
12926,1,2018-08-25,wyoming,@,New Mexico State,W (29-7),13,22,59.1,137,0,56,313,5.6,3,78,450,5.8,7,13,2,22,4,60,0,0,0
12927,2,2018-09-01,wyoming,,Washington State,L (19-41),8,20,40.0,67,0,39,139,3.6,2,59,206,3.5,3,11,1,15,13,109,0,1,1
12928,3,2018-09-08,wyoming,@,Missouri,L (13-40),13,28,46.4,160,0,30,88,2.9,1,58,248,4.3,7,5,3,15,3,17,1,0,1
12929,4,2018-09-15,wyoming,,Wofford,W (17-14),25,42,59.5,224,2,27,89,3.3,0,69,313,4.5,13,5,1,19,5,40,0,1,1
12930,5,2018-09-29,wyoming,,Boise State,L (14-34),15,26,57.7,214,1,24,81,3.4,1,50,295,5.9,7,3,1,11,6,59,1,0,1
12931,6,2018-10-06,wyoming,@,Hawaii,L (13-17),9,18,50.0,87,0,34,157,4.6,0,52,244,4.7,4,8,1,13,6,45,0,0,0
12932,7,2018-10-13,wyoming,@,Fresno State,L (3-27),12,32,37.5,117,0,30,104,3.5,0,62,221,3.6,6,6,2,14,5,22,0,1,1
12933,8,2018-10-20,wyoming,,Utah State,L (16-24),10,24,41.7,100,0,50,231,4.6,1,74,331,4.5,3,10,2,15,10,80,1,1,2
12934,9,2018-10-26,wyoming,@,Colorado State,W (34-21),7,10,70.0,116,2,55,297,5.4,2,65,413,6.4,5,14,1,20,6,57,0,0,0
12935,10,2018-11-03,wyoming,,San Jose State,W (24-9),4,8,50.0,51,1,64,424,6.6,2,72,475,6.6,4,18,0,22,4,25,2,0,2
12936,11,2018-11-17,wyoming,,Air Force,W (35-27),15,29,51.7,262,2,29,111,3.8,3,58,373,6.4,9,7,2,18,5,35,1,0,1
12937,,11 Games,wyoming,,,,131,259,50.6,1535,8,438,2034,4.6,15,697,3569,5.1,68,100,16,184,67,549,6,4,10
12938,1,2014-08-29,nevada-las-vegas,@,Arizona,L (13-58),22,41,53.7,252,1,31,119,3.8,0,72,371,5.2,14,5,1,20,7,64,0,1,1
12939,2,2014-09-06,nevada-las-vegas,,Northern Colorado,W (13-12),11,20,55.0,121,1,48,211,4.4,0,68,332,4.9,6,13,0,19,6,75,0,4,4
12940,3,2014-09-13,nevada-las-vegas,,Northern Illinois,L (34-48),24,42,57.1,397,2,32,102,3.2,2,74,499,6.7,18,3,5,26,5,32,0,1,1
12941,4,2014-09-20,nevada-las-vegas,@,Houston,L (14-47),16,39,41.0,146,0,39,170,4.4,2,78,316,4.1,5,7,4,16,11,105,0,3,3
12942,5,2014-09-27,nevada-las-vegas,@,San Diego State,L (17-34),18,33,54.5,346,1,38,109,2.9,1,71,455,6.4,13,9,4,26,8,72,0,2,2
12943,6,2014-10-04,nevada-las-vegas,@,San Jose State,L (10-33),11,28,39.3,116,0,31,105,3.4,1,59,221,3.7,5,6,1,12,3,15,1,1,2
12944,7,2014-10-10,nevada-las-vegas,,Fresno State,W (30-27),29,40,72.5,332,1,46,146,3.2,2,86,478,5.6,15,5,2,22,8,61,0,1,1
12945,8,2014-10-25,nevada-las-vegas,@,Utah State,L (20-34),22,38,57.9,267,3,27,15,0.6,0,65,282,4.3,10,2,1,13,4,35,1,2,3
12946,9,2014-11-01,nevada-las-vegas,,New Mexico,L (28-31),28,44,63.6,271,0,37,214,5.8,4,81,485,6.0,14,13,2,29,10,69,1,2,3
12947,10,2014-11-08,nevada-las-vegas,,Air Force,L (21-48),22,45,48.9,306,1,30,33,1.1,2,75,339,4.5,12,5,2,19,3,30,0,0,0
12948,11,2014-11-15,nevada-las-vegas,@,Brigham Young,L (23-42),20,45,44.4,204,1,45,199,4.4,1,90,403,4.5,10,7,1,18,6,43,0,1,1
12949,12,2014-11-22,nevada-las-vegas,@,Hawaii,L (35-37),24,44,54.5,423,3,26,51,2.0,2,70,474,6.8,17,4,1,22,7,80,0,1,1
12950,13,2014-11-29,nevada-las-vegas,,Nevada,L (27-49),21,39,53.8,171,2,36,205,5.7,1,75,376,5.0,9,12,4,25,3,35,1,3,4
12951,,13 Games,nevada-las-vegas,,,,268,498,53.8,3352,16,466,1679,3.6,18,964,5031,5.2,148,91,28,267,81,716,4,22,26
12952,1,2015-09-05,nevada-las-vegas,@,Northern Illinois,L (30-38),22,40,55.0,329,2,47,164,3.5,1,87,493,5.7,15,10,3,28,3,30,0,1,1
12953,2,2015-09-12,nevada-las-vegas,,UCLA,L (3-37),6,23,26.1,56,0,43,181,4.2,0,66,237,3.6,2,7,2,11,8,85,1,1,2
12954,3,2015-09-19,nevada-las-vegas,@,Michigan,L (7-28),14,26,53.8,143,1,36,92,2.6,0,62,235,3.8,8,6,1,15,2,10,0,2,2
12955,4,2015-09-26,nevada-las-vegas,,Idaho State,W (80-8),10,15,66.7,109,4,54,517,9.6,6,69,626,9.1,5,20,0,25,10,95,0,0,0
12956,5,2015-10-03,nevada-las-vegas,@,Nevada,W (23-17),13,19,68.4,134,0,44,167,3.8,2,63,301,4.8,8,8,2,18,8,76,0,1,1
12957,6,2015-10-10,nevada-las-vegas,,San Jose State,L (27-33),15,30,50.0,217,2,48,186,3.9,1,78,403,5.2,8,14,1,23,4,40,0,2,2
12958,7,2015-10-16,nevada-las-vegas,@,Fresno State,L (28-31),12,24,50.0,111,2,48,188,3.9,2,72,299,4.2,8,10,2,20,2,16,0,0,0
12959,8,2015-10-31,nevada-las-vegas,,Boise State,L (27-55),30,51,58.8,387,0,25,100,4.0,1,76,487,6.4,17,6,5,28,5,39,0,2,2
12960,9,2015-11-07,nevada-las-vegas,,Hawaii,W (41-21),15,24,62.5,258,2,53,289,5.5,3,77,547,7.1,9,11,2,22,6,60,1,1,2
12961,10,2015-11-14,nevada-las-vegas,@,Colorado State,L (35-49),22,44,50.0,330,3,36,172,4.8,2,80,502,6.3,13,9,2,24,5,60,0,0,0
12962,11,2015-11-21,nevada-las-vegas,,San Diego State,L (14-52),18,35,51.4,190,2,32,80,2.5,0,67,270,4.0,10,5,3,18,3,14,2,2,4
12963,12,2015-11-28,nevada-las-vegas,@,Wyoming,L (28-35),19,34,55.9,273,3,34,183,5.4,1,68,456,6.7,13,9,1,23,1,13,0,1,1
12964,,12 Games,nevada-las-vegas,,,,196,365,53.7,2537,21,500,2319,4.6,19,865,4856,5.6,116,115,24,255,57,538,4,13,17
12965,1,2016-09-01,nevada-las-vegas,,Jackson State,W (63-13),11,13,84.6,223,3,44,280,6.4,4,57,503,8.8,8,13,0,21,6,61,1,0,1
12966,2,2016-09-10,nevada-las-vegas,@,UCLA,L (21-42),11,28,39.3,153,1,35,175,5.0,2,63,328,5.2,8,10,0,18,7,70,0,2,2
12967,3,2016-09-17,nevada-las-vegas,@,Central Michigan,L (21-44),15,41,36.6,131,1,38,182,4.8,1,79,313,4.0,7,8,0,15,9,94,0,2,2
12968,4,2016-09-24,nevada-las-vegas,,Idaho,L (30-33),14,26,53.8,175,1,49,364,7.4,2,75,539,7.2,9,15,2,26,6,58,0,2,2
12969,5,2016-10-01,nevada-las-vegas,,Fresno State,W (45-20),8,16,50.0,129,1,54,364,6.7,5,70,493,7.0,4,13,2,19,4,45,0,0,0
12970,6,2016-10-08,nevada-las-vegas,@,San Diego State,L (7-26),2,13,15.4,9,0,36,113,3.1,0,49,122,2.5,1,7,1,9,0,0,0,1,1
12971,7,2016-10-15,nevada-las-vegas,@,Hawaii,W (41-38),19,29,65.5,279,2,51,256,5.0,3,80,535,6.7,12,15,2,29,8,86,0,0,0
12972,8,2016-10-22,nevada-las-vegas,,Colorado State,L (23-42),7,23,30.4,185,2,32,175,5.5,1,55,360,6.5,6,11,0,17,5,21,1,1,2
12973,9,2016-10-29,nevada-las-vegas,@,San Jose State,L (24-30),12,30,40.0,185,1,40,217,5.4,2,70,402,5.7,7,10,3,20,11,87,0,1,1
12974,10,2016-11-12,nevada-las-vegas,,Wyoming,W (69-66),20,33,60.6,252,3,64,401,6.3,5,97,653,6.7,13,18,0,31,4,35,1,0,1
12975,11,2016-11-18,nevada-las-vegas,@,Boise State,L (25-42),10,20,50.0,113,1,44,189,4.3,2,64,302,4.7,5,12,0,17,6,54,0,0,0
12976,12,2016-11-26,nevada-las-vegas,,Nevada,L (10-45),9,22,40.9,121,0,34,182,5.4,1,56,303,5.4,5,8,1,14,1,3,0,1,1
12977,,12 Games,nevada-las-vegas,,,,138,294,46.9,1955,16,521,2898,5.6,28,815,4853,6.0,85,140,11,236,67,614,3,10,13
12978,1,2017-09-02,nevada-las-vegas,,Howard,L (40-43),11,21,52.4,220,1,46,344,7.5,3,67,564,8.4,9,16,0,25,13,90,3,0,3
12979,2,2017-09-09,nevada-las-vegas,@,Idaho,W (44-16),10,16,62.5,193,1,50,357,7.1,4,66,550,8.3,5,16,1,22,5,47,0,1,1
12980,3,2017-09-23,nevada-las-vegas,@,Ohio State,L (21-54),11,20,55.0,88,0,41,176,4.3,2,61,264,4.3,4,8,5,17,4,30,0,2,2
12981,4,2017-09-30,nevada-las-vegas,,San Jose State,W (41-13),11,16,68.8,203,2,52,345,6.6,4,68,548,8.1,9,15,1,25,6,55,0,0,0
12982,5,2017-10-07,nevada-las-vegas,,San Diego State,L (10-41),12,28,42.9,177,1,31,106,3.4,0,59,283,4.8,7,5,0,12,5,49,0,0,0
12983,6,2017-10-14,nevada-las-vegas,@,Air Force,L (30-34),12,27,44.4,145,0,39,266,6.8,3,66,411,6.2,6,9,0,15,2,20,1,1,2
12984,7,2017-10-21,nevada-las-vegas,,Utah State,L (28-52),13,30,43.3,85,0,53,375,7.1,4,83,460,5.5,3,20,2,25,4,32,1,2,3
12985,8,2017-10-28,nevada-las-vegas,@,Fresno State,W (26-16),17,29,58.6,155,0,44,173,3.9,2,73,328,4.5,10,9,3,22,5,35,0,0,0
12986,9,2017-11-04,nevada-las-vegas,,Hawaii,W (31-23),20,31,64.5,281,2,42,131,3.1,2,73,412,5.6,15,7,1,23,4,36,0,1,1
12987,10,2017-11-10,nevada-las-vegas,,Brigham Young,L (21-31),20,33,60.6,325,2,34,122,3.6,1,67,447,6.7,12,9,0,21,6,75,0,2,2
12988,11,2017-11-17,nevada-las-vegas,@,New Mexico,W (38-35),13,25,52.0,211,1,46,323,7.0,3,71,534,7.5,10,14,1,25,1,5,0,0,0
12989,12,2017-11-25,nevada-las-vegas,@,Nevada,L (16-23),12,23,52.2,160,0,50,164,3.3,1,73,324,4.4,7,14,1,22,1,5,1,0,1
12990,,12 Games,nevada-las-vegas,,,,162,299,54.2,2243,10,528,2882,5.5,29,827,5125,6.2,97,142,15,254,56,479,6,9,15
12991,1,2018-09-01,nevada-las-vegas,@,Southern California,L (21-43),12,27,44.4,97,2,43,308,7.2,1,70,405,5.8,4,13,0,17,4,35,1,0,1
12992,2,2018-09-08,nevada-las-vegas,,Texas-El Paso,W (52-24),6,14,42.9,119,3,56,414,7.4,4,70,533,7.6,5,21,3,29,3,29,0,0,0
12993,3,2018-09-15,nevada-las-vegas,,Prairie View A&M,W (46-17),11,21,52.4,130,1,64,318,5.0,5,85,448,5.3,8,18,2,28,4,29,2,1,3
12994,4,2018-09-22,nevada-las-vegas,@,Arkansas State,L (20-27),5,21,23.8,23,0,49,310,6.3,3,70,333,4.8,2,11,2,15,6,40,1,3,4
12995,5,2018-10-06,nevada-las-vegas,,New Mexico,L (14-50),15,35,42.9,123,2,27,43,1.6,0,62,166,2.7,8,3,2,13,3,25,1,1,2
12996,6,2018-10-13,nevada-las-vegas,@,Utah State,L (28-59),18,36,50.0,250,3,48,154,3.2,1,84,404,4.8,10,8,3,21,9,70,0,1,1
12997,7,2018-10-19,nevada-las-vegas,,Air Force,L (35-41),26,38,68.4,261,3,33,139,4.2,2,71,400,5.6,12,6,5,23,6,40,0,1,1
12998,8,2018-10-27,nevada-las-vegas,@,San Jose State,L (37-50),28,50,56.0,387,4,37,167,4.5,1,87,554,6.4,14,9,2,25,4,35,0,3,3
12999,9,2018-11-03,nevada-las-vegas,,Fresno State,L (3-48),15,35,42.9,105,0,41,197,4.8,0,76,302,4.0,6,12,0,18,8,57,0,1,1
13000,10,2018-11-10,nevada-las-vegas,@,San Diego State,W (27-24),16,24,66.7,237,1,43,199,4.6,2,67,436,6.5,9,9,1,19,5,51,1,1,2
13001,11,2018-11-17,nevada-las-vegas,@,Hawaii,L (28-35),10,24,41.7,87,2,53,221,4.2,2,77,308,4.0,4,12,0,16,8,97,0,0,0
13002,,11 Games,nevada-las-vegas,,,,162,325,49.8,1819,21,494,2470,5.0,21,819,4289,5.2,82,122,20,224,60,508,6,12,18
13003,1,2014-08-28,san-jose-state,,North Dakota,W (42-10),23,26,88.5,256,3,40,150,3.8,2,66,406,6.2,11,10,2,23,4,40,0,0,0
13004,2,2014-09-06,san-jose-state,@,Auburn,L (13-59),19,32,59.4,254,1,45,65,1.4,0,77,319,4.1,10,8,2,20,7,66,0,3,3
13005,3,2014-09-20,san-jose-state,@,Minnesota,L (7-24),16,33,48.5,186,1,32,68,2.1,0,65,254,3.9,8,6,3,17,0,0,3,2,5
13006,4,2014-09-27,san-jose-state,,Nevada,L (10-21),32,46,69.6,276,0,37,170,4.6,1,83,446,5.4,13,10,1,24,9,95,1,2,3
13007,5,2014-10-04,san-jose-state,,Nevada-Las Vegas,W (33-10),20,30,66.7,265,1,56,277,4.9,2,86,542,6.3,11,12,0,23,4,45,1,0,1
13008,6,2014-10-18,san-jose-state,@,Wyoming,W (27-20),33,45,73.3,322,2,41,149,3.6,1,86,471,5.5,18,10,3,31,5,40,2,0,2
13009,7,2014-10-25,san-jose-state,@,Navy,L (31-41),33,46,71.7,322,3,25,100,4.0,1,71,422,5.9,20,6,0,26,2,20,0,1,1
13010,8,2014-11-01,san-jose-state,,Colorado State,L (31-38),26,51,51.0,308,2,32,185,5.8,2,83,493,5.9,15,8,1,24,1,5,1,2,3
13011,9,2014-11-08,san-jose-state,@,Fresno State,L (24-38),26,44,59.1,350,2,23,86,3.7,1,67,436,6.5,12,4,0,16,7,30,1,2,3
13012,10,2014-11-15,san-jose-state,,Hawaii,L (0-13),25,45,55.6,305,0,41,157,3.8,0,86,462,5.4,15,9,0,24,3,20,2,1,3
13013,11,2014-11-21,san-jose-state,@,Utah State,L (7-41),13,21,61.9,61,0,51,191,3.7,1,72,252,3.5,3,9,2,14,7,43,0,0,0
13014,12,2014-11-29,san-jose-state,@,San Diego State,L (7-38),17,30,56.7,133,1,31,98,3.2,0,61,231,3.8,7,5,0,12,3,35,1,1,2
13015,,12 Games,san-jose-state,,,,283,449,63.0,3038,16,454,1696,3.7,11,903,4734,5.2,143,97,14,254,52,439,12,14,26
13016,1,2015-09-03,san-jose-state,,New Hampshire,W (43-13),30,35,85.7,422,1,53,285,5.4,5,88,707,8.0,18,16,0,34,5,43,0,0,0
13017,2,2015-09-12,san-jose-state,@,Air Force,L (16-37),18,33,54.5,140,1,20,150,7.5,1,53,290,5.5,0,0,0,13,8,51,0,2,2
13018,3,2015-09-19,san-jose-state,@,Oregon State,L (21-35),20,33,60.6,149,1,36,104,2.9,2,69,253,3.7,6,8,0,14,2,20,0,2,2
13019,4,2015-09-26,san-jose-state,,Fresno State,W (49-23),20,23,87.0,252,3,58,291,5.0,3,81,543,6.7,10,21,2,33,4,30,1,0,1
13020,5,2015-10-03,san-jose-state,@,Auburn,L (21-35),21,33,63.6,224,1,38,182,4.8,2,71,406,5.7,12,9,1,22,2,15,2,2,4
13021,6,2015-10-10,san-jose-state,@,Nevada-Las Vegas,W (33-27),30,48,62.5,329,2,24,115,4.8,2,72,444,6.2,17,4,1,22,3,22,1,1,2
13022,7,2015-10-17,san-jose-state,,San Diego State,L (7-30),14,24,58.3,113,0,35,35,1.0,1,59,148,2.5,5,6,3,14,4,29,0,2,2
13023,8,2015-10-24,san-jose-state,,New Mexico,W (31-21),16,20,80.0,181,2,57,317,5.6,2,77,498,6.5,8,15,2,25,5,50,0,0,0
13024,9,2015-11-06,san-jose-state,,Brigham Young,L (16-17),18,26,69.2,147,0,38,122,3.2,1,64,269,4.2,9,6,3,18,2,10,1,0,1
13025,10,2015-11-14,san-jose-state,@,Nevada,L (34-37),15,23,65.2,186,3,45,247,5.5,0,68,433,6.4,10,11,0,21,4,40,0,0,0
13026,11,2015-11-21,san-jose-state,@,Hawaii,W (42-23),24,33,72.7,314,3,40,195,4.9,3,73,509,7.0,14,8,1,23,7,50,0,0,0
13027,12,2015-11-27,san-jose-state,,Boise State,L (23-40),28,41,68.3,336,3,33,138,4.2,0,74,474,6.4,16,7,1,24,6,56,0,2,2
13028,13,2015-12-19,san-jose-state,N,Georgia State*,W (27-16),10,19,52.6,89,1,54,197,3.6,1,73,286,3.9,6,12,2,20,5,48,0,1,1
13029,,13 Games,san-jose-state,,,,264,391,67.5,2882,21,531,2378,4.5,23,922,5260,5.7,131,123,16,283,57,464,5,12,17
13030,1,2016-09-03,san-jose-state,@,Tulsa,L (10-45),16,29,55.2,234,1,32,53,1.7,0,61,287,4.7,10,2,1,13,4,30,2,1,3
13031,2,2016-09-10,san-jose-state,,Portland State,W (66-35),14,21,66.7,233,3,57,409,7.2,6,78,642,8.2,8,16,4,28,6,60,0,0,0
13032,3,2016-09-17,san-jose-state,,Utah,L (17-34),21,39,53.8,249,2,32,56,1.8,0,71,305,4.3,10,6,2,18,2,10,1,2,3
13033,4,2016-09-24,san-jose-state,@,Iowa State,L (10-44),13,27,48.1,155,1,47,177,3.8,0,74,332,4.5,9,14,1,24,4,30,0,4,4
13034,5,2016-10-01,san-jose-state,@,New Mexico,L (41-48),16,30,53.3,314,3,26,129,5.0,3,56,443,7.9,12,3,5,20,2,25,0,1,1
13035,6,2016-10-08,san-jose-state,,Hawaii,L (17-34),18,33,54.5,175,1,40,164,4.1,0,73,339,4.6,5,10,1,16,4,25,0,3,3
13036,7,2016-10-15,san-jose-state,,Nevada,W (14-10),11,17,64.7,142,0,54,137,2.5,2,71,279,3.9,8,11,1,20,4,43,0,0,0
13037,8,2016-10-21,san-jose-state,@,San Diego State,L (3-42),18,37,48.6,142,0,28,67,2.4,0,65,209,3.2,10,3,1,14,7,69,0,0,0
13038,9,2016-10-29,san-jose-state,,Nevada-Las Vegas,W (30-24),24,40,60.0,292,2,42,132,3.1,1,82,424,5.2,14,9,1,24,4,50,0,0,0
13039,10,2016-11-04,san-jose-state,@,Boise State,L (31-45),23,35,65.7,278,2,31,209,6.7,1,66,487,7.4,15,12,0,27,5,44,0,1,1
13040,11,2016-11-19,san-jose-state,,Air Force,L (38-41),25,37,67.6,340,2,41,117,2.9,3,78,457,5.9,16,9,3,28,7,41,1,2,3
13041,12,2016-11-26,san-jose-state,@,Fresno State,W (16-14),15,25,60.0,111,1,48,211,4.4,0,73,322,4.4,6,14,0,20,3,12,1,1,2
13042,,12 Games,san-jose-state,,,,214,370,57.8,2665,18,478,1861,3.9,16,848,4526,5.3,123,109,20,252,52,439,5,15,20
13043,1,2017-08-26,san-jose-state,,South Florida,L (22-42),25,50,50.0,278,3,38,109,2.9,0,88,387,4.4,11,5,2,18,9,64,0,3,3
13044,2,2017-09-02,san-jose-state,,Cal Poly,W (34-13),15,26,57.7,211,3,52,271,5.2,1,78,482,6.2,8,15,0,23,7,57,2,0,2
13045,3,2017-09-09,san-jose-state,@,Texas,L (0-56),15,29,51.7,129,0,23,42,1.8,0,52,171,3.3,4,3,1,8,7,49,1,1,2
13046,4,2017-09-16,san-jose-state,@,Utah,L (16-54),17,35,48.6,233,1,37,30,0.8,0,72,263,3.7,11,4,1,16,6,58,3,2,5
13047,5,2017-09-23,san-jose-state,,Utah State,L (10-61),8,22,36.4,54,0,37,108,2.9,0,59,162,2.7,2,8,0,10,9,52,4,1,5
13048,6,2017-09-30,san-jose-state,@,Nevada-Las Vegas,L (13-41),30,49,61.2,315,1,33,147,4.5,0,82,462,5.6,20,7,3,30,7,60,1,2,3
13049,7,2017-10-07,san-jose-state,,Fresno State,L (10-27),15,26,57.7,97,1,33,108,3.3,0,59,205,3.5,4,7,1,12,9,78,2,2,4
13050,8,2017-10-14,san-jose-state,@,Hawaii,L (26-37),21,33,63.6,381,2,37,123,3.3,0,70,504,7.2,12,7,4,23,11,104,1,1,2
13051,9,2017-10-28,san-jose-state,@,Brigham Young,L (20-41),25,39,64.1,198,2,41,140,3.4,0,80,338,4.2,12,9,2,23,2,10,4,1,5
13052,10,2017-11-04,san-jose-state,,San Diego State,L (7-52),12,22,54.5,167,1,21,33,1.6,0,43,200,4.7,5,3,0,8,4,30,1,2,3
13053,11,2017-11-11,san-jose-state,@,Nevada,L (14-59),11,22,50.0,129,1,55,173,3.1,1,77,302,3.9,7,13,3,23,6,67,2,3,5
13054,12,2017-11-18,san-jose-state,@,Colorado State,L (14-42),17,33,51.5,208,0,33,131,4.0,2,66,339,5.1,8,6,2,16,2,10,0,1,1
13055,13,2017-11-25,san-jose-state,,Wyoming,W (20-17),15,29,51.7,174,0,43,146,3.4,2,72,320,4.4,6,7,1,14,5,55,1,1,2
13056,,13 Games,san-jose-state,,,,226,415,54.5,2574,15,483,1561,3.2,6,898,4135,4.6,110,94,20,224,84,694,22,20,42
13057,1,2018-08-30,san-jose-state,,California-Davis,L (38-44),28,52,53.8,365,3,38,141,3.7,2,90,506,5.6,17,8,2,27,12,125,1,2,3
13058,2,2018-09-08,san-jose-state,@,Washington State,L (0-31),14,28,50.0,100,0,23,9,0.4,0,51,109,2.1,5,2,1,8,9,56,0,1,1
13059,3,2018-09-15,san-jose-state,@,Oregon,L (22-35),20,41,48.8,267,1,28,29,1.0,1,69,296,4.3,12,1,3,16,3,25,0,2,2
13060,4,2018-09-29,san-jose-state,,Hawaii,L (41-44),28,49,57.1,451,3,37,39,1.1,2,86,490,5.7,17,5,2,24,10,75,0,0,0
13061,5,2018-10-06,san-jose-state,,Colorado State,L (30-42),18,43,41.9,237,3,34,48,1.4,1,77,285,3.7,8,6,2,16,6,45,0,2,2
13062,6,2018-10-13,san-jose-state,N,Army,L (3-52),13,18,72.2,135,0,30,36,1.2,0,48,171,3.6,7,3,0,10,7,55,4,0,4
13063,7,2018-10-20,san-jose-state,@,San Diego State,L (13-16),27,37,73.0,233,0,34,62,1.8,1,71,295,4.2,13,3,2,18,6,52,0,1,1
13064,8,2018-10-27,san-jose-state,,Nevada-Las Vegas,W (50-37),26,37,70.3,349,4,40,157,3.9,1,77,506,6.6,18,7,0,25,4,36,0,1,1
13065,9,2018-11-03,san-jose-state,@,Wyoming,L (9-24),19,32,59.4,173,1,24,71,3.0,0,56,244,4.4,9,5,1,15,6,45,0,0,0
13066,10,2018-11-10,san-jose-state,@,Utah State,L (24-62),22,42,52.4,344,2,20,56,2.8,0,62,400,6.5,12,1,1,14,9,80,1,2,3
13067,11,2018-11-17,san-jose-state,,Nevada,L (12-21),18,27,66.7,170,2,26,30,1.2,0,53,200,3.8,10,1,0,11,5,21,0,1,1
13068,,11 Games,san-jose-state,,,,233,406,57.4,2824,19,334,678,2.0,8,740,3502,4.7,128,42,14,184,77,615,6,12,18
13069,1,2014-08-30,hawaii,,Washington,L (16-17),23,43,53.5,207,0,54,217,4.0,1,97,424,4.4,11,13,2,26,5,36,0,0,0
13070,2,2014-09-06,hawaii,,Oregon State,L (30-38),20,51,39.2,236,0,33,100,3.0,4,84,336,4.0,8,7,5,20,12,108,1,1,2
13071,3,2014-09-13,hawaii,,Northern Iowa,W (27-24),17,36,47.2,225,1,50,148,3.0,1,86,373,4.3,10,6,1,17,5,45,1,0,1
13072,4,2014-09-20,hawaii,@,Colorado,L (12-21),17,46,37.0,155,0,32,131,4.1,0,78,286,3.7,7,8,5,20,2,15,1,1,2
13073,5,2014-10-04,hawaii,@,Rice,L (14-28),12,27,44.4,117,2,45,144,3.2,0,72,261,3.6,4,11,2,17,5,40,1,1,2
13074,6,2014-10-11,hawaii,,Wyoming,W (38-28),17,26,65.4,281,3,50,232,4.6,2,76,513,6.8,14,10,1,25,3,40,3,0,3
13075,7,2014-10-18,hawaii,@,San Diego State,L (10-20),17,31,54.8,174,1,25,90,3.6,0,56,264,4.7,7,5,0,12,7,40,1,2,3
13076,8,2014-10-25,hawaii,,Nevada,L (18-26),18,32,56.3,201,1,29,102,3.5,1,61,303,5.0,8,7,1,16,3,25,1,1,2
13077,9,2014-11-01,hawaii,,Utah State,L (14-35),26,48,54.2,356,1,31,98,3.2,1,79,454,5.7,14,9,0,23,13,100,1,2,3
13078,10,2014-11-08,hawaii,@,Colorado State,L (22-49),17,49,34.7,211,1,36,141,3.9,1,85,352,4.1,12,7,2,21,2,30,1,2,3
13079,11,2014-11-15,hawaii,@,San Jose State,W (13-0),9,16,56.3,150,0,40,90,2.3,1,56,240,4.3,5,6,0,11,6,45,0,1,1
13080,12,2014-11-22,hawaii,,Nevada-Las Vegas,W (37-35),14,23,60.9,230,2,56,348,6.2,3,79,578,7.3,8,14,1,23,7,50,2,1,3
13081,13,2014-11-29,hawaii,@,Fresno State,L (21-28),22,39,56.4,247,3,46,106,2.3,0,85,353,4.2,11,7,4,22,10,76,0,2,2
13082,,13 Games,hawaii,,,,229,467,49.0,2790,15,527,1947,3.7,15,994,4737,4.8,119,110,24,253,80,650,13,14,27
13083,1,2015-09-03,hawaii,,Colorado,W (28-20),19,38,50.0,202,3,34,100,2.9,0,72,302,4.2,8,4,2,14,9,50,0,2,2
13084,2,2015-09-12,hawaii,@,Ohio State,L (0-38),8,26,30.8,85,0,35,80,2.3,0,61,165,2.7,4,6,2,12,6,36,2,2,4
13085,3,2015-09-19,hawaii,,California-Davis,W (47-27),17,24,70.8,272,2,31,193,6.2,3,55,465,8.5,13,5,4,22,7,42,1,0,1
13086,4,2015-09-26,hawaii,@,Wisconsin,L (0-28),16,34,47.1,240,0,18,15,0.8,0,52,255,4.9,9,1,1,11,11,100,0,0,0
13087,5,2015-10-03,hawaii,@,Boise State,L (0-55),11,38,28.9,88,0,30,82,2.7,0,68,170,2.5,5,4,3,12,7,61,1,3,4
13088,6,2015-10-10,hawaii,,San Diego State,L (14-28),19,39,48.7,198,0,28,53,1.9,2,67,251,3.7,6,4,4,14,4,30,1,2,3
13089,7,2015-10-17,hawaii,@,New Mexico,L (27-28),13,25,52.0,195,1,50,220,4.4,2,75,415,5.5,12,10,1,23,11,94,0,2,2
13090,8,2015-10-24,hawaii,@,Nevada,L (20-30),27,40,67.5,291,2,24,34,1.4,0,64,325,5.1,16,2,1,19,10,79,1,3,4
13091,9,2015-10-31,hawaii,,Air Force,L (7-58),15,35,42.9,180,0,12,-2,-0.2,0,47,178,3.8,7,0,0,7,9,86,2,2,4
13092,10,2015-11-07,hawaii,@,Nevada-Las Vegas,L (21-41),16,33,48.5,187,0,31,191,6.2,3,64,378,5.9,8,6,2,16,5,52,2,1,3
13093,11,2015-11-14,hawaii,,Fresno State,L (14-42),20,49,40.8,245,1,39,192,4.9,1,88,437,5.0,13,11,1,25,11,132,1,3,4
13094,12,2015-11-21,hawaii,,San Jose State,L (23-42),13,25,52.0,202,2,38,213,5.6,1,63,415,6.6,7,10,1,18,9,61,1,1,2
13095,13,2015-11-28,hawaii,,Louisiana-Monroe,W (28-26),8,16,50.0,116,1,54,240,4.4,3,70,356,5.1,5,14,3,22,8,74,1,0,1
13096,,13 Games,hawaii,,,,202,422,47.9,2501,12,424,1611,3.8,15,846,4112,4.9,113,77,25,215,107,897,13,21,34
13097,1,2016-08-26,hawaii,N,California,L (31-51),17,34,50.0,234,1,38,248,6.5,3,72,482,6.7,11,13,2,26,6,52,2,1,3
13098,2,2016-09-03,hawaii,@,Michigan,L (3-63),12,23,52.2,151,0,37,81,2.2,0,60,232,3.9,7,7,2,16,8,60,0,2,2
13099,3,2016-09-10,hawaii,,Tennessee-Martin,W (41-36),10,20,50.0,203,4,37,175,4.7,2,57,378,6.6,6,9,0,15,7,52,0,3,3
13100,4,2016-09-17,hawaii,@,Arizona,L (28-47),21,43,48.8,261,1,38,168,4.4,3,81,429,5.3,13,9,3,25,12,95,1,1,2
13101,5,2016-10-01,hawaii,,Nevada,W (38-17),15,18,83.3,222,2,40,344,8.6,3,58,566,9.8,9,13,2,24,10,90,1,0,1
13102,6,2016-10-08,hawaii,@,San Jose State,W (34-17),24,33,72.7,287,2,31,144,4.6,2,64,431,6.7,13,6,1,20,9,85,2,0,2
13103,7,2016-10-15,hawaii,,Nevada-Las Vegas,L (38-41),17,32,53.1,217,2,33,229,6.9,3,65,446,6.9,9,8,3,20,7,61,1,0,1
13104,8,2016-10-22,hawaii,@,Air Force,W (34-27),21,37,56.8,312,3,26,75,2.9,1,63,387,6.1,16,3,0,19,4,46,0,2,2
13105,9,2016-10-29,hawaii,,New Mexico,L (21-28),16,28,57.1,173,0,40,125,3.1,3,68,298,4.4,9,6,1,16,1,10,1,0,1
13106,10,2016-11-05,hawaii,@,San Diego State,L (0-55),25,45,55.6,167,0,27,48,1.8,0,72,215,3.0,12,3,0,15,8,69,0,4,4
13107,11,2016-11-12,hawaii,,Boise State,L (16-52),16,32,50.0,125,1,32,234,7.3,0,64,359,5.6,6,9,0,15,10,79,1,1,2
13108,12,2016-11-19,hawaii,@,Fresno State,W (14-13),20,31,64.5,227,0,23,49,2.1,2,54,276,5.1,7,3,1,11,11,89,0,1,1
13109,13,2016-11-26,hawaii,,Massachusetts,W (46-40),22,31,71.0,311,5,33,168,5.1,1,64,479,7.5,9,10,4,23,12,101,1,0,1
13110,14,2016-12-24,hawaii,N,Middle Tennessee State*,W (52-35),21,31,67.7,295,4,42,205,4.9,2,73,500,6.8,10,8,0,18,11,114,0,0,0
13111,,14 Games,hawaii,,,,257,438,58.7,3185,25,477,2293,4.8,25,915,5478,6.0,137,107,19,263,116,1003,10,15,25
13112,1,2017-08-26,hawaii,@,Massachusetts,W (38-35),25,38,65.8,391,3,35,112,3.2,2,73,503,6.9,12,6,0,18,9,88,0,1,1
13113,2,2017-09-02,hawaii,,Western Carolina,W (41-18),12,24,50.0,154,2,49,299,6.1,3,73,453,6.2,7,15,1,23,11,104,0,2,2
13114,3,2017-09-09,hawaii,@,UCLA,L (23-56),24,39,61.5,234,2,42,281,6.7,1,81,515,6.4,12,9,4,25,8,80,0,1,1
13115,4,2017-09-23,hawaii,@,Wyoming,L (21-28),29,40,72.5,280,1,38,170,4.5,2,78,450,5.8,13,9,2,24,10,96,0,2,2
13116,5,2017-09-30,hawaii,,Colorado State,L (21-51),31,47,66.0,362,2,21,150,7.1,1,68,512,7.5,15,6,0,21,7,41,1,0,1
13117,6,2017-10-07,hawaii,@,Nevada,L (21-35),18,27,66.7,229,2,35,248,7.1,1,62,477,7.7,8,11,1,20,11,114,1,1,2
13118,7,2017-10-14,hawaii,,San Jose State,W (37-26),13,24,54.2,177,2,50,274,5.5,3,74,451,6.1,9,13,1,23,7,41,1,0,1
13119,8,2017-10-28,hawaii,,San Diego State,L (7-28),19,33,57.6,160,0,23,35,1.5,1,56,195,3.5,7,1,4,12,6,46,0,0,0
13120,9,2017-11-04,hawaii,@,Nevada-Las Vegas,L (23-31),24,47,51.1,269,1,28,131,4.7,1,75,400,5.3,12,9,2,23,6,65,0,0,0
13121,10,2017-11-11,hawaii,,Fresno State,L (21-31),18,31,58.1,154,2,37,118,3.2,0,68,272,4.0,7,8,1,16,4,36,1,1,2
13122,11,2017-11-18,hawaii,@,Utah State,L (0-38),19,35,54.3,146,0,47,172,3.7,0,82,318,3.9,7,12,1,20,8,60,1,0,1
13123,12,2017-11-25,hawaii,,Brigham Young,L (20-30),28,38,73.7,258,2,15,28,1.9,0,53,286,5.4,11,2,0,13,6,55,1,0,1
13124,,12 Games,hawaii,,,,260,423,61.5,2814,19,420,2018,4.8,15,843,4832,5.7,120,101,17,238,93,826,6,8,14
13125,1,2018-08-25,hawaii,@,Colorado State,W (43-34),26,37,70.3,418,3,36,199,5.5,2,73,617,8.5,19,9,2,30,10,65,1,0,1
13126,2,2018-09-01,hawaii,,Navy,W (59-41),31,42,73.8,436,6,26,90,3.5,1,68,526,7.7,17,6,2,25,1,5,1,0,1
13127,3,2018-09-08,hawaii,,Rice,W (43-29),22,33,66.7,319,4,29,162,5.6,2,62,481,7.8,16,6,1,23,6,60,0,0,0
13128,4,2018-09-15,hawaii,@,Army,L (21-28),20,32,62.5,321,2,13,41,3.2,1,45,362,8.0,11,3,1,15,5,30,0,0,0
13129,5,2018-09-22,hawaii,,Duquesne,W (42-21),24,40,60.0,273,5,37,245,6.6,1,77,518,6.7,13,14,7,34,8,95,1,1,2
13130,6,2018-09-29,hawaii,@,San Jose State,W (44-41),34,57,59.6,341,4,42,134,3.2,1,99,475,4.8,16,11,1,28,6,65,1,1,2
13131,7,2018-10-06,hawaii,,Wyoming,W (17-13),19,29,65.5,148,2,37,156,4.2,0,66,304,4.6,6,13,0,19,2,25,1,1,2
13132,8,2018-10-13,hawaii,@,Brigham Young,L (23-49),22,38,57.9,248,2,28,63,2.3,1,66,311,4.7,13,4,1,18,4,25,1,1,2
13133,9,2018-10-20,hawaii,,Nevada,L (22-40),19,38,50.0,259,3,35,112,3.2,0,73,371,5.1,10,5,1,16,7,73,0,0,0
13134,10,2018-10-27,hawaii,@,Fresno State,L (20-50),20,35,57.1,286,2,26,88,3.4,0,61,374,6.1,12,6,1,19,3,14,1,1,2
13135,11,2018-11-03,hawaii,,Utah State,L (17-56),19,48,39.6,347,2,20,43,2.2,0,68,390,5.7,13,1,4,18,10,75,0,2,2
13136,12,2018-11-17,hawaii,,Nevada-Las Vegas,W (35-28),18,36,50.0,328,3,31,83,2.7,1,67,411,6.1,11,6,1,18,3,15,0,2,2
13137,,12 Games,hawaii,,,,274,465,58.9,3724,38,360,1416,3.9,10,825,5140,6.2,157,84,22,263,65,547,7,9,16
13138,1,2014-08-30,texas-christian,,Samford,W (48-14),33,50,66.0,355,3,46,200,4.3,3,96,555,5.8,17,15,1,33,4,60,1,1,2
13139,2,2014-09-13,texas-christian,,Minnesota,W (30-7),27,46,58.7,258,2,27,169,6.3,1,73,427,5.8,13,8,1,22,8,72,1,1,2
13140,3,2014-09-27,texas-christian,@,Southern Methodist,W (56-0),28,43,65.1,349,5,38,265,7.0,3,81,614,7.6,18,12,1,31,5,48,0,0,0
13141,4,2014-10-04,texas-christian,,Oklahoma,W (37-33),20,39,51.3,318,2,39,151,3.9,2,78,469,6.0,12,8,3,23,12,90,2,1,3
13142,5,2014-10-11,texas-christian,@,Baylor,L (58-61),22,48,45.8,346,1,41,139,3.4,4,89,485,5.4,12,7,4,23,8,110,1,0,1
13143,6,2014-10-18,texas-christian,,Oklahoma State,W (42-9),27,42,64.3,415,3,40,261,6.5,3,82,676,8.2,12,13,1,26,5,45,0,1,1
13144,7,2014-10-25,texas-christian,,Texas Tech,W (82-27),27,45,60.0,480,7,41,305,7.4,3,86,785,9.1,16,13,3,32,10,77,0,0,0
13145,8,2014-11-01,texas-christian,@,West Virginia,W (31-30),12,30,40.0,166,1,42,223,5.3,3,72,389,5.4,5,11,0,16,5,40,1,1,2
13146,9,2014-11-08,texas-christian,,Kansas State,W (41-20),23,34,67.6,219,1,48,334,7.0,4,82,553,6.7,12,14,2,28,4,35,0,0,0
13147,10,2014-11-15,texas-christian,@,Kansas,W (34-30),26,36,72.2,330,1,36,133,3.7,2,72,463,6.4,13,10,1,24,5,40,2,1,3
13148,11,2014-11-27,texas-christian,@,Texas,W (48-10),20,34,58.8,233,2,31,135,4.4,2,65,368,5.7,10,5,1,16,6,45,1,1,2
13149,12,2014-12-06,texas-christian,,Iowa State,W (55-3),33,45,73.3,525,5,38,197,5.2,1,83,722,8.7,20,12,1,33,5,50,1,1,2
13150,13,2014-12-31,texas-christian,N,Mississippi*,W (42-3),27,37,73.0,246,4,42,177,4.2,1,79,423,5.4,13,11,0,24,5,55,1,3,4
13151,,13 Games,texas-christian,,,,325,529,61.4,4240,37,509,2689,5.3,32,1038,6929,6.7,173,139,19,331,82,767,11,11,22
13152,1,2015-09-03,texas-christian,@,Minnesota,W (23-17),26,42,61.9,246,1,44,203,4.6,1,86,449,5.2,13,10,2,25,9,50,1,1,2
13153,2,2015-09-12,texas-christian,,Stephen F. Austin,W (70-7),26,37,70.3,403,5,45,224,5.0,4,82,627,7.6,14,16,0,30,3,43,0,1,1
13154,3,2015-09-19,texas-christian,,Southern Methodist,W (56-37),21,30,70.0,454,5,41,266,6.5,3,71,720,10.1,16,12,0,28,9,115,0,1,1
13155,4,2015-09-26,texas-christian,@,Texas Tech,W (55-52),35,56,62.5,503,4,47,247,5.3,3,103,750,7.3,24,13,1,38,10,110,0,0,0
13156,5,2015-10-03,texas-christian,,Texas,W (50-7),22,38,57.9,376,6,42,228,5.4,0,80,604,7.6,18,12,1,31,8,84,0,0,0
13157,6,2015-10-10,texas-christian,@,Kansas State,W (52-45),20,30,66.7,301,2,23,242,10.5,4,53,543,10.2,13,7,2,22,11,81,0,2,2
13158,7,2015-10-17,texas-christian,@,Iowa State,W (45-21),28,34,82.4,444,4,41,177,4.3,2,75,621,8.3,20,7,3,30,7,75,1,0,1
13159,8,2015-10-29,texas-christian,,West Virginia,W (40-10),32,48,66.7,388,3,40,228,5.7,1,88,616,7.0,18,12,5,35,9,100,0,0,0
13160,9,2015-11-07,texas-christian,@,Oklahoma State,L (29-49),35,58,60.3,445,1,52,218,4.2,3,110,663,6.0,21,12,3,36,7,70,0,4,4
13161,10,2015-11-14,texas-christian,,Kansas,W (23-17),19,34,55.9,208,1,58,279,4.8,0,92,487,5.3,9,15,1,25,3,27,0,1,1
13162,11,2015-11-21,texas-christian,@,Oklahoma,L (29-30),13,29,44.8,229,3,36,161,4.5,1,65,390,6.0,5,9,2,16,2,19,1,3,4
13163,12,2015-11-27,texas-christian,,Baylor,W (28-21),18,33,54.5,148,2,46,154,3.3,1,79,302,3.8,5,8,2,15,8,65,1,1,2
13164,13,2016-01-02,texas-christian,N,Oregon*,W (47-41),30,47,63.8,371,2,47,174,3.7,3,94,545,5.8,14,12,1,27,8,83,0,1,1
13165,,13 Games,texas-christian,,,,325,516,63.0,4516,39,562,2801,5.0,26,1078,7317,6.8,190,145,23,358,94,922,4,15,19
13166,1,2016-09-03,texas-christian,,South Dakota State,W (59-41),33,50,66.0,439,2,37,223,6.0,5,87,662,7.6,22,11,2,35,12,125,0,2,2
13167,2,2016-09-10,texas-christian,,Arkansas,L (38-41),36,58,62.1,377,1,32,195,6.1,4,90,572,6.4,19,6,0,25,9,95,1,1,2
13168,3,2016-09-17,texas-christian,,Iowa State,W (41-20),22,35,62.9,252,1,37,229,6.2,4,72,481,6.7,12,8,2,22,5,50,0,0,0
13169,4,2016-09-23,texas-christian,@,Southern Methodist,W (33-3),32,47,68.1,452,2,31,137,4.4,1,78,589,7.6,16,8,1,25,8,65,0,1,1
13170,5,2016-10-01,texas-christian,,Oklahoma,L (46-52),26,45,57.8,449,5,29,65,2.2,1,74,514,6.9,14,4,1,19,9,64,0,1,1
13171,6,2016-10-08,texas-christian,@,Kansas,W (24-23),17,32,53.1,206,1,34,160,4.7,2,66,366,5.5,7,9,2,18,7,79,1,3,4
13172,7,2016-10-22,texas-christian,@,West Virginia,L (10-34),18,31,58.1,148,1,29,152,5.2,0,60,300,5.0,6,11,1,18,10,67,2,1,3
13173,8,2016-10-29,texas-christian,,Texas Tech,L (24-27),22,47,46.8,246,1,39,172,4.4,2,86,418,4.9,14,11,0,25,4,25,0,1,1
13174,9,2016-11-05,texas-christian,@,Baylor,W (62-22),18,31,58.1,257,1,59,431,7.3,6,90,688,7.6,9,21,4,34,7,55,0,0,0
13175,10,2016-11-19,texas-christian,,Oklahoma State,L (6-31),20,33,60.6,198,1,39,145,3.7,0,72,343,4.8,9,7,2,18,4,49,0,2,2
13176,11,2016-11-25,texas-christian,@,Texas,W (31-9),16,30,53.3,178,0,46,309,6.7,4,76,487,6.4,10,13,2,25,7,68,0,1,1
13177,12,2016-12-03,texas-christian,,Kansas State,L (6-30),17,36,47.2,138,0,37,142,3.8,0,73,280,3.8,5,8,2,15,4,45,0,1,1
13178,13,2016-12-30,texas-christian,N,Georgia*,L (23-31),18,28,64.3,146,2,39,175,4.5,1,67,321,4.8,7,8,2,17,2,10,2,0,2
13179,,13 Games,texas-christian,,,,295,503,58.6,3486,18,488,2535,5.2,30,991,6021,6.1,150,125,21,296,88,797,6,14,20
13180,1,2017-09-02,texas-christian,,Jackson State,W (63-0),23,30,76.7,300,6,36,242,6.7,1,66,542,8.2,11,13,0,24,5,51,0,1,1
13181,2,2017-09-09,texas-christian,@,Arkansas,W (28-7),21,31,67.7,166,0,42,195,4.6,4,73,361,4.9,8,15,1,24,6,60,1,1,2
13182,3,2017-09-16,texas-christian,,Southern Methodist,W (56-36),24,30,80.0,365,4,49,254,5.2,3,79,619,7.8,16,13,1,30,11,94,3,0,3
13183,4,2017-09-23,texas-christian,@,Oklahoma State,W (44-31),22,33,66.7,228,1,52,238,4.6,4,85,466,5.5,12,14,6,32,4,23,0,1,1
13184,5,2017-10-07,texas-christian,,West Virginia,W (31-24),16,29,55.2,236,2,36,170,4.7,2,65,406,6.2,9,7,0,16,5,51,0,0,0
13185,6,2017-10-14,texas-christian,@,Kansas State,W (26-6),27,37,73.0,297,0,36,98,2.7,3,73,395,5.4,11,5,1,17,7,51,1,0,1
13186,7,2017-10-21,texas-christian,,Kansas,W (43-0),20,28,71.4,284,5,42,191,4.5,0,70,475,6.8,11,10,1,22,7,55,0,0,0
13187,8,2017-10-28,texas-christian,@,Iowa State,L (7-14),12,25,48.0,135,0,34,172,5.1,0,59,307,5.2,7,6,1,14,11,104,1,2,3
13188,9,2017-11-04,texas-christian,,Texas,W (24-7),19,27,70.4,166,0,46,177,3.8,3,73,343,4.7,7,8,2,17,9,49,0,0,0
13189,10,2017-11-11,texas-christian,@,Oklahoma,L (20-38),14,29,48.3,269,1,32,155,4.8,2,61,424,7.0,7,10,2,19,7,60,0,0,0
13190,11,2017-11-18,texas-christian,@,Texas Tech,W (27-3),6,17,35.3,85,1,42,204,4.9,1,59,289,4.9,4,10,3,17,6,55,1,0,1
13191,12,2017-11-24,texas-christian,,Baylor,W (45-22),26,36,72.2,325,3,36,112,3.1,3,72,437,6.1,13,9,3,25,3,23,0,0,0
13192,13,2017-12-02,texas-christian,N,Oklahoma,L (17-41),27,37,73.0,234,2,24,83,3.5,0,61,317,5.2,14,5,1,20,7,70,1,1,2
13193,14,2017-12-28,texas-christian,N,Stanford*,W (39-37),28,41,68.3,341,3,26,147,5.7,1,67,488,7.3,13,8,0,21,1,4,1,2,3
13194,,14 Games,texas-christian,,,,285,430,66.3,3431,28,533,2438,4.6,27,963,5869,6.1,143,133,22,298,89,750,9,8,17
13195,1,2018-09-01,texas-christian,,Southern,W (55-7),21,32,65.6,264,4,42,235,5.6,2,74,499,6.7,16,12,2,30,5,48,0,0,0
13196,2,2018-09-07,texas-christian,@,Southern Methodist,W (42-12),15,28,53.6,146,1,42,247,5.9,3,70,393,5.6,5,17,1,23,4,35,1,1,2
13197,3,2018-09-15,texas-christian,N,Ohio State,L (28-40),24,40,60.0,308,1,36,203,5.6,3,76,511,6.7,13,8,1,22,5,40,1,2,3
13198,4,2018-09-22,texas-christian,@,Texas,L (16-31),20,39,51.3,231,1,32,141,4.4,0,71,372,5.2,9,7,0,16,3,30,1,3,4
13199,5,2018-09-29,texas-christian,,Iowa State,W (17-14),21,29,72.4,182,1,46,117,2.5,0,75,299,4.0,10,9,0,19,5,55,2,1,3
13200,6,2018-10-11,texas-christian,,Texas Tech,L (14-17),26,45,57.8,290,2,32,121,3.8,0,77,411,5.3,12,6,2,20,8,63,1,2,3
13201,7,2018-10-20,texas-christian,,Oklahoma,L (27-52),10,25,40.0,163,2,30,112,3.7,0,55,275,5.0,6,5,1,12,2,10,0,1,1
13202,8,2018-10-27,texas-christian,@,Kansas,L (26-27),23,33,69.7,351,1,39,153,3.9,2,72,504,7.0,17,7,3,27,5,57,1,1,2
13203,9,2018-11-03,texas-christian,,Kansas State,W (14-13),17,33,51.5,218,1,26,57,2.2,1,59,275,4.7,8,5,0,13,2,15,1,0,1
13204,10,2018-11-10,texas-christian,@,West Virginia,L (10-47),22,37,59.5,229,1,24,-7,-0.3,0,61,222,3.6,9,3,0,12,2,15,2,0,2
13205,11,2018-11-17,texas-christian,@,Baylor,W (16-9),15,21,71.4,151,1,42,160,3.8,1,63,311,4.9,4,10,0,14,8,80,0,0,0
13206,,11 Games,texas-christian,,,,214,362,59.1,2533,16,391,1539,3.9,12,753,4072,5.4,109,89,10,208,49,448,10,11,21
13207,1,2014-08-28,utah,,Idaho State,W (56-14),22,32,68.8,351,1,46,238,5.2,5,78,589,7.6,16,11,0,27,7,54,1,0,1
13208,2,2014-09-06,utah,,Fresno State,W (59-27),15,27,55.6,268,6,54,258,4.8,2,81,526,6.5,10,14,2,26,12,118,0,0,0
13209,3,2014-09-20,utah,@,Michigan,W (26-10),18,27,66.7,205,1,37,81,2.2,0,64,286,4.5,7,6,0,13,6,50,0,1,1
13210,4,2014-09-27,utah,,Washington State,L (27-28),18,40,45.0,165,0,40,192,4.8,1,80,357,4.5,7,10,1,18,8,78,1,0,1
13211,5,2014-10-04,utah,@,UCLA,W (30-28),12,18,66.7,100,1,55,242,4.4,1,73,342,4.7,3,14,1,18,4,40,0,0,0
13212,6,2014-10-16,utah,@,Oregon State,W (29-23),9,18,50.0,62,0,46,253,5.5,3,64,315,4.9,3,10,3,16,6,67,1,1,2
13213,7,2014-10-25,utah,,Southern California,W (24-21),18,32,56.3,194,1,42,137,3.3,1,74,331,4.5,11,9,1,21,4,25,2,0,2
13214,8,2014-11-01,utah,@,Arizona State,L (16-19),12,22,54.5,57,1,52,184,3.5,0,74,241,3.3,4,8,1,13,6,45,0,0,0
13215,9,2014-11-08,utah,,Oregon,L (27-51),22,33,66.7,320,2,35,120,3.4,1,68,440,6.5,10,6,1,17,3,31,2,2,4
13216,10,2014-11-15,utah,@,Stanford,W (20-17),21,28,75.0,177,2,32,70,2.2,1,60,247,4.1,9,4,1,14,5,55,0,0,0
13217,11,2014-11-22,utah,,Arizona,L (10-42),18,35,51.4,171,1,43,213,5.0,0,78,384,4.9,8,10,2,20,3,26,1,3,4
13218,12,2014-11-29,utah,@,Colorado,W (38-34),25,37,67.6,311,3,35,128,3.7,1,72,439,6.1,11,9,1,21,6,45,0,0,0
13219,13,2014-12-20,utah,N,Colorado State*,W (45-10),19,29,65.5,189,1,48,359,7.5,5,77,548,7.1,13,15,1,29,7,68,0,1,1
13220,,13 Games,utah,,,,229,378,60.6,2570,20,565,2475,4.4,21,943,5045,5.3,112,126,15,253,77,702,8,8,16
13221,1,2015-09-03,utah,,Michigan,W (24-17),24,33,72.7,208,0,37,129,3.5,2,70,337,4.8,10,9,1,20,6,55,0,1,1
13222,2,2015-09-11,utah,,Utah State,W (24-14),17,22,77.3,132,0,44,195,4.4,3,66,327,5.0,8,10,3,21,5,43,0,0,0
13223,3,2015-09-19,utah,@,Fresno State,W (45-24),19,26,73.1,159,1,48,221,4.6,2,74,380,5.1,9,12,2,23,1,10,2,1,3
13224,4,2015-09-26,utah,@,Oregon,W (62-20),20,32,62.5,257,5,42,273,6.5,2,74,530,7.2,12,11,1,24,6,54,0,0,0
13225,5,2015-10-10,utah,,California,W (30-24),16,26,61.5,170,1,51,265,5.2,2,77,435,5.6,6,14,1,21,5,48,1,2,3
13226,6,2015-10-17,utah,,Arizona State,W (34-18),26,36,72.2,297,2,31,72,2.3,2,67,369,5.5,11,4,1,16,4,19,0,0,0
13227,7,2015-10-24,utah,@,Southern California,L (24-42),24,36,66.7,254,2,28,99,3.5,1,64,353,5.5,9,8,3,20,4,34,0,4,4
13228,8,2015-10-31,utah,,Oregon State,W (27-12),14,17,82.4,198,1,44,174,4.0,2,61,372,6.1,9,10,1,20,5,45,0,0,0
13229,9,2015-11-07,utah,@,Washington,W (34-23),12,25,48.0,155,0,45,191,4.2,3,70,346,4.9,6,12,1,19,6,60,2,1,3
13230,10,2015-11-14,utah,@,Arizona,L (30-37),20,31,64.5,219,2,55,223,4.1,1,86,442,5.1,7,15,2,24,10,112,1,1,2
13231,11,2015-11-21,utah,,UCLA,L (9-17),13,26,50.0,110,0,49,197,4.0,0,75,307,4.1,5,14,4,23,4,45,2,0,2
13232,12,2015-11-28,utah,,Colorado,W (20-14),10,26,38.5,108,1,50,216,4.3,1,76,324,4.3,7,9,2,18,9,92,2,1,3
13233,13,2015-12-19,utah,N,Brigham Young*,W (35-28),9,16,56.3,71,0,47,126,2.7,3,63,197,3.1,3,8,3,14,7,76,0,0,0
13234,,13 Games,utah,,,,224,352,63.6,2338,15,571,2381,4.2,24,923,4719,5.1,102,136,25,263,72,693,10,11,21
13235,1,2016-09-01,utah,,Southern Utah,W (24-0),23,39,59.0,298,2,37,138,3.7,1,76,436,5.7,11,8,0,19,6,40,1,0,1
13236,2,2016-09-10,utah,,Brigham Young,W (20-19),14,23,60.9,194,1,42,169,4.0,0,65,363,5.6,8,9,3,20,9,85,3,3,6
13237,3,2016-09-17,utah,@,San Jose State,W (34-17),21,30,70.0,255,1,37,201,5.4,3,67,456,6.8,8,11,0,19,7,69,1,1,2
13238,4,2016-09-23,utah,,Southern California,W (31-27),21,34,61.8,270,2,47,186,4.0,1,81,456,5.6,12,16,2,30,5,43,1,0,1
13239,5,2016-10-01,utah,@,California,L (23-28),24,43,55.8,266,0,54,176,3.3,3,97,442,4.6,13,14,3,30,3,30,0,0,0
13240,6,2016-10-08,utah,,Arizona,W (36-23),13,29,44.8,245,1,45,210,4.7,3,74,455,6.1,7,12,4,23,14,98,0,0,0
13241,7,2016-10-15,utah,@,Oregon State,W (19-14),4,13,30.8,42,0,60,275,4.6,2,73,317,4.3,2,14,1,17,5,40,2,0,2
13242,8,2016-10-22,utah,@,UCLA,W (52-45),12,24,50.0,179,0,49,360,7.3,5,73,539,7.4,7,12,1,20,9,103,1,1,2
13243,9,2016-10-29,utah,,Washington,L (24-31),14,33,42.4,163,2,47,213,4.5,1,80,376,4.7,8,13,4,25,10,65,0,0,0
13244,10,2016-11-10,utah,@,Arizona State,W (49-26),21,37,56.8,296,4,22,201,9.1,2,59,497,8.4,12,6,4,22,7,60,2,0,2
13245,11,2016-11-19,utah,,Oregon,L (28-30),20,30,66.7,235,1,37,218,5.9,2,67,453,6.8,14,10,0,24,3,30,1,0,1
13246,12,2016-11-26,utah,@,Colorado,L (22-27),13,40,32.5,160,1,41,179,4.4,0,81,339,4.2,8,7,0,15,3,36,2,2,4
13247,13,2016-12-28,utah,N,Indiana*,W (26-24),12,24,50.0,214,0,52,256,4.9,2,76,470,6.2,8,12,1,21,9,86,3,1,4
13248,,13 Games,utah,,,,212,399,53.1,2817,15,570,2782,4.9,25,969,5599,5.8,118,144,23,285,90,785,17,8,25
13249,1,2017-08-31,utah,,North Dakota,W (37-16),23,32,71.9,227,1,47,272,5.8,3,79,499,6.3,10,15,2,27,11,139,0,1,1
13250,2,2017-09-09,utah,@,Brigham Young,W (19-13),28,37,75.7,314,0,36,116,3.2,1,73,430,5.9,11,6,1,18,11,97,2,0,2
13251,3,2017-09-16,utah,,San Jose State,W (54-16),30,44,68.2,341,4,40,160,4.0,2,84,501,6.0,15,12,2,29,6,50,2,1,3
13252,4,2017-09-22,utah,@,Arizona,W (30-24),17,28,60.7,229,1,38,112,2.9,1,66,341,5.2,8,9,4,21,9,83,2,0,2
13253,5,2017-10-07,utah,,Stanford,L (20-23),20,40,50.0,238,1,33,144,4.4,1,73,382,5.2,12,9,4,25,7,62,0,2,2
13254,6,2017-10-14,utah,@,Southern California,L (27-28),17,28,60.7,267,2,41,169,4.1,1,69,436,6.3,8,9,3,20,6,40,0,1,1
13255,7,2017-10-21,utah,,Arizona State,L (10-30),19,35,54.3,155,0,25,110,4.4,1,60,265,4.4,9,9,1,19,6,50,0,4,4
13256,8,2017-10-28,utah,@,Oregon,L (20-41),25,43,58.1,293,2,30,91,3.0,0,73,384,5.3,14,4,2,20,5,49,1,0,1
13257,9,2017-11-03,utah,,UCLA,W (48-17),15,22,68.2,234,4,50,272,5.4,2,72,506,7.0,7,15,2,24,10,70,0,0,0
13258,10,2017-11-11,utah,,Washington State,L (25-33),21,40,52.5,305,1,36,62,1.7,2,76,367,4.8,13,9,5,27,7,69,3,4,7
13259,11,2017-11-18,utah,@,Washington,L (30-33),19,27,70.4,293,2,45,117,2.6,1,72,410,5.7,13,9,0,22,3,30,0,1,1
13260,12,2017-11-25,utah,,Colorado,W (34-13),15,24,62.5,181,0,52,310,6.0,4,76,491,6.5,9,18,2,29,2,22,0,0,0
13261,13,2017-12-26,utah,N,West Virginia*,W (30-14),12,27,44.4,165,0,53,197,3.7,3,80,362,4.5,7,10,2,19,5,32,2,0,2
13262,,13 Games,utah,,,,261,427,61.1,3242,18,526,2132,4.1,22,953,5374,5.6,136,134,30,300,88,793,12,14,26
13263,1,2018-08-30,utah,,Weber State,W (41-10),26,41,63.4,293,4,36,294,8.2,1,77,587,7.6,12,11,2,25,4,20,3,1,4
13264,2,2018-09-08,utah,@,Northern Illinois,W (17-6),20,31,64.5,286,0,39,68,1.7,1,70,354,5.1,13,4,2,19,6,60,2,0,2
13265,3,2018-09-15,utah,,Washington,L (7-21),20,39,51.3,138,0,29,123,4.2,1,68,261,3.8,6,7,0,13,6,55,2,1,3
13266,4,2018-09-29,utah,@,Washington State,L (24-28),12,21,57.1,118,0,50,204,4.1,3,71,322,4.5,4,11,5,20,9,76,0,0,0
13267,5,2018-10-06,utah,@,Stanford,W (40-21),17,21,81.0,199,1,43,222,5.2,2,64,421,6.6,8,12,2,22,7,65,0,0,0
13268,6,2018-10-12,utah,,Arizona,W (42-10),16,22,72.7,265,3,46,230,5.0,3,68,495,7.3,8,12,3,23,9,94,0,1,1
13269,7,2018-10-20,utah,,Southern California,W (41-28),22,30,73.3,341,4,51,200,3.9,1,81,541,6.7,12,15,0,27,7,69,2,0,2
13270,8,2018-10-26,utah,@,UCLA,W (41-10),14,22,63.6,145,1,50,325,6.5,4,72,470,6.5,9,17,0,26,5,45,0,1,1
13271,9,2018-11-03,utah,@,Arizona State,L (20-38),11,26,42.3,147,1,32,178,5.6,1,58,325,5.6,6,9,2,17,3,28,0,3,3
13272,10,2018-11-10,utah,,Oregon,W (32-25),18,31,58.1,262,0,46,244,5.3,2,77,506,6.6,12,10,2,24,3,25,0,0,0
13273,11,2018-11-17,utah,@,Colorado,W (30-7),11,23,47.8,221,2,47,169,3.6,1,70,390,5.6,8,11,0,19,5,64,0,0,0
13274,,11 Games,utah,,,,187,307,60.9,2415,16,469,2257,4.8,20,776,4672,6.0,98,119,18,235,64,601,9,7,16
13275,1,2014-08-29,brigham-young,@,Connecticut,W (35-10),28,36,77.8,308,3,37,205,5.5,2,73,513,7.0,13,11,3,27,15,150,2,0,2
13276,2,2014-09-06,brigham-young,@,Texas,W (41-7),18,28,64.3,181,0,60,248,4.1,5,88,429,4.9,12,15,1,28,6,40,1,1,2
13277,3,2014-09-11,brigham-young,,Houston,W (33-25),21,34,61.8,200,1,62,323,5.2,3,96,523,5.4,9,19,4,32,11,98,1,2,3
13278,4,2014-09-20,brigham-young,,Virginia,W (41-33),13,23,56.5,187,2,37,145,3.9,2,60,332,5.5,7,7,2,16,12,133,0,0,0
13279,5,2014-10-03,brigham-young,,Utah State,L (20-35),18,40,45.0,271,1,34,154,4.5,1,74,425,5.7,8,12,3,23,9,60,1,3,4
13280,6,2014-10-09,brigham-young,@,Central Florida,L (24-31),22,37,59.5,153,3,49,189,3.9,0,86,342,4.0,7,14,0,21,9,71,1,1,2
13281,7,2014-10-18,brigham-young,,Nevada,L (35-42),39,63,61.9,408,4,39,193,4.9,1,102,601,5.9,25,13,0,38,6,75,3,0,3
13282,8,2014-10-24,brigham-young,@,Boise State,L (30-55),23,38,60.5,259,1,26,63,2.4,2,64,322,5.0,12,4,1,17,7,70,1,1,2
13283,9,2014-11-01,brigham-young,@,Middle Tennessee State,W (27-7),28,45,62.2,316,2,39,128,3.3,2,84,444,5.3,15,9,1,25,7,70,0,0,0
13284,10,2014-11-15,brigham-young,,Nevada-Las Vegas,W (42-23),18,32,56.3,325,3,41,267,6.5,3,73,592,8.1,12,10,1,23,5,50,2,0,2
13285,11,2014-11-22,brigham-young,,Savannah State,W (64-0),15,20,75.0,234,4,62,264,4.3,4,82,498,6.1,9,17,1,27,7,75,1,0,1
13286,12,2014-11-29,brigham-young,@,California,W (42-35),23,38,60.5,433,5,39,107,2.7,1,77,540,7.0,16,6,4,26,9,90,1,1,2
13287,13,2014-12-22,brigham-young,N,Memphis*,L (48-55),23,49,46.9,348,3,42,77,1.8,2,91,425,4.7,15,6,1,22,7,70,1,3,4
13288,,13 Games,brigham-young,,,,289,483,59.8,3623,32,567,2363,4.2,28,1050,5986,5.7,160,143,22,325,110,1052,15,12,27
13289,1,2015-09-05,brigham-young,@,Nebraska,W (33-28),28,46,60.9,379,2,26,132,5.1,2,72,511,7.1,13,7,1,21,4,30,0,1,1
13290,2,2015-09-12,brigham-young,,Boise State,W (35-24),17,29,58.6,309,2,39,72,1.8,2,68,381,5.6,0,0,0,16,5,54,0,2,2
13291,3,2015-09-19,brigham-young,@,UCLA,L (23-24),30,47,63.8,244,1,41,161,3.9,1,88,405,4.6,13,11,2,26,5,35,0,1,1
13292,4,2015-09-26,brigham-young,@,Michigan,L (0-31),12,28,42.9,55,0,22,50,2.3,0,50,105,2.1,2,4,2,8,5,45,0,0,0
13293,5,2015-10-02,brigham-young,,Connecticut,W (30-13),35,54,64.8,365,2,41,174,4.2,1,95,539,5.7,20,9,2,31,7,70,1,2,3
13294,6,2015-10-10,brigham-young,,East Carolina,W (45-38),25,38,65.8,341,3,43,167,3.9,3,81,508,6.3,13,11,2,26,7,61,1,1,2
13295,7,2015-10-16,brigham-young,,Cincinnati,W (38-24),19,32,59.4,252,2,29,197,6.8,3,61,449,7.4,10,7,5,22,10,74,0,1,1
13296,8,2015-10-24,brigham-young,,Wagner,W (70-6),23,27,85.2,411,4,42,330,7.9,6,69,741,10.7,16,15,0,31,7,55,0,0,0
13297,9,2015-11-06,brigham-young,@,San Jose State,W (17-16),23,37,62.2,293,1,25,36,1.4,1,62,329,5.3,14,3,0,17,7,84,0,1,1
13298,10,2015-11-14,brigham-young,N,Missouri,L (16-20),23,41,56.1,244,1,15,46,3.1,1,56,290,5.2,11,3,4,18,6,42,2,0,2
13299,11,2015-11-21,brigham-young,,Fresno State,W (52-10),26,39,66.7,362,2,34,158,4.6,4,73,520,7.1,18,4,0,22,7,70,2,0,2
13300,12,2015-11-28,brigham-young,@,Utah State,W (51-28),16,30,53.3,284,4,31,74,2.4,2,61,358,5.9,9,4,2,15,9,76,0,0,0
13301,13,2015-12-19,brigham-young,N,Utah*,L (28-35),25,56,44.6,315,2,25,71,2.8,2,81,386,4.8,12,5,4,22,6,54,2,3,5
13302,,13 Games,brigham-young,,,,302,504,59.9,3854,26,413,1668,4.0,28,917,5522,6.0,151,83,24,275,85,750,8,12,20
13303,1,2016-09-03,brigham-young,N,Arizona,W (18-16),21,29,72.4,202,1,47,213,4.5,1,76,415,5.5,10,14,0,24,8,65,0,0,0
13304,2,2016-09-10,brigham-young,@,Utah,L (19-20),22,39,56.4,185,0,28,146,5.2,2,67,331,4.9,11,6,1,18,10,112,0,2,2
13305,3,2016-09-17,brigham-young,,UCLA,L (14-17),26,49,53.1,250,1,25,23,0.9,1,74,273,3.7,12,4,3,19,2,15,0,1,1
13306,4,2016-09-24,brigham-young,N,West Virginia,L (32-35),23,36,63.9,241,2,40,280,7.0,2,76,521,6.9,14,12,1,27,8,51,1,3,4
13307,5,2016-09-30,brigham-young,,Toledo,W (55-53),11,21,52.4,248,1,45,338,7.5,6,66,586,8.9,10,14,2,26,7,82,0,0,0
13308,6,2016-10-08,brigham-young,@,Michigan State,W (31-14),18,29,62.1,138,1,49,260,5.3,3,78,398,5.1,7,15,2,24,3,24,0,0,0
13309,7,2016-10-14,brigham-young,,Mississippi State,W (28-21),16,28,57.1,165,3,46,147,3.2,1,74,312,4.2,8,8,4,20,9,84,1,1,2
13310,8,2016-10-20,brigham-young,@,Boise State,L (27-28),21,41,51.2,187,0,38,135,3.6,1,79,322,4.1,9,9,1,19,7,61,0,0,0
13311,9,2016-11-05,brigham-young,@,Cincinnati,W (20-3),15,25,60.0,130,0,47,207,4.4,2,72,337,4.7,9,12,2,23,5,28,0,1,1
13312,10,2016-11-12,brigham-young,,Southern Utah,W (37-7),33,42,78.6,441,2,40,155,3.9,2,82,596,7.3,19,14,0,33,6,65,2,1,3
13313,11,2016-11-19,brigham-young,,Massachusetts,W (51-9),20,34,58.8,184,1,49,247,5.0,4,83,431,5.2,11,12,4,27,5,64,1,0,1
13314,12,2016-11-26,brigham-young,,Utah State,W (28-10),11,22,50.0,106,2,54,249,4.6,1,76,355,4.7,5,14,7,26,8,68,0,2,2
13315,13,2016-12-21,brigham-young,N,Wyoming*,W (24-21),8,15,53.3,96,1,35,216,6.2,2,50,312,6.2,5,7,1,13,5,63,1,1,2
13316,,13 Games,brigham-young,,,,245,410,59.8,2573,15,543,2616,4.8,28,953,5189,5.4,130,141,28,299,83,782,6,12,18
13317,1,2017-08-26,brigham-young,,Portland State,W (20-6),16,27,59.3,194,1,33,173,5.2,1,60,367,6.1,10,3,0,13,7,70,0,0,0
13318,2,2017-09-02,brigham-young,N,Louisiana State,L (0-27),12,24,50.0,102,0,14,-5,-0.4,0,38,97,2.6,4,1,1,6,5,39,0,1,1
13319,3,2017-09-09,brigham-young,,Utah,L (13-19),21,39,53.8,170,1,24,63,2.6,1,63,233,3.7,8,3,2,13,4,35,0,3,3
13320,4,2017-09-16,brigham-young,,Wisconsin,L (6-40),11,20,55.0,111,0,26,81,3.1,0,46,192,4.2,5,5,1,11,5,33,0,2,2
13321,5,2017-09-29,brigham-young,@,Utah State,L (24-40),12,29,41.4,186,2,46,210,4.6,0,75,396,5.3,9,11,0,20,8,55,3,4,7
13322,6,2017-10-06,brigham-young,,Boise State,L (7-24),20,37,54.1,172,0,23,66,2.9,1,60,238,4.0,8,4,0,12,3,35,0,2,2
13323,7,2017-10-14,brigham-young,@,Mississippi State,L (10-35),17,29,58.6,147,1,17,29,1.7,0,46,176,3.8,4,2,2,8,2,22,1,1,2
13324,8,2017-10-21,brigham-young,@,East Carolina,L (17-33),26,41,63.4,319,2,31,102,3.3,0,72,421,5.8,14,7,1,22,8,69,0,1,1
13325,9,2017-10-28,brigham-young,,San Jose State,W (41-20),21,38,55.3,332,3,39,266,6.8,2,77,598,7.8,15,7,0,22,6,65,1,1,2
13326,10,2017-11-04,brigham-young,@,Fresno State,L (13-20),23,43,53.5,214,0,27,122,4.5,1,70,336,4.8,10,10,1,21,3,25,1,0,1
13327,11,2017-11-10,brigham-young,@,Nevada-Las Vegas,W (31-21),14,22,63.6,160,1,42,265,6.3,3,64,425,6.6,9,13,2,24,2,20,0,0,0
13328,12,2017-11-18,brigham-young,,Massachusetts,L (10-16),21,45,46.7,257,1,26,42,1.6,0,71,299,4.2,10,7,0,17,5,35,0,4,4
13329,13,2017-11-25,brigham-young,@,Hawaii,W (30-20),14,24,58.3,166,1,54,285,5.3,3,78,451,5.8,10,14,2,26,1,6,2,0,2
13330,,13 Games,brigham-young,,,,228,418,54.5,2530,13,402,1699,4.2,12,820,4229,5.2,116,87,12,215,59,509,8,19,27
13331,1,2018-09-01,brigham-young,@,Arizona,W (28-23),18,28,64.3,209,1,43,183,4.3,3,71,392,5.5,12,11,0,23,10,94,0,0,0
13332,2,2018-09-08,brigham-young,,California,L (18-21),22,41,53.7,196,1,33,91,2.8,0,74,287,3.9,9,8,0,17,7,65,0,2,2
13333,3,2018-09-15,brigham-young,@,Wisconsin,W (24-21),13,23,56.5,120,1,28,191,6.8,2,51,311,6.1,5,8,1,14,4,36,0,0,0
13334,4,2018-09-22,brigham-young,,McNeese State,W (30-3),16,27,59.3,130,1,42,161,3.8,2,69,291,4.2,7,9,2,18,5,56,1,0,1
13335,5,2018-09-29,brigham-young,@,Washington,L (7-35),18,21,85.7,160,0,28,34,1.2,1,49,194,4.0,6,1,0,7,8,50,1,0,1
13336,6,2018-10-05,brigham-young,,Utah State,L (20-45),30,49,61.2,322,3,16,39,2.4,0,65,361,5.6,14,2,7,23,6,50,2,1,3
13337,7,2018-10-13,brigham-young,,Hawaii,W (49-23),16,24,66.7,194,3,47,280,6.0,4,71,474,6.7,11,14,1,26,6,55,0,1,1
13338,8,2018-10-27,brigham-young,,Northern Illinois,L (6-7),18,30,60.0,208,0,37,93,2.5,0,67,301,4.5,9,5,3,17,7,52,0,1,1
13339,9,2018-11-03,brigham-young,@,Boise State,L (16-21),19,29,65.5,292,0,38,96,2.5,1,67,388,5.8,12,7,2,21,8,58,3,0,3
13340,10,2018-11-10,brigham-young,@,Massachusetts,W (35-16),14,23,60.9,167,2,38,225,5.9,3,61,392,6.4,7,12,0,19,2,20,1,0,1
13341,11,2018-11-17,brigham-young,,New Mexico State,W (45-10),13,29,44.8,193,0,51,317,6.2,6,80,510,6.4,9,15,1,25,2,20,1,1,2
13342,,11 Games,brigham-young,,,,197,324,60.8,2191,12,401,1710,4.3,22,725,3901,5.4,101,92,17,210,65,556,9,6,15
13343,1,2014-08-30,ucla,@,Virginia,W (28-20),20,34,58.8,242,0,39,116,3.0,1,73,358,4.9,9,7,0,16,12,87,2,0,2
13344,2,2014-09-06,ucla,,Memphis,W (42-35),33,44,75.0,396,3,41,144,3.5,3,85,540,6.4,16,11,3,30,9,85,0,1,1
13345,3,2014-09-13,ucla,N,Texas,W (20-17),27,34,79.4,226,2,47,217,4.6,0,81,443,5.5,9,13,2,24,4,51,1,0,1
13346,4,2014-09-25,ucla,@,Arizona State,W (62-27),18,23,78.3,355,4,35,225,6.4,2,58,580,10.0,8,8,3,19,8,78,0,0,0
13347,5,2014-10-04,ucla,,Utah,L (28-30),16,22,72.7,269,2,50,137,2.7,2,72,406,5.6,9,12,3,24,3,29,0,1,1
13348,6,2014-10-11,ucla,,Oregon,L (30-42),27,38,71.1,225,2,54,328,6.1,2,92,553,6.0,12,19,0,31,7,81,1,1,2
13349,7,2014-10-18,ucla,@,California,W (36-34),31,42,73.8,330,2,47,237,5.0,2,89,567,6.4,19,13,1,33,6,63,2,1,3
13350,8,2014-10-25,ucla,@,Colorado,W (40-37),24,39,61.5,200,1,37,309,8.4,4,76,509,6.7,8,11,2,21,14,121,1,0,1
13351,9,2014-11-01,ucla,,Arizona,W (17-7),19,26,73.1,189,1,59,271,4.6,1,85,460,5.4,7,13,1,21,11,118,1,0,1
13352,10,2014-11-08,ucla,@,Washington,W (44-30),29,37,78.4,302,2,40,174,4.4,3,77,476,6.2,18,9,1,28,4,37,0,0,0
13353,11,2014-11-22,ucla,,Southern California,W (38-20),22,31,71.0,326,3,43,135,3.1,2,74,461,6.2,13,9,2,24,7,63,1,1,2
13354,12,2014-11-28,ucla,,Stanford,L (10-31),20,41,48.8,162,1,26,100,3.8,0,67,262,3.9,8,9,0,17,4,38,0,1,1
13355,13,2015-01-02,ucla,N,Kansas State*,W (40-35),12,24,50.0,136,1,39,331,8.5,4,63,467,7.4,6,10,0,16,15,128,1,0,1
13356,,13 Games,ucla,,,,298,435,68.5,3358,24,557,2724,4.9,26,992,6082,6.1,142,144,18,304,104,979,10,6,16
13357,1,2015-09-05,ucla,,Virginia,W (34-16),28,37,75.7,351,3,34,152,4.5,1,71,503,7.1,12,11,2,25,7,75,0,0,0
13358,2,2015-09-12,ucla,@,Nevada-Las Vegas,W (37-3),24,51,47.1,253,1,47,273,5.8,2,98,526,5.4,13,15,2,30,9,80,0,3,3
13359,3,2015-09-19,ucla,,Brigham Young,W (24-23),11,23,47.8,106,1,38,296,7.8,2,61,402,6.6,6,12,0,18,6,75,0,3,3
13360,4,2015-09-26,ucla,@,Arizona,W (56-30),19,28,67.9,284,2,47,213,4.5,6,75,497,6.6,12,11,0,23,9,76,0,0,0
13361,5,2015-10-03,ucla,,Arizona State,L (23-38),22,40,55.0,280,2,28,62,2.2,1,68,342,5.0,12,4,1,17,6,49,0,1,1
13362,6,2015-10-15,ucla,@,Stanford,L (35-56),22,42,52.4,325,3,31,181,5.8,1,73,506,6.9,13,5,1,19,10,93,0,2,2
13363,7,2015-10-22,ucla,,California,W (40-24),34,48,70.8,399,3,42,174,4.1,1,90,573,6.4,17,13,1,31,9,74,1,0,1
13364,8,2015-10-31,ucla,,Colorado,W (35-31),19,33,57.6,262,1,26,138,5.3,3,59,400,6.8,10,4,2,16,10,101,2,0,2
13365,9,2015-11-07,ucla,@,Oregon State,W (41-0),28,43,65.1,390,2,52,284,5.5,3,95,674,7.1,16,16,1,33,10,71,0,0,0
13366,10,2015-11-14,ucla,,Washington State,L (27-31),33,57,57.9,340,0,32,214,6.7,2,89,554,6.2,15,14,1,30,13,75,2,0,2
13367,11,2015-11-21,ucla,@,Utah,W (17-9),15,30,50.0,220,1,38,105,2.8,1,68,325,4.8,12,5,1,18,6,59,0,0,0
13368,12,2015-11-28,ucla,@,Southern California,L (21-40),19,37,51.4,227,1,29,140,4.8,2,66,367,5.6,12,7,4,23,6,30,1,2,3
13369,13,2015-12-26,ucla,N,Nebraska*,L (29-37),26,41,63.4,319,3,16,67,4.2,1,57,386,6.8,14,2,1,17,7,56,0,2,2
13370,,13 Games,ucla,,,,300,510,58.8,3756,23,460,2299,5.0,26,970,6055,6.2,164,119,17,300,108,914,6,13,19
13371,1,2016-09-03,ucla,@,Texas A&M,L (24-31),26,47,55.3,343,1,40,125,3.1,1,87,468,5.4,16,8,4,28,4,17,0,3,3
13372,2,2016-09-10,ucla,,Nevada-Las Vegas,W (42-21),24,39,61.5,280,1,40,219,5.5,5,79,499,6.3,15,13,2,30,9,74,1,0,1
13373,3,2016-09-17,ucla,@,Brigham Young,W (17-14),26,40,65.0,307,2,34,50,1.5,0,74,357,4.8,14,3,1,18,5,49,0,1,1
13374,4,2016-09-24,ucla,,Stanford,L (13-22),18,27,66.7,248,1,33,77,2.3,0,60,325,5.4,11,5,0,16,5,45,1,0,1
13375,5,2016-10-01,ucla,,Arizona,W (45-24),20,37,54.1,350,3,32,125,3.9,3,69,475,6.9,15,4,1,20,5,60,0,0,0
13376,6,2016-10-08,ucla,@,Arizona State,L (20-23),27,54,50.0,444,2,23,-1,0.0,0,77,443,5.8,14,2,2,18,5,50,1,3,4
13377,7,2016-10-15,ucla,@,Washington State,L (21-27),24,40,60.0,258,3,25,43,1.7,0,65,301,4.6,12,4,2,18,7,69,2,2,4
13378,8,2016-10-22,ucla,,Utah,L (45-52),40,71,56.3,464,5,16,46,2.9,1,87,510,5.9,21,3,5,29,3,35,1,4,5
13379,9,2016-11-03,ucla,@,Colorado,L (10-20),15,29,51.7,185,1,30,25,0.8,0,59,210,3.6,7,3,4,14,13,96,0,1,1
13380,10,2016-11-12,ucla,,Oregon State,W (38-24),25,48,52.1,281,0,29,163,5.6,3,77,444,5.8,12,8,5,25,9,82,2,1,3
13381,11,2016-11-19,ucla,,Southern California,L (14-36),16,32,50.0,211,2,19,55,2.9,0,51,266,5.2,7,3,0,10,3,44,0,0,0
13382,12,2016-11-26,ucla,@,California,L (10-36),12,30,40.0,176,1,24,84,3.5,0,54,260,4.8,8,3,0,11,11,95,1,1,2
13383,,12 Games,ucla,,,,273,494,55.3,3547,22,345,1011,2.9,13,839,4558,5.4,152,59,26,237,79,716,9,16,25
13384,1,2017-09-03,ucla,,Texas A&M,W (45-44),35,59,59.3,491,4,25,63,2.5,2,84,554,6.6,24,3,2,29,7,56,3,0,3
13385,2,2017-09-09,ucla,,Hawaii,W (56-23),24,29,82.8,373,5,26,132,5.1,2,55,505,9.2,17,6,2,25,10,83,0,0,0
13386,3,2017-09-16,ucla,@,Memphis,L (45-48),34,56,60.7,463,4,35,170,4.9,2,91,633,7.0,20,9,2,31,10,99,1,2,3
13387,4,2017-09-23,ucla,@,Stanford,L (34-58),40,60,66.7,480,3,15,115,7.7,1,75,595,7.9,19,6,2,27,13,132,2,2,4
13388,5,2017-09-30,ucla,,Colorado,W (27-23),28,45,62.2,372,1,35,95,2.7,2,80,467,5.8,16,9,0,25,9,85,0,1,1
13389,6,2017-10-14,ucla,@,Arizona,L (30-47),20,34,58.8,219,0,38,190,5.0,4,72,409,5.7,11,11,6,28,7,80,1,3,4
13390,7,2017-10-21,ucla,,Oregon,W (31-14),21,36,58.3,266,2,37,142,3.8,2,73,408,5.6,11,11,0,22,7,67,0,0,0
13391,8,2017-10-28,ucla,@,Washington,L (23-44),19,33,57.6,170,2,28,62,2.2,0,61,232,3.8,9,4,2,15,6,59,1,0,1
13392,9,2017-11-03,ucla,@,Utah,L (17-48),11,16,68.8,115,2,32,134,4.2,0,48,249,5.2,3,7,2,12,5,40,1,0,1
13393,10,2017-11-11,ucla,,Arizona State,W (44-37),26,46,56.5,420,1,29,161,5.6,3,75,581,7.7,12,11,2,25,5,39,0,1,1
13394,11,2017-11-18,ucla,@,Southern California,L (23-28),32,52,61.5,421,3,31,80,2.6,0,83,501,6.0,16,10,2,28,12,100,1,1,2
13395,12,2017-11-24,ucla,,California,W (30-27),27,36,75.0,393,2,37,69,1.9,1,73,462,6.3,16,7,1,24,7,64,1,0,1
13396,13,2017-12-26,ucla,N,Kansas State*,L (17-35),21,34,61.8,295,2,25,69,2.8,0,59,364,6.2,9,5,0,14,8,73,1,0,1
13397,,13 Games,ucla,,,,338,536,63.1,4478,31,393,1482,3.8,19,929,5960,6.4,183,99,23,305,106,977,12,10,22
13398,1,2018-09-01,ucla,,Cincinnati,L (17-26),23,37,62.2,162,0,31,144,4.6,2,68,306,4.5,10,4,1,15,6,26,0,1,1
13399,2,2018-09-08,ucla,@,Oklahoma,L (21-49),16,26,61.5,254,1,50,129,2.6,2,76,383,5.0,11,9,0,20,6,77,0,0,0
13400,3,2018-09-15,ucla,,Fresno State,L (14-38),10,24,41.7,151,1,31,119,3.8,1,55,270,4.9,6,5,3,14,11,96,2,2,4
13401,4,2018-09-28,ucla,@,Colorado,L (16-38),17,35,48.6,138,1,28,151,5.4,0,63,289,4.6,5,8,2,15,8,67,0,0,0
13402,5,2018-10-06,ucla,,Washington,L (24-31),27,38,71.1,272,2,27,150,5.6,1,65,422,6.5,12,8,0,20,4,45,0,1,1
13403,6,2018-10-13,ucla,@,California,W (37-7),13,15,86.7,141,0,55,207,3.8,3,70,348,5.0,6,12,2,20,4,30,0,0,0
13404,7,2018-10-20,ucla,,Arizona,W (31-30),22,35,62.9,307,3,47,153,3.3,1,82,460,5.6,14,6,3,23,12,103,1,0,1
13405,8,2018-10-26,ucla,,Utah,L (10-41),20,40,50.0,164,0,26,127,4.9,1,66,291,4.4,7,9,1,17,5,40,1,2,3
13406,9,2018-11-03,ucla,@,Oregon,L (21-42),23,49,46.9,297,2,38,199,5.2,1,87,496,5.7,14,15,0,29,11,64,2,1,3
13407,10,2018-11-10,ucla,@,Arizona State,L (28-31),26,35,74.3,335,2,29,104,3.6,1,64,439,6.9,17,4,3,24,7,58,0,1,1
13408,11,2018-11-17,ucla,,Southern California,W (34-27),13,22,59.1,166,1,51,318,6.2,3,73,484,6.6,10,12,3,25,2,15,0,1,1
13409,,11 Games,ucla,,,,210,356,59.0,2387,13,413,1801,4.4,16,769,4188,5.4,112,92,18,222,76,621,6,9,15
13410,1,2014-08-30,washington,@,Hawaii,W (17-16),10,26,38.5,162,1,48,174,3.6,1,74,336,4.5,5,12,2,19,5,35,0,0,0
13411,2,2014-09-06,washington,,Eastern Washington,W (59-52),14,24,58.3,180,1,57,356,6.2,7,81,536,6.6,10,14,2,26,10,100,0,0,0
13412,3,2014-09-13,washington,,Illinois,W (44-19),16,22,72.7,219,1,58,245,4.2,2,80,464,5.8,7,14,4,25,8,73,1,0,1
13413,4,2014-09-20,washington,,Georgia State,W (45-14),19,27,70.4,154,3,41,182,4.4,2,68,336,4.9,8,9,0,17,6,53,0,0,0
13414,5,2014-09-27,washington,,Stanford,L (13-20),15,30,50.0,98,1,38,81,2.1,0,68,179,2.6,4,7,4,15,10,84,0,0,0
13415,6,2014-10-11,washington,@,California,W (31-7),22,29,75.9,273,3,38,111,2.9,0,67,384,5.7,11,7,0,18,8,76,0,0,0
13416,7,2014-10-18,washington,@,Oregon,L (20-45),24,38,63.2,184,1,36,133,3.7,1,74,317,4.3,10,8,2,20,4,24,1,1,2
13417,8,2014-10-25,washington,,Arizona State,L (10-24),18,26,69.2,139,0,46,151,3.3,0,72,290,4.0,7,12,0,19,4,30,1,2,3
13418,9,2014-11-01,washington,@,Colorado,W (38-23),13,19,68.4,206,2,40,236,5.9,1,59,442,7.5,6,8,0,14,3,24,3,0,3
13419,10,2014-11-08,washington,,UCLA,L (30-44),14,24,58.3,155,0,48,211,4.4,2,72,366,5.1,6,15,1,22,7,65,0,1,1
13420,11,2014-11-15,washington,@,Arizona,L (26-27),21,30,70.0,259,1,60,245,4.1,2,90,504,5.6,12,13,0,25,13,111,3,0,3
13421,12,2014-11-22,washington,,Oregon State,W (37-13),19,24,79.2,255,2,35,226,6.5,2,59,481,8.2,8,8,0,16,6,60,1,0,1
13422,13,2014-11-29,washington,@,Washington State,W (31-13),25,41,61.0,249,2,37,188,5.1,2,78,437,5.6,13,5,4,22,7,60,0,1,1
13423,14,2015-01-02,washington,N,Oklahoma State*,L (22-30),25,40,62.5,268,1,25,101,4.0,1,65,369,5.7,14,7,1,22,7,70,1,1,2
13424,,14 Games,washington,,,,255,400,63.8,2801,19,607,2640,4.3,23,1007,5441,5.4,121,139,20,280,98,865,11,6,17
13425,1,2015-09-04,washington,@,Boise State,L (13-16),20,35,57.1,150,0,22,29,1.3,0,57,179,3.1,8,1,3,12,5,32,0,1,1
13426,2,2015-09-12,washington,,Sacramento State,W (49-0),17,25,68.0,326,2,36,218,6.1,5,61,544,8.9,10,10,3,23,3,30,1,0,1
13427,3,2015-09-19,washington,,Utah State,W (31-17),22,31,71.0,368,3,35,74,2.1,1,66,442,6.7,17,3,0,20,3,38,2,1,3
13428,4,2015-09-26,washington,,California,L (24-30),17,28,60.7,152,0,27,107,4.0,2,55,259,4.7,9,6,0,15,5,53,3,2,5
13429,5,2015-10-08,washington,@,Southern California,W (17-12),17,33,51.5,164,1,36,135,3.8,1,69,299,4.3,7,9,1,17,7,60,0,1,1
13430,6,2015-10-17,washington,,Oregon,L (20-26),20,32,62.5,205,1,30,180,6.0,1,62,385,6.2,8,7,2,17,8,64,0,1,1
13431,7,2015-10-24,washington,@,Stanford,L (14-31),9,21,42.9,118,0,24,113,4.7,2,45,231,5.1,5,6,0,11,3,30,0,0,0
13432,8,2015-10-31,washington,,Arizona,W (49-3),17,25,68.0,267,4,36,201,5.6,3,61,468,7.7,14,8,0,22,4,49,0,0,0
13433,9,2015-11-07,washington,,Utah,L (23-34),23,39,59.0,257,1,39,124,3.2,1,78,381,4.9,12,7,1,20,6,65,3,1,4
13434,10,2015-11-14,washington,@,Arizona State,L (17-27),28,52,53.8,405,1,34,142,4.2,1,86,547,6.4,19,8,0,27,7,60,1,3,4
13435,11,2015-11-21,washington,@,Oregon State,W (52-7),18,21,85.7,211,4,59,271,4.6,2,80,482,6.0,12,16,0,28,5,40,0,0,0
13436,12,2015-11-27,washington,,Washington State,W (45-10),14,20,70.0,203,0,55,240,4.4,3,75,443,5.9,7,14,1,22,10,80,0,1,1
13437,13,2015-12-26,washington,N,Southern Mississippi*,W (44-31),23,34,67.6,284,0,44,296,6.7,5,78,580,7.4,12,13,2,27,5,50,1,0,1
13438,,13 Games,washington,,,,245,396,61.9,3110,17,477,2130,4.5,27,873,5240,6.0,140,108,13,261,71,651,11,11,22
13439,1,2016-09-03,washington,,Rutgers,W (48-13),20,29,69.0,289,4,30,91,3.0,0,59,380,6.4,11,5,1,17,3,30,0,1,1
13440,2,2016-09-10,washington,,Idaho,W (59-14),27,33,81.8,356,6,30,126,4.2,1,63,482,7.7,20,6,1,27,4,30,1,0,1
13441,3,2016-09-17,washington,,Portland State,W (41-3),14,22,63.6,194,5,35,213,6.1,1,57,407,7.1,8,11,1,20,5,65,1,0,1
13442,4,2016-09-24,washington,@,Arizona,W (35-28),14,21,66.7,160,2,51,352,6.9,3,72,512,7.1,7,16,1,24,8,63,0,1,1
13443,5,2016-09-30,washington,,Stanford,W (44-6),15,21,71.4,210,3,41,214,5.2,3,62,424,6.8,9,10,3,22,5,60,0,0,0
13444,6,2016-10-08,washington,@,Oregon,W (70-21),22,28,78.6,304,6,45,378,8.4,4,73,682,9.3,13,14,3,30,12,89,0,0,0
13445,7,2016-10-22,washington,,Oregon State,W (41-17),15,31,48.4,300,3,39,219,5.6,2,70,519,7.4,13,12,1,26,2,10,1,0,1
13446,8,2016-10-29,washington,@,Utah,W (31-24),12,20,60.0,186,2,36,199,5.5,1,56,385,6.9,12,9,1,22,4,21,0,1,1
13447,9,2016-11-05,washington,@,California,W (66-27),20,29,69.0,417,7,44,287,6.5,2,73,704,9.6,13,13,5,31,5,35,1,0,1
13448,10,2016-11-12,washington,,Southern California,L (13-26),17,37,45.9,259,1,27,17,0.6,0,64,276,4.3,9,4,0,13,3,35,0,2,2
13449,11,2016-11-19,washington,,Arizona State,W (44-18),27,44,61.4,338,2,33,201,6.1,2,77,539,7.0,14,11,1,26,7,70,0,2,2
13450,12,2016-11-25,washington,@,Washington State,W (45-17),22,31,71.0,342,3,35,168,4.8,3,66,510,7.7,13,8,1,22,9,75,1,0,1
13451,13,2016-12-02,washington,N,Colorado,W (41-10),9,24,37.5,118,2,54,265,4.9,2,78,383,4.9,4,17,1,22,3,35,0,0,0
13452,14,2016-12-31,washington,N,Alabama,L (7-24),20,38,52.6,150,1,29,44,1.5,0,67,194,2.9,8,6,0,14,3,10,1,2,3
13453,,14 Games,washington,,,,254,408,62.3,3623,47,529,2774,5.2,24,937,6397,6.8,154,142,20,316,73,628,6,9,15
13454,1,2017-09-01,washington,@,Rutgers,W (30-14),17,30,56.7,284,2,24,84,3.5,0,54,368,6.8,12,5,0,17,6,56,0,0,0
13455,2,2017-09-09,washington,,Montana,W (63-7),24,28,85.7,293,2,37,213,5.8,5,65,506,7.8,15,10,0,25,6,50,0,1,1
13456,3,2017-09-16,washington,,Fresno State,W (48-16),25,28,89.3,328,4,30,92,3.1,2,58,420,7.2,14,4,3,21,4,41,2,0,2
13457,4,2017-09-23,washington,@,Colorado,W (37-10),11,21,52.4,160,1,39,254,6.5,3,60,414,6.9,8,11,1,20,3,20,0,1,1
13458,5,2017-09-30,washington,@,Oregon State,W (42-7),26,34,76.5,293,3,41,216,5.3,3,75,509,6.8,13,13,6,32,3,21,0,1,1
13459,6,2017-10-07,washington,,California,W (38-7),27,42,64.3,215,2,38,162,4.3,3,80,377,4.7,13,8,1,22,6,40,1,0,1
13460,7,2017-10-14,washington,@,Arizona State,L (7-13),17,30,56.7,139,0,31,91,2.9,1,61,230,3.8,9,5,0,14,3,15,0,0,0
13461,8,2017-10-28,washington,,UCLA,W (44-23),9,12,75.0,109,0,58,333,5.7,5,70,442,6.3,6,15,3,24,4,47,1,1,2
13462,9,2017-11-04,washington,,Oregon,W (38-3),11,19,57.9,204,2,39,247,6.3,2,58,451,7.8,7,11,1,19,4,35,0,1,1
13463,10,2017-11-10,washington,@,Stanford,L (22-30),17,23,73.9,190,0,33,135,4.1,3,56,325,5.8,8,9,3,20,7,73,1,0,1
13464,11,2017-11-18,washington,,Utah,W (33-30),26,35,74.3,354,2,32,123,3.8,2,67,477,7.1,16,6,1,23,2,10,0,0,0
13465,12,2017-11-25,washington,,Washington State,W (41-14),11,17,64.7,93,0,45,328,7.3,5,62,421,6.8,5,14,1,20,2,15,0,0,0
13466,13,2017-12-30,washington,N,Penn State*,L (28-35),19,29,65.5,227,1,26,104,4.0,3,55,331,6.0,8,5,1,14,4,22,1,0,1
13467,,13 Games,washington,,,,240,348,69.0,2889,19,473,2382,5.0,37,821,5271,6.4,134,116,21,271,54,445,6,5,11
13468,1,2018-09-01,washington,N,Auburn,L (16-21),18,32,56.3,296,1,33,102,3.1,0,65,398,6.1,12,8,4,24,10,95,1,1,2
13469,2,2018-09-08,washington,,North Dakota,W (45-3),31,45,68.9,437,3,34,195,5.7,2,79,632,8.0,17,8,0,25,5,45,0,2,2
13470,3,2018-09-15,washington,@,Utah,W (21-7),14,24,58.3,155,1,41,172,4.2,2,65,327,5.0,10,6,2,18,5,35,0,1,1
13471,4,2018-09-22,washington,,Arizona State,W (27-20),15,23,65.2,202,3,39,171,4.4,0,62,373,6.0,11,12,3,26,3,30,0,1,1
13472,5,2018-09-29,washington,,Brigham Young,W (35-7),23,25,92.0,277,1,37,187,5.1,4,62,464,7.5,15,10,1,26,5,40,1,0,1
13473,6,2018-10-06,washington,@,UCLA,W (31-24),18,26,69.2,265,1,55,197,3.6,3,81,462,5.7,11,13,2,26,1,10,0,1,1
13474,7,2018-10-13,washington,@,Oregon,L (27-30),15,25,60.0,243,1,45,194,4.3,2,70,437,6.2,13,7,2,22,5,38,0,1,1
13475,8,2018-10-20,washington,,Colorado,W (27-13),15,25,60.0,150,1,40,201,5.0,2,65,351,5.4,8,12,3,23,3,45,1,1,2
13476,9,2018-10-27,washington,@,California,L (10-12),12,25,48.0,159,1,33,91,2.8,0,58,250,4.3,8,4,1,13,4,18,0,2,2
13477,10,2018-11-03,washington,,Stanford,W (27-23),16,27,59.3,194,1,45,177,3.9,2,72,371,5.2,11,6,2,19,8,85,0,0,0
13478,11,2018-11-17,washington,,Oregon State,W (42-23),18,25,72.0,228,3,42,275,6.5,3,67,503,7.5,11,10,1,22,4,40,0,0,0
13479,,11 Games,washington,,,,195,302,64.6,2606,17,444,1962,4.4,20,746,4568,6.1,127,96,21,244,53,481,3,10,13
13480,1,2014-08-28,arizona-state,,Weber State,W (45-14),24,39,61.5,303,2,45,267,5.9,4,84,570,6.8,20,9,3,32,4,30,0,0,0
13481,2,2014-09-06,arizona-state,@,New Mexico,W (58-23),12,21,57.1,198,2,48,423,8.8,6,69,621,9.0,7,18,0,25,4,30,1,0,1
13482,3,2014-09-13,arizona-state,@,Colorado,W (38-24),15,25,60.0,203,3,35,223,6.4,2,60,426,7.1,8,8,2,18,8,59,0,0,0
13483,4,2014-09-25,arizona-state,,UCLA,L (27-62),42,69,60.9,488,3,36,138,3.8,0,105,626,6.0,26,9,3,38,6,59,2,2,4
13484,5,2014-10-04,arizona-state,@,Southern California,W (38-34),27,46,58.7,510,5,22,31,1.4,0,68,541,8.0,19,1,4,24,5,36,0,0,0
13485,6,2014-10-18,arizona-state,,Stanford,W (26-10),24,34,70.6,242,1,46,114,2.5,1,80,356,4.5,14,8,1,23,2,9,0,0,0
13486,7,2014-10-25,arizona-state,@,Washington,W (24-10),14,25,56.0,180,2,43,105,2.4,0,68,285,4.2,8,6,0,14,5,20,0,1,1
13487,8,2014-11-01,arizona-state,,Utah,W (19-16),18,33,54.5,205,1,43,239,5.6,0,76,444,5.8,9,10,1,20,6,55,0,2,2
13488,9,2014-11-08,arizona-state,,Notre Dame,W (55-31),17,28,60.7,224,3,45,188,4.2,2,73,412,5.6,10,10,2,22,3,19,0,1,1
13489,10,2014-11-15,arizona-state,@,Oregon State,L (27-35),22,44,50.0,264,2,31,103,3.3,0,75,367,4.9,11,7,2,20,5,54,0,2,2
13490,11,2014-11-22,arizona-state,,Washington State,W (52-31),15,25,60.0,232,4,36,98,2.7,3,61,330,5.4,8,7,1,16,5,25,0,0,0
13491,12,2014-11-28,arizona-state,@,Arizona,L (35-42),27,44,61.4,267,4,43,113,2.6,0,87,380,4.4,13,9,5,27,3,15,1,1,2
13492,13,2014-12-27,arizona-state,N,Duke*,W (36-31),24,34,70.6,240,2,35,152,4.3,2,69,392,5.7,13,8,1,22,2,10,0,0,0
13493,,13 Games,arizona-state,,,,281,467,60.2,3556,34,508,2194,4.3,20,975,5750,5.9,166,110,25,301,58,421,4,9,13
13494,1,2015-09-05,arizona-state,N,Texas A&M,L (17-38),25,41,61.0,199,1,41,92,2.2,1,82,291,3.5,7,9,3,19,6,45,2,0,2
13495,2,2015-09-12,arizona-state,,Cal Poly,W (35-21),23,35,65.7,283,3,45,248,5.5,2,80,531,6.6,15,12,1,28,3,45,1,1,2
13496,3,2015-09-18,arizona-state,,New Mexico,W (34-10),22,37,59.5,317,3,30,132,4.4,1,67,449,6.7,10,9,0,19,3,25,1,0,1
13497,4,2015-09-26,arizona-state,,Southern California,L (14-42),23,44,52.3,272,0,35,182,5.2,2,79,454,5.7,15,8,3,26,2,25,3,1,4
13498,5,2015-10-03,arizona-state,@,UCLA,W (38-23),27,44,61.4,273,2,46,192,4.2,2,90,465,5.2,14,10,1,25,4,39,0,1,1
13499,6,2015-10-10,arizona-state,,Colorado,W (48-23),20,31,64.5,260,5,40,231,5.8,1,71,491,6.9,10,8,3,21,3,19,0,1,1
13500,7,2015-10-17,arizona-state,@,Utah,L (18-34),20,42,47.6,242,0,28,15,0.5,0,70,257,3.7,10,2,0,12,6,46,1,1,2
13501,8,2015-10-29,arizona-state,,Oregon,L (55-61),32,53,60.4,398,5,55,344,6.3,2,108,742,6.9,19,16,2,37,9,70,0,2,2
13502,9,2015-11-07,arizona-state,@,Washington State,L (24-38),28,45,62.2,256,0,42,202,4.8,3,87,458,5.3,13,11,0,24,3,25,1,1,2
13503,10,2015-11-14,arizona-state,,Washington,W (27-17),22,34,64.7,253,1,43,144,3.3,2,77,397,5.2,12,6,1,19,3,39,0,0,0
13504,11,2015-11-21,arizona-state,,Arizona,W (52-37),21,32,65.6,315,2,48,250,5.2,3,80,565,7.1,11,10,3,24,5,50,1,1,2
13505,12,2015-11-28,arizona-state,@,California,L (46-48),27,43,62.8,395,4,52,191,3.7,0,95,586,6.2,17,10,1,28,7,45,0,0,0
13506,13,2016-01-02,arizona-state,N,West Virginia*,L (42-43),29,52,55.8,418,4,32,102,3.2,0,84,520,6.2,17,5,1,23,6,45,0,0,0
13507,,13 Games,arizona-state,,,,319,533,59.8,3881,30,537,2325,4.3,19,1070,6206,5.8,170,116,19,305,60,518,10,9,19
13508,1,2016-09-03,arizona-state,,Northern Arizona,W (44-13),20,27,74.1,180,0,46,276,6.0,5,73,456,6.2,8,18,1,27,5,40,1,1,2
13509,2,2016-09-10,arizona-state,,Texas Tech,W (68-55),28,37,75.7,351,2,53,301,5.7,7,90,652,7.2,18,11,5,34,6,60,0,0,0
13510,3,2016-09-16,arizona-state,@,Texas-San Antonio,W (32-28),15,31,48.4,264,2,48,205,4.3,1,79,469,5.9,11,12,2,25,3,30,2,1,3
13511,4,2016-09-24,arizona-state,,California,W (51-41),21,30,70.0,290,1,50,164,3.3,3,80,454,5.7,12,9,2,23,5,44,0,1,1
13512,5,2016-10-01,arizona-state,@,Southern California,L (20-41),19,37,51.4,228,1,33,75,2.3,1,70,303,4.3,10,4,2,16,5,75,0,1,1
13513,6,2016-10-08,arizona-state,,UCLA,W (23-20),20,39,51.3,196,1,34,79,2.3,1,73,275,3.8,12,3,0,15,5,64,1,2,3
13514,7,2016-10-15,arizona-state,@,Colorado,L (16-40),13,35,37.1,149,1,28,50,1.8,0,63,199,3.2,6,1,0,7,2,20,0,1,1
13515,8,2016-10-22,arizona-state,,Washington State,L (32-37),14,24,58.3,167,0,34,117,3.4,3,58,284,4.9,7,4,1,12,4,40,1,0,1
13516,9,2016-10-29,arizona-state,@,Oregon,L (35-54),23,40,57.5,329,2,36,139,3.9,3,76,468,6.2,14,8,0,22,6,49,0,3,3
13517,10,2016-11-10,arizona-state,,Utah,L (26-49),20,32,62.5,355,1,47,41,0.9,2,79,396,5.0,10,8,0,18,8,75,0,2,2
13518,11,2016-11-19,arizona-state,@,Washington,L (18-44),21,33,63.6,230,2,27,15,0.6,0,60,245,4.1,10,1,3,14,9,66,1,1,2
13519,12,2016-11-25,arizona-state,@,Arizona,L (35-56),43,60,71.7,372,3,38,120,3.2,1,98,492,5.0,16,9,6,31,8,61,1,1,2
13520,,12 Games,arizona-state,,,,257,425,60.5,3111,16,474,1582,3.3,27,899,4693,5.2,134,88,22,244,66,624,7,14,21
13521,1,2017-08-31,arizona-state,,New Mexico State,W (37-31),24,30,80.0,321,2,40,79,2.0,2,70,400,5.7,13,5,1,19,1,10,0,0,0
13522,2,2017-09-09,arizona-state,,San Diego State,L (20-30),20,33,60.6,298,2,31,44,1.4,1,64,342,5.3,10,3,2,15,5,50,1,0,1
13523,3,2017-09-16,arizona-state,@,Texas Tech,L (45-52),27,41,65.9,326,3,44,168,3.8,3,85,494,5.8,13,11,3,27,4,37,1,0,1
13524,4,2017-09-23,arizona-state,,Oregon,W (37-35),24,39,61.5,347,1,53,142,2.7,3,92,489,5.3,14,8,1,23,6,65,1,0,1
13525,5,2017-09-30,arizona-state,@,Stanford,L (24-34),16,25,64.0,195,1,46,214,4.7,2,71,409,5.8,7,12,3,22,3,25,0,2,2
13526,6,2017-10-14,arizona-state,,Washington,W (13-7),29,41,70.7,245,0,32,40,1.3,1,73,285,3.9,10,7,0,17,1,5,0,0,0
13527,7,2017-10-21,arizona-state,@,Utah,W (30-10),19,29,65.5,140,0,46,205,4.5,2,75,345,4.6,7,13,3,23,2,25,0,1,1
13528,8,2017-10-28,arizona-state,,Southern California,L (17-48),18,31,58.1,278,1,29,88,3.0,1,60,366,6.1,9,5,1,15,10,99,0,1,1
13529,9,2017-11-04,arizona-state,,Colorado,W (41-30),18,34,52.9,202,2,54,381,7.1,3,88,583,6.6,8,18,1,27,1,5,0,0,0
13530,10,2017-11-11,arizona-state,@,UCLA,L (37-44),21,37,56.8,290,1,61,294,4.8,2,98,584,6.0,12,17,0,29,4,41,0,1,1
13531,11,2017-11-18,arizona-state,@,Oregon State,W (40-24),12,19,63.2,167,2,49,286,5.8,3,68,453,6.7,6,15,3,24,7,71,1,0,1
13532,12,2017-11-25,arizona-state,,Arizona,W (42-30),11,17,64.7,163,3,49,227,4.6,3,66,390,5.9,7,10,1,19,5,50,1,1,2
13533,13,2017-12-29,arizona-state,N,North Carolina State*,L (31-52),25,40,62.5,352,3,30,117,3.9,1,70,469,6.7,15,8,1,24,1,4,1,3,4
13534,,13 Games,arizona-state,,,,264,416,63.5,3324,21,564,2285,4.1,27,980,5609,5.7,131,132,20,284,50,487,6,9,15
13535,1,2018-09-01,arizona-state,,Texas-San Antonio,W (49-7),16,24,66.7,237,4,35,267,7.6,2,59,504,8.5,9,12,0,21,11,95,0,0,0
13536,2,2018-09-08,arizona-state,,Michigan State,W (16-13),30,48,62.5,380,1,29,44,1.5,0,77,424,5.5,18,6,3,27,4,40,0,1,1
13537,3,2018-09-15,arizona-state,@,San Diego State,L (21-28),31,46,67.4,341,2,24,36,1.5,1,70,377,5.4,16,3,2,21,7,39,0,0,0
13538,4,2018-09-22,arizona-state,@,Washington,L (20-27),17,27,63.0,104,0,40,164,4.1,2,67,268,4.0,5,9,2,16,7,72,1,0,1
13539,5,2018-09-29,arizona-state,,Oregon State,W (52-24),14,25,56.0,162,3,48,396,8.3,4,73,558,7.6,6,20,2,28,1,5,0,0,0
13540,6,2018-10-06,arizona-state,@,Colorado,L (21-28),12,18,66.7,222,1,39,145,3.7,2,57,367,6.4,7,8,3,18,5,35,0,0,0
13541,7,2018-10-18,arizona-state,,Stanford,L (13-20),26,45,57.8,353,0,23,84,3.7,1,68,437,6.4,16,4,0,20,7,86,1,2,3
13542,8,2018-10-27,arizona-state,@,Southern California,W (38-35),14,24,58.3,166,1,44,283,6.4,3,68,449,6.6,7,12,1,20,5,48,1,0,1
13543,9,2018-11-03,arizona-state,,Utah,W (38-20),19,24,79.2,285,3,50,251,5.0,2,74,536,7.2,11,12,2,25,6,60,0,1,1
13544,10,2018-11-10,arizona-state,,UCLA,W (31-28),16,22,72.7,199,1,57,283,5.0,3,79,482,6.1,11,16,2,29,6,75,0,1,1
13545,11,2018-11-17,arizona-state,@,Oregon,L (29-31),15,32,46.9,182,2,41,142,3.5,1,73,324,4.4,8,6,2,16,8,50,1,0,1
13546,,11 Games,arizona-state,,,,210,335,62.7,2631,18,430,2095,4.9,21,765,4726,6.2,114,108,19,241,67,605,4,5,9
13547,1,2014-08-28,utah,,Idaho State,W (56-14),22,32,68.8,351,1,46,238,5.2,5,78,589,7.6,16,11,0,27,7,54,1,0,1
13548,2,2014-09-06,utah,,Fresno State,W (59-27),15,27,55.6,268,6,54,258,4.8,2,81,526,6.5,10,14,2,26,12,118,0,0,0
13549,3,2014-09-20,utah,@,Michigan,W (26-10),18,27,66.7,205,1,37,81,2.2,0,64,286,4.5,7,6,0,13,6,50,0,1,1
13550,4,2014-09-27,utah,,Washington State,L (27-28),18,40,45.0,165,0,40,192,4.8,1,80,357,4.5,7,10,1,18,8,78,1,0,1
13551,5,2014-10-04,utah,@,UCLA,W (30-28),12,18,66.7,100,1,55,242,4.4,1,73,342,4.7,3,14,1,18,4,40,0,0,0
13552,6,2014-10-16,utah,@,Oregon State,W (29-23),9,18,50.0,62,0,46,253,5.5,3,64,315,4.9,3,10,3,16,6,67,1,1,2
13553,7,2014-10-25,utah,,Southern California,W (24-21),18,32,56.3,194,1,42,137,3.3,1,74,331,4.5,11,9,1,21,4,25,2,0,2
13554,8,2014-11-01,utah,@,Arizona State,L (16-19),12,22,54.5,57,1,52,184,3.5,0,74,241,3.3,4,8,1,13,6,45,0,0,0
13555,9,2014-11-08,utah,,Oregon,L (27-51),22,33,66.7,320,2,35,120,3.4,1,68,440,6.5,10,6,1,17,3,31,2,2,4
13556,10,2014-11-15,utah,@,Stanford,W (20-17),21,28,75.0,177,2,32,70,2.2,1,60,247,4.1,9,4,1,14,5,55,0,0,0
13557,11,2014-11-22,utah,,Arizona,L (10-42),18,35,51.4,171,1,43,213,5.0,0,78,384,4.9,8,10,2,20,3,26,1,3,4
13558,12,2014-11-29,utah,@,Colorado,W (38-34),25,37,67.6,311,3,35,128,3.7,1,72,439,6.1,11,9,1,21,6,45,0,0,0
13559,13,2014-12-20,utah,N,Colorado State*,W (45-10),19,29,65.5,189,1,48,359,7.5,5,77,548,7.1,13,15,1,29,7,68,0,1,1
13560,,13 Games,utah,,,,229,378,60.6,2570,20,565,2475,4.4,21,943,5045,5.3,112,126,15,253,77,702,8,8,16
13561,1,2015-09-03,utah,,Michigan,W (24-17),24,33,72.7,208,0,37,129,3.5,2,70,337,4.8,10,9,1,20,6,55,0,1,1
13562,2,2015-09-11,utah,,Utah State,W (24-14),17,22,77.3,132,0,44,195,4.4,3,66,327,5.0,8,10,3,21,5,43,0,0,0
13563,3,2015-09-19,utah,@,Fresno State,W (45-24),19,26,73.1,159,1,48,221,4.6,2,74,380,5.1,9,12,2,23,1,10,2,1,3
13564,4,2015-09-26,utah,@,Oregon,W (62-20),20,32,62.5,257,5,42,273,6.5,2,74,530,7.2,12,11,1,24,6,54,0,0,0
13565,5,2015-10-10,utah,,California,W (30-24),16,26,61.5,170,1,51,265,5.2,2,77,435,5.6,6,14,1,21,5,48,1,2,3
13566,6,2015-10-17,utah,,Arizona State,W (34-18),26,36,72.2,297,2,31,72,2.3,2,67,369,5.5,11,4,1,16,4,19,0,0,0
13567,7,2015-10-24,utah,@,Southern California,L (24-42),24,36,66.7,254,2,28,99,3.5,1,64,353,5.5,9,8,3,20,4,34,0,4,4
13568,8,2015-10-31,utah,,Oregon State,W (27-12),14,17,82.4,198,1,44,174,4.0,2,61,372,6.1,9,10,1,20,5,45,0,0,0
13569,9,2015-11-07,utah,@,Washington,W (34-23),12,25,48.0,155,0,45,191,4.2,3,70,346,4.9,6,12,1,19,6,60,2,1,3
13570,10,2015-11-14,utah,@,Arizona,L (30-37),20,31,64.5,219,2,55,223,4.1,1,86,442,5.1,7,15,2,24,10,112,1,1,2
13571,11,2015-11-21,utah,,UCLA,L (9-17),13,26,50.0,110,0,49,197,4.0,0,75,307,4.1,5,14,4,23,4,45,2,0,2
13572,12,2015-11-28,utah,,Colorado,W (20-14),10,26,38.5,108,1,50,216,4.3,1,76,324,4.3,7,9,2,18,9,92,2,1,3
13573,13,2015-12-19,utah,N,Brigham Young*,W (35-28),9,16,56.3,71,0,47,126,2.7,3,63,197,3.1,3,8,3,14,7,76,0,0,0
13574,,13 Games,utah,,,,224,352,63.6,2338,15,571,2381,4.2,24,923,4719,5.1,102,136,25,263,72,693,10,11,21
13575,1,2016-09-01,utah,,Southern Utah,W (24-0),23,39,59.0,298,2,37,138,3.7,1,76,436,5.7,11,8,0,19,6,40,1,0,1
13576,2,2016-09-10,utah,,Brigham Young,W (20-19),14,23,60.9,194,1,42,169,4.0,0,65,363,5.6,8,9,3,20,9,85,3,3,6
13577,3,2016-09-17,utah,@,San Jose State,W (34-17),21,30,70.0,255,1,37,201,5.4,3,67,456,6.8,8,11,0,19,7,69,1,1,2
13578,4,2016-09-23,utah,,Southern California,W (31-27),21,34,61.8,270,2,47,186,4.0,1,81,456,5.6,12,16,2,30,5,43,1,0,1
13579,5,2016-10-01,utah,@,California,L (23-28),24,43,55.8,266,0,54,176,3.3,3,97,442,4.6,13,14,3,30,3,30,0,0,0
13580,6,2016-10-08,utah,,Arizona,W (36-23),13,29,44.8,245,1,45,210,4.7,3,74,455,6.1,7,12,4,23,14,98,0,0,0
13581,7,2016-10-15,utah,@,Oregon State,W (19-14),4,13,30.8,42,0,60,275,4.6,2,73,317,4.3,2,14,1,17,5,40,2,0,2
13582,8,2016-10-22,utah,@,UCLA,W (52-45),12,24,50.0,179,0,49,360,7.3,5,73,539,7.4,7,12,1,20,9,103,1,1,2
13583,9,2016-10-29,utah,,Washington,L (24-31),14,33,42.4,163,2,47,213,4.5,1,80,376,4.7,8,13,4,25,10,65,0,0,0
13584,10,2016-11-10,utah,@,Arizona State,W (49-26),21,37,56.8,296,4,22,201,9.1,2,59,497,8.4,12,6,4,22,7,60,2,0,2
13585,11,2016-11-19,utah,,Oregon,L (28-30),20,30,66.7,235,1,37,218,5.9,2,67,453,6.8,14,10,0,24,3,30,1,0,1
13586,12,2016-11-26,utah,@,Colorado,L (22-27),13,40,32.5,160,1,41,179,4.4,0,81,339,4.2,8,7,0,15,3,36,2,2,4
13587,13,2016-12-28,utah,N,Indiana*,W (26-24),12,24,50.0,214,0,52,256,4.9,2,76,470,6.2,8,12,1,21,9,86,3,1,4
13588,,13 Games,utah,,,,212,399,53.1,2817,15,570,2782,4.9,25,969,5599,5.8,118,144,23,285,90,785,17,8,25
13589,1,2017-08-31,utah,,North Dakota,W (37-16),23,32,71.9,227,1,47,272,5.8,3,79,499,6.3,10,15,2,27,11,139,0,1,1
13590,2,2017-09-09,utah,@,Brigham Young,W (19-13),28,37,75.7,314,0,36,116,3.2,1,73,430,5.9,11,6,1,18,11,97,2,0,2
13591,3,2017-09-16,utah,,San Jose State,W (54-16),30,44,68.2,341,4,40,160,4.0,2,84,501,6.0,15,12,2,29,6,50,2,1,3
13592,4,2017-09-22,utah,@,Arizona,W (30-24),17,28,60.7,229,1,38,112,2.9,1,66,341,5.2,8,9,4,21,9,83,2,0,2
13593,5,2017-10-07,utah,,Stanford,L (20-23),20,40,50.0,238,1,33,144,4.4,1,73,382,5.2,12,9,4,25,7,62,0,2,2
13594,6,2017-10-14,utah,@,Southern California,L (27-28),17,28,60.7,267,2,41,169,4.1,1,69,436,6.3,8,9,3,20,6,40,0,1,1
13595,7,2017-10-21,utah,,Arizona State,L (10-30),19,35,54.3,155,0,25,110,4.4,1,60,265,4.4,9,9,1,19,6,50,0,4,4
13596,8,2017-10-28,utah,@,Oregon,L (20-41),25,43,58.1,293,2,30,91,3.0,0,73,384,5.3,14,4,2,20,5,49,1,0,1
13597,9,2017-11-03,utah,,UCLA,W (48-17),15,22,68.2,234,4,50,272,5.4,2,72,506,7.0,7,15,2,24,10,70,0,0,0
13598,10,2017-11-11,utah,,Washington State,L (25-33),21,40,52.5,305,1,36,62,1.7,2,76,367,4.8,13,9,5,27,7,69,3,4,7
13599,11,2017-11-18,utah,@,Washington,L (30-33),19,27,70.4,293,2,45,117,2.6,1,72,410,5.7,13,9,0,22,3,30,0,1,1
13600,12,2017-11-25,utah,,Colorado,W (34-13),15,24,62.5,181,0,52,310,6.0,4,76,491,6.5,9,18,2,29,2,22,0,0,0
13601,13,2017-12-26,utah,N,West Virginia*,W (30-14),12,27,44.4,165,0,53,197,3.7,3,80,362,4.5,7,10,2,19,5,32,2,0,2
13602,,13 Games,utah,,,,261,427,61.1,3242,18,526,2132,4.1,22,953,5374,5.6,136,134,30,300,88,793,12,14,26
13603,1,2018-08-30,utah,,Weber State,W (41-10),26,41,63.4,293,4,36,294,8.2,1,77,587,7.6,12,11,2,25,4,20,3,1,4
13604,2,2018-09-08,utah,@,Northern Illinois,W (17-6),20,31,64.5,286,0,39,68,1.7,1,70,354,5.1,13,4,2,19,6,60,2,0,2
13605,3,2018-09-15,utah,,Washington,L (7-21),20,39,51.3,138,0,29,123,4.2,1,68,261,3.8,6,7,0,13,6,55,2,1,3
13606,4,2018-09-29,utah,@,Washington State,L (24-28),12,21,57.1,118,0,50,204,4.1,3,71,322,4.5,4,11,5,20,9,76,0,0,0
13607,5,2018-10-06,utah,@,Stanford,W (40-21),17,21,81.0,199,1,43,222,5.2,2,64,421,6.6,8,12,2,22,7,65,0,0,0
13608,6,2018-10-12,utah,,Arizona,W (42-10),16,22,72.7,265,3,46,230,5.0,3,68,495,7.3,8,12,3,23,9,94,0,1,1
13609,7,2018-10-20,utah,,Southern California,W (41-28),22,30,73.3,341,4,51,200,3.9,1,81,541,6.7,12,15,0,27,7,69,2,0,2
13610,8,2018-10-26,utah,@,UCLA,W (41-10),14,22,63.6,145,1,50,325,6.5,4,72,470,6.5,9,17,0,26,5,45,0,1,1
13611,9,2018-11-03,utah,@,Arizona State,L (20-38),11,26,42.3,147,1,32,178,5.6,1,58,325,5.6,6,9,2,17,3,28,0,3,3
13612,10,2018-11-10,utah,,Oregon,W (32-25),18,31,58.1,262,0,46,244,5.3,2,77,506,6.6,12,10,2,24,3,25,0,0,0
13613,11,2018-11-17,utah,@,Colorado,W (30-7),11,23,47.8,221,2,47,169,3.6,1,70,390,5.6,8,11,0,19,5,64,0,0,0
13614,,11 Games,utah,,,,187,307,60.9,2415,16,469,2257,4.8,20,776,4672,6.0,98,119,18,235,64,601,9,7,16
13615,1,2014-08-30,stanford,,California-Davis,W (45-0),21,30,70.0,312,4,32,149,4.7,1,62,461,7.4,13,8,0,21,4,40,2,1,3
13616,2,2014-09-06,stanford,,Southern California,L (10-13),22,30,73.3,285,0,38,128,3.4,1,68,413,6.1,12,7,2,21,8,68,2,0,2
13617,3,2014-09-13,stanford,,Army,W (35-0),20,28,71.4,216,4,32,199,6.2,1,60,415,6.9,12,9,0,21,3,30,1,0,1
13618,4,2014-09-27,stanford,@,Washington,W (20-13),17,26,65.4,178,1,39,187,4.8,1,65,365,5.6,12,7,3,22,8,85,2,1,3
13619,5,2014-10-04,stanford,@,Notre Dame,L (14-17),18,36,50.0,158,0,32,47,1.5,2,68,205,3.0,10,4,0,14,9,66,0,2,2
13620,6,2014-10-10,stanford,,Washington State,W (34-17),23,35,65.7,284,3,33,193,5.8,1,68,477,7.0,14,4,2,20,9,80,1,0,1
13621,7,2014-10-18,stanford,@,Arizona State,L (10-26),19,39,48.7,212,0,22,76,3.5,1,61,288,4.7,11,3,0,14,5,35,2,0,2
13622,8,2014-10-25,stanford,,Oregon State,W (38-14),19,30,63.3,287,2,35,151,4.3,2,65,438,6.7,13,7,2,22,3,20,0,2,2
13623,9,2014-11-01,stanford,@,Oregon,L (16-45),23,33,69.7,296,0,39,132,3.4,1,72,428,5.9,15,7,2,24,7,53,1,1,2
13624,10,2014-11-15,stanford,,Utah,L (17-20),17,28,60.7,104,2,38,190,5.0,0,66,294,4.5,6,11,1,18,6,60,1,0,1
13625,11,2014-11-22,stanford,@,California,W (38-17),15,21,71.4,214,0,47,204,4.3,5,68,418,6.1,12,8,5,25,4,21,0,1,1
13626,12,2014-11-28,stanford,@,UCLA,W (31-10),16,19,84.2,234,2,45,202,4.5,2,64,436,6.8,10,10,2,22,7,65,0,0,0
13627,13,2014-12-30,stanford,N,Maryland*,W (45-21),18,26,69.2,208,2,45,206,4.6,4,71,414,5.8,9,10,3,22,2,7,1,0,1
13628,,13 Games,stanford,,,,248,381,65.1,2988,20,477,2064,4.3,22,858,5052,5.9,149,95,22,266,75,630,13,8,21
13629,1,2015-09-05,stanford,@,Northwestern,L (6-16),20,35,57.1,155,0,27,85,3.1,0,62,240,3.9,8,6,3,17,5,25,1,1,2
13630,2,2015-09-12,stanford,,Central Florida,W (31-7),18,30,60.0,361,3,41,130,3.2,1,71,491,6.9,13,7,1,21,12,137,0,0,0
13631,3,2015-09-19,stanford,@,Southern California,W (41-31),18,24,75.0,279,2,49,195,4.0,3,73,474,6.5,14,10,2,26,5,40,0,0,0
13632,4,2015-09-25,stanford,@,Oregon State,W (42-24),9,14,64.3,163,2,48,325,6.8,4,62,488,7.9,7,13,4,24,4,25,1,1,2
13633,5,2015-10-03,stanford,,Arizona,W (55-17),21,23,91.3,256,3,46,314,6.8,4,69,570,8.3,10,17,3,30,3,20,0,0,0
13634,6,2015-10-15,stanford,,UCLA,W (56-35),8,16,50.0,131,3,48,310,6.5,4,64,441,6.9,5,13,1,19,5,40,0,1,1
13635,7,2015-10-24,stanford,,Washington,W (31-14),17,24,70.8,290,2,48,188,3.9,2,72,478,6.6,14,9,2,25,6,53,0,1,1
13636,8,2015-10-31,stanford,@,Washington State,W (30-28),10,19,52.6,86,0,40,226,5.7,3,59,312,5.3,5,9,1,15,4,35,1,1,2
13637,9,2015-11-07,stanford,@,Colorado,W (42-10),18,27,66.7,197,3,48,275,5.7,3,75,472,6.3,9,14,2,25,7,55,0,1,1
13638,10,2015-11-14,stanford,,Oregon,L (36-38),28,39,71.8,304,2,47,202,4.3,2,86,506,5.9,18,12,2,32,7,55,2,1,3
13639,11,2015-11-21,stanford,,California,W (35-22),7,12,58.3,96,1,40,260,6.5,3,52,356,6.8,2,14,0,16,2,30,0,0,0
13640,12,2015-11-28,stanford,,Notre Dame,W (38-36),17,21,81.0,269,4,43,153,3.6,1,64,422,6.6,10,8,4,22,1,5,0,0,0
13641,13,2015-12-05,stanford,N,Southern California,W (41-22),10,13,76.9,155,2,51,262,5.1,2,64,417,6.5,6,13,1,20,7,58,0,0,0
13642,14,2016-01-01,stanford,N,Iowa*,W (45-16),12,21,57.1,223,3,34,206,6.1,1,55,429,7.8,8,10,1,19,10,70,0,1,1
13643,,14 Games,stanford,,,,213,318,67.0,2965,30,610,3131,5.1,33,928,6096,6.6,129,155,27,311,78,648,5,8,13
13644,1,2016-09-02,stanford,,Kansas State,W (26-13),15,19,78.9,167,1,30,105,3.5,2,49,272,5.6,10,3,0,13,4,26,1,0,1
13645,2,2016-09-17,stanford,,Southern California,W (27-10),8,14,57.1,102,1,48,302,6.3,2,62,404,6.5,4,13,0,17,3,35,0,1,1
13646,3,2016-09-24,stanford,@,UCLA,W (22-13),14,28,50.0,143,1,37,207,5.6,0,65,350,5.4,9,9,2,20,6,35,1,1,2
13647,4,2016-09-30,stanford,@,Washington,L (6-44),18,27,66.7,184,1,30,29,1.0,0,57,213,3.7,9,2,3,14,11,100,2,0,2
13648,5,2016-10-08,stanford,,Washington State,L (16-42),21,34,61.8,235,1,26,61,2.3,0,60,296,4.9,11,3,2,16,4,34,1,2,3
13649,6,2016-10-15,stanford,@,Notre Dame,W (17-10),10,20,50.0,120,0,40,176,4.4,1,60,296,4.9,9,8,1,18,5,40,2,1,3
13650,7,2016-10-22,stanford,,Colorado,L (5-10),16,29,55.2,170,0,33,93,2.8,0,62,263,4.2,8,6,1,15,7,60,1,3,4
13651,8,2016-10-29,stanford,@,Arizona,W (34-10),14,31,45.2,104,2,42,237,5.6,2,73,341,4.7,4,12,1,17,6,55,0,1,1
13652,9,2016-11-05,stanford,,Oregon State,W (26-15),10,17,58.8,60,0,58,365,6.3,2,75,425,5.7,4,15,1,20,4,43,1,0,1
13653,10,2016-11-12,stanford,@,Oregon,W (52-27),19,27,70.4,258,3,42,282,6.7,4,69,540,7.8,11,14,1,26,8,85,0,0,0
13654,11,2016-11-19,stanford,@,California,W (45-31),13,23,56.5,198,2,50,357,7.1,4,73,555,7.6,7,16,1,24,7,50,0,0,0
13655,12,2016-11-26,stanford,,Rice,W (41-17),12,18,66.7,161,2,43,373,8.7,3,61,534,8.8,6,13,0,19,8,59,0,0,0
13656,13,2016-12-30,stanford,N,North Carolina*,W (25-23),9,18,50.0,154,1,43,129,3.0,0,61,283,4.6,6,8,2,16,12,85,0,0,0
13657,,13 Games,stanford,,,,179,305,58.7,2056,15,522,2716,5.2,20,827,4772,5.8,98,122,15,235,85,707,9,9,18
13658,1,2017-08-26,stanford,N,Rice,W (62-7),21,37,56.8,369,3,36,287,8.0,5,73,656,9.0,12,12,3,27,4,35,0,0,0
13659,2,2017-09-09,stanford,@,Southern California,L (24-42),15,28,53.6,172,2,26,170,6.5,1,54,342,6.3,8,5,3,16,7,35,0,0,0
13660,3,2017-09-16,stanford,@,San Diego State,L (17-20),10,21,47.6,80,0,22,174,7.9,2,43,254,5.9,2,6,1,9,4,20,1,2,3
13661,4,2017-09-23,stanford,,UCLA,W (58-34),16,24,66.7,148,2,45,405,9.0,5,69,553,8.0,7,12,4,23,12,86,1,0,1
13662,5,2017-09-30,stanford,,Arizona State,W (34-24),15,24,62.5,173,1,32,334,10.4,3,56,507,9.1,6,10,1,17,8,78,1,0,1
13663,6,2017-10-07,stanford,@,Utah,W (23-20),13,24,54.2,188,0,31,196,6.3,2,55,384,7.0,7,5,2,14,9,84,0,0,0
13664,7,2017-10-14,stanford,,Oregon,W (49-7),21,28,75.0,256,4,41,248,6.0,2,69,504,7.3,13,9,3,25,2,15,1,1,2
13665,8,2017-10-26,stanford,@,Oregon State,W (15-14),16,33,48.5,141,1,27,81,3.0,0,60,222,3.7,6,5,1,12,8,81,0,1,1
13666,9,2017-11-04,stanford,@,Washington State,L (21-24),9,20,45.0,105,0,27,93,3.4,2,47,198,4.2,5,4,0,9,4,20,0,1,1
13667,10,2017-11-10,stanford,,Washington,W (30-22),16,27,59.3,211,0,44,195,4.4,3,71,406,5.7,10,9,2,21,5,50,0,0,0
13668,11,2017-11-18,stanford,,California,W (17-14),17,26,65.4,185,1,38,193,5.1,1,64,378,5.9,11,9,1,21,5,40,0,1,1
13669,12,2017-11-25,stanford,,Notre Dame,W (38-20),14,22,63.6,176,4,38,152,4.0,1,60,328,5.5,8,7,3,18,3,30,0,0,0
13670,13,2017-12-01,stanford,N,Southern California,L (28-31),10,22,45.5,192,2,38,151,4.0,2,60,343,5.7,7,8,3,18,7,73,0,0,0
13671,14,2017-12-28,stanford,N,Texas Christian*,L (37-39),15,27,55.6,212,3,34,157,4.6,2,61,369,6.0,8,9,0,17,3,15,0,2,2
13672,,14 Games,stanford,,,,208,363,57.3,2608,23,479,2836,5.9,31,842,5444,6.5,110,110,27,247,81,662,4,8,12
13673,1,2018-08-31,stanford,,San Diego State,W (31-10),21,31,67.7,332,4,28,50,1.8,0,59,382,6.5,11,3,5,19,3,20,0,1,1
13674,2,2018-09-08,stanford,,Southern California,W (17-3),16,27,59.3,183,1,29,159,5.5,1,56,342,6.1,9,4,0,13,7,50,0,0,0
13675,3,2018-09-15,stanford,,California-Davis,W (30-10),17,33,51.5,214,2,33,137,4.2,1,66,351,5.3,10,6,1,17,10,64,0,2,2
13676,4,2018-09-22,stanford,@,Oregon,W (38-31),19,26,73.1,327,3,24,71,3.0,1,50,398,8.0,13,3,1,17,5,23,0,0,0
13677,5,2018-09-29,stanford,@,Notre Dame,L (17-38),15,27,55.6,174,1,24,55,2.3,1,51,229,4.5,7,1,2,10,7,50,0,1,1
13678,6,2018-10-06,stanford,,Utah,L (21-40),26,42,61.9,381,1,28,42,1.5,2,70,423,6.0,18,4,4,26,2,20,2,2,4
13679,7,2018-10-18,stanford,@,Arizona State,W (20-13),22,29,75.9,231,1,43,127,3.0,1,72,358,5.0,10,8,6,24,5,60,0,0,0
13680,8,2018-10-27,stanford,,Washington State,L (38-41),34,43,79.1,323,4,23,120,5.2,1,66,443,6.7,16,6,5,27,3,18,1,0,1
13681,9,2018-11-03,stanford,@,Washington,L (23-27),29,44,65.9,347,2,23,77,3.3,1,67,424,6.3,15,3,4,22,4,28,0,3,3
13682,10,2018-11-10,stanford,,Oregon State,W (48-17),25,38,65.8,352,4,30,244,8.1,3,68,596,8.8,11,11,2,24,8,70,0,1,1
13683,,10 Games,stanford,,,,224,340,65.9,2864,23,285,1082,3.8,12,625,3946,6.3,120,49,30,199,54,403,3,10,13
13684,1,2014-08-29,arizona,,Nevada-Las Vegas,W (58-13),26,46,56.5,434,4,48,353,7.4,3,94,787,8.4,17,13,2,32,7,63,0,0,0
13685,2,2014-09-04,arizona,@,Texas-San Antonio,W (26-23),17,32,53.1,231,1,44,223,5.1,1,76,454,6.0,8,11,3,22,8,73,0,0,0
13686,3,2014-09-13,arizona,,Nevada,W (35-28),22,26,84.6,278,3,38,229,6.0,2,64,507,7.9,13,10,3,26,7,47,0,1,1
13687,4,2014-09-20,arizona,,California,W (49-45),47,74,63.5,520,5,32,107,3.3,1,106,627,5.9,24,8,4,36,6,65,0,2,2
13688,5,2014-10-02,arizona,@,Oregon,W (31-24),20,31,64.5,287,1,55,208,3.8,3,86,495,5.8,13,11,5,29,9,78,1,1,2
13689,6,2014-10-11,arizona,,Southern California,L (26-28),43,72,59.7,395,1,30,78,2.6,2,102,473,4.6,23,6,5,34,4,35,1,0,1
13690,7,2014-10-25,arizona,@,Washington State,W (59-37),26,38,68.4,294,5,36,157,4.4,1,74,451,6.1,12,8,5,25,8,89,1,0,1
13691,8,2014-11-01,arizona,@,UCLA,L (7-17),18,48,37.5,175,1,31,80,2.6,0,79,255,3.2,10,5,4,19,4,40,0,1,1
13692,9,2014-11-08,arizona,,Colorado,W (38-20),21,38,55.3,211,4,47,288,6.1,0,85,499,5.9,11,11,6,28,8,75,0,0,0
13693,10,2014-11-15,arizona,,Washington,W (27-26),17,40,42.5,242,0,40,133,3.3,3,80,375,4.7,10,8,4,22,2,14,1,2,3
13694,11,2014-11-22,arizona,@,Utah,W (42-10),11,22,50.0,222,0,47,298,6.3,4,69,520,7.5,9,12,0,21,6,57,1,0,1
13695,12,2014-11-28,arizona,,Arizona State,W (42-35),15,21,71.4,208,2,37,125,3.4,3,58,333,5.7,6,7,0,13,9,123,2,0,2
13696,13,2014-12-05,arizona,N,Oregon,L (13-51),9,26,34.6,113,1,35,111,3.2,1,61,224,3.7,3,7,0,10,8,67,1,1,2
13697,14,2014-12-31,arizona,N,Boise State*,L (30-38),28,50,56.0,335,1,56,157,2.8,2,106,492,4.6,17,11,1,29,6,55,0,2,2
13698,,14 Games,arizona,,,,320,564,56.7,3945,29,576,2547,4.4,26,1140,6492,5.7,176,128,42,346,92,881,8,10,18
13699,1,2015-09-03,arizona,,Texas-San Antonio,W (42-32),22,36,61.1,229,4,38,163,4.3,0,74,392,5.3,12,8,5,25,8,76,1,0,1
13700,2,2015-09-12,arizona,@,Nevada,W (44-20),25,34,73.5,269,2,43,301,7.0,4,77,570,7.4,10,10,4,24,3,30,1,0,1
13701,3,2015-09-19,arizona,,Northern Arizona,W (77-13),26,39,66.7,293,4,41,499,12.2,7,80,792,9.9,15,19,2,36,4,50,0,0,0
13702,4,2015-09-26,arizona,,UCLA,L (30-56),10,28,35.7,115,2,59,353,6.0,2,87,468,5.4,5,23,4,32,5,40,2,1,3
13703,5,2015-10-03,arizona,@,Stanford,L (17-55),17,33,51.5,196,1,34,118,3.5,1,67,314,4.7,9,7,0,16,7,55,0,0,0
13704,6,2015-10-10,arizona,,Oregon State,W (44-7),17,30,56.7,276,0,58,368,6.3,5,88,644,7.3,10,15,2,27,7,56,0,0,0
13705,7,2015-10-17,arizona,@,Colorado,W (38-31),25,40,62.5,325,2,44,291,6.6,3,84,616,7.3,14,12,0,26,3,25,2,0,2
13706,8,2015-10-24,arizona,,Washington State,L (42-45),24,37,64.9,307,2,32,176,5.5,3,69,483,7.0,13,8,3,24,5,40,1,0,1
13707,9,2015-10-31,arizona,@,Washington,L (3-49),25,42,59.5,203,0,44,127,2.9,0,86,330,3.8,9,10,3,22,4,22,1,3,4
13708,10,2015-11-07,arizona,@,Southern California,L (30-38),31,47,66.0,352,3,32,60,1.9,0,79,412,5.2,16,5,3,24,9,80,0,1,1
13709,11,2015-11-14,arizona,,Utah,W (37-30),18,32,56.3,302,3,34,158,4.6,1,66,460,7.0,11,9,4,24,8,71,0,2,2
13710,12,2015-11-21,arizona,@,Arizona State,L (37-52),20,43,46.5,340,2,34,109,3.2,1,77,449,5.8,13,5,1,19,7,58,1,2,3
13711,13,2015-12-19,arizona,N,New Mexico*,W (45-37),13,24,54.2,329,2,32,174,5.4,4,56,503,9.0,10,7,2,19,4,30,1,1,2
13712,,13 Games,arizona,,,,273,465,58.7,3536,27,525,2897,5.5,31,990,6433,6.5,147,138,33,318,74,633,10,10,20
13713,1,2016-09-03,arizona,N,Brigham Young,L (16-18),20,30,66.7,213,0,26,115,4.4,2,56,328,5.9,9,6,2,17,4,20,0,2,2
13714,2,2016-09-10,arizona,,Grambling State,W (31-21),15,30,50.0,223,1,47,222,4.7,3,77,445,5.8,8,11,2,21,7,65,0,0,0
13715,3,2016-09-17,arizona,,Hawaii,W (47-28),16,21,76.2,235,1,49,347,7.1,5,70,582,8.3,8,19,1,28,11,105,0,0,0
13716,4,2016-09-24,arizona,,Washington,L (28-35),19,31,61.3,167,1,43,308,7.2,3,74,475,6.4,8,12,3,23,2,30,2,1,3
13717,5,2016-10-01,arizona,@,UCLA,L (24-45),13,31,41.9,145,3,49,242,4.9,0,80,387,4.8,7,11,4,22,5,40,0,0,0
13718,6,2016-10-08,arizona,@,Utah,L (23-36),16,29,55.2,348,2,37,127,3.4,1,66,475,7.2,11,8,2,21,7,65,0,3,3
13719,7,2016-10-15,arizona,,Southern California,L (14-48),11,26,42.3,142,1,44,201,4.6,1,70,343,4.9,7,8,5,20,4,35,2,2,4
13720,8,2016-10-29,arizona,,Stanford,L (10-34),5,20,25.0,116,1,44,170,3.9,0,64,286,4.5,4,9,2,15,5,55,2,1,3
13721,9,2016-11-05,arizona,@,Washington State,L (7-69),11,23,47.8,128,1,30,158,5.3,0,53,286,5.4,4,7,3,14,7,85,1,2,3
13722,10,2016-11-12,arizona,,Colorado,L (24-49),12,26,46.2,155,0,52,257,4.9,3,78,412,5.3,7,12,4,23,13,138,1,0,1
13723,11,2016-11-19,arizona,@,Oregon State,L (17-42),16,31,51.6,188,1,40,162,4.1,1,71,350,4.9,11,10,2,23,3,29,0,1,1
13724,12,2016-11-25,arizona,,Arizona State,W (56-35),3,8,37.5,77,1,48,511,10.6,7,56,588,10.5,1,16,2,19,8,101,1,0,1
13725,,12 Games,arizona,,,,157,306,51.3,2137,13,509,2820,5.5,26,815,4957,6.1,85,129,32,246,76,768,9,12,21
13726,1,2017-09-02,arizona,,Northern Arizona,W (62-24),7,14,50.0,89,1,47,506,10.8,7,61,595,9.8,2,17,4,23,9,81,0,0,0
13727,2,2017-09-09,arizona,,Houston,L (16-19),22,37,59.5,219,0,39,152,3.9,1,76,371,4.9,10,8,3,21,4,35,1,1,2
13728,3,2017-09-15,arizona,@,Texas-El Paso,W (63-16),20,23,87.0,175,3,64,328,5.1,5,87,503,5.8,11,17,1,29,3,20,1,0,1
13729,4,2017-09-22,arizona,,Utah,L (24-30),24,42,57.1,248,1,42,200,4.8,2,84,448,5.3,9,10,5,24,4,60,2,3,5
13730,5,2017-10-07,arizona,@,Colorado,W (45-42),12,14,85.7,154,1,40,416,10.4,5,54,570,10.6,6,15,4,25,2,10,1,0,1
13731,6,2017-10-14,arizona,,UCLA,W (47-30),9,13,69.2,148,1,61,457,7.5,4,74,605,8.2,5,18,4,27,11,113,0,0,0
13732,7,2017-10-21,arizona,@,California,W (45-44),10,15,66.7,166,2,46,345,7.5,4,61,511,8.4,7,15,2,24,8,88,0,1,1
13733,8,2017-10-28,arizona,,Washington State,W (58-37),10,17,58.8,275,2,34,310,9.1,4,51,585,11.5,8,5,0,13,2,20,2,1,3
13734,9,2017-11-04,arizona,@,Southern California,L (35-49),14,31,45.2,146,2,43,234,5.4,2,74,380,5.1,8,13,4,25,3,32,1,2,3
13735,10,2017-11-11,arizona,,Oregon State,W (49-28),5,7,71.4,68,0,55,534,9.7,7,62,602,9.7,4,21,1,26,5,70,0,1,1
13736,11,2017-11-18,arizona,@,Oregon,L (28-48),18,35,51.4,159,1,45,171,3.8,3,80,330,4.1,8,13,6,27,8,94,0,2,2
13737,12,2017-11-25,arizona,@,Arizona State,L (30-42),15,21,71.4,194,0,51,245,4.8,4,72,439,6.1,7,13,4,23,4,45,0,1,1
13738,13,2017-12-27,arizona,N,Purdue*,L (35-38),17,26,65.4,302,5,43,128,3.0,0,69,430,6.2,12,5,2,19,6,47,1,1,2
13739,,13 Games,arizona,,,,183,295,62.0,2343,19,610,4026,6.6,48,905,6369,7.0,97,170,40,306,69,715,9,13,22
13740,1,2018-09-01,arizona,,Brigham Young,L (23-28),17,34,50.0,197,1,35,129,3.7,2,69,326,4.7,11,7,4,22,4,26,0,0,0
13741,2,2018-09-08,arizona,@,Houston,L (18-45),28,50,56.0,381,0,50,150,3.0,2,100,531,5.3,19,9,3,31,8,85,0,2,2
13742,3,2018-09-15,arizona,,Southern Utah,W (62-31),15,22,68.2,358,5,38,268,7.1,2,60,626,10.4,11,12,3,26,10,98,1,0,1
13743,4,2018-09-22,arizona,@,Oregon State,W (35-14),9,17,52.9,152,2,51,442,8.7,3,68,594,8.7,8,21,0,29,7,55,1,0,1
13744,5,2018-09-29,arizona,,Southern California,L (20-24),16,33,48.5,232,2,37,98,2.6,1,70,330,4.7,10,4,6,20,8,80,0,1,1
13745,6,2018-10-06,arizona,,California,W (24-17),15,25,60.0,141,1,34,124,3.6,0,59,265,4.5,5,7,1,13,10,72,1,1,2
13746,7,2018-10-12,arizona,@,Utah,L (10-42),24,46,52.2,246,1,31,72,2.3,0,77,318,4.1,10,4,5,19,5,56,0,0,0
13747,8,2018-10-20,arizona,@,UCLA,L (30-31),15,34,44.1,231,2,38,289,7.6,1,72,520,7.2,11,7,4,22,6,64,1,2,3
13748,9,2018-10-27,arizona,,Oregon,W (44-15),19,33,57.6,189,3,51,276,5.4,2,84,465,5.5,10,13,4,27,11,106,0,1,1
13749,10,2018-11-02,arizona,,Colorado,W (42-34),17,22,77.3,350,5,47,216,4.6,0,69,566,8.2,12,12,3,27,12,129,1,1,2
13750,11,2018-11-17,arizona,@,Washington State,L (28-69),20,34,58.8,304,4,37,127,3.4,0,71,431,6.1,12,7,2,21,7,75,3,1,4
13751,,11 Games,arizona,,,,195,350,55.7,2781,26,449,2191,4.9,13,799,4972,6.2,119,103,35,257,88,846,8,9,17
13752,1,2014-08-30,california,@,Northwestern,W (31-24),23,39,59.0,300,3,45,114,2.5,1,84,414,4.9,13,10,0,23,6,59,0,2,2
13753,2,2014-09-06,california,,Sacramento State,W (55-14),21,29,72.4,326,5,47,253,5.4,2,76,579,7.6,14,10,2,26,10,100,1,0,1
13754,3,2014-09-20,california,@,Arizona,L (45-49),18,30,60.0,380,3,42,193,4.6,3,72,573,8.0,13,9,2,24,10,99,1,1,2
13755,4,2014-09-27,california,,Colorado,W (59-56),23,41,56.1,449,7,30,127,4.2,1,71,576,8.1,15,7,2,24,12,113,1,1,2
13756,5,2014-10-04,california,@,Washington State,W (60-59),37,53,69.8,527,5,18,62,3.4,1,71,589,8.3,19,5,3,27,8,34,0,0,0
13757,6,2014-10-11,california,,Washington,L (7-31),35,51,68.6,304,0,33,64,1.9,1,84,368,4.4,18,5,2,25,7,56,3,0,3
13758,7,2014-10-18,california,,UCLA,L (34-36),26,42,61.9,310,3,31,56,1.8,2,73,366,5.0,12,6,3,21,4,40,0,1,1
13759,8,2014-10-24,california,,Oregon,L (41-59),33,55,60.0,367,2,38,193,5.1,4,93,560,6.0,16,11,3,30,11,111,2,0,2
13760,9,2014-11-01,california,@,Oregon State,W (45-31),24,47,51.1,277,1,47,269,5.7,4,94,546,5.8,16,14,4,34,9,71,0,0,0
13761,10,2014-11-13,california,@,Southern California,L (30-38),29,47,61.7,279,3,31,105,3.4,1,78,384,4.9,15,6,6,27,11,117,1,0,1
13762,11,2014-11-22,california,,Stanford,L (17-38),21,40,52.5,231,1,36,179,5.0,1,76,410,5.4,14,8,1,23,12,113,1,4,5
13763,12,2014-11-29,california,,Brigham Young,L (35-42),38,60,63.3,393,4,41,173,4.2,1,101,566,5.6,22,8,4,34,7,78,0,1,1
13764,,12 Games,california,,,,328,534,61.4,4143,37,439,1788,4.1,22,973,5931,6.1,187,99,32,318,107,991,10,10,20
13765,1,2015-09-05,california,,Grambling State,W (73-14),34,49,69.4,471,4,39,185,4.7,4,88,656,7.5,22,8,1,31,3,36,1,2,3
13766,2,2015-09-12,california,,San Diego State,W (35-7),17,25,68.0,321,3,36,164,4.6,2,61,485,8.0,10,10,4,24,5,50,0,1,1
13767,3,2015-09-19,california,@,Texas,W (45-44),27,37,73.0,268,3,41,280,6.8,3,78,548,7.0,12,11,3,26,6,50,2,0,2
13768,4,2015-09-26,california,@,Washington,W (30-24),24,41,58.5,342,2,51,139,2.7,1,92,481,5.2,15,11,2,28,6,35,1,1,2
13769,5,2015-10-03,california,,Washington State,W (34-28),33,45,73.3,390,4,30,79,2.6,0,75,469,6.3,19,6,0,25,4,15,1,1,2
13770,6,2015-10-10,california,@,Utah,L (24-30),25,47,53.2,340,2,28,127,4.5,1,75,467,6.2,15,8,2,25,4,43,1,5,6
13771,7,2015-10-22,california,@,UCLA,L (24-40),32,53,60.4,295,3,35,131,3.7,0,88,426,4.8,16,8,1,25,5,37,0,0,0
13772,8,2015-10-31,california,,Southern California,L (21-27),23,31,74.2,272,2,30,117,3.9,1,61,389,6.4,14,6,3,23,3,26,1,2,3
13773,9,2015-11-07,california,@,Oregon,L (28-44),18,42,42.9,329,2,24,103,4.3,1,66,432,6.5,11,6,3,20,6,64,0,1,1
13774,10,2015-11-14,california,,Oregon State,W (54-24),26,37,70.3,453,6,46,307,6.7,1,83,760,9.2,17,16,3,36,9,85,0,1,1
13775,11,2015-11-21,california,@,Stanford,L (22-35),38,55,69.1,397,2,23,98,4.3,0,78,495,6.3,15,7,1,23,8,63,0,0,0
13776,12,2015-11-28,california,,Arizona State,W (48-46),30,51,58.8,542,5,22,138,6.3,1,73,680,9.3,19,8,1,28,3,35,1,0,1
13777,13,2015-12-29,california,N,Air Force*,W (55-36),25,37,67.6,467,6,34,119,3.5,1,71,586,8.3,16,9,2,27,5,29,1,0,1
13778,,13 Games,california,,,,352,550,64.0,4887,44,439,1987,4.5,16,989,6874,7.0,201,114,26,341,67,568,9,14,23
13779,1,2016-08-26,california,N,Hawaii,W (51-31),38,54,70.4,441,4,35,189,5.4,2,89,630,7.1,19,9,2,30,6,80,0,0,0
13780,2,2016-09-10,california,@,San Diego State,L (40-45),41,72,56.9,522,5,22,82,3.7,0,94,604,6.4,23,5,2,30,5,55,1,3,4
13781,3,2016-09-17,california,,Texas,W (50-43),27,40,67.5,396,4,40,111,2.8,3,80,507,6.3,19,4,1,24,6,71,0,0,0
13782,4,2016-09-24,california,@,Arizona State,L (41-51),32,56,57.1,478,5,37,159,4.3,0,93,637,6.8,20,8,1,29,8,60,1,2,3
13783,5,2016-10-01,california,,Utah,W (28-23),22,35,62.9,306,4,14,56,4.0,0,49,362,7.4,12,4,1,17,8,65,0,1,1
13784,6,2016-10-08,california,@,Oregon State,L (44-47),24,45,53.3,124,0,44,317,7.2,4,89,441,5.0,5,17,5,27,10,85,0,1,1
13785,7,2016-10-21,california,,Oregon,W (52-49),42,61,68.9,325,5,57,311,5.5,1,118,636,5.4,20,18,2,40,14,145,0,0,0
13786,8,2016-10-27,california,@,Southern California,L (24-45),34,53,64.2,333,2,30,142,4.7,1,83,475,5.7,16,8,5,29,7,65,1,1,2
13787,9,2016-11-05,california,,Washington,L (27-66),23,47,48.9,262,1,27,100,3.7,2,74,362,4.9,10,6,2,18,9,93,0,3,3
13788,10,2016-11-12,california,@,Washington State,L (21-56),34,53,64.2,425,3,30,100,3.3,0,83,525,6.3,19,7,4,30,10,120,0,1,1
13789,11,2016-11-19,california,,Stanford,L (31-45),34,57,59.6,393,2,24,90,3.8,2,81,483,6.0,19,6,2,27,4,45,0,0,0
13790,12,2016-11-26,california,,UCLA,W (36-10),32,48,66.7,301,2,54,195,3.6,1,102,496,4.9,15,11,8,34,2,25,0,0,0
13791,,12 Games,california,,,,383,621,61.7,4306,37,414,1852,4.5,16,1035,6158,5.9,197,103,35,335,89,909,3,12,15
13792,1,2017-09-02,california,@,North Carolina,W (35-30),24,38,63.2,363,4,35,106,3.0,1,73,469,6.4,13,6,1,20,9,57,0,2,2
13793,2,2017-09-09,california,,Weber State,W (33-20),20,28,71.4,200,0,34,231,6.8,4,62,431,7.0,8,9,2,19,6,34,1,0,1
13794,3,2017-09-16,california,,Mississippi,W (27-16),24,48,50.0,236,1,40,163,4.1,1,88,399,4.5,13,8,4,25,7,90,0,2,2
13795,4,2017-09-23,california,,Southern California,L (20-30),22,52,42.3,303,1,33,113,3.4,1,85,416,4.9,10,9,2,21,6,44,2,4,6
13796,5,2017-09-30,california,@,Oregon,L (24-45),23,43,53.5,255,3,29,8,0.3,0,72,263,3.7,10,3,4,17,4,37,2,0,2
13797,6,2017-10-07,california,@,Washington,L (7-38),16,26,61.5,133,0,26,-40,-1.5,0,52,93,1.8,5,3,1,9,4,31,1,0,1
13798,7,2017-10-13,california,,Washington State,W (37-3),21,38,55.3,259,1,32,106,3.3,2,70,365,5.2,12,7,1,18,8,75,0,0,0
13799,8,2017-10-21,california,,Arizona,L (44-45),29,49,59.2,301,2,47,172,3.7,4,96,473,4.9,17,9,5,31,7,58,0,2,2
13800,9,2017-10-28,california,@,Colorado,L (28-44),30,53,56.6,374,4,25,61,2.4,0,78,435,5.6,16,8,2,26,4,35,0,1,1
13801,10,2017-11-04,california,,Oregon State,W (37-23),24,31,77.4,259,2,45,216,4.8,2,76,475,6.3,15,14,5,34,7,68,1,0,1
13802,11,2017-11-18,california,@,Stanford,L (14-17),20,29,69.0,182,0,28,155,5.5,1,57,337,5.9,9,10,0,19,5,45,0,1,1
13803,12,2017-11-24,california,@,UCLA,L (27-30),25,41,61.0,242,1,42,216,5.1,1,83,458,5.5,11,12,3,26,11,84,1,0,1
13804,,12 Games,california,,,,278,476,58.4,3107,19,416,1507,3.6,17,892,4614,5.2,139,98,30,265,78,658,8,12,20
13805,1,2018-09-01,california,,North Carolina,W (24-17),16,32,50.0,119,1,49,160,3.3,1,81,279,3.4,6,9,4,19,5,35,0,0,0
13806,2,2018-09-08,california,@,Brigham Young,W (21-18),23,35,65.7,214,2,38,172,4.5,1,73,386,5.3,10,10,2,22,9,65,2,1,3
13807,3,2018-09-15,california,,Idaho State,W (45-23),24,32,75.0,269,4,43,213,5.0,1,75,482,6.4,12,11,1,24,11,111,1,1,2
13808,4,2018-09-29,california,,Oregon,L (24-42),16,31,51.6,186,1,41,241,5.9,2,72,427,5.9,7,15,3,25,4,30,1,4,5
13809,5,2018-10-06,california,@,Arizona,L (17-24),32,43,74.4,315,0,34,161,4.7,2,77,476,6.2,15,7,3,25,13,115,1,3,4
13810,6,2018-10-13,california,,UCLA,L (7-37),23,42,54.8,179,0,33,131,4.0,1,75,310,4.1,9,10,1,20,3,36,3,2,5
13811,7,2018-10-20,california,@,Oregon State,W (49-7),17,26,65.4,234,3,43,305,7.1,3,69,539,7.8,9,17,1,27,4,50,1,0,1
13812,8,2018-10-27,california,,Washington,W (12-10),17,24,70.8,151,0,36,91,2.5,0,60,242,4.0,8,6,0,14,4,24,0,0,0
13813,9,2018-11-03,california,@,Washington State,L (13-19),18,33,54.5,179,1,36,112,3.1,0,69,291,4.2,8,6,6,20,2,25,0,2,2
13814,10,2018-11-10,california,@,Southern California,W (15-14),14,26,53.8,93,1,32,114,3.6,1,58,207,3.6,6,3,2,11,4,35,1,0,1
13815,,10 Games,california,,,,200,324,61.7,1939,13,385,1700,4.4,12,709,3639,5.1,90,94,23,207,59,526,10,13,23
13816,1,2014-08-30,oregon,,South Dakota,W (62-13),25,32,78.1,380,4,38,293,7.7,4,70,673,9.6,16,16,0,32,9,64,1,0,1
13817,2,2014-09-06,oregon,,Michigan State,W (46-27),17,28,60.7,318,3,40,173,4.3,3,68,491,7.2,10,7,2,19,9,70,0,0,0
13818,3,2014-09-13,oregon,,Wyoming,W (48-14),25,31,80.6,293,2,37,263,7.1,5,68,556,8.2,15,15,2,32,4,30,0,0,0
13819,4,2014-09-20,oregon,@,Washington State,W (38-31),21,25,84.0,329,5,42,172,4.1,0,67,501,7.5,10,10,2,22,10,86,0,0,0
13820,5,2014-10-02,oregon,,Arizona,L (24-31),21,33,63.6,302,3,41,144,3.5,0,74,446,6.0,18,4,3,25,10,79,2,0,2
13821,6,2014-10-11,oregon,@,UCLA,W (42-30),17,27,63.0,210,2,41,258,6.3,4,68,468,6.9,9,14,3,26,4,37,0,0,0
13822,7,2014-10-18,oregon,,Washington,W (45-20),24,33,72.7,336,2,50,218,4.4,4,83,554,6.7,15,13,1,29,7,90,0,0,0
13823,8,2014-10-24,oregon,@,California,W (59-41),18,30,60.0,326,5,46,264,5.7,2,76,590,7.8,12,13,2,27,10,106,1,1,2
13824,9,2014-11-01,oregon,,Stanford,W (45-16),19,31,61.3,258,2,46,267,5.8,4,77,525,6.8,13,15,2,30,7,60,0,1,1
13825,10,2014-11-08,oregon,@,Utah,W (51-27),17,29,58.6,239,3,50,269,5.4,2,79,508,6.4,10,15,2,27,8,73,1,0,1
13826,11,2014-11-22,oregon,,Colorado,W (44-10),26,36,72.2,332,3,41,265,6.5,3,77,597,7.8,18,11,1,30,8,98,0,0,0
13827,12,2014-11-29,oregon,@,Oregon State,W (47-19),19,25,76.0,367,4,40,198,5.0,2,65,565,8.7,12,13,1,26,8,77,1,0,1
13828,13,2014-12-05,oregon,N,Arizona,W (51-13),27,40,67.5,326,2,54,301,5.6,4,94,627,6.7,15,13,3,31,13,84,0,0,0
13829,14,2015-01-01,oregon,N,Florida State*,W (59-20),26,36,72.2,338,2,45,301,6.7,5,81,639,7.9,12,17,1,30,6,50,1,1,2
13830,15,2015-01-12,oregon,N,Ohio State*,L (20-42),24,38,63.2,333,2,33,132,4.0,0,71,465,6.5,13,7,0,20,10,76,0,1,1
13831,,15 Games,oregon,,,,326,474,68.8,4687,44,644,3518,5.5,42,1118,8205,7.3,198,183,25,406,123,1080,7,4,11
13832,1,2015-09-05,oregon,,Eastern Washington,W (61-42),19,25,76.0,246,2,57,485,8.5,6,82,731,8.9,11,21,2,34,8,70,1,0,1
13833,2,2015-09-12,oregon,@,Michigan State,L (28-31),22,39,56.4,309,1,43,123,2.9,2,82,432,5.3,17,7,2,26,9,56,0,2,2
13834,3,2015-09-19,oregon,,Georgia State,W (61-28),23,31,74.2,228,2,53,311,5.9,3,84,539,6.4,10,18,1,29,7,62,1,0,1
13835,4,2015-09-26,oregon,,Utah,L (20-62),14,30,46.7,178,2,40,222,5.6,1,70,400,5.7,9,10,1,20,10,90,1,2,3
13836,5,2015-10-03,oregon,@,Colorado,W (41-24),13,21,61.9,176,2,60,361,6.0,3,81,537,6.6,6,19,2,27,4,45,0,1,1
13837,6,2015-10-10,oregon,,Washington State,L (38-45),13,24,54.2,123,2,50,410,8.2,3,74,533,7.2,5,13,0,18,5,44,1,1,2
13838,7,2015-10-17,oregon,@,Washington,W (26-20),14,25,56.0,272,2,51,170,3.3,1,76,442,5.8,9,9,3,21,9,82,0,0,0
13839,8,2015-10-29,oregon,@,Arizona State,W (61-55),23,41,56.1,315,4,28,186,6.6,3,69,501,7.3,9,7,3,19,6,50,0,1,1
13840,9,2015-11-07,oregon,,California,W (44-28),17,29,58.6,300,4,63,477,7.6,1,92,777,8.4,11,23,2,36,10,90,0,2,2
13841,10,2015-11-14,oregon,@,Stanford,W (38-36),10,12,83.3,205,2,36,231,6.4,3,48,436,9.1,8,9,1,18,4,45,1,0,1
13842,11,2015-11-21,oregon,,Southern California,W (48-28),20,25,80.0,407,6,38,171,4.5,0,63,578,9.2,15,11,2,28,4,42,0,1,1
13843,12,2015-11-27,oregon,,Oregon State,W (52-42),28,38,73.7,366,3,51,308,6.0,4,89,674,7.6,16,17,4,37,9,93,1,0,1
13844,13,2016-01-02,oregon,N,Texas Christian*,L (41-47),20,35,57.1,233,1,48,186,3.9,4,83,419,5.0,11,9,1,21,5,24,1,0,1
13845,,13 Games,oregon,,,,236,375,62.9,3358,33,618,3641,5.9,34,993,6999,7.0,137,173,24,334,90,793,7,10,17
13846,1,2016-09-03,oregon,,California-Davis,W (53-28),21,30,70.0,271,3,37,251,6.8,4,67,522,7.8,12,8,1,21,8,71,2,0,2
13847,2,2016-09-10,oregon,,Virginia,W (44-26),21,31,67.7,331,3,45,301,6.7,3,76,632,8.3,11,10,4,25,12,117,0,0,0
13848,3,2016-09-17,oregon,@,Nebraska,L (32-35),14,23,60.9,146,0,47,336,7.1,5,70,482,6.9,5,14,1,20,13,126,0,0,0
13849,4,2016-09-24,oregon,,Colorado,L (38-41),22,33,66.7,293,2,45,215,4.8,3,78,508,6.5,14,8,2,24,8,75,0,1,1
13850,5,2016-10-01,oregon,@,Washington State,L (33-51),17,27,63.0,202,0,37,214,5.8,4,64,416,6.5,8,12,0,20,4,42,1,1,2
13851,6,2016-10-08,oregon,,Washington,L (21-70),21,34,61.8,179,2,43,230,5.3,1,77,409,5.3,9,11,2,22,5,40,1,1,2
13852,7,2016-10-21,oregon,@,California,L (49-52),22,40,55.0,258,6,45,192,4.3,1,85,450,5.3,13,9,5,27,14,134,0,1,1
13853,8,2016-10-29,oregon,,Arizona State,W (54-35),31,42,73.8,489,4,46,245,5.3,2,88,734,8.3,16,14,0,30,9,73,1,0,1
13854,9,2016-11-05,oregon,@,Southern California,L (20-45),20,37,54.1,203,1,30,85,2.8,2,67,288,4.3,9,7,3,19,7,43,0,0,0
13855,10,2016-11-12,oregon,,Stanford,L (27-52),21,30,70.0,274,2,45,226,5.0,2,75,500,6.7,11,10,3,24,8,77,2,2,4
13856,11,2016-11-19,oregon,@,Utah,W (30-28),30,43,69.8,324,3,43,251,5.8,1,86,575,6.7,17,10,0,27,5,37,1,0,1
13857,12,2016-11-26,oregon,@,Oregon State,L (24-34),17,29,58.6,213,2,30,171,5.7,1,59,384,6.5,9,9,3,21,6,75,1,0,1
13858,,12 Games,oregon,,,,257,399,64.4,3183,28,493,2717,5.5,29,892,5900,6.6,134,122,24,280,99,910,9,6,15
13859,1,2017-09-02,oregon,,Southern Utah,W (77-21),23,27,85.2,355,1,52,348,6.7,9,79,703,8.9,14,20,3,37,12,115,2,0,2
13860,2,2017-09-09,oregon,,Nebraska,W (42-35),25,33,75.8,365,3,44,201,4.6,3,77,566,7.4,10,11,1,22,12,103,1,1,2
13861,3,2017-09-16,oregon,@,Wyoming,W (49-13),18,30,60.0,251,1,65,307,4.7,6,95,558,5.9,12,18,2,32,4,40,2,1,3
13862,4,2017-09-23,oregon,@,Arizona State,L (35-37),19,35,54.3,281,3,30,120,4.0,2,65,401,6.2,11,5,4,20,14,99,1,0,1
13863,5,2017-09-30,oregon,,California,W (45-24),17,22,77.3,131,1,56,328,5.9,5,78,459,5.9,6,15,3,24,10,110,0,1,1
13864,6,2017-10-07,oregon,,Washington State,L (10-33),15,27,55.6,145,1,45,132,2.9,0,72,277,3.8,5,6,2,13,10,95,1,2,3
13865,7,2017-10-14,oregon,@,Stanford,L (7-49),5,13,38.5,33,0,43,276,6.4,1,56,309,5.5,3,9,0,12,9,101,1,2,3
13866,8,2017-10-21,oregon,@,UCLA,L (14-31),8,15,53.3,74,0,62,246,4.0,2,77,320,4.2,5,14,5,24,3,15,1,1,2
13867,9,2017-10-28,oregon,,Utah,W (41-20),10,13,76.9,69,2,49,347,7.1,2,62,416,6.7,3,15,1,19,8,60,1,0,1
13868,10,2017-11-04,oregon,@,Washington,L (3-38),7,13,53.8,31,0,55,247,4.5,0,68,278,4.1,0,16,0,16,5,50,1,1,2
13869,11,2017-11-18,oregon,,Arizona,W (48-28),14,21,66.7,235,1,50,353,7.1,5,71,588,8.3,9,13,2,24,12,117,0,1,1
13870,12,2017-11-25,oregon,,Oregon State,W (69-10),16,26,61.5,266,3,49,311,6.3,5,75,577,7.7,8,17,3,28,12,138,0,0,0
13871,13,2017-12-16,oregon,N,Boise State*,L (28-38),26,36,72.2,233,2,28,47,1.7,0,64,280,4.4,10,3,1,14,10,95,2,2,4
13872,,13 Games,oregon,,,,203,311,65.3,2469,18,628,3263,5.2,40,939,5732,6.1,96,162,27,285,121,1138,13,12,25
13873,1,2018-09-01,oregon,,Bowling Green State,W (58-24),11,26,42.3,292,5,42,212,5.0,2,68,504,7.4,8,11,4,23,3,35,1,2,3
13874,2,2018-09-08,oregon,,Portland State,W (62-14),23,29,79.3,266,4,47,296,6.3,5,76,562,7.4,14,17,1,32,5,55,0,0,0
13875,3,2018-09-15,oregon,,San Jose State,W (35-22),16,36,44.4,309,3,49,134,2.7,2,85,443,5.2,12,7,1,20,6,59,0,2,2
13876,4,2018-09-22,oregon,,Stanford,L (31-38),26,33,78.8,346,1,49,178,3.6,3,82,524,6.4,15,10,2,27,4,32,1,1,2
13877,5,2018-09-29,oregon,@,California,W (42-24),16,22,72.7,225,2,42,260,6.2,2,64,485,7.6,9,11,1,21,7,72,1,0,1
13878,6,2018-10-13,oregon,,Washington,W (30-27),18,32,56.3,202,2,49,177,3.6,2,81,379,4.7,11,11,2,24,7,70,1,0,1
13879,7,2018-10-20,oregon,@,Washington State,L (20-34),25,44,56.8,270,1,23,65,2.8,1,67,335,5.0,13,5,3,21,6,44,0,0,0
13880,8,2018-10-27,oregon,@,Arizona,L (15-44),24,48,50.0,186,2,23,84,3.7,0,71,270,3.8,12,4,2,18,6,53,2,1,3
13881,9,2018-11-03,oregon,,UCLA,W (42-21),19,33,57.6,292,2,42,200,4.8,3,75,492,6.6,11,8,1,20,1,15,0,0,0
13882,10,2018-11-10,oregon,@,Utah,L (25-32),20,33,60.6,288,3,32,117,3.7,0,65,405,6.2,11,5,1,17,7,63,1,0,1
13883,11,2018-11-17,oregon,,Arizona State,W (31-29),19,34,55.9,262,2,39,199,5.1,2,73,461,6.3,10,10,1,21,6,55,2,2,4
13884,,11 Games,oregon,,,,217,370,58.6,2938,27,437,1922,4.4,22,807,4860,6.0,126,99,19,244,58,553,9,8,17
13885,1,2014-08-28,washington-state,N,Rutgers,L (38-41),40,56,71.4,532,5,14,6,0.4,0,70,538,7.7,18,1,3,22,9,77,1,1,2
13886,2,2014-09-05,washington-state,@,Nevada,L (13-24),38,57,66.7,389,1,18,38,2.1,0,75,427,5.7,20,2,3,25,10,72,0,2,2
13887,3,2014-09-13,washington-state,,Portland State,W (59-21),43,64,67.2,630,7,23,76,3.3,1,87,706,8.1,27,5,1,33,7,70,0,2,2
13888,4,2014-09-20,washington-state,,Oregon,L (31-38),43,63,68.3,436,4,17,63,3.7,0,80,499,6.2,21,4,4,29,5,54,2,0,2
13889,5,2014-09-27,washington-state,@,Utah,W (28-27),39,61,63.9,417,4,25,78,3.1,0,86,495,5.8,19,6,2,27,4,40,1,2,3
13890,6,2014-10-04,washington-state,,California,L (59-60),49,70,70.0,734,6,25,78,3.1,2,95,812,8.5,26,4,3,33,12,121,0,0,0
13891,7,2014-10-10,washington-state,@,Stanford,L (17-34),42,69,60.9,292,2,11,-26,-2.4,0,80,266,3.3,12,4,2,18,10,75,0,1,1
13892,8,2014-10-25,washington-state,,Arizona,L (37-59),56,79,70.9,489,4,20,54,2.7,1,99,543,5.5,25,4,4,33,11,85,0,2,2
13893,9,2014-11-01,washington-state,,Southern California,L (17-44),44,66,66.7,386,2,26,34,1.3,0,92,420,4.6,14,7,2,23,5,48,1,2,3
13894,10,2014-11-08,washington-state,@,Oregon State,W (39-32),44,61,72.1,471,5,22,35,1.6,0,83,506,6.1,26,4,3,33,5,51,0,0,0
13895,11,2014-11-22,washington-state,@,Arizona State,L (31-52),45,76,59.2,601,3,24,21,0.9,1,100,622,6.2,27,2,1,30,7,49,1,4,5
13896,12,2014-11-29,washington-state,,Washington,L (13-31),27,49,55.1,355,2,18,21,1.2,0,67,376,5.6,16,2,2,20,9,70,1,2,3
13897,,12 Games,washington-state,,,,510,771,66.1,5732,45,243,478,2.0,5,1014,6210,6.1,251,45,30,326,94,812,7,18,25
13898,1,2015-09-05,washington-state,,Portland State,L (17-24),28,45,62.2,307,2,30,104,3.5,0,75,411,5.5,13,7,1,21,5,32,1,1,2
13899,2,2015-09-12,washington-state,@,Rutgers,W (37-34),47,66,71.2,478,4,16,81,5.1,0,82,559,6.8,21,6,1,28,5,50,0,0,0
13900,3,2015-09-19,washington-state,,Wyoming,W (31-14),37,45,82.2,303,2,20,75,3.8,2,65,378,5.8,14,4,1,19,5,43,0,1,1
13901,4,2015-10-03,washington-state,@,California,L (28-34),35,49,71.4,389,2,25,14,0.6,2,74,403,5.4,16,4,0,20,2,13,3,1,4
13902,5,2015-10-10,washington-state,@,Oregon,W (45-38),50,75,66.7,505,5,30,136,4.5,1,105,641,6.1,22,8,1,31,7,45,2,0,2
13903,6,2015-10-17,washington-state,,Oregon State,W (52-31),40,52,76.9,409,6,22,111,5.0,0,74,520,7.0,22,10,0,32,6,60,1,2,3
13904,7,2015-10-24,washington-state,@,Arizona,W (45-42),47,62,75.8,514,5,31,117,3.8,1,93,631,6.8,23,9,2,34,9,51,0,0,0
13905,8,2015-10-31,washington-state,,Stanford,L (28-30),35,63,55.6,354,2,23,88,3.8,0,86,442,5.1,19,5,2,26,4,30,0,2,2
13906,9,2015-11-07,washington-state,,Arizona State,W (38-24),36,55,65.5,497,5,17,15,0.9,0,72,512,7.1,18,3,0,21,2,20,0,1,1
13907,10,2015-11-14,washington-state,@,UCLA,W (31-27),40,58,69.0,388,3,22,38,1.7,1,80,426,5.3,18,5,3,26,9,45,0,1,1
13908,11,2015-11-21,washington-state,,Colorado,W (27-3),40,57,70.2,332,2,21,149,7.1,1,78,481,6.2,21,7,2,30,6,40,0,1,1
13909,12,2015-11-27,washington-state,@,Washington,L (10-45),36,58,62.1,288,1,12,31,2.6,0,70,319,4.6,16,1,2,19,4,28,5,2,7
13910,13,2015-12-26,washington-state,N,Miami (FL)*,W (20-14),29,53,54.7,295,2,25,87,3.5,0,78,382,4.9,12,7,4,23,5,63,1,0,1
13911,,13 Games,washington-state,,,,500,738,67.8,5059,41,294,1046,3.6,8,1032,6105,5.9,235,76,19,330,69,520,13,12,25
13912,1,2016-09-03,washington-state,,Eastern Washington,L (42-45),41,52,78.8,418,4,25,97,3.9,2,77,515,6.7,23,5,4,32,12,101,0,1,1
13913,2,2016-09-10,washington-state,@,Boise State,L (28-31),55,71,77.5,480,4,20,40,2.0,0,91,520,5.7,21,4,1,26,10,79,0,1,1
13914,3,2016-09-17,washington-state,,Idaho,W (56-6),27,44,61.4,281,3,35,228,6.5,3,79,509,6.4,12,12,2,26,11,108,0,1,1
13915,4,2016-10-01,washington-state,,Oregon,W (51-33),36,48,75.0,371,1,40,280,7.0,6,88,651,7.4,23,12,1,36,5,37,0,0,0
13916,5,2016-10-08,washington-state,@,Stanford,W (42-16),30,41,73.2,357,4,30,101,3.4,2,71,458,6.5,15,5,1,21,10,81,0,2,2
13917,6,2016-10-15,washington-state,,UCLA,W (27-21),28,48,58.3,261,0,35,95,2.7,3,83,356,4.3,15,6,4,25,8,60,1,1,2
13918,7,2016-10-22,washington-state,@,Arizona State,W (37-32),42,53,79.2,398,3,17,-38,-2.2,1,70,360,5.1,21,1,2,24,3,25,0,0,0
13919,8,2016-10-29,washington-state,@,Oregon State,W (35-31),33,46,71.7,415,5,26,137,5.3,0,72,552,7.7,17,7,3,27,6,65,2,0,2
13920,9,2016-11-05,washington-state,,Arizona,W (69-7),47,52,90.4,474,6,32,140,4.4,3,84,614,7.3,22,7,5,34,9,85,0,0,0
13921,10,2016-11-12,washington-state,,California,W (56-21),39,55,70.9,400,5,31,254,8.2,2,86,654,7.6,18,13,3,34,12,120,0,1,1
13922,11,2016-11-19,washington-state,@,Colorado,L (24-38),26,53,49.1,325,3,22,137,6.2,0,75,462,6.2,14,5,2,21,5,35,1,1,2
13923,12,2016-11-25,washington-state,,Washington,L (17-45),33,50,66.0,269,1,24,65,2.7,1,74,334,4.5,13,3,2,18,5,44,1,3,4
13924,13,2016-12-27,washington-state,N,Minnesota*,L (12-17),30,51,58.8,264,1,23,39,1.7,0,74,303,4.1,11,4,1,16,7,56,0,1,1
13925,,13 Games,washington-state,,,,467,664,70.3,4713,40,360,1575,4.4,23,1024,6288,6.1,225,84,31,340,103,896,5,12,17
13926,1,2017-09-02,washington-state,,Montana State,W (31-0),40,48,83.3,361,3,25,150,6.0,1,73,511,7.0,18,9,0,27,4,32,1,0,1
13927,2,2017-09-09,washington-state,,Boise State,W (47-44),49,67,73.1,433,3,27,22,0.8,1,94,455,4.8,22,3,0,25,5,55,1,2,3
13928,3,2017-09-16,washington-state,,Oregon State,W (52-23),42,58,72.4,431,6,16,60,3.8,0,74,491,6.6,23,2,2,27,7,50,0,0,0
13929,4,2017-09-23,washington-state,,Nevada,W (45-7),38,50,76.0,505,5,34,55,1.6,1,84,560,6.7,20,8,3,31,5,55,1,1,2
13930,5,2017-09-29,washington-state,,Southern California,W (30-27),34,51,66.7,340,2,30,122,4.1,1,81,462,5.7,13,7,3,23,6,59,0,1,1
13931,6,2017-10-07,washington-state,@,Oregon,W (33-10),24,42,57.1,282,3,25,87,3.5,0,67,369,5.5,10,4,6,19,6,74,2,0,2
13932,7,2017-10-13,washington-state,@,California,L (3-37),32,48,66.7,314,0,26,23,0.9,0,74,337,4.6,10,3,1,16,5,50,2,5,7
13933,8,2017-10-21,washington-state,,Colorado,W (28-0),20,43,46.5,212,3,35,194,5.5,1,78,406,5.2,10,10,1,21,6,70,2,0,2
13934,9,2017-10-28,washington-state,@,Arizona,L (37-58),58,84,69.0,602,3,17,44,2.6,2,101,646,6.4,28,3,1,32,7,50,0,4,4
13935,10,2017-11-04,washington-state,,Stanford,W (24-21),34,48,70.8,337,3,29,93,3.2,0,77,430,5.6,17,7,1,25,4,25,0,1,1
13936,11,2017-11-11,washington-state,@,Utah,W (33-25),40,69,58.0,311,3,17,27,1.6,0,86,338,3.9,15,3,2,20,10,66,0,2,2
13937,12,2017-11-25,washington-state,@,Washington,L (14-41),37,55,67.3,369,1,14,-24,-1.7,1,69,345,5.0,18,1,0,19,4,34,1,3,4
13938,13,2017-12-28,washington-state,N,Michigan State*,L (17-42),39,50,78.0,272,2,8,24,3.0,0,58,296,5.1,13,2,2,17,4,46,1,1,2
13939,,13 Games,washington-state,,,,487,713,68.3,4769,37,303,877,2.9,8,1016,5646,5.6,217,62,22,302,73,666,11,20,31
13940,1,2018-09-01,washington-state,@,Wyoming,W (41-19),38,57,66.7,319,3,21,75,3.6,2,78,394,5.1,15,5,4,24,10,75,1,1,2
13941,2,2018-09-08,washington-state,,San Jose State,W (31-0),35,54,64.8,420,3,31,124,4.0,1,85,544,6.4,14,7,2,27,8,60,0,3,3
13942,3,2018-09-15,washington-state,,Eastern Washington,W (59-24),51,65,78.5,524,3,15,41,2.7,4,80,565,7.1,32,1,2,35,7,87,0,0,0
13943,4,2018-09-21,washington-state,@,Southern California,L (36-39),37,52,71.2,344,3,24,91,3.8,2,76,435,5.7,19,4,1,24,11,118,0,0,0
13944,5,2018-09-29,washington-state,,Utah,W (28-24),31,56,55.4,445,3,10,13,1.3,1,66,458,6.9,16,1,4,21,9,104,0,1,1
13945,6,2018-10-06,washington-state,@,Oregon State,W (56-37),30,40,75.0,430,5,22,100,4.5,2,62,530,8.5,18,6,0,24,5,46,1,0,1
13946,7,2018-10-20,washington-state,,Oregon,W (34-20),39,51,76.5,323,4,24,77,3.2,1,75,400,5.3,19,5,1,25,5,55,0,2,2
13947,8,2018-10-27,washington-state,@,Stanford,W (41-38),40,50,80.0,438,3,19,59,3.1,2,69,497,7.2,19,4,1,24,9,89,0,0,0
13948,9,2018-11-03,washington-state,,California,W (19-13),35,51,68.6,334,1,15,79,5.3,1,66,413,6.3,19,4,0,23,7,80,1,1,2
13949,10,2018-11-10,washington-state,@,Colorado,W (31-7),37,61,60.7,346,2,33,131,4.0,2,94,477,5.1,17,7,2,26,2,10,0,0,0
13950,11,2018-11-17,washington-state,,Arizona,W (69-28),44,56,78.6,482,7,23,123,5.3,2,79,605,7.7,20,6,5,31,3,35,0,0,0
13951,,11 Games,washington-state,,,,417,593,70.3,4405,37,237,913,3.9,20,830,5318,6.4,208,50,22,284,76,759,3,8,11
13952,1,2014-08-30,oregon-state,,Portland State,W (29-14),26,45,57.8,328,1,37,177,4.8,1,82,505,6.2,16,8,1,25,13,119,1,0,1
13953,2,2014-09-06,oregon-state,@,Hawaii,W (38-30),26,37,70.3,300,3,36,164,4.6,2,73,464,6.4,10,7,5,22,13,99,1,1,2
13954,3,2014-09-20,oregon-state,,San Diego State,W (28-7),24,31,77.4,275,0,36,97,2.7,4,67,372,5.6,12,8,5,25,7,52,1,1,2
13955,4,2014-09-27,oregon-state,@,Southern California,L (10-35),15,35,42.9,123,0,21,58,2.8,0,56,181,3.2,4,6,7,17,13,108,0,2,2
13956,5,2014-10-04,oregon-state,@,Colorado,W (36-31),27,37,73.0,278,1,32,167,5.2,3,69,445,6.4,13,7,2,22,5,42,0,0,0
13957,6,2014-10-16,oregon-state,,Utah,L (23-29),21,37,56.8,272,2,46,118,2.6,0,83,390,4.7,9,9,3,21,9,75,1,1,2
13958,7,2014-10-25,oregon-state,@,Stanford,L (14-38),18,38,47.4,209,0,29,12,0.4,2,67,221,3.3,9,3,0,12,8,67,0,0,0
13959,8,2014-11-01,oregon-state,,California,L (31-45),30,45,66.7,320,2,23,148,6.4,2,68,468,6.9,17,6,2,25,8,90,0,1,1
13960,9,2014-11-08,oregon-state,,Washington State,L (32-39),31,41,75.6,419,1,24,37,1.5,2,65,456,7.0,15,6,2,23,10,100,0,0,0
13961,10,2014-11-15,oregon-state,,Arizona State,W (35-27),19,33,57.6,251,2,37,247,6.7,2,70,498,7.1,9,8,2,19,9,76,1,1,2
13962,11,2014-11-22,oregon-state,@,Washington,L (13-37),30,46,65.2,314,2,23,47,2.0,0,69,361,5.2,12,3,2,17,5,55,0,1,1
13963,12,2014-11-29,oregon-state,,Oregon,L (19-47),23,47,48.9,216,1,32,146,4.6,1,79,362,4.6,12,7,2,21,7,75,1,0,1
13964,,12 Games,oregon-state,,,,290,472,61.4,3305,15,376,1418,3.8,19,848,4723,5.6,138,78,33,249,107,958,6,8,14
13965,1,2015-09-04,oregon-state,,Weber State,W (26-7),12,22,54.5,110,2,56,281,5.0,0,78,391,5.0,5,13,4,22,7,67,0,1,1
13966,2,2015-09-12,oregon-state,@,Michigan,L (7-35),9,20,45.0,79,1,33,59,1.8,0,53,138,2.6,5,4,3,12,8,62,1,0,1
13967,3,2015-09-19,oregon-state,,San Jose State,W (35-21),13,25,52.0,135,1,46,303,6.6,3,71,438,6.2,9,14,1,24,4,35,1,1,2
13968,4,2015-09-25,oregon-state,,Stanford,L (24-42),20,36,55.6,275,1,36,111,3.1,2,72,386,5.4,13,7,0,20,6,65,1,0,1
13969,5,2015-10-10,oregon-state,@,Arizona,L (7-44),12,35,34.3,98,0,31,151,4.9,1,66,249,3.8,5,8,2,15,5,59,0,1,1
13970,6,2015-10-17,oregon-state,@,Washington State,L (31-52),17,30,56.7,176,1,45,218,4.8,2,75,394,5.3,10,11,0,21,11,86,0,2,2
13971,7,2015-10-24,oregon-state,,Colorado,L (13-17),13,32,40.6,199,0,41,202,4.9,1,73,401,5.5,7,9,1,17,8,65,0,1,1
13972,8,2015-10-31,oregon-state,@,Utah,L (12-27),19,35,54.3,204,1,30,108,3.6,0,65,312,4.8,9,5,2,16,5,40,0,0,0
13973,9,2015-11-07,oregon-state,,UCLA,L (0-41),10,24,41.7,131,0,33,115,3.5,0,57,246,4.3,4,6,2,12,5,45,1,3,4
13974,10,2015-11-14,oregon-state,@,California,L (24-54),15,36,41.7,194,2,34,204,6.0,1,70,398,5.7,10,8,3,21,7,70,0,0,0
13975,11,2015-11-21,oregon-state,,Washington,L (7-52),8,23,34.8,109,1,23,148,6.4,0,46,257,5.6,4,3,1,8,3,30,1,1,2
13976,12,2015-11-27,oregon-state,@,Oregon,L (42-52),13,25,52.0,199,0,38,228,6.0,5,63,427,6.8,8,12,3,23,7,80,0,1,1
13977,,12 Games,oregon-state,,,,161,343,46.9,1909,10,446,2128,4.8,15,789,4037,5.1,89,100,22,211,76,704,5,11,16
13978,1,2016-09-01,oregon-state,@,Minnesota,L (23-30),25,40,62.5,228,3,34,89,2.6,0,74,317,4.3,11,4,3,18,4,55,2,0,2
13979,2,2016-09-17,oregon-state,,Idaho State,W (37-7),15,30,50.0,172,0,41,246,6.0,3,71,418,5.9,7,8,2,17,9,95,0,1,1
13980,3,2016-09-24,oregon-state,,Boise State,L (24-38),22,34,64.7,191,0,35,96,2.7,2,69,287,4.2,8,7,2,17,7,50,1,0,1
13981,4,2016-10-01,oregon-state,@,Colorado,L (6-47),13,32,40.6,100,0,34,126,3.7,0,66,226,3.4,6,7,1,14,5,31,0,2,2
13982,5,2016-10-08,oregon-state,,California,W (47-44),13,24,54.2,85,0,50,474,9.5,6,74,559,7.6,6,19,2,27,10,81,0,2,2
13983,6,2016-10-15,oregon-state,,Utah,L (14-19),9,30,30.0,100,1,35,197,5.6,1,65,297,4.6,4,10,1,15,9,65,1,1,2
13984,7,2016-10-22,oregon-state,@,Washington,L (17-41),12,27,44.4,148,0,30,177,5.9,2,57,325,5.7,8,6,1,15,6,40,0,2,2
13985,8,2016-10-29,oregon-state,,Washington State,L (31-35),23,39,59.0,327,2,28,171,6.1,2,67,498,7.4,12,6,2,20,13,110,0,0,0
13986,9,2016-11-05,oregon-state,@,Stanford,L (15-26),10,24,41.7,137,1,22,129,5.9,1,46,266,5.8,3,3,2,8,9,102,0,2,2
13987,10,2016-11-12,oregon-state,@,UCLA,L (24-38),22,34,64.7,232,0,34,75,2.2,2,68,307,4.5,9,5,2,16,12,119,2,1,3
13988,11,2016-11-19,oregon-state,,Arizona,W (42-17),16,19,84.2,265,5,46,210,4.6,1,65,475,7.3,11,14,1,26,5,49,1,0,1
13989,12,2016-11-26,oregon-state,,Oregon,W (34-24),13,20,65.0,101,1,51,316,6.2,4,71,417,5.9,5,20,0,25,7,65,1,0,1
13990,,12 Games,oregon-state,,,,193,353,54.7,2086,13,440,2306,5.2,24,793,4392,5.5,90,109,19,218,96,862,8,11,19
13991,1,2017-08-26,oregon-state,@,Colorado State,L (27-58),27,47,57.4,304,2,29,152,5.2,1,76,456,6.0,17,6,0,23,3,21,2,3,5
13992,2,2017-09-02,oregon-state,,Portland State,W (35-32),18,25,72.0,235,1,32,154,4.8,3,57,389,6.8,11,5,2,18,5,52,1,1,2
13993,3,2017-09-09,oregon-state,,Minnesota,L (14-48),17,29,58.6,145,1,26,80,3.1,1,55,225,4.1,6,6,2,14,7,91,3,0,3
13994,4,2017-09-16,oregon-state,@,Washington State,L (23-52),24,37,64.9,199,1,33,155,4.7,2,70,354,5.1,9,10,2,21,8,80,2,0,2
13995,5,2017-09-30,oregon-state,,Washington,L (7-42),11,22,50.0,74,0,28,110,3.9,1,50,184,3.7,2,6,0,8,8,86,2,0,2
13996,6,2017-10-07,oregon-state,@,Southern California,L (10-38),16,29,55.2,197,0,36,122,3.4,1,65,319,4.9,7,8,1,16,7,69,2,1,3
13997,7,2017-10-14,oregon-state,,Colorado,L (33-36),20,37,54.1,289,0,46,280,6.1,3,83,569,6.9,14,16,0,30,9,79,0,1,1
13998,8,2017-10-26,oregon-state,,Stanford,L (14-15),13,22,59.1,126,0,41,138,3.4,2,63,264,4.2,7,9,4,20,6,47,2,1,3
13999,9,2017-11-04,oregon-state,@,California,L (23-37),14,26,53.8,195,1,31,104,3.4,1,57,299,5.2,6,10,2,18,9,99,0,0,0
14000,10,2017-11-11,oregon-state,@,Arizona,L (28-49),16,28,57.1,209,4,40,151,3.8,0,68,360,5.3,10,10,2,22,5,39,0,1,1
14001,11,2017-11-18,oregon-state,,Arizona State,L (24-40),26,37,70.3,269,0,33,106,3.2,3,70,375,5.4,14,4,5,23,8,67,1,2,3
14002,12,2017-11-25,oregon-state,@,Oregon,L (10-69),12,23,52.2,113,1,36,98,2.7,0,59,211,3.6,3,5,7,15,9,86,1,2,3
14003,,12 Games,oregon-state,,,,214,362,59.1,2355,11,411,1650,4.0,18,773,4005,5.2,106,95,27,228,84,816,16,12,28
14004,1,2018-09-01,oregon-state,@,Ohio State,L (31-77),14,24,58.3,196,2,39,196,5.0,2,63,392,6.2,7,6,2,15,5,49,2,0,2
14005,2,2018-09-08,oregon-state,,Southern Utah,W (48-25),19,31,61.3,289,1,45,360,8.0,5,76,649,8.5,13,14,0,27,5,70,1,0,1
14006,3,2018-09-15,oregon-state,@,Nevada,L (35-37),35,56,62.5,459,2,40,81,2.0,3,96,540,5.6,17,9,2,28,7,60,1,2,3
14007,4,2018-09-22,oregon-state,,Arizona,L (14-35),18,26,69.2,141,2,44,97,2.2,0,70,238,3.4,7,9,2,18,5,50,0,0,0
14008,5,2018-09-29,oregon-state,@,Arizona State,L (24-52),14,24,58.3,145,1,53,261,4.9,2,77,406,5.3,7,17,0,24,5,50,1,0,1
14009,6,2018-10-06,oregon-state,,Washington State,L (37-56),18,26,69.2,221,0,50,276,5.5,5,76,497,6.5,10,11,1,22,11,104,1,0,1
14010,7,2018-10-20,oregon-state,,California,L (7-49),17,33,51.5,146,0,41,95,2.3,1,74,241,3.3,7,8,3,18,5,43,0,2,2
14011,8,2018-10-27,oregon-state,@,Colorado,W (41-34),34,54,63.0,345,3,45,114,2.5,2,99,459,4.6,20,5,3,28,7,62,0,1,1
14012,9,2018-11-03,oregon-state,,Southern California,L (21-38),31,46,67.4,301,1,32,31,1.0,2,78,332,4.3,17,5,2,24,4,28,0,0,0
14013,10,2018-11-10,oregon-state,@,Stanford,L (17-48),17,35,48.6,236,2,33,168,5.1,0,68,404,5.9,8,9,1,18,6,34,0,1,1
14014,11,2018-11-17,oregon-state,@,Washington,L (23-42),21,36,58.3,229,1,35,134,3.8,1,71,363,5.1,12,8,0,20,3,25,2,0,2
14015,,11 Games,oregon-state,,,,238,391,60.9,2708,15,457,1813,4.0,23,848,4521,5.3,125,101,16,242,63,575,8,6,14
14016,1,2014-08-29,colorado,N,Colorado State,L (17-31),24,39,61.5,241,2,34,134,3.9,0,73,375,5.1,11,8,3,22,6,65,0,0,0
14017,2,2014-09-06,colorado,N,Massachusetts,W (41-38),26,42,61.9,318,3,47,156,3.3,2,89,474,5.3,15,9,5,29,12,124,0,1,1
14018,3,2014-09-13,colorado,,Arizona State,L (24-38),35,54,64.8,313,3,37,232,6.3,0,91,545,6.0,17,8,3,28,8,75,1,2,3
14019,4,2014-09-20,colorado,,Hawaii,W (21-12),29,45,64.4,287,2,36,118,3.3,1,81,405,5.0,15,4,1,20,9,83,0,2,2
14020,5,2014-09-27,colorado,@,California,L (56-59),46,67,68.7,449,7,43,180,4.2,1,110,629,5.7,26,8,5,39,9,75,0,1,1
14021,6,2014-10-04,colorado,,Oregon State,L (31-36),32,49,65.3,308,2,28,123,4.4,2,77,431,5.6,14,9,2,25,6,67,0,1,1
14022,7,2014-10-18,colorado,@,Southern California,L (28-56),31,49,63.3,231,2,46,172,3.7,2,95,403,4.2,12,11,4,27,7,61,0,2,2
14023,8,2014-10-25,colorado,,UCLA,L (37-40),28,46,60.9,267,2,45,233,5.2,2,91,500,5.5,11,15,5,31,6,50,0,2,2
14024,9,2014-11-01,colorado,,Washington,L (23-38),36,52,69.2,314,2,37,181,4.9,0,89,495,5.6,14,10,0,24,5,39,3,1,4
14025,10,2014-11-08,colorado,@,Arizona,L (20-38),25,39,64.1,259,2,36,94,2.6,0,75,353,4.7,9,8,2,19,10,103,2,2,4
14026,11,2014-11-22,colorado,@,Oregon,L (10-44),16,32,50.0,105,1,30,121,4.0,0,62,226,3.6,5,5,4,14,4,36,0,0,0
14027,12,2014-11-29,colorado,,Utah,L (34-38),20,31,64.5,317,1,32,116,3.6,3,63,433,6.9,10,6,2,18,4,35,0,1,1
14028,,12 Games,colorado,,,,348,545,63.9,3409,29,451,1860,4.1,13,996,5269,5.3,159,101,36,296,86,813,6,15,21
14029,1,2015-09-03,colorado,@,Hawaii,L (20-28),23,40,57.5,156,0,53,215,4.1,2,93,371,4.0,8,14,1,23,5,70,2,1,3
14030,2,2015-09-12,colorado,,Massachusetts,W (48-14),15,24,62.5,168,1,59,390,6.6,5,83,558,6.7,8,22,2,32,7,65,0,0,0
14031,3,2015-09-19,colorado,N,Colorado State,W (27-24),15,29,51.7,220,2,32,125,3.9,0,61,345,5.7,9,6,3,18,6,65,0,0,0
14032,4,2015-09-26,colorado,,Nicholls State,W (48-0),18,31,58.1,278,1,62,358,5.8,5,93,636,6.8,14,16,3,33,4,30,1,0,1
14033,5,2015-10-03,colorado,,Oregon,L (24-41),25,42,59.5,231,1,36,77,2.1,2,78,308,3.9,13,5,0,18,6,41,2,1,3
14034,6,2015-10-10,colorado,@,Arizona State,L (23-48),26,41,63.4,401,1,28,49,1.8,2,69,450,6.5,13,5,1,19,9,88,1,1,2
14035,7,2015-10-17,colorado,,Arizona,L (31-38),28,44,63.6,339,2,43,128,3.0,2,87,467,5.4,15,6,1,22,9,65,1,0,1
14036,8,2015-10-24,colorado,@,Oregon State,W (17-13),16,23,69.6,140,1,45,188,4.2,1,68,328,4.8,8,11,1,20,9,80,0,0,0
14037,9,2015-10-31,colorado,@,UCLA,L (31-35),37,58,63.8,312,0,56,242,4.3,2,114,554,4.9,14,18,2,34,7,68,0,2,2
14038,10,2015-11-07,colorado,,Stanford,L (10-42),13,23,56.5,148,0,30,83,2.8,1,53,231,4.4,7,7,1,15,3,21,0,2,2
14039,11,2015-11-13,colorado,,Southern California,L (24-27),24,31,77.4,222,2,36,59,1.6,1,67,281,4.2,12,7,2,21,5,39,1,0,1
14040,12,2015-11-21,colorado,@,Washington State,L (3-27),26,41,63.4,238,0,30,85,2.8,0,71,323,4.5,12,4,1,17,7,61,0,2,2
14041,13,2015-11-28,colorado,@,Utah,L (14-20),19,38,50.0,258,2,33,49,1.5,0,71,307,4.3,11,5,3,19,3,31,1,3,4
14042,,13 Games,colorado,,,,285,465,61.3,3111,13,543,2048,3.8,23,1008,5159,5.1,144,126,21,291,80,724,9,12,21
14043,1,2016-09-02,colorado,N,Colorado State,W (44-7),23,33,69.7,318,1,56,260,4.6,3,89,578,6.5,12,15,1,28,4,35,2,0,2
14044,2,2016-09-10,colorado,,Idaho State,W (56-7),22,31,71.0,335,4,57,262,4.6,4,88,597,6.8,13,15,4,32,5,37,1,0,1
14045,3,2016-09-17,colorado,@,Michigan,L (28-45),18,34,52.9,261,3,33,64,1.9,0,67,325,4.9,8,5,2,15,7,46,0,0,0
14046,4,2016-09-24,colorado,@,Oregon,W (41-38),23,32,71.9,333,3,52,260,5.0,2,84,593,7.1,15,14,3,32,5,47,0,2,2
14047,5,2016-10-01,colorado,,Oregon State,W (47-6),21,30,70.0,316,3,54,247,4.6,2,84,563,6.7,13,13,0,26,5,55,0,0,0
14048,6,2016-10-08,colorado,@,Southern California,L (17-21),28,44,63.6,275,2,29,96,3.3,0,73,371,5.1,15,4,1,20,5,26,0,1,1
14049,7,2016-10-15,colorado,,Arizona State,W (40-16),23,32,71.9,265,0,52,315,6.1,5,84,580,6.9,9,18,0,27,3,20,2,0,2
14050,8,2016-10-22,colorado,@,Stanford,W (10-5),12,25,48.0,135,1,44,241,5.5,0,69,376,5.4,7,15,1,23,6,60,0,0,0
14051,9,2016-11-03,colorado,,UCLA,W (20-10),20,33,60.6,160,0,52,144,2.8,1,85,304,3.6,10,8,6,24,12,128,1,3,4
14052,10,2016-11-12,colorado,@,Arizona,W (49-24),19,27,70.4,213,3,46,175,3.8,4,73,388,5.3,8,11,6,25,7,62,0,1,1
14053,11,2016-11-19,colorado,,Washington State,W (38-24),27,41,65.9,345,0,59,258,4.4,5,100,603,6.0,15,15,1,31,9,75,1,0,1
14054,12,2016-11-26,colorado,,Utah,W (27-22),23,44,52.3,270,1,38,108,2.8,1,82,378,4.6,10,6,2,18,0,0,2,0,2
14055,13,2016-12-02,colorado,N,Washington,L (10-41),8,25,32.0,81,0,29,82,2.8,1,54,163,3.0,3,4,2,9,3,35,0,3,3
14056,14,2016-12-29,colorado,N,Oklahoma State*,L (8-38),22,38,57.9,256,0,29,62,2.1,1,67,318,4.7,11,6,1,18,5,35,0,1,1
14057,,14 Games,colorado,,,,289,469,61.6,3563,21,630,2574,4.1,29,1099,6137,5.6,149,149,30,328,76,661,9,11,20
14058,1,2017-09-01,colorado,N,Colorado State,W (17-3),21,29,72.4,202,1,36,145,4.0,1,65,347,5.3,9,7,3,19,7,59,0,2,2
14059,2,2017-09-09,colorado,,Texas State,W (37-3),23,36,63.9,339,1,39,94,2.4,2,75,433,5.8,14,6,1,21,5,35,0,0,0
14060,3,2017-09-16,colorado,,Northern Colorado,W (41-21),29,41,70.7,357,4,39,212,5.4,1,80,569,7.1,16,12,2,30,14,114,2,1,3
14061,4,2017-09-23,colorado,,Washington,L (10-37),22,30,73.3,191,0,42,131,3.1,1,72,322,4.5,9,11,0,20,3,35,0,3,3
14062,5,2017-09-30,colorado,@,UCLA,L (23-27),17,38,44.7,243,1,38,191,5.0,1,76,434,5.7,10,9,5,24,6,53,0,0,0
14063,6,2017-10-07,colorado,,Arizona,L (42-45),19,32,59.4,251,3,58,300,5.2,3,90,551,6.1,11,18,0,29,12,110,0,0,0
14064,7,2017-10-14,colorado,@,Oregon State,W (36-33),15,25,60.0,179,3,41,206,5.0,2,66,385,5.8,9,13,3,25,3,14,0,0,0
14065,8,2017-10-21,colorado,@,Washington State,L (0-28),13,34,38.2,94,0,40,80,2.0,0,74,174,2.4,3,8,2,13,5,45,1,0,1
14066,9,2017-10-28,colorado,,California,W (44-28),21,27,77.8,353,3,53,200,3.8,1,80,553,6.9,10,16,1,27,7,58,1,0,1
14067,10,2017-11-04,colorado,@,Arizona State,L (30-41),23,41,56.1,345,1,39,109,2.8,2,80,454,5.7,15,8,0,23,3,25,0,1,1
14068,11,2017-11-11,colorado,,Southern California,L (24-38),27,49,55.1,376,2,34,110,3.2,1,83,486,5.9,15,7,1,23,4,45,0,2,2
14069,12,2017-11-25,colorado,@,Utah,L (13-34),14,28,50.0,195,0,35,124,3.5,2,63,319,5.1,7,9,1,17,6,75,1,0,1
14070,,12 Games,colorado,,,,244,410,59.5,3125,19,494,1902,3.9,17,904,5027,5.6,128,124,19,271,75,668,5,9,14
14071,1,2018-08-31,colorado,N,Colorado State,W (45-13),22,25,88.0,338,4,40,258,6.5,2,65,596,9.2,11,12,0,23,6,44,1,1,2
14072,2,2018-09-08,colorado,@,Nebraska,W (33-28),33,50,66.0,351,3,35,44,1.3,1,85,395,4.6,16,7,3,26,8,46,0,0,0
14073,3,2018-09-15,colorado,,New Hampshire,W (45-14),17,24,70.8,180,1,51,311,6.1,4,75,491,6.5,9,12,0,21,6,60,0,2,2
14074,4,2018-09-28,colorado,,UCLA,W (38-16),23,27,85.2,268,1,48,209,4.4,4,75,477,6.4,12,11,3,26,6,60,0,0,0
14075,5,2018-10-06,colorado,,Arizona State,W (28-21),24,33,72.7,328,2,45,166,3.7,2,78,494,6.3,12,12,1,25,6,60,0,0,0
14076,6,2018-10-13,colorado,@,Southern California,L (20-31),26,47,55.3,170,0,37,95,2.6,3,84,265,3.2,7,6,4,17,8,81,0,1,1
14077,7,2018-10-20,colorado,@,Washington,L (13-27),17,28,60.7,144,1,35,119,3.4,0,63,263,4.2,8,6,1,15,4,48,0,1,1
14078,8,2018-10-27,colorado,,Oregon State,L (34-41),24,39,61.5,319,2,36,217,6.0,1,75,536,7.1,13,8,2,23,7,70,0,0,0
14079,9,2018-11-02,colorado,@,Arizona,L (34-42),27,43,62.8,343,3,32,40,1.3,1,75,383,5.1,18,3,6,27,5,52,1,1,2
14080,10,2018-11-10,colorado,,Washington State,L (7-31),21,38,55.3,222,0,16,75,4.7,1,54,297,5.5,10,2,0,12,4,51,2,1,3
14081,11,2018-11-17,colorado,,Utah,L (7-30),21,33,63.6,162,0,34,34,1.0,1,67,196,2.9,8,3,3,14,4,38,1,2,3
14082,,11 Games,colorado,,,,255,387,65.9,2825,17,409,1568,3.8,20,796,4393,5.5,124,82,23,229,64,610,5,9,14
14083,1,2014-09-06,idaho,@,Louisiana-Monroe,L (31-38),26,47,55.3,324,3,36,118,3.3,1,83,442,5.3,15,8,2,25,12,119,1,2,3
14084,2,2014-09-13,idaho,,Western Michigan,L (33-45),27,41,65.9,362,3,31,45,1.5,1,72,407,5.7,14,4,5,23,8,79,0,1,1
14085,3,2014-09-20,idaho,@,Ohio,L (24-36),33,56,58.9,353,2,28,64,2.3,1,84,417,5.0,15,7,1,23,4,32,0,3,3
14086,4,2014-09-27,idaho,,South Alabama,L (10-34),25,40,62.5,239,1,33,30,0.9,0,73,269,3.7,10,4,4,18,7,59,0,2,2
14087,5,2014-10-04,idaho,@,Texas State,L (30-35),33,52,63.5,347,0,53,176,3.3,4,105,523,5.0,18,13,2,33,4,35,0,2,2
14088,6,2014-10-11,idaho,@,Georgia Southern,L (24-47),20,32,62.5,271,0,40,94,2.4,3,72,365,5.1,11,6,0,17,3,23,0,1,1
14089,7,2014-10-18,idaho,,New Mexico State,W (29-17),23,37,62.2,226,1,52,310,6.0,2,89,536,6.0,11,17,2,30,6,57,1,1,2
14090,8,2014-11-01,idaho,,Arkansas State,L (28-44),17,31,54.8,206,0,46,243,5.3,4,77,449,5.8,11,12,2,25,9,93,4,4,8
14091,9,2014-11-08,idaho,@,San Diego State,L (21-35),17,33,51.5,186,1,49,193,3.9,2,82,379,4.6,9,13,4,26,4,30,1,0,1
14092,10,2014-11-15,idaho,,Troy,L (17-34),14,36,38.9,269,1,27,117,4.3,1,63,386,6.1,8,8,3,19,5,40,0,3,3
14093,11,2014-11-29,idaho,@,Appalachian State,L (28-45),21,37,56.8,208,1,42,157,3.7,3,79,365,4.6,11,6,1,18,12,145,0,1,1
14094,,11 Games,idaho,,,,256,442,57.9,2991,13,437,1547,3.5,22,879,4538,5.2,133,98,26,257,74,712,7,20,27
14095,1,2015-09-03,idaho,,Ohio,L (28-45),36,48,75.0,297,1,28,100,3.6,2,76,397,5.2,18,4,3,25,3,31,1,2,3
14096,2,2015-09-12,idaho,@,Southern California,L (9-59),28,45,62.2,240,1,32,71,2.2,0,77,311,4.0,12,6,1,19,2,23,0,0,0
14097,3,2015-09-19,idaho,,Wofford,W (41-38),25,34,73.5,334,1,43,198,4.6,3,77,532,6.9,11,11,0,22,6,75,0,2,2
14098,4,2015-09-26,idaho,,Georgia Southern,L (20-44),20,36,55.6,284,2,34,111,3.3,0,70,395,5.6,10,8,2,20,2,15,0,2,2
14099,5,2015-10-03,idaho,@,Arkansas State,L (35-49),24,42,57.1,166,0,29,172,5.9,4,71,338,4.8,6,6,7,19,11,105,0,3,3
14100,6,2015-10-17,idaho,@,Troy,W (19-16),20,37,54.1,207,0,37,123,3.3,1,74,330,4.5,11,6,3,20,6,59,0,0,0
14101,7,2015-10-24,idaho,,Louisiana-Monroe,W (27-13),23,39,59.0,315,3,52,174,3.3,0,91,489,5.4,15,12,1,28,5,65,2,1,3
14102,8,2015-10-31,idaho,@,New Mexico State,L (48-55),25,42,59.5,307,2,50,262,5.2,3,92,569,6.2,14,14,2,30,4,30,0,2,2
14103,9,2015-11-07,idaho,@,South Alabama,L (45-52),26,39,66.7,317,2,45,177,3.9,4,84,494,5.9,15,9,3,27,3,24,2,1,3
14104,10,2015-11-14,idaho,,Appalachian State,L (20-47),20,32,62.5,243,2,28,56,2.0,0,60,299,5.0,11,5,1,17,5,44,0,0,0
14105,11,2015-11-21,idaho,@,Auburn,L (34-56),29,48,60.4,356,1,37,123,3.3,3,85,479,5.6,11,10,5,26,4,38,1,2,3
14106,12,2015-11-28,idaho,,Texas State,W (38-31),21,31,67.7,309,2,43,199,4.6,3,74,508,6.9,12,10,1,23,3,15,2,0,2
14107,,12 Games,idaho,,,,297,473,62.8,3375,17,458,1766,3.9,23,931,5141,5.5,146,101,29,276,54,524,8,15,23
14108,1,2016-09-01,idaho,,Montana State,W (20-17),8,22,36.4,128,0,35,225,6.4,2,57,353,6.2,6,9,0,15,5,85,1,1,2
14109,2,2016-09-10,idaho,@,Washington,L (14-59),23,38,60.5,218,1,38,104,2.7,1,76,322,4.2,9,8,0,17,4,35,2,1,3
14110,3,2016-09-17,idaho,@,Washington State,L (6-56),20,37,54.1,179,0,31,78,2.5,0,68,257,3.8,10,2,3,15,6,80,2,0,2
14111,4,2016-09-24,idaho,@,Nevada-Las Vegas,W (33-30),17,35,48.6,249,1,36,129,3.6,2,71,378,5.3,11,7,3,21,5,40,1,0,1
14112,5,2016-10-01,idaho,,Troy,L (13-34),19,34,55.9,166,1,36,89,2.5,0,70,255,3.6,10,7,2,19,4,40,0,2,2
14113,6,2016-10-08,idaho,@,Louisiana-Monroe,W (34-31),21,38,55.3,211,1,33,203,6.2,1,71,414,5.8,10,7,1,18,7,61,0,0,0
14114,7,2016-10-15,idaho,,New Mexico State,W (55-23),31,39,79.5,482,4,42,169,4.0,3,81,651,8.0,24,7,3,34,5,40,0,1,1
14115,8,2016-10-22,idaho,@,Appalachian State,L (19-37),26,41,63.4,294,1,26,63,2.4,0,67,357,5.3,16,5,3,24,3,37,0,3,3
14116,9,2016-11-05,idaho,@,Louisiana,W (23-13),20,30,66.7,227,0,40,157,3.9,2,70,384,5.5,14,7,1,22,4,45,0,0,0
14117,10,2016-11-12,idaho,@,Texas State,W (47-14),26,33,78.8,336,1,40,154,3.9,5,73,490,6.7,14,7,2,23,14,103,0,0,0
14118,11,2016-11-26,idaho,,South Alabama,W (38-31),17,34,50.0,231,2,35,176,5.0,3,69,407,5.9,11,11,5,27,4,45,0,3,3
14119,12,2016-12-03,idaho,,Georgia State,W (37-12),16,20,80.0,138,3,45,149,3.3,0,65,287,4.4,7,8,1,16,5,45,0,0,0
14120,13,2016-12-22,idaho,N,Colorado State*,W (61-50),21,31,67.7,381,4,51,225,4.4,5,82,606,7.4,16,13,1,30,7,69,0,0,0
14121,,13 Games,idaho,,,,265,432,61.3,3240,19,488,1921,3.9,24,920,5161,5.6,158,98,25,281,73,725,6,11,17
14122,1,2017-08-31,idaho,,Sacramento State,W (28-6),14,19,73.7,163,2,44,197,4.5,2,63,360,5.7,4,11,0,15,3,20,1,2,3
14123,2,2017-09-09,idaho,,Nevada-Las Vegas,L (16-44),22,34,64.7,261,1,36,123,3.4,1,70,384,5.5,11,6,1,18,4,40,0,1,1
14124,3,2017-09-16,idaho,@,Western Michigan,L (28-37),16,26,61.5,229,3,34,170,5.0,1,60,399,6.7,5,8,2,15,6,44,2,1,3
14125,4,2017-09-23,idaho,@,South Alabama,W (29-23),23,39,59.0,273,1,37,146,3.9,2,76,419,5.5,13,5,6,24,5,51,2,0,2
14126,5,2017-10-07,idaho,,Louisiana,L (16-21),13,28,46.4,149,0,39,130,3.3,1,67,279,4.2,7,6,0,13,6,60,0,0,0
14127,6,2017-10-14,idaho,,Appalachian State,L (20-23),15,28,53.6,200,2,36,112,3.1,0,64,312,4.9,6,8,0,14,7,60,2,0,2
14128,7,2017-10-21,idaho,@,Missouri,L (21-68),22,36,61.1,197,3,38,81,2.1,0,74,278,3.8,8,6,1,15,6,50,1,0,1
14129,8,2017-10-28,idaho,,Louisiana-Monroe,W (31-23),28,42,66.7,360,3,39,158,4.1,1,81,518,6.4,17,9,1,27,5,56,0,0,0
14130,9,2017-11-02,idaho,@,Troy,L (21-24),24,35,68.6,288,3,32,90,2.8,0,67,378,5.6,13,6,3,22,5,45,0,0,0
14131,10,2017-11-18,idaho,,Coastal Carolina,L (7-13),18,26,69.2,177,1,33,100,3.0,0,59,277,4.7,9,5,0,14,8,84,0,1,1
14132,11,2017-11-25,idaho,@,New Mexico State,L (10-17),19,35,54.3,174,1,38,41,1.1,0,73,215,2.9,8,6,2,16,4,20,1,2,3
14133,12,2017-12-02,idaho,@,Georgia State,W (24-10),16,30,53.3,228,1,40,147,3.7,2,70,375,5.4,11,6,1,18,5,37,0,0,0
14134,,12 Games,idaho,,,,230,378,60.8,2699,21,446,1495,3.4,10,824,4194,5.1,112,82,17,211,64,567,9,7,16
14135,1,2018-09-01,idaho,@,Fresno State,L (13-79),14,33,42.4,205,1,32,102,3.2,1,65,307,4.7,9,6,0,15,4,20,2,5,7
14136,2,2018-11-17,idaho,@,Florida,L (10-63),13,35,37.1,73,1,33,154,4.7,0,68,227,3.3,4,11,2,17,6,48,0,2,2
14137,,2 Games,idaho,,,,27,68,39.7,278,2,65,256,3.9,1,133,534,4.0,13,17,2,32,10,68,2,7,9
14138,1,2017-09-09,montana,@,Washington,L (7-63),19,31,61.3,132,0,33,31,0.9,0,64,163,2.5,4,4,2,10,4,35,2,2,4
14139,1,2014-08-30,alabama,N,West Virginia,W (33-23),24,33,72.7,250,0,49,288,5.9,3,82,538,6.6,14,13,3,30,7,49,0,1,1
14140,2,2014-09-06,alabama,,Florida Atlantic,W (41-0),27,38,71.1,430,3,32,190,5.9,2,70,620,8.9,17,10,0,27,6,60,1,0,1
14141,3,2014-09-13,alabama,,Southern Mississippi,W (52-12),17,24,70.8,214,2,49,333,6.8,5,73,547,7.5,14,16,1,31,3,25,1,0,1
14142,4,2014-09-20,alabama,,Florida,W (42-21),24,35,68.6,449,5,52,223,4.3,1,87,672,7.7,13,13,2,28,11,80,3,1,4
14143,5,2014-10-04,alabama,@,Mississippi,L (17-23),19,31,61.3,228,0,44,168,3.8,1,75,396,5.3,13,7,0,20,8,52,1,1,2
14144,6,2014-10-11,alabama,@,Arkansas,W (14-13),11,21,52.4,161,2,32,66,2.1,0,53,227,4.3,6,3,1,10,4,30,2,0,2
14145,7,2014-10-18,alabama,,Texas A&M,W (59-0),21,35,60.0,304,4,45,298,6.6,4,80,602,7.5,15,14,1,30,0,0,0,0,0
14146,8,2014-10-25,alabama,@,Tennessee,W (34-20),14,24,58.3,286,2,41,183,4.5,3,65,469,7.2,10,11,2,23,6,50,2,0,2
14147,9,2014-11-08,alabama,@,Louisiana State,W (20-13),20,46,43.5,209,2,29,106,3.7,0,75,315,4.2,9,6,0,15,3,29,1,0,1
14148,10,2014-11-15,alabama,,Mississippi State,W (25-20),19,31,61.3,211,1,32,124,3.9,2,63,335,5.3,9,7,1,17,7,61,0,0,0
14149,11,2014-11-22,alabama,,Western Carolina,W (48-14),29,43,67.4,337,3,45,275,6.1,3,88,612,7.0,16,19,1,36,5,50,1,1,2
14150,12,2014-11-29,alabama,,Auburn,W (55-44),20,27,74.1,312,4,34,227,6.7,4,61,539,8.8,13,9,2,24,3,30,0,3,3
14151,13,2014-12-06,alabama,N,Missouri,W (42-13),23,27,85.2,262,2,49,242,4.9,4,76,504,6.6,13,14,1,28,2,10,0,0,0
14152,14,2015-01-01,alabama,N,Ohio State*,L (35-42),22,36,61.1,237,2,34,170,5.0,3,70,407,5.8,8,12,1,21,4,36,0,3,3
14153,,14 Games,alabama,,,,290,451,64.3,3890,32,567,2893,5.1,35,1018,6783,6.7,170,154,16,340,69,562,12,10,22
14154,1,2015-09-05,alabama,N,Wisconsin,W (35-17),22,29,75.9,264,1,37,238,6.4,4,66,502,7.6,14,12,1,27,11,120,0,0,0
14155,2,2015-09-12,alabama,,Middle Tennessee State,W (37-10),26,43,60.5,312,2,39,220,5.6,3,82,532,6.5,13,13,2,28,5,40,0,2,2
14156,3,2015-09-19,alabama,,Mississippi,L (37-43),32,59,54.2,288,3,42,215,5.1,2,101,503,5.0,14,11,4,29,4,36,2,3,5
14157,4,2015-09-26,alabama,,Louisiana-Monroe,W (34-0),18,32,56.3,166,3,35,137,3.9,1,67,303,4.5,8,8,1,17,7,72,0,1,1
14158,5,2015-10-03,alabama,@,Georgia,W (38-10),11,16,68.8,190,1,47,189,4.0,2,63,379,6.0,6,6,3,15,7,39,2,0,2
14159,6,2015-10-10,alabama,,Arkansas,W (27-14),24,33,72.7,262,2,46,134,2.9,1,79,396,5.0,8,12,2,22,6,56,0,2,2
14160,7,2015-10-17,alabama,@,Texas A&M,W (41-23),19,25,76.0,138,0,45,258,5.7,2,70,396,5.7,6,11,0,17,7,60,1,0,1
14161,8,2015-10-24,alabama,,Tennessee,W (19-14),21,27,77.8,247,0,42,117,2.8,2,69,364,5.3,12,10,1,23,7,64,0,1,1
14162,9,2015-11-07,alabama,,Louisiana State,W (30-16),18,24,75.0,184,0,55,250,4.5,3,79,434,5.5,12,14,2,28,9,88,1,0,1
14163,10,2015-11-14,alabama,@,Mississippi State,W (31-6),15,25,60.0,144,1,30,235,7.8,2,55,379,6.9,4,8,1,13,4,40,0,1,1
14164,11,2015-11-21,alabama,,Charleston Southern,W (56-6),19,25,76.0,208,2,35,195,5.6,4,60,403,6.7,10,13,0,23,2,30,0,0,0
14165,12,2015-11-28,alabama,@,Auburn,W (29-13),17,26,65.4,179,1,50,286,5.7,1,76,465,6.1,8,13,3,24,7,65,0,0,0
14166,13,2015-12-05,alabama,N,Florida,W (29-15),18,26,69.2,204,2,58,233,4.0,1,84,437,5.2,9,14,2,25,5,35,1,0,1
14167,14,2015-12-31,alabama,N,Michigan State*,W (38-0),25,31,80.6,286,2,35,154,4.4,2,66,440,6.7,12,7,2,21,6,69,0,0,0
14168,15,2016-01-11,alabama,N,Clemson*,W (45-40),16,25,64.0,335,2,46,138,3.0,3,71,473,6.7,11,6,1,18,2,21,0,0,0
14169,,15 Games,alabama,,,,301,446,67.5,3407,22,642,2999,4.7,33,1088,6406,5.9,147,158,25,330,89,835,7,10,17
14170,1,2016-09-03,alabama,N,Southern California,W (52-6),12,18,66.7,223,3,45,242,5.4,3,63,465,7.4,6,9,0,15,4,29,1,1,2
14171,2,2016-09-10,alabama,,Western Kentucky,W (38-10),25,42,59.5,351,2,39,124,3.2,2,81,475,5.9,13,9,1,23,12,84,1,0,1
14172,3,2016-09-17,alabama,@,Mississippi,W (48-43),19,31,61.3,158,0,48,334,7.0,3,79,492,6.2,7,14,1,22,9,75,1,0,1
14173,4,2016-09-24,alabama,,Kent State,W (48-0),22,34,64.7,217,2,46,285,6.2,3,80,502,6.3,10,16,0,26,2,20,0,0,0
14174,5,2016-10-01,alabama,,Kentucky,W (34-6),25,38,65.8,315,2,37,173,4.7,1,75,488,6.5,14,11,0,25,4,20,1,0,1
14175,6,2016-10-08,alabama,@,Arkansas,W (49-30),13,17,76.5,253,2,34,264,7.8,3,51,517,10.1,8,8,0,16,7,86,2,1,3
14176,7,2016-10-15,alabama,@,Tennessee,W (49-10),18,28,64.3,185,1,48,409,8.5,4,76,594,7.8,8,20,0,28,5,38,1,1,2
14177,8,2016-10-22,alabama,,Texas A&M,W (33-14),15,25,60.0,164,2,57,287,5.0,1,82,451,5.5,7,19,2,28,7,44,0,2,2
14178,9,2016-11-05,alabama,@,Louisiana State,W (10-0),10,19,52.6,107,0,51,216,4.2,1,70,323,4.6,3,12,1,16,6,29,1,1,2
14179,10,2016-11-12,alabama,,Mississippi State,W (51-3),31,41,75.6,397,5,31,218,7.0,1,72,615,8.5,17,7,2,26,3,35,1,1,2
14180,11,2016-11-19,alabama,,Chattanooga,W (31-3),15,21,71.4,136,3,37,196,5.3,1,58,332,5.7,4,10,0,14,1,10,1,0,1
14181,12,2016-11-26,alabama,,Auburn,W (30-12),28,37,75.7,298,2,44,203,4.6,1,81,501,6.2,13,12,1,26,4,28,0,2,2
14182,13,2016-12-03,alabama,N,Florida,W (54-16),11,20,55.0,138,1,38,234,6.2,4,58,372,6.4,3,12,3,18,2,14,0,0,0
14183,14,2016-12-31,alabama,N,Washington,W (24-7),7,14,50.0,57,0,50,269,5.4,2,64,326,5.1,3,13,0,16,11,66,0,0,0
14184,15,2017-01-09,alabama,N,Clemson,L (31-35),14,32,43.8,155,1,34,221,6.5,3,66,376,5.7,5,10,1,16,9,82,0,0,0
14185,,15 Games,alabama,,,,265,417,63.5,3154,26,639,3675,5.8,33,1056,6829,6.5,121,182,12,315,86,660,10,9,19
14186,1,2017-09-02,alabama,N,Florida State,W (24-7),10,18,55.6,96,1,42,173,4.1,1,60,269,4.5,4,8,1,13,5,30,0,0,0
14187,2,2017-09-09,alabama,,Fresno State,W (41-10),20,27,74.1,192,2,39,305,7.8,3,66,497,7.5,11,17,0,28,4,30,0,0,0
14188,3,2017-09-16,alabama,,Colorado State,W (41-23),13,21,61.9,248,2,39,239,6.1,3,60,487,8.1,10,12,1,23,4,45,0,0,0
14189,4,2017-09-23,alabama,@,Vanderbilt,W (59-0),17,27,63.0,181,2,66,496,7.5,6,93,677,7.3,12,24,2,38,6,40,0,0,0
14190,5,2017-09-30,alabama,,Mississippi,W (66-3),15,24,62.5,248,3,51,365,7.2,5,75,613,8.2,11,14,1,26,7,60,0,0,0
14191,6,2017-10-07,alabama,@,Texas A&M,W (27-19),13,22,59.1,123,1,44,232,5.3,2,66,355,5.4,6,8,2,16,6,50,1,0,1
14192,7,2017-10-14,alabama,,Arkansas,W (41-9),13,21,61.9,188,1,43,308,7.2,4,64,496,7.8,9,14,0,23,6,66,1,1,2
14193,8,2017-10-21,alabama,,Tennessee,W (45-7),22,33,66.7,332,2,53,272,5.1,4,86,604,7.0,16,16,3,35,7,56,1,1,2
14194,9,2017-11-04,alabama,,Louisiana State,W (24-10),11,24,45.8,183,1,36,116,3.2,2,60,299,5.0,6,7,1,14,1,11,0,0,0
14195,10,2017-11-11,alabama,@,Mississippi State,W (31-24),10,19,52.6,242,1,38,202,5.3,3,57,444,7.8,7,11,1,19,5,60,0,0,0
14196,11,2017-11-18,alabama,,Mercer,W (56-0),14,18,77.8,265,6,42,265,6.3,2,60,530,8.8,10,12,0,22,1,5,2,0,2
14197,12,2017-11-25,alabama,@,Auburn,L (14-26),13,23,56.5,103,1,38,211,5.6,1,61,314,5.1,4,12,2,18,9,65,1,0,1
14198,13,2018-01-01,alabama,N,Clemson*,W (24-6),16,24,66.7,120,2,42,141,3.4,0,66,261,4.0,6,9,3,16,2,10,1,0,1
14199,14,2018-01-08,alabama,N,Georgia*,W (26-23),17,32,53.1,187,3,39,184,4.7,0,71,371,5.2,8,10,2,20,6,41,0,1,1
14200,,14 Games,alabama,,,,204,333,61.3,2708,28,612,3509,5.7,36,945,6217,6.6,120,174,19,311,69,569,7,3,10
14201,1,2018-09-01,alabama,N,Louisville,W (51-14),17,26,65.4,297,2,42,222,5.3,3,68,519,7.6,12,8,1,21,10,111,1,0,1
14202,2,2018-09-08,alabama,,Arkansas State,W (57-7),20,29,69.0,321,6,44,278,6.3,1,73,599,8.2,11,13,2,26,4,35,1,0,1
14203,3,2018-09-15,alabama,@,Mississippi,W (62-7),19,28,67.9,306,4,44,210,4.8,3,72,516,7.2,14,10,3,27,8,60,1,1,2
14204,4,2018-09-22,alabama,,Texas A&M,W (45-23),25,33,75.8,415,4,28,109,3.9,2,61,524,8.6,16,6,2,24,9,82,0,0,0
14205,5,2018-09-29,alabama,,Louisiana,W (56-14),13,16,81.3,340,4,46,268,5.8,3,62,608,9.8,11,14,1,26,3,15,0,0,0
14206,6,2018-10-06,alabama,@,Arkansas,W (65-31),14,18,77.8,393,4,41,246,6.0,4,59,639,10.8,13,11,0,24,5,31,0,0,0
14207,7,2018-10-13,alabama,,Missouri,W (39-10),19,30,63.3,380,3,45,184,4.1,1,75,564,7.5,12,11,2,25,5,60,1,0,1
14208,8,2018-10-20,alabama,@,Tennessee,W (58-21),21,32,65.6,327,4,42,218,5.2,4,74,545,7.4,16,12,2,30,5,36,0,1,1
14209,9,2018-11-03,alabama,@,Louisiana State,W (29-0),25,42,59.5,295,2,37,281,7.6,2,79,576,7.3,15,14,0,29,6,60,0,1,1
14210,10,2018-11-10,alabama,,Mississippi State,W (24-0),17,27,63.0,163,1,45,142,3.2,2,72,305,4.2,9,12,2,23,0,0,1,1,2
14211,11,2018-11-17,alabama,,Citadel,W (50-17),21,26,80.8,371,4,23,190,8.3,2,49,561,11.4,15,5,1,21,6,68,2,0,2
14212,,11 Games,alabama,,,,211,307,68.7,3608,38,437,2348,5.4,27,744,5956,8.0,144,116,16,276,61,558,7,4,11
14213,1,2014-08-31,tennessee,,Utah State,W (38-7),28,40,70.0,273,3,39,110,2.8,2,79,383,4.8,13,8,3,24,6,40,0,0,0
14214,2,2014-09-06,tennessee,,Arkansas State,W (34-19),22,38,57.9,247,2,45,168,3.7,2,83,415,5.0,12,9,2,23,2,14,0,1,1
14215,3,2014-09-13,tennessee,@,Oklahoma,L (10-34),21,44,47.7,201,1,33,112,3.4,0,77,313,4.1,12,5,1,18,1,10,1,2,3
14216,4,2014-09-27,tennessee,@,Georgia,L (32-35),27,44,61.4,284,3,34,117,3.4,1,78,401,5.1,11,9,2,22,7,49,2,0,2
14217,5,2014-10-04,tennessee,,Florida,L (9-10),26,39,66.7,205,0,29,28,1.0,0,68,233,3.4,10,2,0,12,8,49,1,2,3
14218,6,2014-10-11,tennessee,,Chattanooga,W (45-10),22,29,75.9,217,3,42,123,2.9,3,71,340,4.8,11,9,0,20,1,5,1,0,1
14219,7,2014-10-18,tennessee,@,Mississippi,L (3-34),19,34,55.9,191,0,28,0,0.0,0,62,191,3.1,8,2,0,10,3,23,1,3,4
14220,8,2014-10-25,tennessee,,Alabama,L (20-34),21,36,58.3,202,2,43,181,4.2,0,79,383,4.8,10,10,1,21,4,33,1,1,2
14221,9,2014-11-01,tennessee,@,South Carolina,W (45-42),23,40,57.5,301,2,55,344,6.3,4,95,645,6.8,13,18,4,35,4,31,0,1,1
14222,10,2014-11-15,tennessee,,Kentucky,W (50-16),19,29,65.5,297,3,51,214,4.2,2,80,511,6.4,14,13,1,28,3,40,0,0,0
14223,11,2014-11-22,tennessee,,Missouri,L (21-29),25,38,65.8,226,2,29,53,1.8,0,67,279,4.2,11,6,1,18,5,40,1,1,2
14224,12,2014-11-29,tennessee,@,Vanderbilt,W (24-17),11,20,55.0,92,0,45,170,3.8,2,65,262,4.0,4,12,3,19,6,55,0,2,2
14225,13,2015-01-02,tennessee,N,Iowa*,W (45-28),17,22,77.3,178,2,51,283,5.5,4,73,461,6.3,10,15,2,27,4,55,0,1,1
14226,,13 Games,tennessee,,,,281,453,62.0,2914,23,524,1903,3.6,20,977,4817,4.9,139,118,20,277,54,444,8,14,22
14227,1,2015-09-05,tennessee,N,Bowling Green State,W (59-30),15,23,65.2,205,2,64,399,6.2,6,87,604,6.9,10,17,2,29,4,40,0,0,0
14228,2,2015-09-12,tennessee,,Oklahoma,L (24-31),13,31,41.9,125,1,45,129,2.9,2,76,254,3.3,7,11,1,19,10,80,0,1,1
14229,3,2015-09-19,tennessee,,Western Carolina,W (55-10),21,29,72.4,237,3,49,210,4.3,2,78,447,5.7,10,13,2,25,3,15,0,0,0
14230,4,2015-09-26,tennessee,@,Florida,L (27-28),12,19,63.2,165,1,51,254,5.0,2,70,419,6.0,7,13,0,20,4,25,1,0,1
14231,5,2015-10-03,tennessee,,Arkansas,L (20-24),20,37,54.1,232,0,33,133,4.0,1,70,365,5.2,11,8,0,19,4,39,0,0,0
14232,6,2015-10-10,tennessee,,Georgia,W (38-31),25,42,59.5,312,3,48,207,4.3,2,90,519,5.8,15,10,1,26,3,15,1,1,2
14233,7,2015-10-24,tennessee,@,Alabama,L (14-19),13,22,59.1,171,1,39,132,3.4,1,61,303,5.0,9,11,1,21,6,30,1,0,1
14234,8,2015-10-31,tennessee,@,Kentucky,W (52-21),16,26,61.5,233,2,43,249,5.8,3,69,482,7.0,11,10,0,21,6,65,1,1,2
14235,9,2015-11-07,tennessee,,South Carolina,W (27-24),20,34,58.8,255,2,41,153,3.7,1,75,408,5.4,12,6,1,19,6,47,2,1,3
14236,10,2015-11-14,tennessee,,North Texas,W (24-0),18,28,64.3,172,0,48,237,4.9,3,76,409,5.4,11,13,0,24,2,10,0,1,1
14237,11,2015-11-21,tennessee,@,Missouri,W (19-8),16,25,64.0,89,0,51,248,4.9,1,76,337,4.4,7,11,1,19,4,27,0,0,0
14238,12,2015-11-28,tennessee,,Vanderbilt,W (53-28),15,25,60.0,192,2,52,331,6.4,3,77,523,6.8,12,13,2,27,6,47,0,0,0
14239,13,2016-01-01,tennessee,N,Northwestern*,W (45-6),16,30,53.3,194,0,53,226,4.3,5,83,420,5.1,8,14,2,24,8,90,0,0,0
14240,,13 Games,tennessee,,,,220,371,59.3,2582,17,617,2908,4.7,32,988,5490,5.6,130,150,13,293,66,530,6,5,11
14241,1,2016-09-01,tennessee,,Appalachian State,W (20-13),16,29,55.2,192,1,43,127,3.0,1,72,319,4.4,10,9,0,19,6,55,1,1,2
14242,2,2016-09-10,tennessee,N,Virginia Tech,W (45-24),10,19,52.6,91,3,46,239,5.2,3,65,330,5.1,4,9,3,16,6,60,0,1,1
14243,3,2016-09-17,tennessee,,Ohio,W (28-19),19,27,70.4,203,2,42,201,4.8,2,69,404,5.9,10,13,0,23,9,94,0,1,1
14244,4,2016-09-24,tennessee,,Florida,W (38-28),16,33,48.5,319,4,46,179,3.9,1,79,498,6.3,13,7,2,22,5,40,0,2,2
14245,5,2016-10-01,tennessee,@,Georgia,W (34-31),16,26,61.5,230,3,38,127,3.3,1,64,357,5.6,8,10,0,18,2,25,2,1,3
14246,6,2016-10-08,tennessee,@,Texas A&M,L (38-45),29,48,60.4,402,2,51,282,5.5,3,99,684,6.9,16,12,1,29,12,84,5,2,7
14247,7,2016-10-15,tennessee,,Alabama,L (10-49),18,31,58.1,131,0,32,32,1.0,1,63,163,2.6,8,2,1,11,1,10,0,1,1
14248,8,2016-10-29,tennessee,@,South Carolina,L (21-24),12,27,44.4,161,1,37,136,3.7,1,64,297,4.6,5,9,2,16,9,87,1,2,3
14249,9,2016-11-05,tennessee,,Tennessee Tech,W (55-0),22,27,81.5,294,3,25,177,7.1,3,52,471,9.1,14,4,3,21,6,71,0,0,0
14250,10,2016-11-12,tennessee,,Kentucky,W (49-36),11,18,61.1,223,3,41,376,9.2,4,59,599,10.2,10,17,2,29,9,64,2,1,3
14251,11,2016-11-19,tennessee,,Missouri,W (63-37),15,22,68.2,223,3,45,386,8.6,5,67,609,9.1,10,12,2,24,5,45,0,0,0
14252,12,2016-11-26,tennessee,@,Vanderbilt,L (34-45),31,34,91.2,340,2,33,176,5.3,2,67,516,7.7,16,10,1,27,4,35,2,0,2
14253,13,2016-12-30,tennessee,N,Nebraska*,W (38-24),23,38,60.5,291,1,38,230,6.1,4,76,521,6.9,12,12,1,25,6,65,1,0,1
14254,,13 Games,tennessee,,,,238,379,62.8,3100,28,517,2668,5.2,31,896,5768,6.4,136,126,18,280,80,735,14,12,26
14255,1,2017-09-04,tennessee,N,Georgia Tech,W (42-41),20,37,54.1,221,2,22,148,6.7,4,59,369,6.3,10,6,2,18,2,20,0,0,0
14256,2,2017-09-09,tennessee,,Indiana State,W (42-7),17,30,56.7,235,3,37,160,4.3,2,67,395,5.9,11,11,2,24,6,53,1,1,2
14257,3,2017-09-16,tennessee,@,Florida,L (20-26),21,39,53.8,259,1,33,183,5.5,1,72,442,6.1,12,9,2,23,7,54,0,3,3
14258,4,2017-09-23,tennessee,,Massachusetts,W (17-13),19,32,59.4,184,1,39,135,3.5,1,71,319,4.5,9,8,1,18,5,51,1,0,1
14259,5,2017-09-30,tennessee,,Georgia,L (0-41),11,23,47.8,80,0,29,62,2.1,0,52,142,2.7,2,3,2,7,5,26,2,2,4
14260,6,2017-10-14,tennessee,,South Carolina,L (9-15),11,19,57.9,133,0,39,120,3.1,0,58,253,4.4,6,6,4,16,7,40,0,0,0
14261,7,2017-10-21,tennessee,@,Alabama,L (7-45),9,16,56.3,44,0,30,64,2.1,0,46,108,2.3,2,3,2,7,9,81,0,1,1
14262,8,2017-10-28,tennessee,@,Kentucky,L (26-29),18,23,78.3,242,0,55,203,3.7,2,78,445,5.7,12,13,2,27,9,54,0,0,0
14263,9,2017-11-04,tennessee,,Southern Mississippi,W (24-10),10,21,47.6,115,0,38,95,2.5,3,59,210,3.6,7,3,4,14,3,29,0,0,0
14264,10,2017-11-11,tennessee,@,Missouri,L (17-50),16,32,50.0,139,1,36,146,4.1,0,68,285,4.2,6,10,0,16,4,36,2,2,4
14265,11,2017-11-18,tennessee,,Louisiana State,L (10-30),14,25,56.0,249,1,33,44,1.3,0,58,293,5.1,9,2,1,12,5,26,2,0,2
14266,12,2017-11-25,tennessee,,Vanderbilt,L (24-42),14,22,63.6,183,2,21,55,2.6,1,43,238,5.5,9,3,3,15,5,27,0,1,1
14267,,12 Games,tennessee,,,,180,319,56.4,2084,11,412,1415,3.4,14,731,3499,4.8,95,77,25,197,67,497,8,10,18
14268,1,2018-09-01,tennessee,N,West Virginia,L (14-40),19,25,76.0,172,1,38,129,3.4,1,63,301,4.8,9,9,1,19,6,48,0,0,0
14269,2,2018-09-08,tennessee,,East Tennessee State,W (59-3),11,16,68.8,224,1,44,190,4.3,5,60,414,6.9,8,10,1,19,3,19,0,0,0
14270,3,2018-09-15,tennessee,,Texas-El Paso,W (24-0),13,19,68.4,167,1,50,345,6.9,2,69,512,7.4,9,14,1,24,8,65,2,0,2
14271,4,2018-09-22,tennessee,,Florida,L (21-47),10,25,40.0,208,0,52,161,3.1,2,77,369,4.8,6,6,6,18,6,58,4,2,6
14272,5,2018-09-29,tennessee,@,Georgia,L (12-38),13,21,61.9,143,2,25,66,2.6,0,46,209,4.5,5,4,2,11,5,25,1,0,1
14273,6,2018-10-13,tennessee,@,Auburn,W (30-24),21,32,65.6,328,2,35,70,2.0,0,67,398,5.9,12,4,0,16,5,40,0,0,0
14274,7,2018-10-20,tennessee,,Alabama,L (21-58),14,25,56.0,227,2,30,31,1.0,0,55,258,4.7,9,2,2,13,9,59,1,0,1
14275,8,2018-10-27,tennessee,@,South Carolina,L (24-27),27,39,69.2,207,2,34,144,4.2,1,73,351,4.8,12,10,1,23,9,75,0,0,0
14276,9,2018-11-03,tennessee,,UNC Charlotte,W (14-3),16,21,76.2,172,1,26,20,0.8,0,47,192,4.1,7,2,1,10,4,55,0,0,0
14277,10,2018-11-10,tennessee,,Kentucky,W (24-7),12,20,60.0,197,2,38,219,5.8,1,58,416,7.2,7,8,1,16,4,30,2,0,2
14278,11,2018-11-17,tennessee,,Missouri,L (17-50),7,21,33.3,173,0,28,82,2.9,2,49,255,5.2,5,3,3,11,6,59,1,2,3
14279,,11 Games,tennessee,,,,163,264,61.7,2218,14,400,1457,3.6,14,664,3675,5.5,89,72,19,180,65,533,11,4,15
14280,1,2014-08-30,georgia,,Clemson,W (45-21),18,26,69.2,131,0,41,328,8.0,5,67,459,6.9,7,13,2,22,8,65,1,0,1
14281,2,2014-09-13,georgia,@,South Carolina,L (35-38),16,22,72.7,191,2,38,217,5.7,2,60,408,6.8,8,9,1,18,7,44,0,0,0
14282,3,2014-09-20,georgia,,Troy,W (66-0),14,22,63.6,180,3,39,367,9.4,5,61,547,9.0,8,13,2,23,5,35,0,0,0
14283,4,2014-09-27,georgia,,Tennessee,W (35-32),16,25,64.0,147,1,53,289,5.5,3,78,436,5.6,9,16,0,25,7,57,0,2,2
14284,5,2014-10-04,georgia,,Vanderbilt,W (44-17),14,22,63.6,202,2,35,243,6.9,3,57,445,7.8,7,12,1,20,2,12,0,1,1
14285,6,2014-10-11,georgia,@,Missouri,W (34-0),23,29,79.3,169,1,58,210,3.6,3,87,379,4.4,9,16,0,25,4,30,0,0,0
14286,7,2014-10-18,georgia,N,Arkansas,W (45-32),10,17,58.8,179,2,39,207,5.3,3,56,386,6.9,6,10,2,18,9,101,0,0,0
14287,8,2014-11-01,georgia,N,Florida,L (20-38),26,41,63.4,319,1,32,141,4.4,2,73,460,6.3,15,5,1,21,4,30,1,0,1
14288,9,2014-11-08,georgia,@,Kentucky,W (63-31),18,21,85.7,254,5,39,305,7.8,2,60,559,9.3,13,15,0,28,4,33,1,0,1
14289,10,2014-11-15,georgia,,Auburn,W (34-7),10,19,52.6,123,1,52,289,5.6,3,71,412,5.8,5,19,3,27,6,51,0,0,0
14290,11,2014-11-22,georgia,,Charleston Southern,W (55-9),20,26,76.9,310,4,37,270,7.3,3,63,580,9.2,16,9,3,28,3,30,1,1,2
14291,12,2014-11-29,georgia,,Georgia Tech,L (24-30),18,28,64.3,194,1,39,194,5.0,1,67,388,5.8,12,8,1,21,2,20,2,1,3
14292,13,2014-12-30,georgia,N,Louisville*,W (37-14),14,24,58.3,200,1,52,305,5.9,3,76,505,6.6,11,9,2,22,4,32,1,1,2
14293,,13 Games,georgia,,,,217,322,67.4,2599,24,554,3365,6.1,38,876,5964,6.8,126,154,18,298,65,540,7,6,13
14294,1,2015-09-05,georgia,,Louisiana-Monroe,W (51-14),10,14,71.4,192,3,38,243,6.4,4,52,435,8.4,8,11,0,19,4,30,0,0,0
14295,2,2015-09-12,georgia,@,Vanderbilt,W (31-14),13,25,52.0,141,0,41,282,6.9,2,66,423,6.4,9,9,1,19,10,92,0,0,0
14296,3,2015-09-19,georgia,,South Carolina,W (52-20),24,25,96.0,330,3,38,246,6.5,4,63,576,9.1,17,12,3,32,7,74,1,0,1
14297,4,2015-09-26,georgia,,Southern,W (48-6),20,24,83.3,271,2,33,261,7.9,4,57,532,9.3,13,13,1,27,2,10,1,0,1
14298,5,2015-10-03,georgia,,Alabama,L (10-38),11,31,35.5,106,0,38,193,5.1,1,69,299,4.3,4,7,1,12,8,82,1,3,4
14299,6,2015-10-10,georgia,@,Tennessee,L (31-38),15,33,45.5,279,2,29,165,5.7,0,62,444,7.2,11,4,0,15,7,51,1,0,1
14300,7,2015-10-17,georgia,,Missouri,W (9-6),23,32,71.9,178,0,45,120,2.7,0,77,298,3.9,9,9,1,19,3,30,0,1,1
14301,8,2015-10-31,georgia,N,Florida,L (3-27),15,34,44.1,154,0,22,69,3.1,0,56,223,4.0,8,3,1,12,3,20,1,4,5
14302,9,2015-11-07,georgia,,Kentucky,W (27-3),10,19,52.6,90,1,52,300,5.8,2,71,390,5.5,6,15,0,21,6,60,2,0,2
14303,10,2015-11-14,georgia,@,Auburn,W (20-13),12,17,70.6,97,0,45,146,3.2,1,62,243,3.9,6,8,1,15,5,48,0,0,0
14304,11,2015-11-21,georgia,,Georgia Southern,W (23-17),16,25,64.0,183,1,28,106,3.8,2,53,289,5.5,8,8,0,16,2,15,2,0,2
14305,12,2015-11-28,georgia,@,Georgia Tech,W (13-7),18,25,72.0,224,0,34,178,5.2,1,59,402,6.8,8,7,1,16,5,35,0,0,0
14306,13,2016-01-02,georgia,N,Penn State*,W (24-17),12,23,52.2,161,2,41,166,4.0,1,64,327,5.1,7,9,1,17,5,45,0,0,0
14307,,13 Games,georgia,,,,199,327,60.9,2406,14,484,2475,5.1,22,811,4881,6.0,114,115,11,240,67,592,9,8,17
14308,1,2016-09-03,georgia,N,North Carolina,W (33-24),13,20,65.0,185,1,52,289,5.6,3,72,474,6.6,8,13,4,25,9,70,1,0,1
14309,2,2016-09-10,georgia,,Nicholls State,W (26-24),13,23,56.5,206,1,39,167,4.3,1,62,373,6.0,9,8,0,17,3,34,2,1,3
14310,3,2016-09-17,georgia,@,Missouri,W (28-27),29,55,52.7,308,3,38,101,2.7,1,93,409,4.4,18,5,2,25,3,42,0,1,1
14311,4,2016-09-24,georgia,@,Mississippi,L (14-45),17,37,45.9,166,0,44,230,5.2,2,81,396,4.9,9,12,0,21,8,52,1,1,2
14312,5,2016-10-01,georgia,,Tennessee,L (31-34),17,28,60.7,211,2,46,181,3.9,2,74,392,5.3,11,11,2,24,8,44,1,1,2
14313,6,2016-10-09,georgia,@,South Carolina,W (28-14),5,17,29.4,29,1,50,326,6.5,2,67,355,5.3,1,17,1,19,8,56,0,1,1
14314,7,2016-10-15,georgia,,Vanderbilt,L (16-17),27,40,67.5,346,1,35,75,2.1,0,75,421,5.6,17,4,2,23,8,53,0,0,0
14315,8,2016-10-29,georgia,N,Florida,L (10-24),15,33,45.5,143,1,19,21,1.1,0,52,164,3.2,7,0,1,8,5,49,0,0,0
14316,9,2016-11-05,georgia,@,Kentucky,W (27-24),17,31,54.8,245,1,42,215,5.1,1,73,460,6.3,10,12,1,23,6,54,3,0,3
14317,10,2016-11-12,georgia,,Auburn,W (13-7),20,33,60.6,208,0,43,135,3.1,0,76,343,4.5,8,11,2,21,5,30,0,1,1
14318,11,2016-11-19,georgia,,Louisiana,W (35-21),13,20,65.0,165,2,39,235,6.0,2,59,400,6.8,7,9,0,16,2,15,1,1,2
14319,12,2016-11-26,georgia,,Georgia Tech,L (27-28),14,28,50.0,139,1,42,263,6.3,2,70,402,5.7,7,13,2,22,2,15,0,2,2
14320,13,2016-12-30,georgia,N,Texas Christian*,W (31-23),12,21,57.1,164,2,42,251,6.0,2,63,415,6.6,5,11,1,17,7,45,1,0,1
14321,,13 Games,georgia,,,,212,386,54.9,2515,16,531,2489,4.7,18,917,5004,5.5,117,126,18,261,74,559,10,9,19
14322,1,2017-09-02,georgia,,Appalachian State,W (31-10),11,20,55.0,147,1,44,221,5.0,3,64,368,5.8,6,9,3,18,8,46,0,2,2
14323,2,2017-09-09,georgia,@,Notre Dame,W (20-19),16,29,55.2,141,1,43,185,4.3,1,72,326,4.5,3,9,4,16,12,127,1,1,2
14324,3,2017-09-16,georgia,,Samford,W (42-14),9,15,60.0,175,3,54,284,5.3,3,69,459,6.7,5,22,0,27,3,25,1,0,1
14325,4,2017-09-23,georgia,,Mississippi State,W (31-3),9,12,75.0,201,2,42,203,4.8,2,54,404,7.5,7,7,1,15,4,35,1,0,1
14326,5,2017-09-30,georgia,@,Tennessee,W (41-0),7,17,41.2,84,1,55,294,5.3,4,72,378,5.3,5,13,2,20,6,65,0,1,1
14327,6,2017-10-07,georgia,@,Vanderbilt,W (45-14),10,14,71.4,126,2,54,423,7.8,4,68,549,8.1,6,21,0,27,7,46,1,0,1
14328,7,2017-10-14,georgia,,Missouri,W (53-28),18,26,69.2,326,2,54,370,6.9,4,80,696,8.7,11,13,0,24,8,42,0,1,1
14329,8,2017-10-28,georgia,N,Florida,W (42-7),4,7,57.1,101,1,35,292,8.3,4,42,393,9.4,4,10,0,14,7,40,0,1,1
14330,9,2017-11-04,georgia,,South Carolina,W (24-10),16,22,72.7,196,2,53,242,4.6,1,75,438,5.8,12,13,1,26,5,55,1,0,1
14331,10,2017-11-11,georgia,@,Auburn,L (17-40),13,29,44.8,184,1,32,46,1.4,1,61,230,3.8,8,4,1,13,7,75,1,0,1
14332,11,2017-11-18,georgia,,Kentucky,W (42-13),9,14,64.3,123,1,44,381,8.7,5,58,504,8.7,7,17,1,25,7,59,0,1,1
14333,12,2017-11-25,georgia,@,Georgia Tech,W (38-7),12,17,70.6,224,2,43,247,5.7,3,60,471,7.9,9,13,1,23,2,25,0,0,0
14334,13,2017-12-02,georgia,N,Auburn,W (28-7),16,22,72.7,183,2,41,238,5.8,1,63,421,6.7,6,11,3,20,7,91,0,0,0
14335,14,2018-01-01,georgia,N,Oklahoma*,W (54-48),20,29,69.0,210,2,34,317,9.3,5,63,527,8.4,12,8,1,21,6,39,1,0,1
14336,15,2018-01-08,georgia,N,Alabama*,L (23-26),16,32,50.0,232,1,45,133,3.0,1,77,365,4.7,11,8,3,22,6,65,0,2,2
14337,,15 Games,georgia,,,,186,305,61.0,2653,24,673,3876,5.8,42,978,6529,6.7,112,178,21,311,95,835,7,9,16
14338,1,2018-09-01,georgia,,Austin Peay,W (45-0),21,27,77.8,224,3,33,284,8.6,3,60,508,8.5,13,8,0,21,3,40,1,0,1
14339,2,2018-09-08,georgia,@,South Carolina,W (41-17),16,19,84.2,202,1,52,271,5.2,3,71,473,6.7,12,15,3,30,4,47,0,1,1
14340,3,2018-09-15,georgia,,Middle Tennessee State,W (49-7),17,21,81.0,223,4,35,261,7.5,2,56,484,8.6,10,11,2,23,7,54,0,0,0
14341,4,2018-09-22,georgia,@,Missouri,W (43-29),13,23,56.5,260,3,40,185,4.6,0,63,445,7.1,8,10,0,18,7,66,0,1,1
14342,5,2018-09-29,georgia,,Tennessee,W (38-12),17,24,70.8,190,0,50,251,5.0,5,74,441,6.0,10,16,0,26,6,40,0,0,0
14343,6,2018-10-06,georgia,,Vanderbilt,W (41-13),21,31,67.7,341,3,34,219,6.4,2,65,560,8.6,12,14,2,28,13,115,0,0,0
14344,7,2018-10-13,georgia,@,Louisiana State,L (16-36),16,34,47.1,209,1,30,113,3.8,1,64,322,5.0,10,7,1,18,4,20,2,2,4
14345,8,2018-10-27,georgia,N,Florida,W (36-17),17,24,70.8,240,3,41,189,4.6,1,65,429,6.6,10,8,2,20,4,53,0,0,0
14346,9,2018-11-03,georgia,@,Kentucky,W (34-17),14,20,70.0,113,1,50,331,6.6,3,70,444,6.3,6,16,3,25,4,45,2,0,2
14347,10,2018-11-10,georgia,,Auburn,W (27-10),15,23,65.2,213,2,44,309,7.0,1,67,522,7.8,8,13,3,24,12,85,0,1,1
14348,11,2018-11-17,georgia,,Massachusetts,W (66-27),14,17,82.4,275,3,45,426,9.5,6,62,701,11.3,8,20,2,30,2,20,1,0,1
14349,,11 Games,georgia,,,,181,263,68.8,2490,24,454,2839,6.3,27,717,5329,7.4,107,138,18,263,66,585,6,5,11
14350,1,2014-09-06,florida,,Eastern Michigan,W (65-0),33,47,70.2,396,3,39,259,6.6,4,86,655,7.6,12,13,2,27,10,100,0,0,0
14351,2,2014-09-13,florida,,Kentucky,W (36-30),25,44,56.8,295,3,50,237,4.7,1,94,532,5.7,13,14,1,28,8,78,0,1,1
14352,3,2014-09-20,florida,@,Alabama,L (21-42),9,28,32.1,93,1,27,107,4.0,1,55,200,3.6,5,5,1,11,5,36,1,2,3
14353,4,2014-10-04,florida,@,Tennessee,W (10-9),13,27,48.1,76,0,48,156,3.3,1,75,232,3.1,5,11,0,16,5,45,0,3,3
14354,5,2014-10-11,florida,,Louisiana State,L (27-30),14,25,56.0,183,1,32,123,3.8,1,57,306,5.4,4,8,1,13,4,34,1,2,3
14355,6,2014-10-18,florida,,Missouri,L (13-42),15,31,48.4,148,1,48,135,2.8,1,79,283,3.6,7,8,2,17,3,39,3,3,6
14356,7,2014-11-01,florida,N,Georgia,W (38-20),3,6,50.0,27,0,60,418,7.0,5,66,445,6.7,2,16,1,19,4,31,1,0,1
14357,8,2014-11-08,florida,@,Vanderbilt,W (34-10),13,22,59.1,215,0,50,214,4.3,4,72,429,6.0,10,9,0,19,10,82,0,0,0
14358,9,2014-11-15,florida,,South Carolina,L (20-23),5,11,45.5,60,1,49,218,4.4,1,60,278,4.6,2,10,3,15,10,75,1,0,1
14359,10,2014-11-22,florida,,Eastern Kentucky,W (52-3),13,23,56.5,326,5,38,104,2.7,2,61,430,7.0,11,6,0,17,5,45,1,0,1
14360,11,2014-11-29,florida,@,Florida State,L (19-24),13,32,40.6,169,1,33,113,3.4,0,65,282,4.3,9,3,1,13,10,105,0,2,2
14361,12,2015-01-03,florida,N,East Carolina*,W (28-20),13,28,46.4,171,2,43,168,3.9,1,71,339,4.8,6,8,1,15,6,40,2,1,3
14362,,12 Games,florida,,,,169,324,52.2,2159,18,517,2252,4.4,22,841,4411,5.2,86,111,13,210,80,710,10,14,24
14363,1,2015-09-05,florida,,New Mexico State,W (61-13),30,37,81.1,382,4,42,224,5.3,4,79,606,7.7,18,10,0,28,1,10,1,0,1
14364,2,2015-09-12,florida,,East Carolina,W (31-24),15,25,60.0,205,2,38,168,4.4,1,63,373,5.9,8,8,1,17,12,105,1,1,2
14365,3,2015-09-19,florida,@,Kentucky,W (14-9),13,22,59.1,125,0,37,120,3.2,2,59,245,4.2,7,8,1,16,10,61,0,1,1
14366,4,2015-09-26,florida,,Tennessee,W (28-27),23,43,53.5,283,2,28,109,3.9,2,71,392,5.5,13,4,0,17,4,25,0,1,1
14367,5,2015-10-03,florida,,Mississippi,W (38-10),24,29,82.8,271,4,34,84,2.5,1,63,355,5.6,13,4,1,18,6,51,0,0,0
14368,6,2015-10-10,florida,@,Missouri,W (21-3),20,33,60.6,208,0,44,129,2.9,2,77,337,4.4,13,7,3,23,4,30,0,0,0
14369,7,2015-10-17,florida,@,Louisiana State,L (28-35),17,32,53.1,271,2,31,55,1.8,1,63,326,5.2,10,5,0,15,6,45,0,0,0
14370,8,2015-10-31,florida,N,Georgia,W (27-3),8,19,42.1,155,1,48,258,5.4,2,67,413,6.2,4,11,0,15,8,74,1,0,1
14371,9,2015-11-07,florida,,Vanderbilt,W (9-7),13,26,50.0,165,0,34,93,2.7,1,60,258,4.3,7,5,0,12,8,61,3,1,4
14372,10,2015-11-14,florida,@,South Carolina,W (24-14),19,33,57.6,256,1,43,148,3.4,2,76,404,5.3,12,7,1,20,8,55,0,2,2
14373,11,2015-11-21,florida,,Florida Atlantic,W (20-14),8,17,47.1,122,2,43,143,3.3,1,60,265,4.4,6,6,1,13,5,43,1,1,2
14374,12,2015-11-28,florida,,Florida State,L (2-27),19,39,48.7,134,0,40,128,3.2,0,79,262,3.3,5,13,1,19,7,60,0,0,0
14375,13,2015-12-05,florida,N,Alabama,L (15-29),9,24,37.5,165,1,21,15,0.7,0,45,180,4.0,6,1,0,7,5,51,0,1,1
14376,14,2016-01-01,florida,N,Michigan*,L (7-41),10,25,40.0,155,1,27,118,4.4,0,52,273,5.3,7,7,0,14,7,66,0,2,2
14377,,14 Games,florida,,,,228,404,56.4,2897,20,510,1792,3.5,19,914,4689,5.1,129,96,9,234,91,737,7,10,17
14378,1,2016-09-03,florida,,Massachusetts,W (24-7),29,44,65.9,256,2,29,107,3.7,0,73,363,5.0,14,7,0,21,8,80,0,0,0
14379,2,2016-09-10,florida,,Kentucky,W (45-7),19,33,57.6,320,4,50,244,4.9,2,83,564,6.8,15,13,0,28,6,75,0,1,1
14380,3,2016-09-17,florida,,North Texas,W (32-0),16,29,55.2,216,0,43,255,5.9,4,72,471,6.5,10,11,5,26,11,97,0,1,1
14381,4,2016-09-24,florida,@,Tennessee,L (28-38),23,39,59.0,296,3,31,106,3.4,1,70,402,5.7,10,6,1,17,9,75,1,1,2
14382,5,2016-10-01,florida,@,Vanderbilt,W (13-6),19,28,67.9,144,0,35,92,2.6,1,63,236,3.7,7,6,2,15,4,45,1,0,1
14383,6,2016-10-15,florida,,Missouri,W (40-14),18,38,47.4,236,1,39,287,7.4,1,77,523,6.8,12,10,0,22,11,65,1,3,4
14384,7,2016-10-29,florida,N,Georgia,W (24-10),15,25,60.0,131,1,48,100,2.1,2,73,231,3.2,8,9,3,20,6,45,0,1,1
14385,8,2016-11-05,florida,@,Arkansas,L (10-31),19,37,51.4,229,0,14,12,0.9,0,51,241,4.7,11,1,1,13,3,34,0,2,2
14386,9,2016-11-12,florida,,South Carolina,W (20-7),17,21,81.0,201,2,37,171,4.6,0,58,372,6.4,11,7,0,18,10,80,2,1,3
14387,10,2016-11-19,florida,@,Louisiana State,W (16-10),7,17,41.2,144,1,35,126,3.6,0,52,270,5.2,3,10,1,14,1,5,0,0,0
14388,11,2016-11-26,florida,@,Florida State,L (13-31),19,35,54.3,149,0,29,58,2.0,0,64,207,3.2,6,7,1,14,4,44,2,0,2
14389,12,2016-12-03,florida,N,Alabama,L (16-54),26,39,66.7,261,2,30,0,0.0,0,69,261,3.8,13,2,1,16,7,53,0,3,3
14390,13,2017-01-02,florida,N,Iowa*,W (30-3),14,25,56.0,222,2,32,109,3.4,0,57,331,5.8,5,6,0,11,8,60,0,2,2
14391,,13 Games,florida,,,,241,410,58.8,2805,18,452,1667,3.7,11,862,4472,5.2,125,95,15,235,88,758,7,15,22
14392,1,2017-09-02,florida,N,Michigan,L (17-33),14,26,53.8,181,0,27,11,0.4,0,53,192,3.6,6,2,1,9,5,45,3,0,3
14393,2,2017-09-16,florida,,Tennessee,W (26-20),18,28,64.3,212,2,29,168,5.8,0,57,380,6.7,8,6,0,14,8,38,2,1,3
14394,3,2017-09-23,florida,@,Kentucky,W (28-27),17,27,63.0,209,2,36,186,5.2,2,63,395,6.3,10,9,1,20,8,72,0,1,1
14395,4,2017-09-30,florida,,Vanderbilt,W (38-24),17,26,65.4,249,0,51,218,4.3,5,77,467,6.1,9,11,3,23,9,64,0,0,0
14396,5,2017-10-07,florida,,Louisiana State,L (16-17),10,16,62.5,108,0,38,194,5.1,2,54,302,5.6,6,8,2,16,6,48,0,0,0
14397,6,2017-10-14,florida,,Texas A&M,L (17-19),18,27,66.7,135,1,41,236,5.8,1,68,371,5.5,6,11,0,17,6,44,0,2,2
14398,7,2017-10-28,florida,N,Georgia,L (7-42),10,25,40.0,66,0,41,183,4.5,1,66,249,3.8,6,9,0,15,14,85,1,1,2
14399,8,2017-11-04,florida,@,Missouri,L (16-45),20,29,69.0,256,1,31,93,3.0,0,60,349,5.8,12,3,2,17,11,84,1,1,2
14400,9,2017-11-11,florida,@,South Carolina,L (20-28),17,39,43.6,223,0,22,78,3.5,2,61,301,4.9,8,3,1,12,10,56,2,1,3
14401,10,2017-11-18,florida,,Alabama-Birmingham,W (36-7),15,30,50.0,152,2,50,257,5.1,1,80,409,5.1,11,14,0,25,6,60,0,0,0
14402,11,2017-11-25,florida,,Florida State,L (22-38),18,39,46.2,184,2,34,96,2.8,1,73,280,3.8,10,7,0,17,4,50,1,3,4
14403,,11 Games,florida,,,,174,312,55.8,1975,10,400,1720,4.3,15,712,3695,5.2,92,83,10,185,87,646,10,10,20
14404,1,2018-09-01,florida,,Charleston Southern,W (53-6),19,27,70.4,241,5,39,203,5.2,1,66,444,6.7,12,12,1,25,3,20,0,0,0
14405,2,2018-09-08,florida,,Kentucky,L (16-27),17,38,44.7,232,2,29,128,4.4,0,67,360,5.4,14,5,5,24,6,55,1,1,2
14406,3,2018-09-15,florida,,Colorado State,W (48-10),8,15,53.3,119,2,29,222,7.7,2,44,341,7.8,3,10,1,14,8,75,0,1,1
14407,4,2018-09-22,florida,@,Tennessee,W (47-21),10,19,52.6,186,3,34,201,5.9,3,53,387,7.3,6,7,1,14,10,79,1,0,1
14408,5,2018-09-29,florida,@,Mississippi State,W (13-6),23,32,71.9,239,1,34,118,3.5,0,66,357,5.4,13,7,0,20,11,90,0,1,1
14409,6,2018-10-06,florida,,Louisiana State,W (27-19),13,28,46.4,176,1,43,215,5.0,2,71,391,5.5,6,11,2,19,11,115,0,1,1
14410,7,2018-10-13,florida,@,Vanderbilt,W (37-27),19,29,65.5,284,2,63,292,4.6,2,92,576,6.3,13,18,0,31,7,89,2,1,3
14411,8,2018-10-27,florida,N,Georgia,L (17-36),13,21,61.9,105,1,37,170,4.6,1,58,275,4.7,5,9,2,16,7,27,2,1,3
14412,9,2018-11-03,florida,,Missouri,L (17-38),19,40,47.5,210,1,28,113,4.0,1,68,323,4.8,8,7,2,17,8,66,0,0,0
14413,10,2018-11-10,florida,,South Carolina,W (35-31),15,21,71.4,161,1,62,367,5.9,4,83,528,6.4,11,22,0,33,7,55,1,0,1
14414,11,2018-11-17,florida,,Idaho,W (63-10),31,43,72.1,399,5,35,204,5.8,2,78,603,7.7,16,15,1,32,5,55,1,0,1
14415,,11 Games,florida,,,,187,313,59.7,2352,24,433,2233,5.2,18,746,4585,6.1,107,123,15,245,83,726,8,6,14
14416,1,2014-08-30,auburn,,Arkansas,W (45-21),16,22,72.7,293,2,48,302,6.3,3,70,595,8.5,11,15,1,27,7,71,1,0,1
14417,2,2014-09-06,auburn,,San Jose State,W (59-13),13,23,56.5,135,1,50,358,7.2,6,73,493,6.8,6,18,2,26,5,45,2,0,2
14418,3,2014-09-18,auburn,@,Kansas State,W (20-14),17,31,54.8,231,2,45,128,2.8,0,76,359,4.7,15,7,0,22,6,46,0,1,1
14419,4,2014-09-27,auburn,,Louisiana Tech,W (45-17),14,22,63.6,219,4,48,254,5.3,1,70,473,6.8,9,14,0,23,5,51,0,0,0
14420,5,2014-10-04,auburn,,Louisiana State,W (41-7),17,25,68.0,268,2,49,298,6.1,3,74,566,7.6,9,15,1,25,7,80,1,0,1
14421,6,2014-10-11,auburn,@,Mississippi State,L (23-38),17,35,48.6,209,2,43,232,5.4,0,78,441,5.7,9,15,1,25,6,56,2,2,4
14422,7,2014-10-25,auburn,,South Carolina,W (42-35),13,15,86.7,156,1,47,395,8.4,5,62,551,8.9,9,16,0,25,4,53,1,0,1
14423,8,2014-11-01,auburn,@,Mississippi,W (35-31),15,22,68.2,254,2,46,248,5.4,3,68,502,7.4,10,12,0,22,13,145,0,1,1
14424,9,2014-11-08,auburn,,Texas A&M,L (38-41),15,21,71.4,219,1,59,363,6.2,4,80,582,7.3,11,18,2,31,8,65,3,0,3
14425,10,2014-11-15,auburn,@,Georgia,L (7-34),15,28,53.6,142,0,35,150,4.3,1,63,292,4.6,9,8,0,17,7,78,2,1,3
14426,11,2014-11-22,auburn,,Samford,W (31-7),13,22,59.1,186,1,47,200,4.3,3,69,386,5.6,7,14,1,22,8,76,0,1,1
14427,12,2014-11-29,auburn,@,Alabama,L (44-55),27,43,62.8,456,3,47,174,3.7,1,90,630,7.0,18,9,1,28,7,55,1,1,2
14428,13,2015-01-01,auburn,N,Wisconsin*,L (31-34),16,23,69.6,216,2,43,219,5.1,2,66,435,6.6,9,11,1,21,9,75,0,0,0
14429,,13 Games,auburn,,,,208,332,62.7,2984,23,607,3321,5.5,32,939,6305,6.7,132,172,10,314,92,896,13,7,20
14430,1,2015-09-05,auburn,N,Louisville,W (31-24),11,21,52.4,137,1,41,190,4.6,2,62,327,5.3,8,11,2,21,8,80,0,3,3
14431,2,2015-09-12,auburn,,Jacksonville State,W (27-20),21,32,65.6,236,2,38,165,4.3,1,70,401,5.7,13,10,0,23,3,40,1,2,3
14432,3,2015-09-19,auburn,@,Louisiana State,L (21-45),11,19,57.9,100,2,37,160,4.3,1,56,260,4.6,5,10,1,16,4,26,1,1,2
14433,4,2015-09-26,auburn,,Mississippi State,L (9-17),20,28,71.4,188,0,50,201,4.0,0,78,389,5.0,9,16,0,25,6,40,0,1,1
14434,5,2015-10-03,auburn,,San Jose State,W (35-21),6,10,60.0,108,0,48,234,4.9,5,58,342,5.9,3,12,0,15,1,15,0,0,0
14435,6,2015-10-15,auburn,@,Kentucky,W (30-27),17,28,60.7,255,0,47,152,3.2,3,75,407,5.4,11,9,1,21,5,49,0,0,0
14436,7,2015-10-24,auburn,@,Arkansas,L (46-54),19,34,55.9,254,0,52,162,3.1,6,86,416,4.8,13,8,1,22,2,25,0,0,0
14437,8,2015-10-31,auburn,,Mississippi,L (19-27),13,32,40.6,302,1,41,125,3.0,0,73,427,5.8,10,8,0,18,3,20,0,1,1
14438,9,2015-11-07,auburn,@,Texas A&M,W (26-10),13,17,76.5,132,1,52,311,6.0,1,69,443,6.4,4,16,0,20,6,78,0,0,0
14439,10,2015-11-14,auburn,,Georgia,L (13-20),15,27,55.6,62,0,37,213,5.8,1,64,275,4.3,1,14,1,16,2,16,2,1,3
14440,11,2015-11-21,auburn,,Idaho,W (56-34),13,19,68.4,163,2,51,297,5.8,5,70,460,6.6,9,14,2,25,11,107,0,0,0
14441,12,2015-11-28,auburn,,Alabama,L (13-29),10,23,43.5,169,1,37,91,2.5,0,60,260,4.3,4,6,2,12,8,62,1,0,1
14442,13,2015-12-30,auburn,N,Memphis*,W (31-10),10,16,62.5,150,1,56,252,4.5,3,72,402,5.6,7,16,0,23,3,45,0,3,3
14443,,13 Games,auburn,,,,179,306,58.5,2256,11,587,2553,4.3,28,893,4809,5.4,97,150,10,257,62,603,5,12,17
14444,1,2016-09-03,auburn,,Clemson,L (13-19),15,28,53.6,175,0,41,87,2.1,1,69,262,3.8,8,6,3,17,9,60,1,2,3
14445,2,2016-09-10,auburn,,Arkansas State,W (51-14),17,23,73.9,244,3,62,462,7.5,3,85,706,8.3,10,20,2,32,5,40,1,0,1
14446,3,2016-09-17,auburn,,Texas A&M,L (16-29),22,35,62.9,163,0,54,236,4.4,2,89,399,4.5,9,14,3,26,6,28,1,0,1
14447,4,2016-09-24,auburn,,Louisiana State,W (18-13),19,26,73.1,234,0,49,154,3.1,0,75,388,5.2,10,7,1,18,4,28,1,0,1
14448,5,2016-10-01,auburn,,Louisiana-Monroe,W (58-7),15,18,83.3,278,3,66,410,6.2,5,84,688,8.2,11,23,2,36,3,15,1,0,1
14449,6,2016-10-08,auburn,@,Mississippi State,W (38-14),14,18,77.8,204,1,56,228,4.1,3,74,432,5.8,10,10,2,22,5,40,1,1,2
14450,7,2016-10-22,auburn,,Arkansas,W (56-3),7,12,58.3,89,1,57,543,9.5,7,69,632,9.2,4,22,0,26,2,10,0,0,0
14451,8,2016-10-29,auburn,@,Mississippi,W (40-29),15,22,68.2,247,1,52,307,5.9,3,74,554,7.5,12,14,0,26,4,30,0,0,0
14452,9,2016-11-05,auburn,,Vanderbilt,W (23-16),12,17,70.6,115,1,45,271,6.0,1,62,386,6.2,4,11,1,16,5,56,1,0,1
14453,10,2016-11-12,auburn,@,Georgia,L (7-13),8,22,36.4,37,0,32,127,4.0,1,54,164,3.0,2,8,0,10,3,36,0,1,1
14454,11,2016-11-19,auburn,,Alabama A&M,W (55-0),14,20,70.0,147,1,59,451,7.6,6,79,598,7.6,7,19,1,27,5,50,1,0,1
14455,12,2016-11-26,auburn,@,Alabama,L (12-30),7,19,36.8,116,0,26,66,2.5,0,45,182,4.0,3,4,0,7,4,19,0,1,1
14456,13,2017-01-02,auburn,N,Oklahoma*,L (19-35),13,27,48.1,154,1,46,185,4.0,1,73,339,4.6,7,14,1,22,6,63,0,1,1
14457,,13 Games,auburn,,,,178,287,62.0,2203,12,645,3527,5.5,33,932,5730,6.1,97,172,16,285,61,475,8,6,14
14458,1,2017-09-02,auburn,,Georgia Southern,W (41-7),15,26,57.7,184,2,53,351,6.6,3,79,535,6.8,10,15,0,25,4,42,2,1,3
14459,2,2017-09-09,auburn,@,Clemson,L (6-14),13,24,54.2,79,0,42,38,0.9,0,66,117,1.8,2,9,2,13,5,43,0,0,0
14460,3,2017-09-16,auburn,,Mercer,W (24-10),32,37,86.5,364,0,43,146,3.4,3,80,510,6.4,16,8,2,26,6,65,4,1,5
14461,4,2017-09-23,auburn,@,Missouri,W (51-14),16,21,76.2,219,1,53,263,5.0,5,74,482,6.5,7,12,3,22,5,50,0,0,0
14462,5,2017-09-30,auburn,,Mississippi State,W (49-10),14,17,82.4,267,2,39,244,6.3,4,56,511,9.1,5,8,1,14,1,15,2,0,2
14463,6,2017-10-07,auburn,,Mississippi,W (44-23),14,21,66.7,235,2,51,326,6.4,3,72,561,7.8,8,15,2,25,3,30,0,0,0
14464,7,2017-10-14,auburn,@,Louisiana State,L (23-27),9,26,34.6,165,1,44,189,4.3,1,70,354,5.1,5,9,3,17,6,26,0,0,0
14465,8,2017-10-21,auburn,@,Arkansas,W (52-20),21,30,70.0,284,2,47,345,7.3,5,77,629,8.2,8,17,1,26,3,25,1,1,2
14466,9,2017-11-04,auburn,@,Texas A&M,W (42-27),20,27,74.1,268,3,52,228,4.4,2,79,496,6.3,8,14,1,23,3,34,0,0,0
14467,10,2017-11-11,auburn,,Georgia,W (40-17),17,25,68.0,251,3,46,237,5.2,1,71,488,6.9,8,14,3,25,5,29,0,0,0
14468,11,2017-11-18,auburn,,Louisiana-Monroe,W (42-14),18,24,75.0,235,2,48,317,6.6,3,72,552,7.7,10,15,0,25,5,41,1,1,2
14469,12,2017-11-25,auburn,,Alabama,W (26-14),22,29,75.9,240,1,49,168,3.4,2,78,408,5.2,15,8,2,25,4,40,1,0,1
14470,13,2017-12-02,auburn,N,Georgia,L (7-28),16,32,50.0,145,1,31,114,3.7,0,63,259,4.1,7,9,2,18,5,39,2,0,2
14471,14,2018-01-01,auburn,N,Central Florida*,L (27-34),28,43,65.1,331,1,44,90,2.0,2,87,421,4.8,17,8,3,28,8,61,1,2,3
14472,,14 Games,auburn,,,,255,382,66.8,3267,21,642,3056,4.8,34,1024,6323,6.2,126,161,25,312,63,540,14,6,20
14473,1,2018-09-01,auburn,N,Washington,W (21-16),26,36,72.2,273,1,45,147,3.3,1,81,420,5.2,17,8,2,27,12,111,0,0,0
14474,2,2018-09-08,auburn,,Alabama State,W (63-9),8,14,57.1,138,1,59,429,7.3,6,73,567,7.8,4,22,2,28,4,30,4,0,4
14475,3,2018-09-15,auburn,,Louisiana State,L (21-22),16,28,57.1,198,1,38,130,3.4,2,66,328,5.0,10,5,4,19,9,111,0,2,2
14476,4,2018-09-22,auburn,,Arkansas,W (34-3),15,22,68.2,134,0,36,91,2.5,3,58,225,3.9,6,6,1,13,7,40,0,0,0
14477,5,2018-09-29,auburn,,Southern Mississippi,W (24-13),19,33,57.6,245,2,36,96,2.7,1,69,341,4.9,8,7,2,17,9,78,1,0,1
14478,6,2018-10-06,auburn,@,Mississippi State,L (9-23),19,38,50.0,214,0,21,90,4.3,0,59,304,5.2,9,5,1,15,2,10,2,0,2
14479,7,2018-10-13,auburn,,Tennessee,L (24-30),28,45,62.2,322,2,34,126,3.7,1,79,448,5.7,13,8,1,22,5,38,1,2,3
14480,8,2018-10-20,auburn,@,Mississippi,W (31-16),13,22,59.1,215,1,46,269,5.8,3,68,484,7.1,5,15,0,20,8,80,0,0,0
14481,9,2018-11-03,auburn,,Texas A&M,W (28-24),19,30,63.3,259,3,21,19,0.9,1,51,278,5.5,11,2,0,13,6,39,0,0,0
14482,10,2018-11-10,auburn,@,Georgia,L (10-27),25,37,67.6,172,1,20,102,5.1,0,57,274,4.8,10,6,3,19,6,52,0,0,0
14483,11,2018-11-17,auburn,,Liberty,W (53-0),14,21,66.7,191,2,61,340,5.6,3,82,531,6.5,8,22,0,29,3,25,0,0,0
14484,,11 Games,auburn,,,,202,326,62.0,2361,14,417,1839,4.4,21,743,4200,5.7,101,106,16,222,71,614,8,4,12
14485,1,2014-08-30,missouri,,South Dakota State,W (38-18),13,21,61.9,178,3,39,215,5.5,1,60,393,6.6,6,13,0,19,5,27,0,0,0
14486,2,2014-09-06,missouri,@,Toledo,W (49-24),21,33,63.6,325,5,47,177,3.8,2,80,502,6.3,15,9,1,25,2,25,0,2,2
14487,3,2014-09-13,missouri,,Central Florida,W (38-10),14,24,58.3,144,4,35,178,5.1,0,59,322,5.5,8,10,1,19,4,47,0,1,1
14488,4,2014-09-20,missouri,,Indiana,L (27-31),29,48,60.4,331,2,35,172,4.9,1,83,503,6.1,18,8,2,27,10,75,0,1,1
14489,5,2014-09-27,missouri,@,South Carolina,W (21-20),12,34,35.3,132,0,36,148,4.1,3,70,280,4.0,5,9,2,16,8,74,0,0,0
14490,6,2014-10-11,missouri,,Georgia,L (0-34),9,21,42.9,97,0,22,50,2.3,0,43,147,3.4,5,4,1,10,4,30,1,4,5
14491,7,2014-10-18,missouri,@,Florida,W (42-13),6,18,33.3,20,0,31,99,3.2,1,49,119,2.4,1,6,0,7,11,74,0,1,1
14492,8,2014-10-25,missouri,,Vanderbilt,W (24-14),11,23,47.8,141,2,46,244,5.3,1,69,385,5.6,7,12,1,20,14,100,0,0,0
14493,9,2014-11-01,missouri,,Kentucky,W (20-10),18,33,54.5,164,2,45,156,3.5,0,78,320,4.1,10,8,3,21,5,50,0,0,0
14494,10,2014-11-15,missouri,@,Texas A&M,W (34-27),23,40,57.5,252,1,49,335,6.8,3,89,587,6.6,13,16,3,32,12,81,0,1,1
14495,11,2014-11-22,missouri,@,Tennessee,W (29-21),12,25,48.0,230,2,45,180,4.0,2,70,410,5.9,8,9,2,19,12,82,0,0,0
14496,12,2014-11-28,missouri,,Arkansas,W (21-14),25,42,59.5,265,1,41,158,3.9,1,83,423,5.1,12,12,2,26,7,75,1,1,2
14497,13,2014-12-06,missouri,N,Alabama,L (13-42),16,34,47.1,272,1,23,41,1.8,0,57,313,5.5,9,1,0,10,6,60,1,0,1
14498,14,2015-01-01,missouri,N,Minnesota*,W (33-17),12,19,63.2,97,2,45,337,7.5,2,64,434,6.8,5,12,1,18,2,15,0,2,2
14499,,14 Games,missouri,,,,221,415,53.3,2648,25,539,2490,4.6,17,954,5138,5.4,122,129,19,269,102,815,3,13,16
14500,1,2015-09-05,missouri,,Southeast Missouri State,W (34-3),18,32,56.3,319,3,33,98,3.0,0,65,417,6.4,11,5,3,19,6,54,0,1,1
14501,2,2015-09-12,missouri,@,Arkansas State,W (27-20),16,37,43.2,148,3,34,140,4.1,0,71,288,4.1,8,8,3,19,9,75,0,3,3
14502,3,2015-09-19,missouri,,Connecticut,W (9-6),20,31,64.5,185,0,34,85,2.5,1,65,270,4.2,7,7,2,16,3,30,1,1,2
14503,4,2015-09-26,missouri,@,Kentucky,L (13-21),18,35,51.4,227,1,33,111,3.4,0,68,338,5.0,12,7,5,24,3,30,0,0,0
14504,5,2015-10-03,missouri,,South Carolina,W (24-10),21,28,75.0,136,2,42,163,3.9,1,70,299,4.3,5,13,0,18,3,29,0,0,0
14505,6,2015-10-10,missouri,,Florida,L (3-21),16,39,41.0,151,0,26,106,4.1,0,65,257,4.0,6,6,0,12,6,38,0,2,2
14506,7,2015-10-17,missouri,@,Georgia,L (6-9),11,26,42.3,143,0,22,21,1.0,0,48,164,3.4,5,0,1,6,4,27,1,0,1
14507,8,2015-10-24,missouri,@,Vanderbilt,L (3-10),14,34,41.2,108,0,19,80,4.2,0,53,188,3.5,5,3,2,10,6,37,1,0,1
14508,9,2015-11-05,missouri,,Mississippi State,L (13-31),11,26,42.3,107,0,45,215,4.8,1,71,322,4.5,6,9,1,16,6,38,0,2,2
14509,10,2015-11-14,missouri,N,Brigham Young,W (20-16),19,28,67.9,244,1,55,190,3.5,1,83,434,5.2,12,9,2,23,8,91,1,1,2
14510,11,2015-11-21,missouri,,Tennessee,L (8-19),13,30,43.3,135,0,29,88,3.0,1,59,223,3.8,5,4,1,10,7,50,1,1,2
14511,12,2015-11-27,missouri,@,Arkansas,L (3-28),9,27,33.3,83,0,25,88,3.5,0,52,171,3.3,3,5,0,8,2,18,0,1,1
14512,,12 Games,missouri,,,,186,373,49.9,1986,10,397,1385,3.5,5,770,3371,4.4,85,76,20,181,63,517,5,12,17
14513,1,2016-09-03,missouri,@,West Virginia,L (11-26),24,53,45.3,282,1,47,180,3.8,0,100,462,4.6,11,13,2,26,6,51,1,0,1
14514,2,2016-09-10,missouri,,Eastern Michigan,W (61-21),27,40,67.5,477,5,38,170,4.5,2,78,647,8.3,15,12,3,30,8,75,2,0,2
14515,3,2016-09-17,missouri,,Georgia,L (27-28),23,38,60.5,376,3,37,95,2.6,0,75,471,6.3,10,8,0,18,7,50,2,3,5
14516,4,2016-09-24,missouri,,Delaware State,W (79-0),29,39,74.4,430,6,39,268,6.9,5,78,698,8.9,15,17,2,34,6,60,0,0,0
14517,5,2016-10-01,missouri,@,Louisiana State,L (7-42),18,38,47.4,188,1,22,77,3.5,0,60,265,4.4,10,3,1,14,5,50,0,1,1
14518,6,2016-10-15,missouri,@,Florida,L (14-40),7,22,31.8,98,0,46,265,5.8,2,68,363,5.3,4,11,1,16,5,24,1,2,3
14519,7,2016-10-22,missouri,,Middle Tennessee State,L (45-51),20,40,50.0,281,2,64,348,5.4,4,104,629,6.0,13,21,2,36,13,125,2,0,2
14520,8,2016-10-29,missouri,,Kentucky,L (21-35),19,32,59.4,229,2,37,157,4.2,1,69,386,5.6,9,8,1,18,9,65,0,0,0
14521,9,2016-11-05,missouri,@,South Carolina,L (21-31),23,40,57.5,302,1,36,163,4.5,2,76,465,6.1,12,11,1,24,5,45,1,2,3
14522,10,2016-11-12,missouri,,Vanderbilt,W (26-17),22,37,59.5,294,2,37,187,5.1,1,74,481,6.5,10,7,3,20,7,90,1,0,1
14523,11,2016-11-19,missouri,@,Tennessee,L (37-63),21,43,48.8,320,1,67,420,6.3,4,110,740,6.7,13,27,1,41,7,51,2,2,4
14524,12,2016-11-25,missouri,,Arkansas,W (28-24),16,26,61.5,268,1,30,131,4.4,3,56,399,7.1,8,6,1,15,2,10,1,0,1
14525,,12 Games,missouri,,,,249,448,55.6,3545,25,500,2461,4.9,24,948,6006,6.3,130,144,18,292,80,696,13,10,23
14526,1,2017-09-02,missouri,,Missouri State,W (72-43),21,34,61.8,521,7,41,294,7.2,3,75,815,10.9,19,15,1,35,6,52,1,1,2
14527,2,2017-09-09,missouri,,South Carolina,L (13-31),14,32,43.8,245,1,37,178,4.8,0,69,423,6.1,10,11,0,21,4,24,1,2,3
14528,3,2017-09-16,missouri,,Purdue,L (3-35),12,28,42.9,133,0,24,70,2.9,0,52,203,3.9,5,4,1,10,6,46,1,2,3
14529,4,2017-09-23,missouri,,Auburn,L (14-51),23,39,59.0,216,2,30,124,4.1,0,69,340,4.9,12,7,2,21,7,55,3,1,4
14530,5,2017-10-07,missouri,@,Kentucky,L (34-40),22,43,51.2,355,3,33,213,6.5,1,76,568,7.5,11,13,0,24,7,55,2,0,2
14531,6,2017-10-14,missouri,@,Georgia,L (28-53),15,25,60.0,253,4,24,59,2.5,0,49,312,6.4,6,4,0,10,4,40,0,1,1
14532,7,2017-10-21,missouri,,Idaho,W (68-21),24,34,70.6,475,6,30,183,6.1,2,64,658,10.3,20,7,1,28,6,45,0,1,1
14533,8,2017-10-28,missouri,@,Connecticut,W (52-12),34,43,79.1,408,5,34,175,5.1,2,77,583,7.6,16,12,3,31,12,107,0,1,1
14534,9,2017-11-04,missouri,,Florida,W (45-16),15,21,71.4,228,3,46,227,4.9,3,67,455,6.8,10,12,4,26,7,71,0,1,1
14535,10,2017-11-11,missouri,,Tennessee,W (50-17),14,30,46.7,226,4,53,433,8.2,2,83,659,7.9,7,20,2,29,7,60,0,1,1
14536,11,2017-11-18,missouri,@,Vanderbilt,W (45-17),10,25,40.0,235,3,39,191,4.9,1,64,426,6.7,7,9,1,17,11,56,0,0,0
14537,12,2017-11-24,missouri,@,Arkansas,W (48-45),25,42,59.5,448,5,60,248,4.1,1,102,696,6.8,17,14,4,35,10,77,0,2,2
14538,13,2017-12-27,missouri,N,Texas*,L (16-33),18,34,52.9,269,1,33,134,4.1,1,67,403,6.0,10,5,2,17,9,86,3,1,4
14539,,13 Games,missouri,,,,247,430,57.4,4012,44,484,2529,5.2,16,914,6541,7.2,150,133,21,304,96,774,11,14,25
14540,1,2018-09-01,missouri,,Tennessee-Martin,W (51-14),23,34,67.6,394,4,44,164,3.7,2,78,558,7.2,13,8,5,26,4,45,0,0,0
14541,2,2018-09-08,missouri,,Wyoming,W (40-13),33,45,73.3,398,4,46,203,4.4,1,91,601,6.6,23,10,0,33,8,79,1,0,1
14542,3,2018-09-15,missouri,@,Purdue,W (40-37),26,43,60.5,375,3,46,233,5.1,1,89,608,6.8,14,14,3,31,4,27,0,1,1
14543,4,2018-09-22,missouri,,Georgia,L (29-43),23,48,47.9,221,0,37,172,4.6,4,85,393,4.6,15,9,2,26,5,30,2,1,3
14544,5,2018-10-06,missouri,@,South Carolina,L (35-37),17,36,47.2,204,0,46,286,6.2,3,82,490,6.0,9,10,4,23,10,83,0,2,2
14545,6,2018-10-13,missouri,@,Alabama,L (10-39),13,26,50.0,142,1,35,70,2.0,0,61,212,3.5,6,5,2,13,5,53,1,2,3
14546,7,2018-10-20,missouri,,Memphis,W (65-33),24,32,75.0,373,4,40,273,6.8,4,72,646,9.0,13,14,3,30,12,122,0,0,0
14547,8,2018-10-27,missouri,,Kentucky,L (14-15),15,27,55.6,165,0,35,84,2.4,2,62,249,4.0,7,3,3,13,8,69,0,0,0
14548,9,2018-11-03,missouri,@,Florida,W (38-17),24,32,75.0,250,3,42,221,5.3,2,74,471,6.4,12,10,0,22,11,84,0,0,0
14549,10,2018-11-10,missouri,,Vanderbilt,W (33-28),22,33,66.7,253,2,49,253,5.2,2,82,506,6.2,12,17,1,30,2,15,0,2,2
14550,11,2018-11-17,missouri,@,Tennessee,W (50-17),21,30,70.0,257,2,49,227,4.6,3,79,484,6.1,14,12,3,29,10,79,1,0,1
14551,,11 Games,missouri,,,,241,386,62.4,3032,23,469,2186,4.7,24,855,5218,6.1,138,112,26,276,79,686,5,8,13
14552,1,2014-08-30,arkansas,@,Auburn,L (21-45),18,31,58.1,175,2,29,153,5.3,1,60,328,5.5,9,9,2,20,4,40,0,1,1
14553,2,2014-09-06,arkansas,,Nicholls State,W (73-7),8,14,57.1,189,4,40,495,12.4,6,54,684,12.7,7,19,0,26,7,69,0,1,1
14554,3,2014-09-13,arkansas,@,Texas Tech,W (49-28),6,12,50.0,61,0,68,438,6.4,7,80,499,6.2,5,24,3,32,2,15,2,0,2
14555,4,2014-09-20,arkansas,,Northern Illinois,W (52-14),16,23,69.6,215,2,45,212,4.7,3,68,427,6.3,11,11,2,24,4,30,0,0,0
14556,5,2014-09-27,arkansas,N,Texas A&M,L (28-35),15,27,55.6,199,1,47,285,6.1,3,74,484,6.5,7,13,2,22,8,76,1,0,1
14557,6,2014-10-11,arkansas,,Alabama,L (13-14),21,40,52.5,246,1,39,89,2.3,1,79,335,4.2,12,5,1,18,4,28,2,1,3
14558,7,2014-10-18,arkansas,N,Georgia,L (32-45),28,45,62.2,296,3,37,126,3.4,2,82,422,5.1,13,9,7,29,7,79,2,2,4
14559,8,2014-10-25,arkansas,,Alabama-Birmingham,W (45-17),16,26,61.5,211,3,46,273,5.9,3,72,484,6.7,10,14,0,24,2,9,1,0,1
14560,9,2014-11-01,arkansas,@,Mississippi State,L (10-17),22,44,50.0,238,0,38,163,4.3,1,82,401,4.9,13,8,0,21,6,40,0,1,1
14561,10,2014-11-15,arkansas,,Louisiana State,W (17-0),16,27,59.3,169,0,38,95,2.5,2,65,264,4.1,10,6,1,17,4,43,0,0,0
14562,11,2014-11-22,arkansas,,Mississippi,W (30-0),8,17,47.1,152,1,50,159,3.2,1,67,311,4.6,7,10,0,17,6,44,1,0,1
14563,12,2014-11-28,arkansas,@,Missouri,L (14-21),13,30,43.3,133,2,30,155,5.2,0,60,288,4.8,9,7,2,18,12,93,2,0,2
14564,13,2014-12-29,arkansas,N,Texas*,W (31-7),12,23,52.2,160,2,50,191,3.8,1,73,351,4.8,7,11,2,20,2,15,0,0,0
14565,,13 Games,arkansas,,,,199,359,55.4,2444,21,557,2834,5.1,31,916,5278,5.8,120,146,22,288,68,581,11,6,17
14566,1,2015-09-05,arkansas,,Texas-El Paso,W (48-13),14,20,70.0,308,4,34,182,5.4,2,54,490,9.1,11,7,0,18,6,68,0,0,0
14567,2,2015-09-12,arkansas,N,Toledo,L (12-16),32,53,60.4,412,0,31,103,3.3,1,84,515,6.1,20,9,1,30,9,85,0,1,1
14568,3,2015-09-19,arkansas,,Texas Tech,L (24-35),16,21,76.2,196,2,43,228,5.3,1,64,424,6.6,10,12,1,23,5,43,1,1,2
14569,4,2015-09-26,arkansas,N,Texas A&M,L (21-28),20,25,80.0,225,1,42,232,5.5,2,67,457,6.8,11,13,1,25,11,93,1,1,2
14570,5,2015-10-03,arkansas,@,Tennessee,W (24-20),11,24,45.8,219,1,49,288,5.9,2,73,507,6.9,10,12,1,23,3,20,0,0,0
14571,6,2015-10-10,arkansas,@,Alabama,L (14-27),15,32,46.9,176,2,25,44,1.8,0,57,220,3.9,8,1,1,10,7,44,0,1,1
14572,7,2015-10-24,arkansas,,Auburn,W (54-46),20,32,62.5,244,3,49,213,4.3,4,81,457,5.6,14,14,1,29,3,25,0,1,1
14573,8,2015-10-31,arkansas,,Tennessee-Martin,W (63-28),15,20,75.0,300,3,36,291,8.1,6,56,591,10.6,10,12,0,22,3,25,0,0,0
14574,9,2015-11-07,arkansas,@,Mississippi,W (53-52),33,45,73.3,442,6,39,163,4.2,1,84,605,7.2,24,9,1,34,2,20,0,0,0
14575,10,2015-11-14,arkansas,@,Louisiana State,W (31-14),9,16,56.3,141,1,40,299,7.5,3,56,440,7.9,7,10,0,17,2,20,1,1,2
14576,11,2015-11-21,arkansas,,Mississippi State,L (50-51),30,43,69.8,406,7,29,73,2.5,0,72,479,6.7,21,2,1,24,1,9,0,0,0
14577,12,2015-11-27,arkansas,,Missouri,W (28-3),11,17,64.7,102,0,52,208,4.0,4,69,310,4.5,6,12,1,19,1,5,0,1,1
14578,13,2016-01-02,arkansas,N,Kansas State*,W (45-23),20,26,76.9,315,1,42,254,6.0,5,68,569,8.4,14,16,0,30,2,20,0,1,1
14579,,13 Games,arkansas,,,,246,374,65.8,3486,31,511,2578,5.0,31,885,6064,6.9,166,129,9,304,55,477,3,8,11
14580,1,2016-09-03,arkansas,,Louisiana Tech,W (21-20),20,29,69.0,191,2,40,106,2.7,1,69,297,4.3,12,8,1,21,4,35,0,2,2
14581,2,2016-09-10,arkansas,@,Texas Christian,W (41-38),17,29,58.6,223,3,43,180,4.2,1,72,403,5.6,11,9,0,20,5,45,0,0,0
14582,3,2016-09-17,arkansas,,Texas State,W (42-3),16,22,72.7,241,2,44,226,5.1,3,66,467,7.1,9,15,2,26,7,40,1,0,1
14583,4,2016-09-24,arkansas,N,Texas A&M,L (24-45),28,42,66.7,371,2,40,120,3.0,1,82,491,6.0,17,4,6,27,7,62,3,0,3
14584,5,2016-10-01,arkansas,,Alcorn State,W (52-10),13,18,72.2,206,3,38,353,9.3,3,56,559,10.0,8,17,0,25,4,45,1,0,1
14585,6,2016-10-08,arkansas,,Alabama,L (30-49),25,48,52.1,400,3,36,73,2.0,1,84,473,5.6,13,7,5,25,6,60,2,3,5
14586,7,2016-10-15,arkansas,,Mississippi,W (34-30),19,32,59.4,229,3,51,200,3.9,1,83,429,5.2,13,12,2,27,6,71,0,1,1
14587,8,2016-10-22,arkansas,@,Auburn,L (3-56),18,33,54.5,190,0,31,25,0.8,0,64,215,3.4,10,4,0,14,4,29,1,1,2
14588,9,2016-11-05,arkansas,,Florida,W (31-10),15,26,57.7,243,1,49,223,4.6,2,75,466,6.2,10,9,3,22,9,97,0,1,1
14589,10,2016-11-12,arkansas,,Louisiana State,L (10-38),15,31,48.4,210,1,24,81,3.4,0,55,291,5.3,8,4,1,13,7,56,1,2,3
14590,11,2016-11-19,arkansas,@,Mississippi State,W (58-42),19,26,73.1,304,3,40,359,9.0,5,66,663,10.0,14,13,0,27,1,10,0,0,0
14591,12,2016-11-25,arkansas,@,Missouri,L (24-28),24,39,61.5,348,1,46,155,3.4,2,85,503,5.9,14,13,0,27,8,55,0,2,2
14592,13,2016-12-29,arkansas,N,Virginia Tech*,L (24-35),18,31,58.1,278,2,34,36,1.1,1,65,314,4.8,11,1,2,16,12,70,1,3,4
14593,,13 Games,arkansas,,,,247,406,60.8,3434,26,516,2137,4.1,21,922,5571,6.0,150,116,22,290,80,675,10,15,25
14594,1,2017-08-31,arkansas,N,Florida A&M,W (49-7),16,22,72.7,179,2,45,236,5.2,4,67,415,6.2,9,16,1,26,2,20,0,1,1
14595,2,2017-09-09,arkansas,,Texas Christian,L (7-28),9,23,39.1,138,1,31,129,4.2,0,54,267,4.9,6,5,2,13,5,49,1,0,1
14596,3,2017-09-23,arkansas,N,Texas A&M,L (43-50),13,27,48.1,231,3,45,226,5.0,3,72,457,6.3,8,12,1,21,9,69,0,1,1
14597,4,2017-09-30,arkansas,,New Mexico State,W (42-24),19,26,73.1,264,3,51,230,4.5,3,77,494,6.4,13,13,3,29,3,35,0,1,1
14598,5,2017-10-07,arkansas,@,South Carolina,L (22-48),20,37,54.1,224,2,32,106,3.3,1,69,330,4.8,11,7,1,19,4,25,2,2,4
14599,6,2017-10-14,arkansas,@,Alabama,L (9-41),23,43,53.5,200,1,29,27,0.9,0,72,227,3.2,9,3,3,15,5,25,0,1,1
14600,7,2017-10-21,arkansas,,Auburn,L (20-52),15,26,57.7,163,0,42,171,4.1,1,68,334,4.9,7,10,2,19,7,50,3,0,3
14601,8,2017-10-28,arkansas,@,Mississippi,W (38-37),19,30,63.3,189,3,53,260,4.9,1,83,449,5.4,10,15,2,27,1,10,1,1,2
14602,9,2017-11-04,arkansas,,Coastal Carolina,W (39-38),16,25,64.0,264,1,35,259,7.4,4,60,523,8.7,8,13,0,21,5,52,1,0,1
14603,10,2017-11-11,arkansas,@,Louisiana State,L (10-33),16,33,48.5,176,0,34,142,4.2,1,67,318,4.7,10,6,1,17,5,59,0,1,1
14604,11,2017-11-18,arkansas,,Mississippi State,L (21-28),12,18,66.7,124,0,34,97,2.9,2,52,221,4.3,7,3,2,12,4,35,1,0,1
14605,12,2017-11-24,arkansas,,Missouri,L (45-48),14,30,46.7,313,2,31,133,4.3,4,61,446,7.3,10,7,2,19,8,76,0,1,1
14606,,12 Games,arkansas,,,,192,340,56.5,2465,18,462,2016,4.4,24,802,4481,5.6,108,110,20,238,58,505,9,9,18
14607,1,2018-09-01,arkansas,,Eastern Illinois,W (55-20),21,29,72.4,353,4,37,80,2.2,2,66,433,6.6,13,5,0,18,4,40,0,0,0
14608,2,2018-09-08,arkansas,@,Colorado State,L (27-34),11,22,50.0,138,2,53,299,5.6,1,75,437,5.8,5,16,3,24,6,60,0,2,2
14609,3,2018-09-15,arkansas,,North Texas,L (17-44),20,45,44.4,210,0,32,126,3.9,2,77,336,4.4,12,4,4,20,10,70,0,6,6
14610,4,2018-09-22,arkansas,@,Auburn,L (3-34),13,32,40.6,141,0,38,149,3.9,0,70,290,4.1,5,6,2,13,8,57,1,1,2
14611,5,2018-09-29,arkansas,N,Texas A&M,L (17-24),14,27,51.9,193,1,26,55,2.1,1,53,248,4.7,8,3,0,11,6,61,0,1,1
14612,6,2018-10-06,arkansas,,Alabama,L (31-65),26,40,65.0,233,3,31,172,5.5,1,71,405,5.7,12,7,3,22,2,20,2,1,3
14613,7,2018-10-13,arkansas,,Mississippi,L (33-37),15,22,68.2,177,2,48,299,6.2,1,70,476,6.8,7,17,3,27,5,65,0,1,1
14614,8,2018-10-20,arkansas,,Tulsa,W (23-0),11,19,57.9,131,1,53,196,3.7,1,72,327,4.5,6,12,2,20,3,40,1,1,2
14615,9,2018-10-27,arkansas,,Vanderbilt,L (31-45),23,36,63.9,240,2,29,207,7.1,2,65,447,6.9,12,8,1,21,6,46,0,2,2
14616,10,2018-11-10,arkansas,,Louisiana State,L (17-24),19,39,48.7,200,2,19,16,0.8,0,58,216,3.7,9,2,3,14,6,60,1,1,2
14617,11,2018-11-17,arkansas,@,Mississippi State,L (6-52),19,34,55.9,150,0,35,69,2.0,0,69,219,3.2,6,10,1,17,9,85,2,1,3
14618,,11 Games,arkansas,,,,192,345,55.7,2166,17,401,1668,4.2,11,746,3834,5.1,95,90,22,207,65,604,7,17,24
14619,1,2014-08-28,south-carolina,,Texas A&M,L (28-52),20,40,50.0,366,4,22,67,3.0,0,62,433,7.0,14,5,4,23,4,21,0,1,1
14620,2,2014-09-06,south-carolina,,East Carolina,W (33-23),25,38,65.8,266,1,38,175,4.6,2,76,441,5.8,15,10,1,26,5,60,0,1,1
14621,3,2014-09-13,south-carolina,,Georgia,W (38-35),21,30,70.0,271,3,42,176,4.2,2,72,447,6.2,13,13,1,27,7,69,1,1,2
14622,4,2014-09-20,south-carolina,@,Vanderbilt,W (48-34),22,34,64.7,237,3,34,212,6.2,2,68,449,6.6,10,12,2,24,5,35,1,0,1
14623,5,2014-09-27,south-carolina,,Missouri,L (20-21),21,37,56.8,219,1,42,119,2.8,1,79,338,4.3,7,9,2,18,8,71,0,0,0
14624,6,2014-10-04,south-carolina,@,Kentucky,L (38-45),23,37,62.2,218,1,48,282,5.9,4,85,500,5.9,13,16,3,32,4,35,0,3,3
14625,7,2014-10-18,south-carolina,,Furman,W (41-10),16,28,57.1,281,2,43,267,6.2,3,71,548,7.7,11,14,1,26,7,53,2,0,2
14626,8,2014-10-25,south-carolina,@,Auburn,L (35-42),30,53,56.6,416,5,33,119,3.6,0,86,535,6.2,20,7,3,30,4,20,0,3,3
14627,9,2014-11-01,south-carolina,,Tennessee,L (42-45),21,34,61.8,377,3,39,248,6.4,3,73,625,8.6,14,12,0,26,7,51,0,1,1
14628,10,2014-11-15,south-carolina,@,Florida,W (23-20),22,42,52.4,206,0,38,95,2.5,3,80,301,3.8,8,8,3,19,6,67,1,0,1
14629,11,2014-11-22,south-carolina,,South Alabama,W (37-12),11,20,55.0,244,2,37,210,5.7,1,57,454,8.0,7,12,1,20,6,57,4,1,5
14630,12,2014-11-29,south-carolina,@,Clemson,L (17-35),23,41,56.1,276,1,33,63,1.9,1,74,339,4.6,8,8,2,18,2,6,1,0,1
14631,13,2014-12-27,south-carolina,N,Miami (FL)*,W (24-21),22,34,64.7,294,2,30,60,2.0,1,64,354,5.5,10,5,1,16,5,61,0,0,0
14632,,13 Games,south-carolina,,,,277,468,59.2,3671,28,479,2093,4.4,23,947,5764,6.1,150,131,24,305,70,606,10,11,21
14633,1,2015-09-03,south-carolina,N,North Carolina,W (17-13),12,27,44.4,140,1,47,254,5.4,1,74,394,5.3,7,15,0,22,8,60,0,0,0
14634,2,2015-09-12,south-carolina,,Kentucky,L (22-26),17,27,63.0,222,1,34,195,5.7,1,61,417,6.8,10,9,3,22,5,50,0,1,1
14635,3,2015-09-19,south-carolina,@,Georgia,L (20-52),10,22,45.5,84,0,39,174,4.5,2,61,258,4.2,7,8,1,16,4,40,0,1,1
14636,4,2015-09-26,south-carolina,,Central Florida,W (31-14),12,25,48.0,184,2,43,216,5.0,1,68,400,5.9,9,10,1,20,2,20,1,0,1
14637,5,2015-10-03,south-carolina,@,Missouri,L (10-24),17,30,56.7,186,1,34,112,3.3,0,64,298,4.7,9,7,1,17,4,35,0,3,3
14638,6,2015-10-10,south-carolina,,Louisiana State,L (24-45),15,30,50.0,209,2,20,74,3.7,0,50,283,5.7,6,6,0,12,5,32,0,1,1
14639,7,2015-10-17,south-carolina,,Vanderbilt,W (19-10),17,29,58.6,272,1,37,152,4.1,0,66,424,6.4,10,6,1,17,6,39,1,1,2
14640,8,2015-10-31,south-carolina,@,Texas A&M,L (28-35),15,24,62.5,192,0,43,253,5.9,4,67,445,6.6,8,11,0,19,5,26,0,2,2
14641,9,2015-11-07,south-carolina,@,Tennessee,L (24-27),20,39,51.3,233,3,40,152,3.8,0,79,385,4.9,11,10,2,23,6,40,1,0,1
14642,10,2015-11-14,south-carolina,,Florida,L (14-24),14,25,56.0,180,2,23,21,0.9,0,48,201,4.2,9,1,3,13,4,45,0,2,2
14643,11,2015-11-21,south-carolina,,Citadel,L (22-23),28,43,65.1,367,1,25,72,2.9,1,68,439,6.5,14,4,0,18,7,51,0,0,0
14644,12,2015-11-28,south-carolina,,Clemson,L (32-37),14,30,46.7,221,3,38,181,4.8,1,68,402,5.9,7,10,0,17,4,30,0,1,1
14645,,12 Games,south-carolina,,,,191,351,54.4,2490,17,423,1856,4.4,11,774,4346,5.6,107,97,12,216,60,468,3,12,15
14646,1,2016-09-01,south-carolina,@,Vanderbilt,W (13-10),16,30,53.3,187,0,32,121,3.8,1,62,308,5.0,10,4,0,14,7,51,2,0,2
14647,2,2016-09-10,south-carolina,@,Mississippi State,L (14-27),20,39,51.3,209,2,31,34,1.1,0,70,243,3.5,12,5,1,18,6,70,1,1,2
14648,3,2016-09-17,south-carolina,,East Carolina,W (20-15),16,28,57.1,195,0,25,117,4.7,2,53,312,5.9,8,3,2,13,7,65,0,0,0
14649,4,2016-09-24,south-carolina,@,Kentucky,L (10-17),15,30,50.0,177,0,35,91,2.6,1,65,268,4.1,10,5,1,16,5,45,0,0,0
14650,5,2016-10-01,south-carolina,,Texas A&M,L (13-24),22,35,62.9,217,0,35,161,4.6,1,70,378,5.4,11,8,2,21,3,20,1,1,2
14651,6,2016-10-09,south-carolina,,Georgia,L (14-28),26,36,72.2,288,0,26,30,1.2,2,62,318,5.1,9,4,0,13,5,42,2,1,3
14652,7,2016-10-22,south-carolina,,Massachusetts,W (34-28),17,26,65.4,201,2,44,194,4.4,3,70,395,5.6,6,11,4,21,6,67,2,0,2
14653,8,2016-10-29,south-carolina,,Tennessee,W (24-21),15,21,71.4,167,2,49,158,3.2,1,70,325,4.6,8,9,2,19,7,77,0,0,0
14654,9,2016-11-05,south-carolina,,Missouri,W (31-21),22,28,78.6,254,2,49,174,3.6,2,77,428,5.6,10,11,1,22,6,45,0,0,0
14655,10,2016-11-12,south-carolina,@,Florida,L (7-20),18,33,54.5,213,0,30,43,1.4,1,63,256,4.1,10,4,1,15,2,10,1,1,2
14656,11,2016-11-19,south-carolina,,Western Carolina,W (44-31),15,24,62.5,166,0,56,422,7.5,4,80,588,7.4,8,19,1,28,3,25,1,0,1
14657,12,2016-11-26,south-carolina,@,Clemson,L (7-56),14,29,48.3,107,1,29,111,3.8,0,58,218,3.8,5,6,3,14,5,54,0,1,1
14658,13,2016-12-29,south-carolina,N,South Florida*,L (39-46),32,43,74.4,390,3,34,91,2.7,2,77,481,6.2,20,4,3,27,3,35,3,2,5
14659,,13 Games,south-carolina,,,,248,402,61.7,2771,12,475,1747,3.7,20,877,4518,5.2,127,93,21,241,65,606,13,7,20
14660,1,2017-09-02,south-carolina,N,North Carolina State,W (35-28),17,29,58.6,215,3,21,31,1.5,1,50,246,4.9,8,4,0,12,6,45,0,1,1
14661,2,2017-09-09,south-carolina,@,Missouri,W (31-13),18,28,64.3,187,1,40,172,4.3,2,68,359,5.3,9,9,2,20,4,29,0,0,0
14662,3,2017-09-16,south-carolina,,Kentucky,L (13-23),24,37,64.9,304,2,20,54,2.7,0,57,358,6.3,11,3,0,14,7,45,0,2,2
14663,4,2017-09-23,south-carolina,,Louisiana Tech,W (17-16),22,35,62.9,295,1,31,154,5.0,1,66,449,6.8,12,11,0,23,1,15,1,1,2
14664,5,2017-09-30,south-carolina,@,Texas A&M,L (17-24),17,30,56.7,256,2,26,23,0.9,0,56,279,5.0,11,2,1,14,2,10,1,0,1
14665,6,2017-10-07,south-carolina,,Arkansas,W (48-22),16,31,51.6,199,3,36,159,4.4,0,67,358,5.3,9,9,1,19,3,25,0,0,0
14666,7,2017-10-14,south-carolina,@,Tennessee,W (15-9),15,24,62.5,129,0,40,194,4.9,1,64,323,5.0,8,11,0,19,8,59,0,0,0
14667,8,2017-10-28,south-carolina,,Vanderbilt,W (34-27),19,29,65.5,174,1,37,212,5.7,3,66,386,5.8,8,14,4,26,7,50,0,0,0
14668,9,2017-11-04,south-carolina,@,Georgia,L (10-24),21,36,58.3,227,1,17,43,2.5,0,53,270,5.1,11,1,2,14,2,15,0,2,2
14669,10,2017-11-11,south-carolina,,Florida,W (28-20),19,29,65.5,249,0,47,220,4.7,4,76,469,6.2,13,9,2,24,3,26,1,3,4
14670,11,2017-11-18,south-carolina,,Wofford,W (31-10),22,28,78.6,194,1,38,195,5.1,3,66,389,5.9,9,13,1,23,3,31,0,0,0
14671,12,2017-11-25,south-carolina,,Clemson,L (10-34),16,29,55.2,126,1,25,81,3.2,0,54,207,3.8,6,4,0,10,9,76,0,2,2
14672,13,2018-01-01,south-carolina,N,Michigan*,W (26-19),19,32,59.4,239,2,26,61,2.3,1,58,300,5.2,10,2,1,13,7,68,2,1,3
14673,,13 Games,south-carolina,,,,245,397,61.7,2794,18,404,1599,4.0,16,801,4393,5.5,125,92,14,231,62,494,5,12,17
14674,1,2018-09-01,south-carolina,,Coastal Carolina,W (49-15),25,35,71.4,294,5,37,267,7.2,2,72,561,7.8,15,16,1,32,9,99,0,0,0
14675,2,2018-09-08,south-carolina,,Georgia,L (17-41),31,48,64.6,282,2,20,54,2.7,0,68,336,4.9,16,1,2,19,3,40,0,2,2
14676,3,2018-09-22,south-carolina,@,Vanderbilt,W (37-14),19,28,67.9,261,1,48,273,5.7,3,76,534,7.0,14,12,2,28,8,54,2,1,3
14677,4,2018-09-29,south-carolina,@,Kentucky,L (10-24),17,34,50.0,193,1,35,133,3.8,0,69,326,4.7,8,11,1,20,11,94,1,3,4
14678,5,2018-10-06,south-carolina,,Missouri,W (37-35),20,35,57.1,249,3,47,128,2.7,0,82,377,4.6,13,4,1,18,9,83,1,0,1
14679,6,2018-10-13,south-carolina,,Texas A&M,L (23-26),17,35,48.6,223,3,18,76,4.2,0,53,299,5.6,8,6,5,19,4,39,1,1,2
14680,7,2018-10-27,south-carolina,,Tennessee,W (27-24),11,16,68.8,152,1,40,224,5.6,2,56,376,6.7,6,12,1,19,2,9,0,1,1
14681,8,2018-11-03,south-carolina,@,Mississippi,W (48-44),22,32,68.8,363,2,36,145,4.0,3,68,508,7.5,12,6,0,18,5,51,0,0,0
14682,9,2018-11-10,south-carolina,@,Florida,L (31-35),18,28,64.3,239,2,36,147,4.1,2,64,386,6.0,10,7,1,18,7,41,0,1,1
14683,10,2018-11-17,south-carolina,,Chattanooga,W (49-9),29,36,80.6,364,4,42,238,5.7,3,78,602,7.7,13,17,3,33,6,48,0,0,0
14684,,10 Games,south-carolina,,,,209,327,63.9,2620,24,359,1685,4.7,15,686,4305,6.3,115,92,17,224,64,558,5,9,14
14685,1,2014-08-30,mississippi-state,,Southern Mississippi,W (49-0),23,34,67.6,349,5,44,201,4.6,1,78,550,7.1,20,9,0,29,3,30,1,1,2
14686,2,2014-09-06,mississippi-state,,Alabama-Birmingham,W (47-34),14,31,45.2,224,4,57,292,5.1,2,88,516,5.9,8,18,0,26,3,32,0,1,1
14687,3,2014-09-13,mississippi-state,@,South Alabama,W (35-3),16,24,66.7,226,2,45,288,6.4,3,69,514,7.4,9,14,1,24,8,70,2,0,2
14688,4,2014-09-20,mississippi-state,@,Louisiana State,W (34-29),15,24,62.5,268,2,49,302,6.2,2,73,570,7.8,9,14,0,23,6,41,2,0,2
14689,5,2014-10-04,mississippi-state,,Texas A&M,W (48-31),21,27,77.8,279,2,50,280,5.6,5,77,559,7.3,13,11,2,26,3,20,2,0,2
14690,6,2014-10-11,mississippi-state,,Auburn,W (38-23),18,35,51.4,246,1,44,223,5.1,4,79,469,5.9,12,10,2,24,7,50,1,3,4
14691,7,2014-10-25,mississippi-state,@,Kentucky,W (45-31),18,33,54.5,216,1,51,326,6.4,4,84,542,6.5,11,18,1,30,2,20,0,1,1
14692,8,2014-11-01,mississippi-state,,Arkansas,W (17-10),18,27,66.7,331,1,35,128,3.7,1,62,459,7.4,11,8,0,19,8,45,1,2,3
14693,9,2014-11-08,mississippi-state,,Tennessee-Martin,W (45-16),17,27,63.0,266,3,32,254,7.9,3,59,520,8.8,12,8,1,21,3,20,1,0,1
14694,10,2014-11-15,mississippi-state,@,Alabama,L (20-25),27,48,56.3,290,2,40,138,3.5,0,88,428,4.9,13,11,2,26,4,33,0,3,3
14695,11,2014-11-22,mississippi-state,,Vanderbilt,W (51-0),19,25,76.0,219,4,51,283,5.5,2,76,502,6.6,11,18,3,32,11,87,0,0,0
14696,12,2014-11-29,mississippi-state,@,Mississippi,L (17-31),22,37,59.5,282,1,47,163,3.5,1,84,445,5.3,11,9,1,21,4,25,0,0,0
14697,13,2014-12-31,mississippi-state,N,Georgia Tech*,L (34-49),33,51,64.7,453,3,33,152,4.6,1,84,605,7.2,19,12,2,33,5,40,1,1,2
14698,,13 Games,mississippi-state,,,,261,423,61.7,3649,31,578,3030,5.2,29,1001,6679,6.7,159,160,15,334,67,513,11,12,23
14699,1,2015-09-05,mississippi-state,@,Southern Mississippi,W (34-16),22,38,57.9,237,2,28,205,7.3,1,66,442,6.7,9,8,2,19,6,60,2,0,2
14700,2,2015-09-12,mississippi-state,,Louisiana State,L (19-21),34,54,63.0,335,1,26,43,1.7,1,80,378,4.7,0,0,0,27,5,45,0,0,0
14701,3,2015-09-19,mississippi-state,,Northwestern State,W (62-13),16,18,88.9,372,4,37,275,7.4,5,55,647,11.8,11,15,0,26,2,20,2,0,2
14702,4,2015-09-26,mississippi-state,@,Auburn,W (17-9),29,41,70.7,270,2,21,56,2.7,0,62,326,5.3,14,4,0,18,4,30,1,0,1
14703,5,2015-10-03,mississippi-state,@,Texas A&M,L (17-30),20,34,58.8,210,0,34,196,5.8,2,68,406,6.0,9,10,1,20,3,30,2,0,2
14704,6,2015-10-10,mississippi-state,,Troy,W (45-17),10,15,66.7,211,3,33,125,3.8,1,48,336,7.0,4,8,0,12,3,28,0,0,0
14705,7,2015-10-17,mississippi-state,,Louisiana Tech,W (45-20),30,43,69.8,347,3,30,93,3.1,2,73,440,6.0,16,10,2,28,4,38,0,0,0
14706,8,2015-10-24,mississippi-state,,Kentucky,W (42-16),26,36,72.2,382,3,36,204,5.7,3,72,586,8.1,19,11,0,30,6,62,0,1,1
14707,9,2015-11-05,mississippi-state,@,Missouri,W (31-13),27,41,65.9,303,4,36,127,3.5,0,77,430,5.6,12,11,0,23,2,18,2,0,2
14708,10,2015-11-14,mississippi-state,,Alabama,L (6-31),23,45,51.1,304,0,42,89,2.1,0,87,393,4.5,11,8,1,20,4,40,1,1,2
14709,11,2015-11-21,mississippi-state,@,Arkansas,W (51-50),38,51,74.5,508,5,35,123,3.5,2,86,631,7.3,21,10,1,32,3,30,2,1,3
14710,12,2015-11-28,mississippi-state,,Mississippi,L (27-38),31,42,73.8,254,2,34,148,4.4,1,76,402,5.3,12,9,0,21,6,50,1,1,2
14711,13,2015-12-30,mississippi-state,N,North Carolina State*,W (51-28),25,42,59.5,380,4,35,189,5.4,3,77,569,7.4,15,9,2,26,5,55,0,1,1
14712,,13 Games,mississippi-state,,,,331,500,66.2,4113,33,427,1873,4.4,21,927,5986,6.5,153,113,9,302,53,506,13,5,18
14713,1,2016-09-03,mississippi-state,,South Alabama,L (20-21),20,31,64.5,143,1,34,239,7.0,1,65,382,5.9,11,8,3,22,5,41,0,0,0
14714,2,2016-09-10,mississippi-state,,South Carolina,W (27-14),20,30,66.7,195,3,43,294,6.8,0,73,489,6.7,9,12,3,24,6,60,0,1,1
14715,3,2016-09-17,mississippi-state,@,Louisiana State,L (20-23),17,32,53.1,214,1,32,56,1.8,1,64,270,4.2,9,4,1,14,5,35,1,0,1
14716,4,2016-09-24,mississippi-state,@,Massachusetts,W (47-35),26,39,66.7,305,3,44,297,6.8,2,83,602,7.3,14,17,0,31,9,90,1,0,1
14717,5,2016-10-08,mississippi-state,,Auburn,L (14-38),18,35,51.4,186,2,33,103,3.1,0,68,289,4.3,9,7,0,16,7,80,2,1,3
14718,6,2016-10-14,mississippi-state,@,Brigham Young,L (21-28),18,37,48.6,223,1,49,163,3.3,2,86,386,4.5,11,9,3,23,7,63,0,2,2
14719,7,2016-10-22,mississippi-state,@,Kentucky,L (38-40),13,21,61.9,81,1,39,281,7.2,3,60,362,6.0,4,11,1,16,7,50,0,1,1
14720,8,2016-10-29,mississippi-state,,Samford,W (56-41),20,35,57.1,417,5,46,252,5.5,2,81,669,8.3,14,13,2,29,4,35,1,2,3
14721,9,2016-11-05,mississippi-state,,Texas A&M,W (35-28),18,31,58.1,209,2,58,365,6.3,3,89,574,6.4,8,19,2,29,3,30,0,2,2
14722,10,2016-11-12,mississippi-state,@,Alabama,L (3-51),16,43,37.2,180,0,35,94,2.7,0,78,274,3.5,9,6,2,17,4,31,0,1,1
14723,11,2016-11-19,mississippi-state,,Arkansas,L (42-58),23,33,69.7,328,2,35,205,5.9,4,68,533,7.8,14,10,1,25,3,22,0,0,0
14724,12,2016-11-26,mississippi-state,@,Mississippi,W (55-20),8,17,47.1,109,3,47,457,9.7,4,64,566,8.8,5,17,1,23,6,55,1,0,1
14725,13,2016-12-26,mississippi-state,N,Miami (OH)*,W (17-16),13,27,48.1,136,0,33,199,6.0,2,60,335,5.6,6,9,2,17,2,25,0,0,0
14726,,13 Games,mississippi-state,,,,230,411,56.0,2726,24,528,3005,5.7,24,939,5731,6.1,123,142,21,286,68,617,6,10,16
14727,1,2017-09-02,mississippi-state,,Charleston Southern,W (49-0),20,36,55.6,274,3,50,281,5.6,3,86,555,6.5,11,17,1,29,7,60,0,0,0
14728,2,2017-09-09,mississippi-state,@,Louisiana Tech,W (57-21),13,20,65.0,132,3,40,327,8.2,3,60,459,7.7,6,15,0,21,5,39,0,1,1
14729,3,2017-09-16,mississippi-state,,Louisiana State,W (37-7),15,23,65.2,180,2,48,285,5.9,2,71,465,6.5,9,12,4,25,5,49,0,0,0
14730,4,2017-09-23,mississippi-state,@,Georgia,L (3-31),15,33,45.5,103,0,37,177,4.8,0,70,280,4.0,5,10,0,15,4,35,0,2,2
14731,5,2017-09-30,mississippi-state,@,Auburn,L (10-49),13,37,35.1,157,1,47,194,4.1,0,84,351,4.2,5,12,1,18,10,39,0,2,2
14732,6,2017-10-14,mississippi-state,,Brigham Young,W (35-10),20,31,64.5,240,2,53,306,5.8,3,84,546,6.5,14,19,2,35,6,60,1,2,3
14733,7,2017-10-21,mississippi-state,,Kentucky,W (45-7),19,27,70.4,159,1,48,282,5.9,4,75,441,5.9,7,16,2,25,5,55,0,0,0
14734,8,2017-10-28,mississippi-state,@,Texas A&M,W (35-14),12,21,57.1,141,2,52,228,4.4,2,73,369,5.1,7,11,1,19,5,45,0,1,1
14735,9,2017-11-04,mississippi-state,,Massachusetts,W (34-23),14,26,53.8,139,0,45,254,5.6,2,71,393,5.5,7,13,1,21,5,63,0,3,3
14736,10,2017-11-11,mississippi-state,,Alabama,L (24-31),13,24,54.2,158,0,49,172,3.5,3,73,330,4.5,9,10,3,22,4,30,0,0,0
14737,11,2017-11-18,mississippi-state,@,Arkansas,W (28-21),12,23,52.2,153,2,48,195,4.1,2,71,348,4.9,6,13,0,19,4,47,2,0,2
14738,12,2017-11-23,mississippi-state,,Mississippi,L (28-31),14,32,43.8,207,1,62,294,4.7,2,94,501,5.3,9,16,2,27,9,88,3,2,5
14739,13,2017-12-30,mississippi-state,N,Louisville*,W (31-27),11,20,55.0,127,0,55,277,5.0,4,75,404,5.4,4,18,1,23,11,100,2,1,3
14740,,13 Games,mississippi-state,,,,191,353,54.1,2170,17,634,3272,5.2,30,987,5442,5.5,99,182,18,299,80,710,8,14,22
14741,1,2018-09-01,mississippi-state,,Stephen F. Austin,W (63-6),15,34,44.1,398,5,37,220,5.9,4,71,618,8.7,12,12,1,25,7,80,0,0,0
14742,2,2018-09-08,mississippi-state,@,Kansas State,W (31-10),11,27,40.7,154,2,39,384,9.8,2,66,538,8.2,6,18,0,24,11,84,0,1,1
14743,3,2018-09-15,mississippi-state,,Louisiana,W (56-10),16,24,66.7,276,2,47,331,7.0,6,71,607,8.5,11,18,0,29,3,15,0,1,1
14744,4,2018-09-22,mississippi-state,@,Kentucky,L (7-28),16,32,50.0,145,0,28,56,2.0,1,60,201,3.4,6,5,0,11,16,139,0,1,1
14745,5,2018-09-29,mississippi-state,,Florida,L (6-13),11,26,42.3,98,0,32,104,3.3,0,58,202,3.5,6,7,2,15,2,15,0,0,0
14746,6,2018-10-06,mississippi-state,,Auburn,W (23-9),9,17,52.9,69,0,57,349,6.1,2,74,418,5.6,3,18,1,22,1,15,0,1,1
14747,7,2018-10-20,mississippi-state,@,Louisiana State,L (3-19),8,24,33.3,59,0,37,201,5.4,0,61,260,4.3,3,9,3,15,5,45,0,4,4
14748,8,2018-10-27,mississippi-state,,Texas A&M,W (28-13),14,22,63.6,241,2,31,143,4.6,2,53,384,7.2,7,7,1,15,10,95,0,0,0
14749,9,2018-11-03,mississippi-state,,Louisiana Tech,W (45-3),17,29,58.6,243,4,36,289,8.0,2,65,532,8.2,11,13,2,26,3,25,0,0,0
14750,10,2018-11-10,mississippi-state,@,Alabama,L (0-24),11,20,55.0,125,0,30,44,1.5,0,50,169,3.4,3,3,0,6,7,50,1,0,1
14751,11,2018-11-17,mississippi-state,,Arkansas,W (52-6),12,18,66.7,188,5,47,287,6.1,2,65,475,7.3,9,16,4,29,7,60,1,0,1
14752,,11 Games,mississippi-state,,,,140,273,51.3,1996,20,421,2408,5.7,21,694,4404,6.3,77,126,14,217,72,623,2,8,10
14753,1,2014-08-30,kentucky,,Tennessee-Martin,W (59-14),22,33,66.7,422,1,28,234,8.4,6,61,656,10.8,13,8,3,24,6,59,0,0,0
14754,2,2014-09-06,kentucky,,Ohio,W (20-3),17,31,54.8,170,1,52,232,4.5,1,83,402,4.8,8,15,1,24,4,45,0,0,0
14755,3,2014-09-13,kentucky,@,Florida,L (30-36),24,45,53.3,369,3,33,81,2.5,0,78,450,5.8,14,6,3,23,8,61,0,3,3
14756,4,2014-09-27,kentucky,,Vanderbilt,W (17-7),23,30,76.7,201,1,50,183,3.7,1,80,384,4.8,10,13,0,23,5,55,2,1,3
14757,5,2014-10-04,kentucky,,South Carolina,W (45-38),20,30,66.7,208,1,36,239,6.6,4,66,447,6.8,9,12,1,22,8,80,1,0,1
14758,6,2014-10-11,kentucky,,Louisiana-Monroe,W (48-14),16,30,53.3,216,3,29,136,4.7,1,59,352,6.0,7,6,2,15,6,54,0,1,1
14759,7,2014-10-18,kentucky,@,Louisiana State,L (3-41),19,36,52.8,146,0,27,71,2.6,0,63,217,3.4,6,5,1,12,5,55,0,0,0
14760,8,2014-10-25,kentucky,,Mississippi State,L (31-45),25,44,56.8,401,2,32,103,3.2,2,76,504,6.6,16,7,0,23,3,25,1,0,1
14761,9,2014-11-01,kentucky,@,Missouri,L (10-20),19,37,51.4,158,1,35,100,2.9,0,72,258,3.6,5,6,3,14,9,65,0,1,1
14762,10,2014-11-08,kentucky,,Georgia,L (31-63),16,31,51.6,139,1,47,214,4.6,3,78,353,4.5,8,12,2,22,3,25,0,1,1
14763,11,2014-11-15,kentucky,@,Tennessee,L (16-50),13,29,44.8,168,0,34,94,2.8,1,63,262,4.2,7,6,2,15,5,35,0,2,2
14764,12,2014-11-29,kentucky,@,Louisville,L (40-44),14,29,48.3,176,0,41,151,3.7,2,70,327,4.7,5,9,0,14,4,45,0,2,2
14765,,12 Games,kentucky,,,,228,405,56.3,2774,14,444,1838,4.1,21,849,4612,5.4,108,105,18,231,66,604,4,11,15
14766,1,2015-09-05,kentucky,,Louisiana,W (40-33),16,34,47.1,257,3,26,178,6.8,2,60,435,7.3,8,7,3,18,4,54,0,1,1
14767,2,2015-09-12,kentucky,@,South Carolina,W (26-22),21,29,72.4,192,0,38,207,5.4,3,67,399,6.0,7,12,0,19,7,74,0,1,1
14768,3,2015-09-19,kentucky,,Florida,L (9-14),8,24,33.3,126,0,41,115,2.8,0,65,241,3.7,5,8,1,14,5,37,0,2,2
14769,4,2015-09-26,kentucky,,Missouri,W (21-13),22,27,81.5,249,2,38,120,3.2,1,65,369,5.7,8,9,1,18,8,91,0,0,0
14770,5,2015-10-03,kentucky,,Eastern Kentucky,W (34-27),29,42,69.0,329,3,36,55,1.5,2,78,384,4.9,16,5,3,24,6,46,1,2,3
14771,6,2015-10-15,kentucky,,Auburn,L (27-30),27,44,61.4,359,0,33,138,4.2,3,77,497,6.5,17,6,2,25,5,37,0,1,1
14772,7,2015-10-24,kentucky,@,Mississippi State,L (16-42),30,52,57.7,260,0,33,163,4.9,1,85,423,5.0,14,12,4,30,3,30,0,3,3
14773,8,2015-10-31,kentucky,,Tennessee,L (21-52),16,33,48.5,184,1,32,165,5.2,1,65,349,5.4,8,7,3,18,9,93,1,1,2
14774,9,2015-11-07,kentucky,@,Georgia,L (3-27),9,23,39.1,101,0,24,79,3.3,0,47,180,3.8,4,4,0,8,7,58,1,2,3
14775,10,2015-11-14,kentucky,@,Vanderbilt,L (17-21),15,34,44.1,127,1,37,225,6.1,1,71,352,5.0,3,9,0,12,4,31,1,2,3
14776,11,2015-11-21,kentucky,,UNC Charlotte,W (58-10),16,29,55.2,129,0,44,415,9.4,6,73,544,7.5,7,15,0,22,2,30,1,0,1
14777,12,2015-11-28,kentucky,,Louisville,L (24-38),9,26,34.6,199,0,37,92,2.5,2,63,291,4.6,6,6,2,14,9,95,1,1,2
14778,,12 Games,kentucky,,,,218,397,54.9,2512,10,419,1952,4.7,22,816,4464,5.5,103,100,19,222,69,676,6,16,22
14779,1,2016-09-03,kentucky,,Southern Mississippi,L (35-44),16,25,64.0,313,4,25,96,3.8,1,50,409,8.2,8,5,1,14,6,75,2,1,3
14780,2,2016-09-10,kentucky,@,Florida,L (7-45),3,14,21.4,55,0,34,94,2.8,1,48,149,3.1,1,6,2,9,2,25,1,3,4
14781,3,2016-09-17,kentucky,,New Mexico State,W (62-42),18,24,75.0,311,3,51,381,7.5,5,75,692,9.2,12,16,0,28,11,87,2,1,3
14782,4,2016-09-24,kentucky,,South Carolina,W (17-10),11,19,57.9,135,0,50,216,4.3,2,69,351,5.1,7,14,2,23,4,30,1,1,2
14783,5,2016-10-01,kentucky,@,Alabama,L (6-34),13,22,59.1,89,0,36,72,2.0,0,58,161,2.8,4,7,1,12,2,15,2,0,2
14784,6,2016-10-08,kentucky,,Vanderbilt,W (20-13),10,24,41.7,49,0,52,258,5.0,2,76,307,4.0,2,18,0,20,5,42,1,1,2
14785,7,2016-10-22,kentucky,,Mississippi State,W (40-38),17,33,51.5,292,2,44,262,6.0,1,77,554,7.2,13,12,1,26,2,20,2,0,2
14786,8,2016-10-29,kentucky,@,Missouri,W (35-21),15,24,62.5,205,2,59,377,6.4,3,83,582,7.0,9,14,2,25,3,25,1,1,2
14787,9,2016-11-05,kentucky,,Georgia,L (24-27),11,21,52.4,122,0,40,186,4.7,3,61,308,5.0,5,8,3,16,5,40,1,1,2
14788,10,2016-11-12,kentucky,@,Tennessee,L (36-49),12,29,41.4,192,0,55,443,8.1,4,84,635,7.6,10,16,3,29,6,59,1,1,2
14789,11,2016-11-19,kentucky,,Austin Peay,W (49-13),8,14,57.1,129,2,35,281,8.0,5,49,410,8.4,4,10,0,14,10,85,0,1,1
14790,12,2016-11-26,kentucky,@,Louisville,W (41-38),17,29,58.6,352,3,43,229,5.3,2,72,581,8.1,11,10,3,24,4,41,1,1,2
14791,13,2016-12-31,kentucky,N,Georgia Tech*,L (18-33),19,34,55.9,175,1,36,149,4.1,1,70,324,4.6,10,9,1,20,6,61,1,0,1
14792,,13 Games,kentucky,,,,170,312,54.5,2419,17,560,3044,5.4,30,872,5463,6.3,96,145,19,260,66,605,16,12,28
14793,1,2017-09-02,kentucky,@,Southern Mississippi,W (24-17),11,20,55.0,176,1,35,78,2.2,1,55,254,4.6,5,5,2,12,8,60,1,0,1
14794,2,2017-09-09,kentucky,,Eastern Kentucky,W (27-16),16,24,66.7,229,1,39,207,5.3,2,63,436,6.9,10,9,3,22,6,60,0,0,0
14795,3,2017-09-16,kentucky,@,South Carolina,W (23-13),16,26,61.5,169,0,47,184,3.9,2,73,353,4.8,11,7,2,20,4,10,1,1,2
14796,4,2017-09-23,kentucky,,Florida,L (27-28),18,27,66.7,220,3,32,120,3.8,0,59,340,5.8,11,7,3,21,7,55,0,0,0
14797,5,2017-09-30,kentucky,,Eastern Michigan,W (24-20),18,27,66.7,175,2,37,53,1.4,1,64,228,3.6,9,4,3,16,5,40,1,0,1
14798,6,2017-10-07,kentucky,,Missouri,W (40-34),22,37,59.5,298,2,39,188,4.8,2,76,486,6.4,14,7,1,22,6,34,0,1,1
14799,7,2017-10-21,kentucky,@,Mississippi State,L (7-45),14,30,46.7,145,0,29,115,4.0,1,59,260,4.4,8,5,1,14,4,41,0,2,2
14800,8,2017-10-28,kentucky,,Tennessee,W (29-26),7,16,43.8,82,0,36,289,8.0,4,52,371,7.1,3,13,1,17,4,44,4,0,4
14801,9,2017-11-04,kentucky,,Mississippi,L (34-37),20,25,80.0,236,1,45,219,4.9,3,70,455,6.5,10,12,1,23,4,40,0,0,0
14802,10,2017-11-11,kentucky,@,Vanderbilt,W (44-21),13,17,76.5,195,0,47,232,4.9,5,64,427,6.7,8,10,3,21,9,61,1,0,1
14803,11,2017-11-18,kentucky,@,Georgia,L (13-42),12,23,52.2,138,0,37,124,3.4,1,60,262,4.4,5,10,2,17,2,30,0,1,1
14804,12,2017-11-25,kentucky,,Louisville,L (17-44),8,19,42.1,110,0,43,228,5.3,2,62,338,5.5,6,13,1,20,7,86,0,0,0
14805,13,2017-12-29,kentucky,N,Northwestern*,L (23-24),21,39,53.8,273,0,22,65,3.0,3,61,338,5.5,12,3,2,17,5,65,0,2,2
14806,,13 Games,kentucky,,,,196,330,59.4,2446,10,488,2102,4.3,27,818,4548,5.6,112,105,25,242,71,626,8,7,15
14807,1,2018-09-01,kentucky,,Central Michigan,W (35-20),15,27,55.6,128,1,43,299,7.0,4,70,427,6.1,8,15,4,27,3,40,2,2,4
14808,2,2018-09-08,kentucky,@,Florida,W (27-16),11,16,68.8,151,2,41,303,7.4,1,57,454,8.0,5,15,0,20,12,114,1,1,2
14809,3,2018-09-15,kentucky,,Murray State,W (48-10),24,31,77.4,283,2,43,245,5.7,4,74,528,7.1,13,14,1,28,7,67,0,0,0
14810,4,2018-09-22,kentucky,,Mississippi State,W (28-7),8,14,57.1,71,0,47,229,4.9,4,61,300,4.9,3,11,4,18,5,42,0,1,1
14811,5,2018-09-29,kentucky,,South Carolina,W (24-10),13,20,65.0,132,0,44,221,5.0,3,64,353,5.5,7,12,1,20,11,115,0,1,1
14812,6,2018-10-06,kentucky,@,Texas A&M,L (14-20),13,20,65.0,108,1,30,70,2.3,0,50,178,3.6,3,5,0,8,8,52,0,0,0
14813,7,2018-10-20,kentucky,,Vanderbilt,W (14-7),3,9,33.3,18,1,53,280,5.3,1,62,298,4.8,2,15,0,17,4,35,2,0,2
14814,8,2018-10-27,kentucky,@,Missouri,W (15-14),25,39,64.1,294,1,35,91,2.6,0,74,385,5.2,13,5,3,21,5,31,0,1,1
14815,9,2018-11-03,kentucky,,Georgia,L (17-34),23,29,79.3,226,1,35,84,2.4,1,64,310,4.8,11,8,2,21,6,64,2,0,2
14816,10,2018-11-10,kentucky,@,Tennessee,L (7-24),23,38,60.5,185,1,34,85,2.5,0,72,270,3.8,10,8,1,19,3,20,1,2,3
14817,11,2018-11-17,kentucky,,Middle Tennessee State,W (34-23),10,14,71.4,121,1,40,203,5.1,2,54,324,6.0,5,10,0,15,6,51,0,0,0
14818,,11 Games,kentucky,,,,168,257,65.4,1717,11,445,2110,4.7,20,702,3827,5.5,80,118,16,214,70,631,8,8,16
14819,1,2014-08-28,vanderbilt,,Temple,L (7-37),16,34,47.1,224,0,29,54,1.9,0,63,278,4.4,11,2,0,13,7,66,4,3,7
14820,2,2014-09-06,vanderbilt,N,Mississippi,L (3-41),6,25,24.0,60,0,25,107,4.3,0,50,167,3.3,4,4,1,9,7,53,0,1,1
14821,3,2014-09-13,vanderbilt,,Massachusetts,W (34-31),16,23,69.6,150,1,40,160,4.0,2,63,310,4.9,8,8,1,17,9,77,0,1,1
14822,4,2014-09-20,vanderbilt,,South Carolina,L (34-48),15,25,60.0,223,2,30,156,5.2,0,55,379,6.9,8,9,1,18,7,75,1,1,2
14823,5,2014-09-27,vanderbilt,@,Kentucky,L (7-17),8,25,32.0,85,0,22,54,2.5,0,47,139,3.0,4,3,1,8,2,10,0,3,3
14824,6,2014-10-04,vanderbilt,@,Georgia,L (17-44),16,31,51.6,188,0,36,132,3.7,2,67,320,4.8,7,8,0,15,4,29,0,1,1
14825,7,2014-10-11,vanderbilt,,Charleston Southern,W (21-20),15,23,65.2,189,1,31,106,3.4,1,54,295,5.5,5,5,1,11,10,85,0,1,1
14826,8,2014-10-25,vanderbilt,@,Missouri,L (14-24),17,31,54.8,196,2,27,44,1.6,0,58,240,4.1,10,3,5,18,5,41,0,1,1
14827,9,2014-11-01,vanderbilt,,Old Dominion,W (42-28),20,29,69.0,281,5,56,243,4.3,1,85,524,6.2,12,17,4,33,4,38,2,0,2
14828,10,2014-11-08,vanderbilt,,Florida,L (10-34),21,45,46.7,225,1,24,83,3.5,0,69,308,4.5,11,4,2,17,6,49,2,2,4
14829,11,2014-11-22,vanderbilt,@,Mississippi State,L (0-51),17,36,47.2,179,0,27,49,1.8,0,63,228,3.6,7,5,3,15,5,57,1,2,3
14830,12,2014-11-29,vanderbilt,,Tennessee,L (17-24),13,30,43.3,149,1,36,123,3.4,1,66,272,4.1,6,10,3,19,7,50,0,3,3
14831,,12 Games,vanderbilt,,,,180,357,50.4,2149,13,383,1311,3.4,7,740,3460,4.7,93,78,22,193,73,630,10,19,29
14832,1,2015-09-03,vanderbilt,,Western Kentucky,L (12-14),18,34,52.9,217,1,42,176,4.2,0,76,393,5.2,9,9,2,20,5,48,1,2,3
14833,2,2015-09-12,vanderbilt,,Georgia,L (14-31),24,50,48.0,295,1,39,105,2.7,0,89,400,4.5,12,6,3,21,4,20,0,3,3
14834,3,2015-09-19,vanderbilt,,Austin Peay,W (47-7),30,39,76.9,394,2,35,147,4.2,4,74,541,7.3,17,9,0,26,7,50,1,1,2
14835,4,2015-09-26,vanderbilt,@,Mississippi,L (16-27),23,42,54.8,194,1,43,128,3.0,0,85,322,3.8,9,8,4,21,8,43,0,0,0
14836,5,2015-10-03,vanderbilt,@,Middle Tennessee State,W (17-13),18,31,58.1,177,0,41,237,5.8,2,72,414,5.8,10,8,0,18,6,40,1,2,3
14837,6,2015-10-17,vanderbilt,@,South Carolina,L (10-19),21,42,50.0,177,1,35,155,4.4,0,77,332,4.3,9,10,1,20,6,53,2,3,5
14838,7,2015-10-24,vanderbilt,,Missouri,W (10-3),17,28,60.7,136,0,49,168,3.4,1,77,304,3.9,8,9,1,18,5,59,1,0,1
14839,8,2015-10-31,vanderbilt,@,Houston,L (0-34),5,20,25.0,44,0,42,141,3.4,0,62,185,3.0,2,10,0,12,6,39,1,3,4
14840,9,2015-11-07,vanderbilt,@,Florida,L (7-9),3,14,21.4,30,0,48,145,3.0,1,62,175,2.8,0,8,3,11,7,45,0,0,0
14841,10,2015-11-14,vanderbilt,,Kentucky,W (21-17),13,26,50.0,166,2,42,135,3.2,0,68,301,4.4,7,6,0,13,3,25,2,0,2
14842,11,2015-11-21,vanderbilt,,Texas A&M,L (0-25),5,16,31.3,23,0,44,125,2.8,0,60,148,2.5,0,8,2,10,7,68,0,1,1
14843,12,2015-11-28,vanderbilt,@,Tennessee,L (28-53),15,34,44.1,209,3,36,202,5.6,1,70,411,5.9,11,8,2,21,9,84,0,1,1
14844,,12 Games,vanderbilt,,,,192,376,51.1,2062,11,496,1864,3.8,9,872,3926,4.5,94,99,18,211,73,574,9,16,25
14845,1,2016-09-01,vanderbilt,,South Carolina,L (10-13),8,23,34.8,73,0,42,169,4.0,1,65,242,3.7,4,9,1,14,5,33,0,0,0
14846,2,2016-09-10,vanderbilt,,Middle Tennessee State,W (47-24),15,28,53.6,113,1,45,231,5.1,5,73,344,4.7,6,12,2,20,4,40,1,0,1
14847,3,2016-09-17,vanderbilt,@,Georgia Tech,L (7-38),20,31,64.5,190,1,30,85,2.8,0,61,275,4.5,12,4,1,17,5,45,0,1,1
14848,4,2016-09-24,vanderbilt,@,Western Kentucky,W (31-30),18,29,62.1,279,1,42,110,2.6,3,71,389,5.5,10,5,4,19,5,51,0,1,1
14849,5,2016-10-01,vanderbilt,,Florida,L (6-13),12,32,37.5,118,0,37,147,4.0,0,69,265,3.8,8,10,3,21,6,47,1,2,3
14850,6,2016-10-08,vanderbilt,@,Kentucky,L (13-20),17,30,56.7,141,0,32,141,4.4,0,62,282,4.5,9,9,0,18,7,35,1,0,1
14851,7,2016-10-15,vanderbilt,@,Georgia,W (17-16),7,18,38.9,109,0,32,62,1.9,2,50,171,3.4,5,3,1,9,5,45,0,0,0
14852,8,2016-10-22,vanderbilt,,Tennessee State,W (35-17),15,24,62.5,143,1,42,358,8.5,4,66,501,7.6,9,16,3,28,5,63,0,0,0
14853,9,2016-11-05,vanderbilt,@,Auburn,L (16-23),24,38,63.2,221,1,33,120,3.6,0,71,341,4.8,15,6,1,22,5,26,0,1,1
14854,10,2016-11-12,vanderbilt,@,Missouri,L (17-26),17,30,56.7,252,0,43,159,3.7,2,73,411,5.6,10,7,1,18,7,80,0,2,2
14855,11,2016-11-19,vanderbilt,,Mississippi,W (38-17),17,30,56.7,273,2,46,208,4.5,3,76,481,6.3,12,9,1,22,5,40,1,0,1
14856,12,2016-11-26,vanderbilt,,Tennessee,W (45-34),21,35,60.0,416,2,38,192,5.1,4,73,608,8.3,18,8,1,27,4,30,0,1,1
14857,13,2016-12-26,vanderbilt,N,North Carolina State*,L (17-41),19,46,41.3,158,0,35,156,4.5,2,81,314,3.9,11,7,0,18,4,40,0,3,3
14858,,13 Games,vanderbilt,,,,210,394,53.3,2486,9,497,2138,4.3,26,891,4624,5.2,129,105,19,253,67,575,4,11,15
14859,1,2017-09-02,vanderbilt,@,Middle Tennessee State,W (28-6),20,28,71.4,296,3,35,76,2.2,1,63,372,5.9,10,5,0,15,6,69,0,0,0
14860,2,2017-09-09,vanderbilt,,Alabama A&M,W (42-0),19,26,73.1,227,4,35,174,5.0,2,61,401,6.6,10,8,0,18,4,40,0,0,0
14861,3,2017-09-16,vanderbilt,,Kansas State,W (14-7),14,23,60.9,205,1,32,65,2.0,1,55,270,4.9,9,2,0,11,5,50,1,0,1
14862,4,2017-09-23,vanderbilt,,Alabama,L (0-59),7,22,31.8,38,0,16,40,2.5,0,38,78,2.1,1,1,1,3,5,20,1,1,2
14863,5,2017-09-30,vanderbilt,@,Florida,L (24-38),18,40,45.0,264,3,20,46,2.3,0,60,310,5.2,13,3,1,17,4,38,0,0,0
14864,6,2017-10-07,vanderbilt,,Georgia,L (14-45),17,31,54.8,172,1,22,64,2.9,1,53,236,4.5,8,3,0,11,5,25,0,0,0
14865,7,2017-10-14,vanderbilt,@,Mississippi,L (35-57),18,37,48.6,229,3,37,188,5.1,2,74,417,5.6,13,7,1,21,6,52,1,1,2
14866,8,2017-10-28,vanderbilt,@,South Carolina,L (27-34),27,49,55.1,333,4,23,107,4.7,0,72,440,6.1,15,8,4,27,10,100,0,1,1
14867,9,2017-11-04,vanderbilt,,Western Kentucky,W (31-17),14,21,66.7,220,2,35,174,5.0,2,56,394,7.0,12,7,0,19,6,54,1,0,1
14868,10,2017-11-11,vanderbilt,,Kentucky,L (21-44),30,43,69.8,308,1,20,60,3.0,2,63,368,5.8,15,3,3,21,4,48,0,4,4
14869,11,2017-11-18,vanderbilt,,Missouri,L (17-45),28,52,53.8,348,1,30,51,1.7,1,82,399,4.9,16,5,4,25,6,45,0,3,3
14870,12,2017-11-25,vanderbilt,@,Tennessee,W (42-24),20,31,64.5,283,4,43,246,5.7,2,74,529,7.1,16,15,2,33,8,60,0,0,0
14871,,12 Games,vanderbilt,,,,232,403,57.6,2923,27,348,1291,3.7,14,751,4214,5.6,138,67,16,221,69,601,4,10,14
14872,1,2018-09-01,vanderbilt,,Middle Tennessee State,W (35-7),10,17,58.8,170,2,37,177,4.8,2,54,347,6.4,8,10,1,19,7,49,0,0,0
14873,2,2018-09-08,vanderbilt,,Nevada,W (41-10),24,34,70.6,270,2,39,198,5.1,3,73,468,6.4,13,9,3,25,6,44,2,0,2
14874,3,2018-09-15,vanderbilt,@,Notre Dame,L (17-22),26,43,60.5,326,1,27,94,3.5,1,70,420,6.0,14,5,4,23,5,60,2,1,3
14875,4,2018-09-22,vanderbilt,,South Carolina,L (14-37),19,40,47.5,192,1,33,92,2.8,1,73,284,3.9,11,9,2,22,4,21,1,1,2
14876,5,2018-09-29,vanderbilt,,Tennessee State,W (31-27),22,30,73.3,297,3,34,256,7.5,1,64,553,8.6,13,8,2,23,2,15,0,2,2
14877,6,2018-10-06,vanderbilt,@,Georgia,L (13-41),16,30,53.3,183,0,29,138,4.8,1,59,321,5.4,9,6,3,18,9,69,0,0,0
14878,7,2018-10-13,vanderbilt,,Florida,L (27-37),18,36,50.0,229,2,22,107,4.9,1,58,336,5.8,9,3,5,17,5,28,0,1,1
14879,8,2018-10-20,vanderbilt,@,Kentucky,L (7-14),15,23,65.2,216,1,31,68,2.2,0,54,284,5.3,7,4,1,12,5,25,2,0,2
14880,9,2018-10-27,vanderbilt,@,Arkansas,W (45-31),13,19,68.4,192,2,49,250,5.1,4,68,442,6.5,8,15,2,25,7,60,0,0,0
14881,10,2018-11-10,vanderbilt,@,Missouri,L (28-33),24,36,66.7,249,3,29,216,7.4,1,65,465,7.2,10,9,0,19,5,45,0,0,0
14882,11,2018-11-17,vanderbilt,,Mississippi,W (36-29),22,35,62.9,191,3,36,196,5.4,1,71,387,5.5,8,10,3,21,10,83,0,1,1
14883,,11 Games,vanderbilt,,,,209,343,60.9,2515,20,366,1792,4.9,16,709,4307,6.1,110,88,26,224,65,499,7,6,13
14884,1,2014-08-28,tulane,@,Tulsa,L (31-38),22,44,50.0,262,3,30,254,8.5,1,74,516,7.0,13,6,3,22,9,96,1,1,2
14885,2,2014-09-06,tulane,,Georgia Tech,L (21-38),17,35,48.6,231,2,25,96,3.8,1,60,327,5.5,10,6,1,17,10,69,0,3,3
14886,3,2014-09-13,tulane,,Southeastern Louisiana,W (35-20),14,30,46.7,238,3,40,122,3.1,2,70,360,5.1,10,5,6,21,12,115,1,2,3
14887,4,2014-09-20,tulane,@,Duke,L (13-47),14,36,38.9,160,0,58,231,4.0,2,94,391,4.2,7,17,4,28,13,92,1,4,5
14888,5,2014-09-27,tulane,@,Rutgers,L (6-31),18,29,62.1,152,0,31,152,4.9,1,60,304,5.1,4,7,2,13,7,62,0,0,0
14889,6,2014-10-11,tulane,,Connecticut,W (12-3),19,26,73.1,135,1,33,167,5.1,0,59,302,5.1,6,8,0,14,7,64,0,0,0
14890,7,2014-10-18,tulane,@,Central Florida,L (13-20),18,42,42.9,147,0,36,131,3.6,1,78,278,3.6,6,9,3,18,9,84,0,2,2
14891,8,2014-10-31,tulane,,Cincinnati,L (14-38),24,35,68.6,205,1,33,175,5.3,1,68,380,5.6,12,9,0,21,4,51,1,0,1
14892,9,2014-11-08,tulane,@,Houston,W (31-24),24,35,68.6,237,3,36,124,3.4,1,71,361,5.1,11,9,2,22,5,64,1,1,2
14893,10,2014-11-15,tulane,,Memphis,L (7-38),26,48,54.2,196,0,39,155,4.0,1,87,351,4.0,10,9,2,21,3,30,2,3,5
14894,11,2014-11-22,tulane,@,East Carolina,L (6-34),25,43,58.1,301,0,27,24,0.9,0,70,325,4.6,11,2,2,15,7,79,0,1,1
14895,12,2014-12-06,tulane,,Temple,L (3-10),19,40,47.5,151,0,31,115,3.7,0,71,266,3.7,5,6,3,14,4,35,0,1,1
14896,,12 Games,tulane,,,,240,443,54.2,2415,13,419,1746,4.2,11,862,4161,4.8,105,93,28,226,90,841,7,18,25
14897,1,2015-09-03,tulane,,Duke,L (7-37),24,42,57.1,246,1,23,25,1.1,0,65,271,4.2,8,3,3,14,5,25,0,1,1
14898,2,2015-09-12,tulane,@,Georgia Tech,L (10-65),15,33,45.5,177,1,33,71,2.2,0,66,248,3.8,9,8,1,18,4,34,1,1,2
14899,3,2015-09-19,tulane,,Maine,W (38-7),18,31,58.1,292,1,42,205,4.9,4,73,497,6.8,14,6,0,20,7,65,1,1,2
14900,4,2015-10-03,tulane,,Central Florida,W (45-31),17,29,58.6,225,5,44,170,3.9,1,73,395,5.4,7,8,2,17,7,67,1,0,1
14901,5,2015-10-10,tulane,@,Temple,L (10-49),17,30,56.7,102,1,27,8,0.3,0,57,110,1.9,5,2,1,8,9,102,0,2,2
14902,6,2015-10-16,tulane,,Houston,L (7-42),14,33,42.4,150,0,32,112,3.5,1,65,262,4.0,6,4,1,11,12,133,0,0,0
14903,7,2015-10-24,tulane,@,Navy,L (14-31),27,38,71.1,263,1,27,123,4.6,1,65,386,5.9,18,2,1,21,9,80,2,1,3
14904,8,2015-10-31,tulane,@,Memphis,L (13-41),10,24,41.7,131,0,42,139,3.3,2,66,270,4.1,6,8,3,17,6,50,0,0,0
14905,9,2015-11-07,tulane,,Connecticut,L (3-7),13,40,32.5,106,0,25,34,1.4,0,65,140,2.2,6,3,0,9,2,10,0,1,1
14906,10,2015-11-14,tulane,@,Army,W (34-31),14,29,48.3,252,2,28,115,4.1,1,57,367,6.4,11,7,0,18,2,10,0,1,1
14907,11,2015-11-21,tulane,@,Southern Methodist,L (21-49),13,33,39.4,128,2,33,200,6.1,1,66,328,5.0,7,8,2,17,4,40,0,0,0
14908,12,2015-11-27,tulane,,Tulsa,L (34-45),23,41,56.1,343,4,41,187,4.6,0,82,530,6.5,15,9,1,25,3,25,0,2,2
14909,,12 Games,tulane,,,,205,403,50.9,2415,18,397,1389,3.5,11,800,3804,4.8,112,68,15,195,70,641,5,10,15
14910,1,2016-09-01,tulane,@,Wake Forest,L (3-7),12,23,52.2,134,0,47,146,3.1,0,70,280,4.0,6,7,1,14,4,30,1,0,1
14911,2,2016-09-10,tulane,,Southern,W (66-21),2,6,33.3,12,0,57,437,7.7,7,63,449,7.1,0,20,2,22,4,35,0,1,1
14912,3,2016-09-17,tulane,,Navy,L (14-21),3,12,25.0,21,0,47,240,5.1,2,59,261,4.4,0,14,0,14,9,71,0,0,0
14913,4,2016-09-24,tulane,,Louisiana,W (41-39),13,26,50.0,181,4,48,130,2.7,0,74,311,4.2,7,7,0,14,6,40,0,1,1
14914,5,2016-10-01,tulane,@,Massachusetts,W (31-24),11,21,52.4,168,1,64,280,4.4,3,85,448,5.3,8,16,3,27,6,50,1,0,1
14915,6,2016-10-14,tulane,,Memphis,L (14-24),11,30,36.7,144,1,44,169,3.8,1,74,313,4.2,7,9,4,20,7,62,2,1,3
14916,7,2016-10-22,tulane,@,Tulsa,L (27-50),3,19,15.8,37,0,49,355,7.2,4,68,392,5.8,2,12,1,15,9,85,1,0,1
14917,8,2016-10-29,tulane,,Southern Methodist,L (31-35),13,26,50.0,164,2,46,227,4.9,2,72,391,5.4,7,9,2,18,10,100,0,1,1
14918,9,2016-11-05,tulane,@,Central Florida,L (6-37),5,21,23.8,68,0,64,280,4.4,1,85,348,4.1,3,16,3,22,6,65,2,3,5
14919,10,2016-11-12,tulane,@,Houston,L (18-30),21,42,50.0,241,2,36,100,2.8,0,78,341,4.4,11,5,1,17,5,33,1,0,1
14920,11,2016-11-19,tulane,,Temple,L (0-31),4,13,30.8,24,0,33,118,3.6,0,46,142,3.1,0,8,0,8,6,50,2,0,2
14921,12,2016-11-26,tulane,@,Connecticut,W (38-13),11,19,57.9,166,0,55,257,4.7,5,74,423,5.7,8,8,1,17,5,40,0,1,1
14922,,12 Games,tulane,,,,109,258,42.2,1360,10,590,2739,4.6,25,848,4099,4.8,59,131,18,208,77,661,10,8,18
14923,1,2017-09-02,tulane,,Grambling State,W (43-14),10,15,66.7,185,3,51,296,5.8,3,66,481,7.3,9,15,2,26,8,75,0,0,0
14924,2,2017-09-09,tulane,@,Navy,L (21-23),8,13,61.5,71,0,46,191,4.2,2,59,262,4.4,1,10,0,11,7,41,0,0,0
14925,3,2017-09-16,tulane,@,Oklahoma,L (14-56),6,12,50.0,54,0,62,237,3.8,2,74,291,3.9,3,16,1,20,2,20,1,1,2
14926,4,2017-09-23,tulane,,Army,W (21-17),10,22,45.5,103,0,30,253,8.4,3,52,356,6.8,5,8,2,15,6,59,0,0,0
14927,5,2017-10-07,tulane,,Tulsa,W (62-28),9,13,69.2,165,1,70,488,7.0,8,83,653,7.9,7,22,2,31,6,60,0,0,0
14928,6,2017-10-14,tulane,@,Florida International,L (10-23),5,16,31.3,36,0,40,203,5.1,1,56,239,4.3,1,14,3,18,1,15,1,1,2
14929,7,2017-10-21,tulane,,South Florida,L (28-34),9,19,47.4,221,2,47,194,4.1,2,66,415,6.3,8,12,3,23,12,137,0,1,1
14930,8,2017-10-27,tulane,@,Memphis,L (26-56),15,31,48.4,203,3,52,122,2.3,1,83,325,3.9,6,11,1,18,4,27,1,0,1
14931,9,2017-11-04,tulane,,Cincinnati,L (16-17),17,24,70.8,196,0,35,132,3.8,1,59,328,5.6,8,5,3,16,6,39,0,0,0
14932,10,2017-11-11,tulane,@,East Carolina,W (31-24),12,20,60.0,121,0,52,325,6.3,4,72,446,6.2,5,17,0,22,8,70,1,2,3
14933,11,2017-11-18,tulane,,Houston,W (20-17),17,25,68.0,251,1,47,166,3.5,1,72,417,5.8,12,11,0,23,5,42,0,1,1
14934,12,2017-11-25,tulane,@,Southern Methodist,L (38-41),18,31,58.1,314,2,43,171,4.0,3,74,485,6.6,13,12,2,27,5,40,1,0,1
14935,,12 Games,tulane,,,,136,241,56.4,1920,12,575,2778,4.8,31,816,4698,5.8,78,153,19,250,70,625,5,6,11
14936,1,2018-08-30,tulane,,Wake Forest,L (17-23),19,38,50.0,283,2,41,153,3.7,0,79,436,5.5,8,9,3,20,9,83,1,0,1
14937,2,2018-09-08,tulane,,Nicholls State,W (42-17),12,16,75.0,190,1,41,268,6.5,5,57,458,8.0,9,12,1,22,9,78,1,0,1
14938,3,2018-09-15,tulane,@,Alabama-Birmingham,L (24-31),7,26,26.9,180,2,40,175,4.4,1,66,355,5.4,6,8,3,17,2,25,2,1,3
14939,4,2018-09-22,tulane,@,Ohio State,L (6-49),10,16,62.5,156,0,41,107,2.6,1,57,263,4.6,8,5,1,14,6,55,0,0,0
14940,5,2018-09-28,tulane,,Memphis,W (40-24),13,22,59.1,178,1,56,318,5.7,4,78,496,6.4,9,13,0,22,9,95,0,0,0
14941,6,2018-10-06,tulane,@,Cincinnati,L (21-37),12,31,38.7,132,2,38,134,3.5,1,69,266,3.9,5,7,2,14,12,90,1,0,1
14942,7,2018-10-20,tulane,,Southern Methodist,L (23-27),14,22,63.6,153,0,46,168,3.7,2,68,321,4.7,7,10,1,18,10,96,2,1,3
14943,8,2018-10-27,tulane,@,Tulsa,W (24-17),10,19,52.6,92,0,55,312,5.7,3,74,404,5.5,5,9,3,17,8,70,1,0,1
14944,9,2018-11-03,tulane,@,South Florida,W (41-15),4,11,36.4,61,0,52,365,7.0,5,63,426,6.8,1,15,1,17,7,52,1,0,1
14945,10,2018-11-10,tulane,,East Carolina,W (24-18),12,28,42.9,372,3,49,163,3.3,0,77,535,6.9,10,7,0,17,8,93,1,0,1
14946,11,2018-11-15,tulane,@,Houston,L (17-48),10,24,41.7,147,0,43,212,4.9,2,67,359,5.4,6,12,0,18,5,43,1,3,4
14947,,11 Games,tulane,,,,123,253,48.6,1944,11,502,2375,4.7,24,755,4319,5.7,74,107,15,196,85,780,11,5,16
14948,1,2014-08-30,georgia-tech,,Wofford,W (38-19),11,16,68.8,282,2,43,226,5.3,3,59,508,8.6,9,12,0,21,5,50,0,0,0
14949,2,2014-09-06,georgia-tech,@,Tulane,W (38-21),3,8,37.5,15,0,57,344,6.0,4,65,359,5.5,2,20,2,24,4,35,2,1,3
14950,3,2014-09-13,georgia-tech,,Georgia Southern,W (42-38),11,24,45.8,188,4,53,348,6.6,2,77,536,7.0,7,19,2,28,4,55,0,0,0
14951,4,2014-09-20,georgia-tech,@,Virginia Tech,W (27-24),7,18,38.9,125,1,44,250,5.7,1,62,375,6.0,6,12,1,19,8,60,1,0,1
14952,5,2014-10-04,georgia-tech,,Miami (FL),W (28-17),4,7,57.1,53,0,65,318,4.9,4,72,371,5.2,2,18,1,21,7,69,0,0,0
14953,6,2014-10-11,georgia-tech,,Duke,L (25-31),14,26,53.8,201,0,46,282,6.1,3,72,483,6.7,9,17,0,26,8,69,1,2,3
14954,7,2014-10-18,georgia-tech,@,North Carolina,L (43-48),8,18,44.4,235,3,51,376,7.4,3,69,611,8.9,7,22,0,29,5,32,1,0,1
14955,8,2014-10-25,georgia-tech,@,Pittsburgh,W (56-28),5,12,41.7,147,1,64,465,7.3,7,76,612,8.1,4,23,0,27,3,15,1,0,1
14956,9,2014-11-01,georgia-tech,,Virginia,W (35-10),7,13,53.8,141,3,63,268,4.3,2,76,409,5.4,6,15,2,23,4,30,0,1,1
14957,10,2014-11-08,georgia-tech,@,North Carolina State,W (56-23),7,8,87.5,70,1,64,479,7.5,5,72,549,7.6,4,24,2,30,8,62,2,0,2
14958,11,2014-11-15,georgia-tech,,Clemson,W (28-6),8,11,72.7,102,1,50,251,5.0,0,61,353,5.8,6,9,1,16,2,10,2,0,2
14959,12,2014-11-29,georgia-tech,@,Georgia,W (30-24),6,16,37.5,64,1,70,399,5.7,3,86,463,5.4,4,27,1,32,5,24,2,0,2
14960,13,2014-12-06,georgia-tech,N,Florida State,L (35-37),8,14,57.1,134,1,59,331,5.6,4,73,465,6.4,8,19,1,28,3,20,0,1,1
14961,14,2014-12-31,georgia-tech,N,Mississippi State*,W (49-34),7,12,58.3,125,1,61,452,7.4,6,73,577,7.9,4,22,0,26,3,45,0,1,1
14962,,14 Games,georgia-tech,,,,106,203,52.2,1882,19,790,4789,6.1,47,993,6671,6.7,78,259,13,350,69,576,12,6,18
14963,1,2015-09-03,georgia-tech,,Alcorn State,W (69-6),4,5,80.0,77,1,52,476,9.2,9,57,553,9.7,4,20,2,26,0,0,1,0,1
14964,2,2015-09-12,georgia-tech,,Tulane,W (65-10),8,10,80.0,132,3,56,439,7.8,6,66,571,8.7,7,21,0,28,2,24,1,0,1
14965,3,2015-09-19,georgia-tech,@,Notre Dame,L (22-30),8,24,33.3,121,2,47,216,4.6,1,71,337,4.7,6,12,3,21,4,30,1,0,1
14966,4,2015-09-26,georgia-tech,@,Duke,L (20-34),6,22,27.3,143,1,60,173,2.9,1,82,316,3.9,5,11,0,16,1,5,1,1,2
14967,5,2015-10-03,georgia-tech,,North Carolina,L (31-38),12,21,57.1,162,1,59,255,4.3,3,80,417,5.2,8,17,2,27,4,39,1,1,2
14968,6,2015-10-10,georgia-tech,@,Clemson,L (24-43),6,14,42.9,159,2,42,71,1.7,0,56,230,4.1,5,6,1,12,5,50,0,1,1
14969,7,2015-10-17,georgia-tech,,Pittsburgh,L (28-31),6,15,40.0,106,1,40,376,9.4,3,55,482,8.8,3,15,1,19,5,54,1,1,2
14970,8,2015-10-24,georgia-tech,,Florida State,W (22-16),4,10,40.0,67,0,49,261,5.3,1,59,328,5.6,2,12,1,15,5,41,0,2,2
14971,9,2015-10-31,georgia-tech,@,Virginia,L (21-27),13,31,41.9,251,2,33,144,4.4,1,64,395,6.2,12,6,0,18,6,42,2,0,2
14972,10,2015-11-12,georgia-tech,,Virginia Tech,L (21-23),4,13,30.8,97,0,47,161,3.4,2,60,258,4.3,4,6,5,15,3,26,3,0,3
14973,11,2015-11-21,georgia-tech,@,Miami (FL),L (21-38),4,9,44.4,59,0,57,314,5.5,3,66,373,5.7,3,16,0,19,1,5,2,2,4
14974,12,2015-11-28,georgia-tech,,Georgia,L (7-13),6,18,33.3,82,1,41,194,4.7,0,59,276,4.7,4,11,2,17,2,13,1,2,3
14975,,12 Games,georgia-tech,,,,81,192,42.2,1456,14,583,3080,5.3,30,775,4536,5.9,63,153,17,233,38,329,14,10,24
14976,1,2016-09-03,georgia-tech,N,Boston College,W (17-14),8,15,53.3,119,0,44,119,2.7,2,59,238,4.0,4,7,1,12,3,28,1,0,1
14977,2,2016-09-10,georgia-tech,,Mercer,W (35-10),5,10,50.0,80,0,52,364,7.0,5,62,444,7.2,3,20,2,25,1,10,2,0,2
14978,3,2016-09-17,georgia-tech,,Vanderbilt,W (38-7),8,16,50.0,222,2,46,289,6.3,3,62,511,8.2,5,14,2,21,4,55,0,1,1
14979,4,2016-09-22,georgia-tech,,Clemson,L (7-26),4,14,28.6,29,0,38,95,2.5,1,52,124,2.4,1,7,3,11,2,15,0,1,1
14980,5,2016-10-01,georgia-tech,,Miami (FL),L (21-35),11,19,57.9,94,1,54,267,4.9,2,73,361,4.9,5,17,0,22,4,41,2,1,3
14981,6,2016-10-08,georgia-tech,@,Pittsburgh,L (34-37),7,10,70.0,130,1,45,241,5.4,2,55,371,6.7,5,13,0,18,5,46,0,0,0
14982,7,2016-10-15,georgia-tech,,Georgia Southern,W (35-24),7,11,63.6,172,1,44,265,6.0,4,55,437,7.9,7,11,1,19,3,30,0,0,0
14983,8,2016-10-29,georgia-tech,,Duke,W (38-35),10,14,71.4,264,2,47,341,7.3,3,61,605,9.9,9,11,0,20,8,46,2,0,2
14984,9,2016-11-05,georgia-tech,@,North Carolina,L (20-48),4,9,44.4,144,1,59,374,6.3,1,68,518,7.6,4,19,1,24,4,26,2,0,2
14985,10,2016-11-12,georgia-tech,@,Virginia Tech,W (30-20),2,7,28.6,34,0,58,309,5.3,3,65,343,5.3,1,12,2,15,7,35,1,0,1
14986,11,2016-11-19,georgia-tech,,Virginia,W (31-17),5,10,50.0,122,1,31,199,6.4,2,41,321,7.8,4,4,0,8,4,50,0,0,0
14987,12,2016-11-26,georgia-tech,@,Georgia,W (28-27),6,10,60.0,164,0,42,226,5.4,4,52,390,7.5,5,10,0,15,4,45,1,1,2
14988,13,2016-12-31,georgia-tech,N,Kentucky*,W (33-18),6,14,42.9,105,0,51,266,5.2,2,65,371,5.7,4,15,2,21,8,74,0,0,0
14989,,13 Games,georgia-tech,,,,83,159,52.2,1679,9,611,3355,5.5,34,770,5034,6.5,57,160,14,231,57,501,11,4,15
14990,1,2017-09-04,georgia-tech,N,Tennessee,L (41-42),5,10,50.0,120,0,86,535,6.2,6,96,655,6.8,4,29,0,33,4,37,2,0,2
14991,2,2017-09-09,georgia-tech,,Jacksonville State,W (37-10),5,7,71.4,112,3,49,210,4.3,2,56,322,5.8,5,8,4,17,8,70,0,0,0
14992,3,2017-09-23,georgia-tech,,Pittsburgh,W (35-17),4,7,57.1,48,0,67,436,6.5,5,74,484,6.5,2,21,2,25,4,18,4,0,4
14993,4,2017-09-30,georgia-tech,,North Carolina,W (33-7),5,10,50.0,53,1,66,403,6.1,3,76,456,6.0,3,18,1,22,1,5,2,0,2
14994,5,2017-10-14,georgia-tech,@,Miami (FL),L (24-25),3,7,42.9,55,1,53,226,4.3,1,60,281,4.7,1,14,1,16,1,6,1,0,1
14995,6,2017-10-21,georgia-tech,,Wake Forest,W (38-24),5,11,45.5,68,0,66,427,6.5,5,77,495,6.4,5,21,3,29,5,45,0,0,0
14996,7,2017-10-28,georgia-tech,@,Clemson,L (10-24),3,13,23.1,32,0,43,198,4.6,1,56,230,4.1,2,7,1,10,2,20,1,0,1
14997,8,2017-11-04,georgia-tech,@,Virginia,L (36-40),6,22,27.3,179,1,52,220,4.2,3,74,399,5.4,5,11,0,16,6,45,0,2,2
14998,9,2017-11-11,georgia-tech,,Virginia Tech,W (28-22),2,8,25.0,140,2,57,261,4.6,2,65,401,6.2,2,15,2,19,5,45,0,1,1
14999,10,2017-11-18,georgia-tech,@,Duke,L (20-43),3,14,21.4,82,1,47,277,5.9,2,61,359,5.9,2,13,0,15,5,63,0,1,1
15000,11,2017-11-25,georgia-tech,,Georgia,L (7-38),2,9,22.2,38,1,46,188,4.1,0,55,226,4.1,1,11,0,12,3,40,0,1,1
15001,,11 Games,georgia-tech,,,,43,118,36.4,927,10,632,3381,5.3,30,750,4308,5.7,32,168,14,214,44,394,10,5,15
15002,1,2018-09-01,georgia-tech,,Alcorn State,W (41-0),9,18,50.0,104,1,54,439,8.1,4,72,543,7.5,4,20,1,25,3,30,2,1,3
15003,2,2018-09-08,georgia-tech,@,South Florida,L (38-49),9,18,50.0,183,1,57,419,7.4,4,75,602,8.0,6,19,2,27,8,80,1,2,3
15004,3,2018-09-15,georgia-tech,@,Pittsburgh,L (19-24),6,15,40.0,66,0,56,320,5.7,3,71,386,5.4,4,16,2,22,5,35,1,1,2
15005,4,2018-09-22,georgia-tech,,Clemson,L (21-49),3,8,37.5,57,1,56,146,2.6,2,64,203,3.2,2,10,3,15,4,30,1,0,1
15006,5,2018-09-29,georgia-tech,,Bowling Green State,W (63-17),5,7,71.4,160,0,49,372,7.6,7,56,532,9.5,5,16,2,23,3,54,0,0,0
15007,6,2018-10-05,georgia-tech,@,Louisville,W (66-31),1,2,50.0,12,0,65,542,8.3,8,67,554,8.3,1,27,0,28,4,50,0,0,0
15008,7,2018-10-13,georgia-tech,,Duke,L (14-28),7,17,41.2,125,1,61,229,3.8,1,78,354,4.5,5,14,1,20,3,18,3,0,3
15009,8,2018-10-25,georgia-tech,@,Virginia Tech,W (49-28),0,1,0.0,0,0,78,465,6.0,7,79,465,5.9,0,31,4,35,6,50,0,0,0
15010,9,2018-11-03,georgia-tech,@,North Carolina,W (38-28),2,2,100.0,104,1,74,461,6.2,4,76,565,7.4,2,24,1,27,3,20,3,0,3
15011,10,2018-11-10,georgia-tech,,Miami (FL),W (27-21),3,4,75.0,73,1,53,231,4.4,2,57,304,5.3,3,12,0,15,3,35,1,0,1
15012,11,2018-11-17,georgia-tech,,Virginia,W (30-27),1,8,12.5,37,0,52,268,5.2,1,60,305,5.1,1,11,1,13,3,25,0,0,0
15013,,11 Games,georgia-tech,,,,46,100,46.0,921,6,655,3892,5.9,43,755,4813,6.4,33,200,17,250,45,427,12,4,16
15014,1,2014-08-30,appalachian-state,@,Michigan,L (14-52),17,33,51.5,127,1,36,153,4.3,1,69,280,4.1,6,9,2,17,8,69,0,0,0
15015,2,2014-09-20,appalachian-state,@,Southern Mississippi,L (20-21),28,40,70.0,264,2,47,191,4.1,1,87,455,5.2,16,9,4,29,11,59,1,2,3
15016,3,2014-10-04,appalachian-state,,South Alabama,L (21-47),20,36,55.6,191,3,38,203,5.3,0,74,394,5.3,9,9,7,25,8,77,2,1,3
15017,4,2014-10-11,appalachian-state,,Liberty,L (48-55),20,31,64.5,397,3,37,231,6.2,2,68,628,9.2,11,11,1,23,7,58,2,2,4
15018,5,2014-10-18,appalachian-state,@,Troy,W (53-14),9,16,56.3,110,1,54,441,8.2,5,70,551,7.9,3,19,2,24,7,52,1,0,1
15019,6,2014-11-01,appalachian-state,,Georgia State,W (44-0),9,14,64.3,98,0,66,469,7.1,6,80,567,7.1,5,21,0,26,1,17,0,0,0
15020,7,2014-11-08,appalachian-state,,Louisiana-Monroe,W (31-29),25,35,71.4,276,2,36,104,2.9,2,71,380,5.4,13,6,4,23,7,50,0,1,1
15021,8,2014-11-15,appalachian-state,@,Arkansas State,W (37-32),14,22,63.6,255,2,63,294,4.7,3,85,549,6.5,10,16,3,29,10,87,2,0,2
15022,9,2014-11-22,appalachian-state,@,Louisiana,W (35-16),11,22,50.0,195,1,47,232,4.9,3,69,427,6.2,9,10,1,20,3,30,1,1,2
15023,10,2014-11-29,appalachian-state,,Idaho,W (45-28),13,20,65.0,223,3,43,207,4.8,3,63,430,6.8,9,10,4,23,7,70,1,1,2
15024,,10 Games,appalachian-state,,,,166,269,61.7,2136,18,467,2525,5.4,26,736,4661,6.3,91,120,28,239,69,569,10,8,18
15025,1,2015-09-05,appalachian-state,,Howard,W (49-0),21,28,75.0,287,4,56,376,6.7,3,84,663,7.9,12,18,3,33,7,60,1,0,1
15026,2,2015-09-12,appalachian-state,@,Clemson,L (10-41),9,28,32.1,95,1,45,203,4.5,0,73,298,4.1,3,8,1,12,12,91,1,3,4
15027,3,2015-09-26,appalachian-state,@,Old Dominion,W (49-0),12,17,70.6,198,4,56,303,5.4,2,73,501,6.9,6,15,3,24,7,68,1,0,1
15028,4,2015-10-03,appalachian-state,,Wyoming,W (31-13),3,12,25.0,65,1,34,249,7.3,2,46,314,6.8,2,10,2,14,4,30,0,1,1
15029,5,2015-10-10,appalachian-state,@,Georgia State,W (37-3),18,25,72.0,291,3,44,207,4.7,0,69,498,7.2,13,8,3,24,8,56,0,1,1
15030,6,2015-10-17,appalachian-state,@,Louisiana-Monroe,W (59-14),9,16,56.3,275,3,50,379,7.6,5,66,654,9.9,8,15,0,23,6,68,1,0,1
15031,7,2015-10-22,appalachian-state,,Georgia Southern,W (31-13),14,20,70.0,202,2,48,231,4.8,2,68,433,6.4,11,11,0,22,5,40,0,0,0
15032,8,2015-10-31,appalachian-state,,Troy,W (44-41),16,26,61.5,184,2,58,248,4.3,2,84,432,5.1,8,11,3,22,7,71,0,1,1
15033,9,2015-11-05,appalachian-state,,Arkansas State,L (27-40),23,36,63.9,357,4,30,108,3.6,0,66,465,7.0,14,4,0,18,6,64,2,1,3
15034,10,2015-11-14,appalachian-state,@,Idaho,W (47-20),10,17,58.8,110,4,56,401,7.2,2,73,511,7.0,5,23,1,29,5,36,0,0,0
15035,11,2015-11-28,appalachian-state,,Louisiana,W (28-7),14,21,66.7,172,1,46,230,5.0,3,67,402,6.0,9,13,3,25,5,57,2,0,2
15036,12,2015-12-05,appalachian-state,@,South Alabama,W (34-27),15,22,68.2,163,2,36,301,8.4,2,58,464,8.0,9,9,2,20,3,19,3,1,4
15037,13,2015-12-19,appalachian-state,N,Ohio*,W (31-29),13,26,50.0,124,2,49,303,6.2,2,75,427,5.7,9,12,3,24,9,80,2,1,3
15038,,13 Games,appalachian-state,,,,177,294,60.2,2523,33,608,3539,5.8,25,902,6062,6.7,109,157,24,290,84,740,13,9,22
15039,1,2016-09-01,appalachian-state,@,Tennessee,L (13-20),15,23,65.2,108,1,43,184,4.3,1,66,292,4.4,7,10,0,17,5,36,0,1,1
15040,2,2016-09-10,appalachian-state,,Old Dominion,W (31-7),15,22,68.2,185,0,48,230,4.8,4,70,415,5.9,7,14,1,22,7,72,0,1,1
15041,3,2016-09-17,appalachian-state,,Miami (FL),L (10-45),10,22,45.5,115,1,47,161,3.4,0,69,276,4.0,6,9,2,17,8,58,0,1,1
15042,4,2016-09-24,appalachian-state,@,Akron,W (45-38),22,31,71.0,280,3,49,307,6.3,3,80,587,7.3,16,13,1,30,7,83,1,0,1
15043,5,2016-10-01,appalachian-state,,Georgia State,W (17-3),13,25,52.0,143,1,48,218,4.5,1,73,361,4.9,7,12,7,26,9,101,0,1,1
15044,6,2016-10-12,appalachian-state,@,Louisiana,W (24-0),15,26,57.7,201,1,36,177,4.9,2,62,378,6.1,8,9,3,20,5,50,0,1,1
15045,7,2016-10-22,appalachian-state,,Idaho,W (37-19),20,25,80.0,246,1,35,139,4.0,2,60,385,6.4,10,9,2,21,5,39,1,0,1
15046,8,2016-10-27,appalachian-state,@,Georgia Southern,W (34-10),16,27,59.3,199,0,43,335,7.8,4,70,534,7.6,10,16,2,28,4,36,1,2,3
15047,9,2016-11-05,appalachian-state,,Texas State,W (35-10),15,22,68.2,136,4,38,303,8.0,1,60,439,7.3,5,12,1,18,9,79,0,0,0
15048,10,2016-11-12,appalachian-state,@,Troy,L (24-28),14,28,50.0,167,0,38,167,4.4,2,66,334,5.1,9,9,0,18,6,61,1,1,2
15049,11,2016-11-19,appalachian-state,,Louisiana-Monroe,W (42-17),14,22,63.6,208,2,46,431,9.4,4,68,639,9.4,10,17,0,27,6,65,0,0,0
15050,12,2016-11-26,appalachian-state,@,New Mexico State,W (37-7),20,28,71.4,220,1,48,384,8.0,3,76,604,7.9,10,12,0,22,6,53,1,0,1
15051,13,2016-12-17,appalachian-state,N,Toledo*,W (31-28),14,33,42.4,119,1,47,304,6.5,2,80,423,5.3,9,14,2,25,2,21,0,0,0
15052,,13 Games,appalachian-state,,,,203,334,60.8,2327,16,566,3340,5.9,29,900,5667,6.3,114,156,21,291,79,754,5,8,13
15053,1,2017-09-02,appalachian-state,@,Georgia,L (10-31),21,32,65.6,148,0,32,136,4.3,1,64,284,4.4,6,6,0,12,11,105,0,0,0
15054,2,2017-09-09,appalachian-state,,Savannah State,W (54-7),16,22,72.7,345,5,47,274,5.8,2,69,619,9.0,13,12,2,27,8,106,2,0,2
15055,3,2017-09-16,appalachian-state,@,Texas State,W (20-13),17,28,60.7,167,1,29,116,4.0,1,57,283,5.0,9,7,3,19,6,57,1,0,1
15056,4,2017-09-23,appalachian-state,,Wake Forest,L (19-20),26,52,50.0,372,2,35,122,3.5,0,87,494,5.7,16,8,3,27,7,65,0,0,0
15057,5,2017-10-07,appalachian-state,,New Mexico State,W (45-31),11,22,50.0,75,1,38,350,9.2,5,60,425,7.1,5,12,0,17,11,81,1,2,3
15058,6,2017-10-14,appalachian-state,@,Idaho,W (23-20),19,26,73.1,155,3,38,121,3.2,0,64,276,4.3,3,10,1,14,0,0,1,1,2
15059,7,2017-10-21,appalachian-state,,Coastal Carolina,W (37-29),23,39,59.0,427,2,35,122,3.5,3,74,549,7.4,16,8,3,27,8,72,0,0,0
15060,8,2017-10-28,appalachian-state,@,Massachusetts,L (27-30),14,29,48.3,133,2,47,234,5.0,1,76,367,4.8,5,9,1,15,11,104,2,1,3
15061,9,2017-11-04,appalachian-state,@,Louisiana-Monroe,L (45-52),20,29,69.0,339,4,36,169,4.7,2,65,508,7.8,14,9,2,25,5,40,1,0,1
15062,10,2017-11-09,appalachian-state,,Georgia Southern,W (27-6),7,14,50.0,161,2,47,256,5.4,1,61,417,6.8,5,11,3,19,7,61,0,0,0
15063,11,2017-11-25,appalachian-state,@,Georgia State,W (31-10),15,23,65.2,107,2,46,323,7.0,2,69,430,6.2,7,12,1,20,8,65,0,2,2
15064,12,2017-12-02,appalachian-state,,Louisiana,W (63-14),18,23,78.3,251,4,47,357,7.6,5,70,608,8.7,10,17,0,27,5,50,0,0,0
15065,13,2017-12-23,appalachian-state,N,Toledo*,W (34-0),8,17,47.1,131,0,53,327,6.2,4,70,458,6.5,5,16,2,23,4,25,0,0,0
15066,,13 Games,appalachian-state,,,,215,356,60.4,2811,28,530,2907,5.5,27,886,5718,6.5,114,137,21,272,91,831,8,6,14
15067,1,2018-09-01,appalachian-state,@,Penn State,L (38-45),26,39,66.7,292,2,37,159,4.3,2,76,451,5.9,13,8,1,22,9,100,0,1,1
15068,2,2018-09-08,appalachian-state,@,UNC Charlotte,W (45-9),15,15,100.0,295,3,35,139,4.0,1,50,434,8.7,9,7,2,18,5,55,2,0,2
15069,3,2018-09-22,appalachian-state,,Gardner-Webb,W (72-7),20,27,74.1,260,2,48,432,9.0,6,75,692,9.2,13,18,0,31,8,85,0,0,0
15070,4,2018-09-29,appalachian-state,,South Alabama,W (52-7),10,20,50.0,169,3,46,348,7.6,4,66,517,7.8,8,15,5,28,4,45,0,2,2
15071,5,2018-10-09,appalachian-state,@,Arkansas State,W (35-9),12,27,44.4,144,2,38,246,6.5,3,65,390,6.0,4,8,3,15,4,50,0,0,0
15072,6,2018-10-20,appalachian-state,,Louisiana,W (27-17),10,20,50.0,106,1,48,266,5.5,2,68,372,5.5,8,10,3,21,5,42,0,1,1
15073,7,2018-10-25,appalachian-state,@,Georgia Southern,L (14-34),12,27,44.4,139,1,36,149,4.1,1,63,288,4.6,6,8,0,14,11,91,1,4,5
15074,8,2018-11-03,appalachian-state,@,Coastal Carolina,W (23-7),9,19,47.4,127,1,56,278,5.0,2,75,405,5.4,6,14,1,21,6,40,0,2,2
15075,9,2018-11-10,appalachian-state,@,Texas State,W (38-7),25,36,69.4,247,2,34,221,6.5,3,70,468,6.7,11,8,0,19,5,50,0,0,0
15076,10,2018-11-17,appalachian-state,,Georgia State,W (45-17),22,26,84.6,296,3,39,228,5.8,2,65,524,8.1,13,10,2,25,0,0,0,0,0
15077,,10 Games,appalachian-state,,,,161,256,62.9,2075,20,417,2466,5.9,26,673,4541,6.7,91,106,17,214,57,558,3,10,13
15078,1,2014-08-30,georgia-southern,@,North Carolina State,L (23-24),10,17,58.8,192,1,47,246,5.2,1,64,438,6.8,6,12,0,18,3,35,1,0,1
15079,2,2014-09-13,georgia-southern,@,Georgia Tech,L (38-42),13,22,59.1,245,1,38,283,7.4,4,60,528,8.8,9,12,1,22,5,60,1,0,1
15080,3,2014-09-20,georgia-southern,@,South Alabama,W (28-6),6,11,54.5,85,0,52,335,6.4,4,63,420,6.7,4,14,0,18,1,10,1,1,2
15081,4,2014-10-04,georgia-southern,@,New Mexico State,W (36-28),3,13,23.1,18,0,61,405,6.6,4,74,423,5.7,0,21,1,22,4,39,1,0,1
15082,5,2014-10-11,georgia-southern,,Idaho,W (47-24),11,15,73.3,201,2,58,349,6.0,4,73,550,7.5,7,18,1,26,6,48,1,0,1
15083,6,2014-10-25,georgia-southern,@,Georgia State,W (69-31),5,6,83.3,47,0,63,613,9.7,10,69,660,9.6,2,28,0,30,5,39,0,0,0
15084,7,2014-10-30,georgia-southern,,Troy,W (42-10),6,10,60.0,40,0,63,421,6.7,6,73,461,6.3,2,24,2,28,3,25,2,0,2
15085,8,2014-11-08,georgia-southern,@,Texas State,W (28-25),6,9,66.7,41,0,40,227,5.7,3,49,268,5.5,2,6,1,9,7,74,0,0,0
15086,9,2014-11-15,georgia-southern,@,Navy,L (19-52),10,16,62.5,73,0,47,375,8.0,3,63,448,7.1,4,15,0,19,7,65,1,2,3
15087,10,2014-11-29,georgia-southern,,Louisiana-Monroe,W (22-16),8,19,42.1,136,0,59,333,5.6,3,78,469,6.0,4,14,1,19,6,65,0,0,0
15088,,10 Games,georgia-southern,,,,78,138,56.5,1078,4,528,3587,6.8,42,666,4665,7.0,40,164,7,211,47,460,8,3,11
15089,1,2015-09-05,georgia-southern,@,West Virginia,L (0-44),2,13,15.4,29,0,57,195,3.4,0,70,224,3.2,2,11,1,14,1,15,1,4,5
15090,2,2015-09-12,georgia-southern,,Western Michigan,W (43-17),1,4,25.0,7,0,52,413,7.9,5,56,420,7.5,1,12,1,14,4,35,0,0,0
15091,3,2015-09-19,georgia-southern,,Citadel,W (48-13),12,19,63.2,101,0,49,383,7.8,6,68,484,7.1,5,13,0,18,5,40,1,0,1
15092,4,2015-09-26,georgia-southern,@,Idaho,W (44-20),7,16,43.8,127,0,52,441,8.5,5,68,568,8.4,6,17,0,23,4,38,1,1,2
15093,5,2015-10-03,georgia-southern,@,Louisiana-Monroe,W (51-31),3,10,30.0,48,0,67,455,6.8,6,77,503,6.5,3,21,2,26,12,109,0,1,1
15094,6,2015-10-17,georgia-southern,,New Mexico State,W (56-26),4,8,50.0,85,1,59,507,8.6,7,67,592,8.8,2,21,1,24,7,86,1,0,1
15095,7,2015-10-22,georgia-southern,@,Appalachian State,L (13-31),5,13,38.5,64,0,38,188,4.9,2,51,252,4.9,2,11,0,13,4,26,0,2,2
15096,8,2015-10-29,georgia-southern,,Texas State,W (37-13),3,6,50.0,31,0,67,503,7.5,4,73,534,7.3,2,19,1,22,2,30,3,0,3
15097,9,2015-11-14,georgia-southern,@,Troy,W (45-10),4,7,57.1,85,1,66,325,4.9,4,73,410,5.6,3,19,3,25,7,70,1,0,1
15098,10,2015-11-21,georgia-southern,@,Georgia,L (17-23),4,7,57.1,44,0,49,227,4.6,1,56,271,4.8,2,9,0,11,3,25,1,0,1
15099,11,2015-11-28,georgia-southern,,South Alabama,W (55-17),4,7,57.1,53,1,56,489,8.7,6,63,542,8.6,2,18,0,20,7,67,2,0,2
15100,12,2015-12-05,georgia-southern,,Georgia State,L (7-34),6,19,31.6,68,0,44,135,3.1,1,63,203,3.2,4,6,4,14,6,38,0,2,2
15101,13,2015-12-23,georgia-southern,N,Bowling Green State*,W (58-27),4,8,50.0,82,1,68,452,6.6,7,76,534,7.0,4,20,2,26,5,45,0,0,0
15102,,13 Games,georgia-southern,,,,59,137,43.1,824,4,724,4713,6.5,54,861,5537,6.4,38,197,15,250,67,624,11,10,21
15103,1,2016-09-03,georgia-southern,,Savannah State,W (54-0),12,15,80.0,185,2,69,420,6.1,6,84,605,7.2,8,23,3,34,8,58,1,1,2
15104,2,2016-09-10,georgia-southern,@,South Alabama,W (24-9),7,10,70.0,137,0,63,304,4.8,3,73,441,6.0,6,15,2,23,10,65,1,0,1
15105,3,2016-09-17,georgia-southern,,Louisiana-Monroe,W (23-21),5,17,29.4,71,0,71,345,4.9,2,88,416,4.7,5,18,4,27,14,136,1,0,1
15106,4,2016-09-24,georgia-southern,@,Western Michigan,L (31-49),9,16,56.3,168,3,50,202,4.0,1,66,370,5.6,6,12,2,20,5,39,2,2,4
15107,5,2016-10-05,georgia-southern,@,Arkansas State,L (26-27),14,23,60.9,203,1,45,162,3.6,1,68,365,5.4,10,6,0,16,7,52,0,0,0
15108,6,2016-10-15,georgia-southern,@,Georgia Tech,L (24-35),18,33,54.5,168,1,50,167,3.3,2,83,335,4.0,8,14,3,25,7,66,0,0,0
15109,7,2016-10-22,georgia-southern,@,New Mexico State,W (22-19),11,20,55.0,157,2,53,254,4.8,0,73,411,5.6,8,11,1,20,8,79,1,2,3
15110,8,2016-10-27,georgia-southern,,Appalachian State,L (10-34),12,29,41.4,94,0,26,65,2.5,0,55,159,2.9,5,3,1,9,4,45,0,3,3
15111,9,2016-11-05,georgia-southern,@,Mississippi,L (27-37),7,17,41.2,134,1,59,267,4.5,2,76,401,5.3,4,12,3,19,6,54,0,1,1
15112,10,2016-11-10,georgia-southern,,Louisiana,L (26-33),22,37,59.5,254,1,28,52,1.9,2,65,306,4.7,14,1,1,16,6,61,0,0,0
15113,11,2016-11-19,georgia-southern,@,Georgia State,L (24-30),14,26,53.8,122,0,46,241,5.2,3,72,363,5.0,7,11,1,19,11,78,2,0,2
15114,12,2016-12-03,georgia-southern,,Troy,W (28-24),16,21,76.2,175,2,42,218,5.2,2,63,393,6.2,6,13,1,20,5,45,1,0,1
15115,,12 Games,georgia-southern,,,,147,264,55.7,1868,13,602,2697,4.5,24,866,4565,5.3,87,139,22,248,91,778,9,9,18
15116,1,2017-09-02,georgia-southern,@,Auburn,L (7-41),4,9,44.4,8,0,47,70,1.5,0,56,78,1.4,0,5,3,8,3,15,0,1,1
15117,2,2017-09-09,georgia-southern,N,New Hampshire,L (12-22),11,22,50.0,93,0,57,226,4.0,1,79,319,4.0,5,15,1,21,5,50,1,1,2
15118,3,2017-09-23,georgia-southern,@,Indiana,L (17-52),7,16,43.8,133,2,54,242,4.5,0,70,375,5.4,2,11,2,15,13,108,3,0,3
15119,4,2017-10-04,georgia-southern,,Arkansas State,L (25-43),10,18,55.6,160,1,63,333,5.3,2,81,493,6.1,5,16,3,24,7,63,2,2,4
15120,5,2017-10-14,georgia-southern,,New Mexico State,L (27-35),6,9,66.7,73,0,50,192,3.8,2,59,265,4.5,3,10,0,13,6,61,0,0,0
15121,6,2017-10-21,georgia-southern,@,Massachusetts,L (20-55),5,18,27.8,155,0,41,136,3.3,2,59,291,4.9,3,8,1,12,11,114,3,1,4
15122,7,2017-10-28,georgia-southern,@,Troy,L (16-38),6,12,50.0,82,0,62,227,3.7,2,74,309,4.2,3,16,0,19,4,30,0,1,1
15123,8,2017-11-04,georgia-southern,,Georgia State,L (17-21),22,28,78.6,147,1,50,189,3.8,1,78,336,4.3,8,10,1,19,8,60,3,0,3
15124,9,2017-11-09,georgia-southern,@,Appalachian State,L (6-27),10,18,55.6,80,0,38,111,2.9,0,56,191,3.4,6,8,1,15,5,42,0,0,0
15125,10,2017-11-18,georgia-southern,,South Alabama,W (52-0),11,17,64.7,227,2,68,356,5.2,5,85,583,6.9,7,18,1,26,5,45,0,0,0
15126,11,2017-11-25,georgia-southern,@,Louisiana,W (34-24),6,11,54.5,75,1,63,389,6.2,3,74,464,6.3,2,19,2,23,5,40,0,0,0
15127,12,2017-12-02,georgia-southern,@,Coastal Carolina,L (17-28),7,17,41.2,87,1,51,197,3.9,1,68,284,4.2,5,11,0,16,5,25,1,1,2
15128,,12 Games,georgia-southern,,,,105,195,53.8,1320,8,644,2668,4.1,19,839,3988,4.8,49,147,15,211,77,653,13,7,20
15129,1,2018-09-01,georgia-southern,,South Carolina State,W (37-6),5,7,71.4,29,0,53,319,6.0,5,60,348,5.8,1,17,1,19,2,10,0,0,0
15130,2,2018-09-08,georgia-southern,,Massachusetts,W (34-13),6,9,66.7,154,2,55,341,6.2,2,64,495,7.7,5,18,1,24,3,35,1,0,1
15131,3,2018-09-15,georgia-southern,@,Clemson,L (7-38),3,9,33.3,60,0,43,80,1.9,1,52,140,2.7,3,3,1,7,4,20,1,0,1
15132,4,2018-09-29,georgia-southern,,Arkansas State,W (28-21),1,3,33.3,61,1,49,348,7.1,3,52,409,7.9,1,14,0,15,8,70,0,0,0
15133,5,2018-10-06,georgia-southern,,South Alabama,W (48-13),5,8,62.5,99,1,43,295,6.9,4,51,394,7.7,3,13,2,18,9,83,0,0,0
15134,6,2018-10-11,georgia-southern,@,Texas State,W (15-13),7,12,58.3,51,0,52,164,3.2,1,64,215,3.4,3,8,1,12,5,49,1,0,1
15135,7,2018-10-20,georgia-southern,@,New Mexico State,W (48-31),4,4,100.0,77,0,61,389,6.4,6,65,466,7.2,3,23,1,27,4,36,0,0,0
15136,8,2018-10-25,georgia-southern,,Appalachian State,W (34-14),1,3,33.3,57,1,49,278,5.7,3,52,335,6.4,1,11,2,14,2,11,0,0,0
15137,9,2018-11-03,georgia-southern,@,Louisiana-Monroe,L (25-44),8,15,53.3,78,1,46,138,3.0,0,61,216,3.5,5,10,3,17,6,52,1,0,1
15138,10,2018-11-10,georgia-southern,,Troy,L (21-35),14,23,60.9,190,2,34,101,3.0,1,57,291,5.1,6,6,1,13,4,47,0,0,0
15139,11,2018-11-17,georgia-southern,@,Coastal Carolina,W (41-17),4,6,66.7,33,0,54,409,7.6,5,60,442,7.4,2,17,0,19,2,17,1,0,1
15140,,11 Games,georgia-southern,,,,58,99,58.6,889,8,539,2862,5.3,31,638,3751,5.9,33,140,13,185,49,430,5,0,5
15141,1,2014-08-30,troy,@,Alabama-Birmingham,L (10-48),21,31,67.7,201,0,37,71,1.9,1,68,272,4.0,8,6,1,15,5,57,1,0,1
15142,2,2014-09-06,troy,,Duke,L (17-34),22,34,64.7,238,0,43,158,3.7,2,77,396,5.1,11,8,1,20,7,55,0,0,0
15143,3,2014-09-13,troy,,Abilene Christian,L (35-38),21,38,55.3,286,1,29,131,4.5,4,67,417,6.2,8,9,0,17,10,108,0,0,0
15144,4,2014-09-20,troy,@,Georgia,L (0-66),18,33,54.5,169,0,28,47,1.7,0,61,216,3.5,5,5,1,11,4,35,1,1,2
15145,5,2014-09-27,troy,@,Louisiana-Monroe,L (20-22),23,34,67.6,270,3,32,81,2.5,0,66,351,5.3,10,7,0,17,3,45,1,0,1
15146,6,2014-10-11,troy,,New Mexico State,W (41-24),23,30,76.7,211,1,53,360,6.8,3,83,571,6.9,10,17,0,27,5,49,1,1,2
15147,7,2014-10-18,troy,,Appalachian State,L (14-53),27,40,67.5,229,0,32,79,2.5,1,72,308,4.3,8,7,2,17,11,89,2,2,4
15148,8,2014-10-24,troy,@,South Alabama,L (13-27),13,24,54.2,145,1,40,164,4.1,0,64,309,4.8,5,10,4,19,10,100,0,0,0
15149,9,2014-10-30,troy,@,Georgia Southern,L (10-42),4,11,36.4,13,0,33,141,4.3,1,44,154,3.5,0,9,0,9,4,45,1,0,1
15150,10,2014-11-08,troy,,Georgia State,W (45-21),18,22,81.8,116,1,45,324,7.2,5,67,440,6.6,4,16,1,21,3,23,0,0,0
15151,11,2014-11-15,troy,@,Idaho,W (34-17),19,26,73.1,231,2,57,293,5.1,1,83,524,6.3,7,15,1,23,8,92,1,0,1
15152,12,2014-11-29,troy,,Louisiana,L (23-42),29,34,85.3,272,3,32,122,3.8,0,66,394,6.0,14,7,3,24,4,40,2,0,2
15153,,12 Games,troy,,,,238,357,66.7,2381,12,461,1971,4.3,18,818,4352,5.3,90,116,14,220,74,738,10,4,14
15154,1,2015-09-05,troy,@,North Carolina State,L (21-49),14,21,66.7,184,1,25,121,4.8,2,46,305,6.6,7,5,1,13,5,54,1,1,2
15155,2,2015-09-12,troy,,Charleston Southern,W (44-16),19,28,67.9,249,2,28,125,4.5,3,56,374,6.7,10,7,1,18,7,62,0,0,0
15156,3,2015-09-19,troy,@,Wisconsin,L (3-28),23,35,65.7,174,0,33,81,2.5,0,68,255,3.8,10,6,3,19,7,59,1,0,1
15157,4,2015-10-03,troy,,South Alabama,L (18-24),16,35,45.7,146,1,33,119,3.6,1,68,265,3.9,9,7,2,18,7,66,0,3,3
15158,5,2015-10-10,troy,@,Mississippi State,L (17-45),20,36,55.6,142,0,46,112,2.4,2,82,254,3.1,8,9,2,19,3,20,1,1,2
15159,6,2015-10-17,troy,,Idaho,L (16-19),20,38,52.6,238,1,37,143,3.9,0,75,381,5.1,13,6,3,22,7,47,2,2,4
15160,7,2015-10-24,troy,@,New Mexico State,W (52-7),26,42,61.9,316,5,24,166,6.9,1,66,482,7.3,16,4,3,23,5,27,0,0,0
15161,8,2015-10-31,troy,@,Appalachian State,L (41-44),29,43,67.4,310,1,45,140,3.1,4,88,450,5.1,16,8,1,25,8,73,0,2,2
15162,9,2015-11-07,troy,,Louisiana-Monroe,W (51-14),24,36,66.7,345,4,35,148,4.2,0,71,493,6.9,13,7,0,20,5,30,0,0,0
15163,10,2015-11-14,troy,,Georgia Southern,L (10-45),15,29,51.7,170,0,18,68,3.8,0,47,238,5.1,8,3,0,11,4,41,2,1,3
15164,11,2015-11-27,troy,@,Georgia State,L (21-31),21,46,45.7,293,2,25,81,3.2,1,71,374,5.3,11,7,2,20,12,117,1,1,2
15165,12,2015-12-05,troy,@,Louisiana,W (41-17),22,28,78.6,320,4,33,128,3.9,0,61,448,7.3,12,6,0,18,10,95,0,0,0
15166,,12 Games,troy,,,,249,417,59.7,2887,21,382,1432,3.7,14,799,4319,5.4,133,75,18,226,80,691,8,11,19
15167,1,2016-09-03,troy,,Austin Peay,W (57-17),29,36,80.6,323,3,43,383,8.9,5,79,706,8.9,11,18,0,29,14,153,1,0,1
15168,2,2016-09-10,troy,@,Clemson,L (24-30),26,45,57.8,245,2,33,141,4.3,1,78,386,4.9,11,6,4,21,11,95,0,3,3
15169,3,2016-09-17,troy,@,Southern Mississippi,W (37-31),10,28,35.7,123,3,49,186,3.8,1,77,309,4.0,5,11,3,19,10,70,0,1,1
15170,4,2016-09-24,troy,,New Mexico State,W (52-6),27,37,73.0,285,2,41,207,5.0,3,78,492,6.3,16,9,2,27,2,26,0,0,0
15171,5,2016-10-01,troy,@,Idaho,W (34-13),31,42,73.8,373,3,33,157,4.8,1,75,530,7.1,15,11,1,27,7,58,1,2,3
15172,6,2016-10-15,troy,,Georgia State,W (31-21),20,36,55.6,235,2,43,128,3.0,1,79,363,4.6,10,7,3,20,10,95,0,1,1
15173,7,2016-10-20,troy,@,South Alabama,W (28-21),28,42,66.7,395,1,38,190,5.0,2,80,585,7.3,15,11,2,28,7,55,2,0,2
15174,8,2016-11-05,troy,,Massachusetts,W (52-31),29,39,74.4,287,4,38,198,5.2,3,77,485,6.3,16,11,1,28,5,35,0,1,1
15175,9,2016-11-12,troy,,Appalachian State,W (28-24),20,36,55.6,223,1,38,187,4.9,3,74,410,5.5,8,11,3,22,8,70,1,1,2
15176,10,2016-11-17,troy,,Arkansas State,L (3-35),20,39,51.3,207,0,24,55,2.3,0,63,262,4.2,10,4,3,17,3,16,3,2,5
15177,11,2016-11-26,troy,@,Texas State,W (40-7),24,37,64.9,237,2,42,154,3.7,3,79,391,4.9,10,11,4,25,2,15,0,0,0
15178,12,2016-12-03,troy,@,Georgia Southern,L (24-28),27,34,79.4,218,1,32,126,3.9,2,66,344,5.2,14,6,0,20,3,25,0,0,0
15179,13,2016-12-23,troy,N,Ohio*,W (28-23),24,41,58.5,235,1,31,87,2.8,3,72,322,4.5,13,3,1,17,6,90,0,2,2
15180,,13 Games,troy,,,,315,492,64.0,3386,25,485,2199,4.5,28,977,5585,5.7,154,119,27,300,88,803,8,13,21
15181,1,2017-09-02,troy,@,Boise State,L (13-24),17,34,50.0,139,0,29,76,2.6,0,63,215,3.4,4,5,2,11,8,60,2,1,3
15182,2,2017-09-09,troy,,Alabama State,W (34-7),33,42,78.6,354,0,35,251,7.2,5,77,605,7.9,18,12,2,32,10,110,0,1,1
15183,3,2017-09-16,troy,@,New Mexico State,W (27-24),25,40,62.5,286,1,37,192,5.2,3,77,478,6.2,13,9,4,26,9,61,0,0,0
15184,4,2017-09-23,troy,,Akron,W (22-17),28,42,66.7,314,1,28,181,6.5,2,70,495,7.1,15,6,3,24,16,159,1,0,1
15185,5,2017-09-30,troy,@,Louisiana State,W (24-21),16,28,57.1,157,0,42,206,4.9,3,70,363,5.2,8,8,0,16,5,35,2,0,2
15186,6,2017-10-11,troy,,South Alabama,L (8-19),25,47,53.2,269,0,20,30,1.5,1,67,299,4.5,11,4,3,18,6,33,3,1,4
15187,7,2017-10-21,troy,@,Georgia State,W (34-10),25,36,69.4,335,2,22,122,5.5,2,58,457,7.9,14,5,1,20,1,5,1,1,2
15188,8,2017-10-28,troy,,Georgia Southern,W (38-16),10,20,50.0,142,2,30,241,8.0,3,50,383,7.7,6,8,2,16,4,18,0,0,0
15189,9,2017-11-02,troy,,Idaho,W (24-21),20,31,64.5,212,1,36,183,5.1,2,67,395,5.9,8,11,1,20,10,91,1,1,2
15190,10,2017-11-11,troy,@,Coastal Carolina,W (42-17),21,33,63.6,259,1,36,122,3.4,3,69,381,5.5,12,11,1,24,4,29,0,1,1
15191,11,2017-11-24,troy,,Texas State,W (62-9),26,35,74.3,487,5,31,154,5.0,3,66,641,9.7,17,5,0,22,3,15,0,0,0
15192,12,2017-12-02,troy,@,Arkansas State,W (32-25),23,41,56.1,246,2,25,47,1.9,0,66,293,4.4,12,0,2,14,7,46,1,0,1
15193,13,2017-12-16,troy,N,North Texas*,W (50-30),24,31,77.4,305,4,38,130,3.4,3,69,435,6.3,13,5,3,21,8,80,1,1,2
15194,,13 Games,troy,,,,293,460,63.7,3505,19,409,1935,4.7,30,869,5440,6.3,151,89,24,264,91,742,12,7,19
15195,1,2018-09-01,troy,,Boise State,L (20-56),24,34,70.6,255,1,44,124,2.8,2,78,379,4.9,13,7,1,21,3,25,3,1,4
15196,2,2018-09-08,troy,,Florida A&M,W (59-7),22,38,57.9,185,5,41,292,7.1,2,79,477,6.0,10,15,1,26,5,51,0,0,0
15197,3,2018-09-15,troy,@,Nebraska,W (24-19),14,21,66.7,110,0,34,143,4.2,2,55,253,4.6,4,5,3,12,10,95,1,1,2
15198,4,2018-09-22,troy,@,Louisiana-Monroe,W (35-27),27,32,84.4,329,3,35,140,4.0,2,67,469,7.0,15,10,2,27,5,32,0,0,0
15199,5,2018-09-29,troy,,Coastal Carolina,W (45-21),14,19,73.7,185,2,31,282,9.1,3,50,467,9.3,7,9,2,18,6,45,1,1,2
15200,6,2018-10-04,troy,,Georgia State,W (37-20),19,25,76.0,217,3,37,337,9.1,2,62,554,8.9,9,9,0,18,13,95,0,1,1
15201,7,2018-10-13,troy,@,Liberty,L (16-22),16,30,53.3,160,1,39,133,3.4,0,69,293,4.2,5,10,2,17,10,65,2,1,3
15202,8,2018-10-23,troy,@,South Alabama,W (38-17),9,16,56.3,158,3,35,252,7.2,2,51,410,8.0,5,7,4,16,7,67,1,1,2
15203,9,2018-11-03,troy,,Louisiana,W (26-16),18,22,81.8,317,1,40,110,2.8,1,62,427,6.9,12,8,1,21,9,73,1,0,1
15204,10,2018-11-10,troy,@,Georgia Southern,W (35-21),23,30,76.7,314,1,42,140,3.3,3,72,454,6.3,13,9,2,24,4,45,1,0,1
15205,11,2018-11-17,troy,,Texas State,W (12-7),13,27,48.1,79,0,47,141,3.0,0,74,220,3.0,4,9,0,13,4,25,0,0,0
15206,,11 Games,troy,,,,199,294,67.7,2309,20,425,2094,4.9,19,719,4403,6.1,97,98,18,213,76,618,10,6,16
15207,1,2014-08-30,arkansas-state,,Montana State,W (37-10),20,30,66.7,264,1,49,283,5.8,3,79,547,6.9,10,13,0,23,4,25,2,0,2
15208,2,2014-09-06,arkansas-state,@,Tennessee,L (19-34),22,36,61.1,190,1,42,141,3.4,2,78,331,4.2,9,8,0,17,9,75,1,0,1
15209,3,2014-09-13,arkansas-state,@,Miami (FL),L (20-41),23,42,54.8,236,1,47,93,2.0,2,89,329,3.7,15,6,3,24,9,84,1,1,2
15210,4,2014-09-20,arkansas-state,,Utah State,W (21-14),19,33,57.6,190,1,47,126,2.7,2,80,316,4.0,9,10,3,22,8,62,3,1,4
15211,5,2014-10-04,arkansas-state,,Louisiana-Monroe,W (28-14),21,36,58.3,284,1,51,288,5.6,3,87,572,6.6,11,15,3,29,11,110,1,2,3
15212,6,2014-10-11,arkansas-state,@,Georgia State,W (52-10),22,30,73.3,234,3,53,384,7.2,4,83,618,7.4,12,20,0,32,5,40,2,0,2
15213,7,2014-10-21,arkansas-state,@,Louisiana,L (40-55),27,39,69.2,342,3,37,253,6.8,2,76,595,7.8,12,9,1,22,7,51,0,1,1
15214,8,2014-11-01,arkansas-state,@,Idaho,W (44-28),21,29,72.4,244,0,48,198,4.1,5,77,442,5.7,11,8,1,20,11,99,1,0,1
15215,9,2014-11-08,arkansas-state,,South Alabama,W (45-10),17,34,50.0,186,2,49,214,4.4,3,83,400,4.8,8,13,1,22,8,77,0,0,0
15216,10,2014-11-15,arkansas-state,,Appalachian State,L (32-37),14,29,48.3,147,3,30,167,5.6,1,59,314,5.3,5,7,2,14,5,54,1,0,1
15217,11,2014-11-20,arkansas-state,@,Texas State,L (27-45),31,57,54.4,366,2,40,132,3.3,1,97,498,5.1,16,7,2,25,8,80,0,1,1
15218,12,2014-11-29,arkansas-state,,New Mexico State,W (68-35),16,22,72.7,295,2,51,469,9.2,7,73,764,10.5,10,22,2,34,14,107,0,2,2
15219,13,2015-01-04,arkansas-state,N,Toledo*,L (44-63),23,31,74.2,403,5,32,65,2.0,0,63,468,7.4,11,7,2,20,5,41,2,0,2
15220,,13 Games,arkansas-state,,,,276,448,61.6,3381,25,576,2813,4.9,35,1024,6194,6.0,139,145,20,304,104,905,14,8,22
15221,1,2015-09-05,arkansas-state,@,Southern California,L (6-55),17,37,45.9,193,0,50,208,4.2,1,87,401,4.6,8,11,0,19,8,88,2,2,4
15222,2,2015-09-12,arkansas-state,,Missouri,L (20-27),14,30,46.7,124,2,45,93,2.1,0,75,217,2.9,6,10,2,18,7,80,0,3,3
15223,3,2015-09-19,arkansas-state,,Missouri State,W (70-7),23,26,88.5,280,3,46,344,7.5,6,72,624,8.7,13,13,1,27,7,49,1,0,1
15224,4,2015-09-26,arkansas-state,@,Toledo,L (7-37),18,35,51.4,223,0,24,-14,-0.6,0,59,209,3.5,10,0,1,11,8,90,2,3,5
15225,5,2015-10-03,arkansas-state,,Idaho,W (49-35),16,25,64.0,188,1,53,333,6.3,6,78,521,6.7,11,16,2,29,15,169,1,1,2
15226,6,2015-10-13,arkansas-state,@,South Alabama,W (49-31),10,18,55.6,119,2,53,226,4.3,2,71,345,4.9,6,1,1,17,8,80,1,0,1
15227,7,2015-10-20,arkansas-state,,Louisiana,W (37-27),9,20,45.0,129,2,52,306,5.9,2,72,435,6.0,6,14,2,22,3,20,0,1,1
15228,8,2015-10-31,arkansas-state,,Georgia State,W (48-34),21,29,72.4,224,3,52,296,5.7,4,81,520,6.4,10,14,4,28,9,64,1,2,3
15229,9,2015-11-05,arkansas-state,@,Appalachian State,W (40-27),14,25,56.0,208,1,52,309,5.9,2,77,517,6.7,7,17,0,24,2,5,0,0,0
15230,10,2015-11-14,arkansas-state,@,Louisiana-Monroe,W (59-21),15,32,46.9,300,5,50,148,3.0,2,82,448,5.5,8,9,2,19,11,105,1,0,1
15231,11,2015-11-28,arkansas-state,@,New Mexico State,W (52-28),23,43,53.5,367,2,46,238,5.2,3,89,605,6.8,15,13,2,30,11,118,0,1,1
15232,12,2015-12-05,arkansas-state,,Texas State,W (55-17),12,16,75.0,192,2,46,353,7.7,5,62,545,8.8,9,13,1,23,9,67,1,0,1
15233,13,2015-12-19,arkansas-state,N,Louisiana Tech*,L (28-47),15,29,51.7,146,0,39,177,4.5,2,68,323,4.8,6,11,6,23,11,109,1,2,3
15234,,13 Games,arkansas-state,,,,207,365,56.7,2693,23,608,3017,5.0,35,973,5710,5.9,115,142,24,290,109,1044,11,15,26
15235,1,2016-09-02,arkansas-state,,Toledo,L (10-31),11,25,44.0,124,0,38,142,3.7,1,63,266,4.2,3,8,2,13,6,48,0,0,0
15236,2,2016-09-10,arkansas-state,@,Auburn,L (14-51),19,30,63.3,260,0,35,66,1.9,2,65,326,5.0,9,4,1,14,10,71,0,0,0
15237,3,2016-09-16,arkansas-state,@,Utah State,L (20-34),20,33,60.6,287,1,31,70,2.3,1,64,357,5.6,11,3,2,16,18,129,1,2,3
15238,4,2016-09-24,arkansas-state,,Central Arkansas,L (23-28),21,38,55.3,424,3,34,45,1.3,0,72,469,6.5,14,6,0,20,8,63,2,2,4
15239,5,2016-10-05,arkansas-state,,Georgia Southern,W (27-26),16,28,57.1,182,2,49,343,7.0,1,77,525,6.8,9,16,2,27,2,20,3,2,5
15240,6,2016-10-15,arkansas-state,,South Alabama,W (17-7),9,13,69.2,93,0,54,204,3.8,1,67,297,4.4,14,20,2,36,4,25,0,1,1
15241,7,2016-10-29,arkansas-state,,Louisiana-Monroe,W (51-10),24,41,58.5,316,5,31,118,3.8,2,72,434,6.0,16,5,3,24,7,58,0,0,0
15242,8,2016-11-03,arkansas-state,@,Georgia State,W (31-16),15,35,42.9,212,0,41,93,2.3,2,76,305,4.0,10,6,1,17,6,50,1,0,1
15243,9,2016-11-12,arkansas-state,,New Mexico State,W (41-22),22,29,75.9,293,3,38,160,4.2,2,67,453,6.8,10,8,0,18,6,51,0,1,1
15244,10,2016-11-17,arkansas-state,@,Troy,W (35-3),14,26,53.8,180,1,51,208,4.1,3,77,388,5.0,6,12,1,19,9,57,0,0,0
15245,11,2016-11-26,arkansas-state,@,Louisiana,L (19-24),35,57,61.4,393,1,33,128,3.9,1,90,521,5.8,20,8,0,28,6,58,0,1,1
15246,12,2016-12-03,arkansas-state,@,Texas State,W (36-14),13,21,61.9,179,2,44,178,4.0,3,65,357,5.5,7,9,2,18,10,65,0,0,0
15247,13,2016-12-17,arkansas-state,N,Central Florida*,W (31-13),12,26,46.2,205,3,38,29,0.8,0,64,234,3.7,5,3,0,8,15,140,1,0,1
15248,,13 Games,arkansas-state,,,,231,402,57.5,3148,21,517,1784,3.5,19,919,4932,5.4,134,108,16,258,107,835,8,9,17
15249,1,2017-09-02,arkansas-state,@,Nebraska,L (36-43),46,68,67.6,415,3,21,82,3.9,0,89,497,5.6,25,5,2,32,9,63,0,2,2
15250,2,2017-09-16,arkansas-state,,Arkansas-Pine Bluff,W (48-3),26,34,76.5,356,6,37,137,3.7,1,71,493,6.9,16,9,1,26,5,39,0,0,0
15251,3,2017-09-23,arkansas-state,@,Southern Methodist,L (21-44),23,43,53.5,284,2,29,143,4.9,1,72,427,5.9,14,6,0,20,12,93,1,1,2
15252,4,2017-10-04,arkansas-state,@,Georgia Southern,W (43-25),12,26,46.2,316,4,35,65,1.9,2,61,381,6.2,11,6,2,19,5,55,1,4,5
15253,5,2017-10-14,arkansas-state,,Coastal Carolina,W (51-17),24,37,64.9,286,5,37,189,5.1,0,74,475,6.4,16,10,2,27,6,59,0,0,0
15254,6,2017-10-19,arkansas-state,,Louisiana,W (47-3),24,39,61.5,309,2,42,264,6.3,3,81,573,7.1,12,14,4,30,7,60,1,0,1
15255,7,2017-10-28,arkansas-state,@,New Mexico State,W (37-21),25,40,62.5,297,4,40,120,3.0,1,80,417,5.2,16,6,5,27,13,126,1,1,2
15256,8,2017-11-11,arkansas-state,@,South Alabama,L (19-24),28,45,62.2,299,2,33,66,2.0,0,78,365,4.7,12,9,2,23,7,40,2,4,6
15257,9,2017-11-18,arkansas-state,,Texas State,W (30-12),20,33,60.6,229,1,61,233,3.8,3,94,462,4.9,10,14,1,25,6,39,0,0,0
15258,10,2017-11-25,arkansas-state,@,Louisiana-Monroe,W (67-50),26,38,68.4,520,4,44,261,5.9,4,82,781,9.5,21,8,2,31,10,108,0,1,1
15259,11,2017-12-02,arkansas-state,,Troy,L (25-32),31,50,62.0,437,2,44,169,3.8,1,94,606,6.4,21,9,2,32,7,65,0,3,3
15260,12,2017-12-16,arkansas-state,N,Middle Tennessee State*,L (30-35),32,58,55.2,358,3,39,104,2.7,1,97,462,4.8,17,9,4,30,7,81,2,1,3
15261,,12 Games,arkansas-state,,,,317,511,62.0,4106,38,462,1833,4.0,17,973,5939,6.1,191,105,27,322,94,828,8,17,25
15262,1,2018-09-01,arkansas-state,,Southeast Missouri State,W (48-21),28,40,70.0,497,7,39,188,4.8,0,79,685,8.7,18,10,2,30,12,119,1,2,3
15263,2,2018-09-08,arkansas-state,@,Alabama,L (7-57),22,51,43.1,218,1,31,173,5.6,0,82,391,4.8,12,6,1,19,10,84,0,1,1
15264,3,2018-09-15,arkansas-state,@,Tulsa,W (29-20),20,33,60.6,191,0,47,218,4.6,2,80,409,5.1,9,14,1,24,11,101,1,0,1
15265,4,2018-09-22,arkansas-state,,Nevada-Las Vegas,W (27-20),19,27,70.4,199,3,36,197,5.5,1,63,396,6.3,9,8,0,17,11,87,1,0,1
15266,5,2018-09-29,arkansas-state,@,Georgia Southern,L (21-28),38,51,74.5,376,1,36,117,3.3,1,87,493,5.7,18,10,0,28,5,39,1,0,1
15267,6,2018-10-09,arkansas-state,,Appalachian State,L (9-35),27,45,60.0,219,0,37,117,3.2,0,82,336,4.1,10,6,2,18,7,65,0,3,3
15268,7,2018-10-18,arkansas-state,,Georgia State,W (51-35),17,28,60.7,257,3,37,273,7.4,3,65,530,8.2,10,11,2,23,11,109,0,0,0
15269,8,2018-10-27,arkansas-state,@,Louisiana,L (43-47),17,31,54.8,270,1,45,208,4.6,5,76,478,6.3,10,14,3,27,4,65,0,1,1
15270,9,2018-11-03,arkansas-state,,South Alabama,W (38-14),27,40,67.5,354,3,37,155,4.2,2,77,509,6.6,15,8,3,26,3,15,0,0,0
15271,10,2018-11-10,arkansas-state,@,Coastal Carolina,W (44-16),23,29,79.3,281,4,29,173,6.0,2,58,454,7.8,11,9,3,23,10,71,1,0,1
15272,11,2018-11-17,arkansas-state,,Louisiana-Monroe,W (31-17),21,27,77.8,246,3,39,158,4.1,0,66,404,6.1,11,7,2,20,7,68,0,0,0
15273,,11 Games,arkansas-state,,,,259,402,64.4,3108,26,413,1977,4.8,16,815,5085,6.2,133,103,19,255,91,823,5,7,12
15274,1,2014-09-06,south-alabama,@,Kent State,W (23-13),15,25,60.0,161,1,50,186,3.7,2,75,347,4.6,7,10,3,20,6,30,0,0,0
15275,2,2014-09-13,south-alabama,,Mississippi State,L (3-35),28,55,50.9,288,0,27,57,2.1,0,82,345,4.2,16,5,1,22,3,12,2,2,4
15276,3,2014-09-20,south-alabama,,Georgia Southern,L (6-28),13,34,38.2,149,1,42,147,3.5,0,76,296,3.9,9,11,0,20,6,50,0,2,2
15277,4,2014-09-27,south-alabama,@,Idaho,W (34-10),15,25,60.0,196,1,38,233,6.1,2,63,429,6.8,7,11,1,19,8,65,1,1,2
15278,5,2014-10-04,south-alabama,@,Appalachian State,W (47-21),19,28,67.9,339,3,46,243,5.3,3,74,582,7.9,16,12,0,28,10,124,0,0,0
15279,6,2014-10-18,south-alabama,,Georgia State,W (30-27),11,32,34.4,126,2,54,321,5.9,1,86,447,5.2,7,19,0,26,8,82,0,0,0
15280,7,2014-10-24,south-alabama,,Troy,W (27-13),9,21,42.9,106,1,45,296,6.6,2,66,402,6.1,5,14,4,23,8,78,0,0,0
15281,8,2014-11-01,south-alabama,@,Louisiana,L (9-19),20,35,57.1,270,1,35,66,1.9,0,70,336,4.8,11,5,2,18,8,76,1,0,1
15282,9,2014-11-08,south-alabama,@,Arkansas State,L (10-45),9,25,36.0,90,0,36,111,3.1,1,61,201,3.3,4,6,4,14,3,25,1,3,4
15283,10,2014-11-15,south-alabama,,Texas State,W (24-20),21,29,72.4,210,2,35,174,5.0,1,64,384,6.0,8,8,1,17,6,46,3,1,4
15284,11,2014-11-22,south-alabama,@,South Carolina,L (12-37),17,34,50.0,170,0,44,119,2.7,0,78,289,3.7,12,6,2,20,5,30,1,4,5
15285,12,2014-11-28,south-alabama,,Navy,L (40-42),21,32,65.6,177,4,47,238,5.1,1,79,415,5.3,8,13,1,22,5,51,0,2,2
15286,13,2014-12-20,south-alabama,N,Bowling Green State*,L (28-33),20,37,54.1,279,1,38,136,3.6,3,75,415,5.5,13,9,1,23,5,48,2,2,4
15287,,13 Games,south-alabama,,,,218,412,52.9,2561,17,537,2327,4.3,16,949,4888,5.2,123,129,20,272,81,717,11,17,28
15288,1,2015-09-05,south-alabama,,Gardner-Webb,W (33-23),14,25,56.0,184,2,31,224,7.2,2,56,408,7.3,2,10,1,13,7,55,1,2,3
15289,2,2015-09-12,south-alabama,@,Nebraska,L (9-48),26,45,57.8,313,1,24,19,0.8,0,69,332,4.8,15,1,2,18,7,67,2,1,3
15290,3,2015-09-19,south-alabama,@,San Diego State,W (34-27),18,36,50.0,270,2,47,241,5.1,2,83,511,6.2,12,9,2,23,5,22,0,0,0
15291,4,2015-09-26,south-alabama,,North Carolina State,L (13-63),16,35,45.7,213,1,26,45,1.7,0,61,258,4.2,9,3,2,14,2,25,1,2,3
15292,5,2015-10-03,south-alabama,@,Troy,W (24-18),11,21,52.4,205,2,51,160,3.1,1,72,365,5.1,7,12,2,21,4,55,1,1,2
15293,6,2015-10-13,south-alabama,,Arkansas State,L (31-49),18,33,54.5,273,3,32,29,0.9,1,65,302,4.6,8,3,1,12,7,52,2,3,5
15294,7,2015-10-24,south-alabama,@,Texas State,L (18-36),16,27,59.3,196,0,47,272,5.8,2,74,468,6.3,7,12,3,22,16,127,0,0,0
15295,8,2015-11-07,south-alabama,,Idaho,W (52-45),11,19,57.9,114,2,45,286,6.4,3,64,400,6.3,6,13,0,19,7,71,2,0,2
15296,9,2015-11-12,south-alabama,,Louisiana,W (32-25),18,31,58.1,288,2,52,207,4.0,2,83,495,6.0,12,13,1,26,7,59,0,1,1
15297,10,2015-11-21,south-alabama,@,Georgia State,L (10-24),14,34,41.2,125,0,34,159,4.7,1,68,284,4.2,6,10,3,19,8,70,0,1,1
15298,11,2015-11-28,south-alabama,@,Georgia Southern,L (17-55),7,19,36.8,62,0,36,74,2.1,1,55,136,2.5,3,4,2,9,4,25,0,2,2
15299,12,2015-12-05,south-alabama,,Appalachian State,L (27-34),15,27,55.6,151,0,56,214,3.8,3,83,365,4.4,10,11,0,21,7,65,0,3,3
15300,,12 Games,south-alabama,,,,184,352,52.3,2394,15,481,1930,4.0,18,833,4324,5.2,97,101,19,217,81,693,9,16,25
15301,1,2016-09-03,south-alabama,@,Mississippi State,W (21-20),24,34,70.6,285,2,29,94,3.2,1,63,379,6.0,12,6,1,19,8,57,0,0,0
15302,2,2016-09-10,south-alabama,,Georgia Southern,L (9-24),21,43,48.8,279,0,27,73,2.7,0,70,352,5.0,11,6,2,19,6,65,0,1,1
15303,3,2016-09-17,south-alabama,@,Louisiana,L (23-28),21,29,72.4,264,2,37,74,2.0,1,66,338,5.1,13,5,2,20,3,20,1,0,1
15304,4,2016-09-24,south-alabama,,Nicholls State,W (41-40),24,50,48.0,302,1,42,208,5.0,3,92,510,5.5,16,8,0,24,6,70,0,4,4
15305,5,2016-10-01,south-alabama,,San Diego State,W (42-24),16,21,76.2,242,3,40,89,2.2,2,61,331,5.4,9,7,2,18,10,93,0,1,1
15306,6,2016-10-15,south-alabama,@,Arkansas State,L (7-17),12,27,44.4,194,0,31,61,2.0,1,58,255,4.4,7,6,0,13,9,67,1,1,2
15307,7,2016-10-20,south-alabama,,Troy,L (21-28),11,20,55.0,195,1,39,145,3.7,2,59,340,5.8,7,4,1,12,13,100,1,0,1
15308,8,2016-10-29,south-alabama,,Georgia State,W (13-10),15,27,55.6,124,0,43,182,4.2,1,70,306,4.4,7,11,1,19,5,44,1,1,2
15309,9,2016-11-05,south-alabama,@,Louisiana-Monroe,L (35-42),23,37,62.2,307,1,41,209,5.1,4,78,516,6.6,17,11,2,30,12,83,0,1,1
15310,10,2016-11-19,south-alabama,,Presbyterian,W (31-7),15,28,53.6,167,0,35,251,7.2,3,63,418,6.6,9,8,0,17,4,58,1,0,1
15311,11,2016-11-26,south-alabama,@,Idaho,L (31-38),25,45,55.6,326,3,35,157,4.5,1,80,483,6.0,14,9,2,25,10,73,0,2,2
15312,12,2016-12-03,south-alabama,,New Mexico State,W (35-28),16,28,57.1,239,1,49,282,5.8,4,77,521,6.8,9,13,0,22,4,50,1,2,3
15313,13,2016-12-30,south-alabama,N,Air Force*,L (21-45),10,26,38.5,245,1,21,68,3.2,2,47,313,6.7,7,6,0,13,9,71,2,1,3
15314,,13 Games,south-alabama,,,,233,415,56.1,3169,15,469,1893,4.0,25,884,5062,5.7,138,100,13,251,99,851,8,14,22
15315,1,2017-09-02,south-alabama,@,Mississippi,L (27-47),19,31,61.3,204,1,37,170,4.6,2,68,374,5.5,13,11,1,25,3,22,0,0,0
15316,2,2017-09-08,south-alabama,,Oklahoma State,L (7-44),14,24,58.3,134,1,27,41,1.5,0,51,175,3.4,9,2,1,12,3,40,1,1,2
15317,3,2017-09-16,south-alabama,,Alabama A&M,W (45-0),9,13,69.2,255,2,39,158,4.1,2,52,413,7.9,8,9,1,18,9,83,0,0,0
15318,4,2017-09-23,south-alabama,,Idaho,L (23-29),11,26,42.3,106,0,48,244,5.1,2,74,350,4.7,5,10,2,17,12,109,0,1,1
15319,5,2017-09-30,south-alabama,@,Louisiana Tech,L (16-34),21,45,46.7,235,1,22,98,4.5,0,67,333,5.0,13,3,0,16,7,45,0,2,2
15320,6,2017-10-11,south-alabama,@,Troy,W (19-8),11,20,55.0,176,1,44,48,1.1,1,64,224,3.5,8,3,1,12,8,90,0,1,1
15321,7,2017-10-21,south-alabama,,Louisiana-Monroe,W (33-23),20,33,60.6,317,3,35,232,6.6,1,68,549,8.1,12,14,0,26,7,65,0,1,1
15322,8,2017-10-26,south-alabama,@,Georgia State,L (13-21),27,48,56.3,297,1,23,41,1.8,0,71,338,4.8,12,2,1,15,3,32,0,2,2
15323,9,2017-11-04,south-alabama,,Louisiana,L (14-19),23,42,54.8,281,2,28,87,3.1,0,70,368,5.3,13,8,2,23,6,49,0,2,2
15324,10,2017-11-11,south-alabama,,Arkansas State,W (24-19),25,46,54.3,343,2,32,-3,-0.1,1,78,340,4.4,14,2,2,18,9,81,1,0,1
15325,11,2017-11-18,south-alabama,@,Georgia Southern,L (0-52),16,37,43.2,166,0,16,29,1.8,0,53,195,3.7,7,2,1,10,4,37,1,2,3
15326,12,2017-12-02,south-alabama,@,New Mexico State,L (17-22),26,46,56.5,331,1,24,22,0.9,1,70,353,5.0,17,3,1,21,2,26,1,2,3
15327,,12 Games,south-alabama,,,,222,411,54.0,2845,15,375,1167,3.1,10,786,4012,5.1,131,69,13,213,73,679,4,14,18
15328,1,2018-09-01,south-alabama,,Louisiana Tech,L (26-30),11,23,47.8,91,1,43,217,5.0,3,66,308,4.7,4,10,1,15,7,82,2,2,4
15329,2,2018-09-08,south-alabama,@,Oklahoma State,L (13-55),17,34,50.0,136,1,37,78,2.1,1,71,214,3.0,5,5,5,15,12,85,0,1,1
15330,3,2018-09-15,south-alabama,,Texas State,W (41-31),24,33,72.7,266,2,27,116,4.3,2,60,382,6.4,7,4,2,13,15,143,3,0,3
15331,4,2018-09-22,south-alabama,@,Memphis,L (35-52),24,32,75.0,360,3,36,107,3.0,2,68,467,6.9,11,7,1,19,8,83,2,0,2
15332,5,2018-09-29,south-alabama,@,Appalachian State,L (7-52),20,33,60.6,225,0,35,83,2.4,1,68,308,4.5,10,4,2,16,9,91,0,1,1
15333,6,2018-10-06,south-alabama,@,Georgia Southern,L (13-48),19,31,61.3,197,0,39,129,3.3,1,70,326,4.7,7,7,3,17,10,90,2,2,4
15334,7,2018-10-13,south-alabama,,Alabama State,W (45-7),13,17,76.5,211,2,44,185,4.2,3,61,396,6.5,7,13,1,21,7,75,0,0,0
15335,8,2018-10-23,south-alabama,,Troy,L (17-38),18,30,60.0,275,2,45,110,2.4,0,75,385,5.1,14,8,1,23,7,91,0,3,3
15336,9,2018-11-03,south-alabama,@,Arkansas State,L (14-38),12,22,54.5,93,2,46,156,3.4,0,68,249,3.7,8,7,1,16,6,64,0,0,0
15337,10,2018-11-10,south-alabama,,Louisiana-Monroe,L (10-38),14,23,60.9,129,1,31,89,2.9,0,54,218,4.0,5,5,1,11,5,36,0,0,0
15338,11,2018-11-17,south-alabama,@,Louisiana,L (38-48),18,28,64.3,254,2,57,223,3.9,3,85,477,5.6,10,13,4,27,9,61,2,1,3
15339,,11 Games,south-alabama,,,,190,306,62.1,2237,16,440,1493,3.4,16,746,3730,5.0,88,83,22,193,95,901,11,10,21
15340,1,2014-08-28,louisiana-monroe,,Wake Forest,W (17-10),23,41,56.1,189,0,44,163,3.7,1,85,352,4.1,9,11,1,21,5,25,1,0,1
15341,2,2014-09-06,louisiana-monroe,,Idaho,W (38-31),24,45,53.3,384,2,37,150,4.1,3,82,534,6.5,15,10,4,29,5,40,0,1,1
15342,3,2014-09-13,louisiana-monroe,@,Louisiana State,L (0-31),16,30,53.3,77,0,18,16,0.9,0,48,93,1.9,5,0,1,6,5,45,1,0,1
15343,4,2014-09-27,louisiana-monroe,,Troy,W (22-20),28,43,65.1,328,2,33,29,0.9,0,76,357,4.7,14,4,1,19,0,0,0,1,1
15344,5,2014-10-04,louisiana-monroe,@,Arkansas State,L (14-28),27,47,57.4,276,2,25,72,2.9,0,72,348,4.8,12,4,0,16,8,69,2,0,2
15345,6,2014-10-11,louisiana-monroe,@,Kentucky,L (14-48),22,39,56.4,187,2,40,77,1.9,0,79,264,3.3,8,6,1,15,5,41,1,2,3
15346,7,2014-10-25,louisiana-monroe,,Texas State,L (18-22),25,40,62.5,250,0,42,144,3.4,1,82,394,4.8,12,7,1,20,5,34,0,1,1
15347,8,2014-11-01,louisiana-monroe,@,Texas A&M,L (16-21),28,49,57.1,269,0,30,78,2.6,1,79,347,4.4,14,4,1,19,4,20,0,1,1
15348,9,2014-11-08,louisiana-monroe,@,Appalachian State,L (29-31),20,41,48.8,244,2,30,55,1.8,1,71,299,4.2,13,5,2,20,8,78,0,0,0
15349,10,2014-11-15,louisiana-monroe,,Louisiana,L (27-34),39,56,69.6,483,2,21,-39,-1.9,1,77,444,5.8,18,1,2,21,0,0,3,0,3
15350,11,2014-11-22,louisiana-monroe,@,New Mexico State,W (30-17),35,50,70.0,350,1,27,70,2.6,1,77,420,5.5,14,4,1,19,4,40,1,1,2
15351,12,2014-11-29,louisiana-monroe,@,Georgia Southern,L (16-22),30,48,62.5,322,2,16,19,1.2,0,64,341,5.3,13,2,1,16,4,33,1,0,1
15352,,12 Games,louisiana-monroe,,,,317,529,59.9,3359,15,363,834,2.3,9,892,4193,4.7,147,58,16,221,53,425,10,7,17
15353,1,2015-09-05,louisiana-monroe,@,Georgia,L (14-51),23,29,79.3,206,2,26,45,1.7,0,55,251,4.6,9,3,0,12,5,30,0,1,1
15354,2,2015-09-12,louisiana-monroe,,Nicholls State,W (47-0),28,38,73.7,391,3,38,202,5.3,3,76,593,7.8,15,10,2,27,18,158,0,0,0
15355,3,2015-09-26,louisiana-monroe,@,Alabama,L (0-34),20,43,46.5,83,0,31,9,0.3,0,74,92,1.2,5,1,4,10,10,90,0,2,2
15356,4,2015-10-03,louisiana-monroe,,Georgia Southern,L (31-51),21,36,58.3,232,3,26,47,1.8,0,62,279,4.5,11,3,2,16,10,72,0,3,3
15357,5,2015-10-10,louisiana-monroe,@,Tulsa,L (24-34),25,48,52.1,231,1,29,173,6.0,2,77,404,5.2,13,6,2,21,8,73,2,1,3
15358,6,2015-10-17,louisiana-monroe,,Appalachian State,L (14-59),18,35,51.4,191,2,39,159,4.1,0,74,350,4.7,11,7,3,21,3,15,0,2,2
15359,7,2015-10-24,louisiana-monroe,@,Idaho,L (13-27),19,37,51.4,186,1,23,57,2.5,0,60,243,4.1,9,3,3,15,6,42,0,0,0
15360,8,2015-10-31,louisiana-monroe,@,Louisiana,L (24-30),16,35,45.7,265,3,34,76,2.2,0,69,341,4.9,11,4,0,15,5,45,2,0,2
15361,9,2015-11-07,louisiana-monroe,@,Troy,L (14-51),24,42,57.1,262,2,35,114,3.3,0,77,376,4.9,13,7,0,20,11,84,3,3,6
15362,10,2015-11-14,louisiana-monroe,,Arkansas State,L (21-59),10,31,32.3,100,1,44,152,3.5,2,75,252,3.4,3,5,2,10,6,43,1,4,5
15363,11,2015-11-19,louisiana-monroe,@,Texas State,L (3-16),16,33,48.5,83,0,24,98,4.1,0,57,181,3.2,4,5,1,10,3,28,1,1,2
15364,12,2015-11-28,louisiana-monroe,@,Hawaii,L (26-28),27,44,61.4,234,2,33,142,4.3,0,77,376,4.9,16,6,4,26,8,54,1,0,1
15365,13,2015-12-05,louisiana-monroe,,New Mexico State,W (42-35),9,26,34.6,239,5,43,64,1.5,0,69,303,4.4,7,5,1,13,2,20,1,2,3
15366,,13 Games,louisiana-monroe,,,,256,477,53.7,2703,25,425,1338,3.1,7,902,4041,4.5,127,65,24,216,95,754,11,19,30
15367,1,2016-09-03,louisiana-monroe,,Southern,W (38-21),20,33,60.6,208,2,46,325,7.1,3,79,533,6.7,10,16,0,26,7,73,0,2,2
15368,2,2016-09-10,louisiana-monroe,@,Oklahoma,L (17-59),23,37,62.2,272,2,29,78,2.7,0,66,350,5.3,11,4,0,15,4,36,1,0,1
15369,3,2016-09-17,louisiana-monroe,@,Georgia Southern,L (21-23),17,33,51.5,283,2,29,67,2.3,1,62,350,5.6,10,4,1,15,5,70,1,1,2
15370,4,2016-10-01,louisiana-monroe,@,Auburn,L (7-58),19,33,57.6,139,1,32,112,3.5,0,65,251,3.9,7,8,1,16,2,30,1,1,2
15371,5,2016-10-08,louisiana-monroe,,Idaho,L (31-34),20,38,52.6,302,2,38,221,5.8,2,76,523,6.9,13,12,2,27,2,15,1,3,4
15372,6,2016-10-15,louisiana-monroe,,Texas State,W (40-34),14,23,60.9,179,2,73,298,4.1,3,96,477,5.0,10,18,3,31,2,30,1,1,2
15373,7,2016-10-22,louisiana-monroe,@,New Mexico,L (17-59),12,22,54.5,120,1,41,115,2.8,1,63,235,3.7,6,6,0,12,6,52,0,2,2
15374,8,2016-10-29,louisiana-monroe,@,Arkansas State,L (10-51),14,29,48.3,162,0,42,174,4.1,1,71,336,4.7,8,7,2,17,7,51,0,2,2
15375,9,2016-11-05,louisiana-monroe,,South Alabama,W (42-35),26,39,66.7,279,3,46,181,3.9,3,85,460,5.4,14,10,3,27,4,40,0,1,1
15376,10,2016-11-12,louisiana-monroe,@,Georgia State,W (37-23),17,31,54.8,193,0,54,264,4.9,5,85,457,5.4,11,18,2,31,3,25,0,0,0
15377,11,2016-11-19,louisiana-monroe,@,Appalachian State,L (17-42),13,32,40.6,136,0,44,225,5.1,2,76,361,4.8,7,13,2,22,5,50,0,1,1
15378,12,2016-12-03,louisiana-monroe,,Louisiana,L (3-30),3,14,21.4,31,0,38,116,3.1,0,52,147,2.8,2,6,0,8,3,35,3,2,5
15379,,12 Games,louisiana-monroe,,,,198,364,54.4,2304,15,512,2176,4.3,21,876,4480,5.1,109,122,16,247,50,507,8,16,24
15380,1,2017-08-31,louisiana-monroe,@,Memphis,L (29-37),21,37,56.8,279,2,49,146,3.0,2,86,425,4.9,13,10,2,25,8,53,3,1,4
15381,2,2017-09-16,louisiana-monroe,,Southern Mississippi,L (17-28),11,27,40.7,112,0,37,218,5.9,2,64,330,5.2,5,9,1,15,5,54,1,0,1
15382,3,2017-09-23,louisiana-monroe,@,Louisiana,W (56-50),28,34,82.4,343,1,45,250,5.6,7,79,593,7.5,14,12,1,27,9,87,0,0,0
15383,4,2017-09-30,louisiana-monroe,,Coastal Carolina,W (51-43),12,20,60.0,101,1,40,243,6.1,4,60,344,5.7,5,9,2,16,4,35,0,0,0
15384,5,2017-10-07,louisiana-monroe,@,Texas State,W (45-27),24,37,64.9,433,3,41,156,3.8,2,78,589,7.6,15,9,0,24,6,57,0,0,0
15385,6,2017-10-14,louisiana-monroe,,Georgia State,L (37-47),23,37,62.2,314,3,37,117,3.2,1,74,431,5.8,10,8,1,19,4,25,1,0,1
15386,7,2017-10-21,louisiana-monroe,@,South Alabama,L (23-33),14,23,60.9,179,0,41,309,7.5,3,64,488,7.6,6,13,1,20,4,18,1,1,2
15387,8,2017-10-28,louisiana-monroe,@,Idaho,L (23-31),24,37,64.9,415,3,29,98,3.4,0,66,513,7.8,20,4,1,25,1,5,1,1,2
15388,9,2017-11-04,louisiana-monroe,,Appalachian State,W (52-45),24,32,75.0,356,3,38,213,5.6,3,70,569,8.1,15,11,2,28,6,55,0,1,1
15389,10,2017-11-18,louisiana-monroe,@,Auburn,L (14-42),16,36,44.4,217,1,41,116,2.8,1,77,333,4.3,11,3,2,16,3,14,1,2,3
15390,11,2017-11-25,louisiana-monroe,,Arkansas State,L (50-67),21,37,56.8,454,4,39,136,3.5,2,76,590,7.8,15,9,3,27,8,80,1,3,4
15391,12,2017-12-02,louisiana-monroe,@,Florida State,L (10-42),28,47,59.6,262,1,22,38,1.7,0,69,300,4.3,14,3,0,17,5,38,0,0,0
15392,,12 Games,louisiana-monroe,,,,246,404,60.9,3465,22,459,2040,4.4,27,863,5505,6.4,143,100,16,259,63,521,9,9,18
15393,1,2018-08-30,louisiana-monroe,,Southeastern Louisiana,W (34-31),35,53,66.0,346,2,43,208,4.8,2,96,554,5.8,15,14,2,31,10,75,1,1,2
15394,2,2018-09-08,louisiana-monroe,@,Southern Mississippi,W (21-20),15,28,53.6,195,2,30,159,5.3,0,58,354,6.1,7,6,0,13,8,55,1,1,2
15395,3,2018-09-15,louisiana-monroe,@,Texas A&M,L (10-48),15,28,53.6,225,1,29,103,3.6,0,57,328,5.8,7,6,1,14,4,38,0,1,1
15396,4,2018-09-22,louisiana-monroe,,Troy,L (27-35),29,48,60.4,290,2,36,200,5.6,2,84,490,5.8,15,11,1,27,10,94,0,1,1
15397,5,2018-09-29,louisiana-monroe,@,Georgia State,L (14-46),20,34,58.8,137,0,20,125,6.3,2,54,262,4.9,6,5,2,13,3,11,2,2,4
15398,6,2018-10-06,louisiana-monroe,@,Mississippi,L (21-70),23,38,60.5,297,1,38,130,3.4,1,76,427,5.6,13,10,2,25,2,15,2,0,2
15399,7,2018-10-13,louisiana-monroe,@,Coastal Carolina,W (45-20),16,22,72.7,224,1,34,242,7.1,5,56,466,8.3,8,11,1,20,2,30,1,0,1
15400,8,2018-10-20,louisiana-monroe,,Texas State,W (20-14),13,29,44.8,124,1,43,229,5.3,1,72,353,4.9,8,12,3,23,7,67,2,0,2
15401,9,2018-11-03,louisiana-monroe,,Georgia Southern,W (44-25),13,22,59.1,337,2,42,236,5.6,4,64,573,9.0,9,10,2,21,8,75,0,2,2
15402,10,2018-11-10,louisiana-monroe,@,South Alabama,W (38-10),28,33,84.8,376,2,38,175,4.6,3,71,551,7.8,16,8,2,26,1,15,1,0,1
15403,11,2018-11-17,louisiana-monroe,@,Arkansas State,L (17-31),17,28,60.7,218,1,26,58,2.2,1,54,276,5.1,10,4,2,16,5,63,0,3,3
15404,,11 Games,louisiana-monroe,,,,224,363,61.7,2769,15,379,1865,4.9,21,742,4634,6.2,114,97,18,229,60,538,10,11,21
15405,1,2017-09-02,coastal-carolina,,Massachusetts,W (38-28),10,18,55.6,80,1,47,321,6.8,4,65,401,6.2,3,16,1,20,6,68,0,0,0
15406,2,2017-09-16,coastal-carolina,@,Alabama-Birmingham,L (23-30),9,23,39.1,100,0,49,227,4.6,2,72,327,4.5,6,13,4,23,9,75,0,3,3
15407,3,2017-09-23,coastal-carolina,,Western Illinois,L (10-52),11,23,47.8,137,0,35,170,4.9,1,58,307,5.3,6,9,0,15,7,66,1,3,4
15408,4,2017-09-30,coastal-carolina,@,Louisiana-Monroe,L (43-51),18,32,56.3,329,4,38,112,2.9,2,70,441,6.3,11,8,2,21,7,80,1,2,3
15409,5,2017-10-07,coastal-carolina,,Georgia State,L (21-27),18,26,69.2,239,3,32,127,4.0,0,58,366,6.3,10,7,0,17,7,58,0,0,0
15410,6,2017-10-14,coastal-carolina,@,Arkansas State,L (17-51),13,29,44.8,231,1,38,197,5.2,1,67,428,6.4,9,11,4,23,6,40,1,0,1
15411,7,2017-10-21,coastal-carolina,@,Appalachian State,L (29-37),17,29,58.6,332,2,30,102,3.4,1,59,434,7.4,13,3,2,18,10,85,2,0,2
15412,8,2017-10-28,coastal-carolina,,Texas State,L (7-27),13,27,48.1,149,0,20,34,1.7,0,47,183,3.9,7,2,0,9,14,123,1,0,1
15413,9,2017-11-04,coastal-carolina,@,Arkansas,L (38-39),15,28,53.6,228,3,38,131,3.4,1,66,359,5.4,10,8,3,21,6,55,0,0,0
15414,10,2017-11-11,coastal-carolina,,Troy,L (17-42),14,28,50.0,164,2,37,94,2.5,0,65,258,4.0,7,9,0,16,5,59,0,2,2
15415,11,2017-11-18,coastal-carolina,@,Idaho,W (13-7),11,24,45.8,100,0,40,175,4.4,1,64,275,4.3,7,11,2,20,3,15,1,0,1
15416,12,2017-12-02,coastal-carolina,,Georgia Southern,W (28-17),9,17,52.9,180,2,42,185,4.4,2,59,365,6.2,6,11,0,17,4,30,0,1,1
15417,,12 Games,coastal-carolina,,,,158,304,52.0,2269,18,446,1875,4.2,15,750,4144,5.5,95,108,18,220,84,754,7,11,18
15418,1,2018-09-01,coastal-carolina,@,South Carolina,L (15-49),13,18,72.2,112,1,38,131,3.4,0,56,243,4.3,5,10,5,20,4,36,1,0,1
15419,2,2018-09-08,coastal-carolina,,Alabama-Birmingham,W (47-24),11,18,61.1,167,2,43,296,6.9,5,61,463,7.6,7,13,5,25,5,55,0,0,0
15420,3,2018-09-12,coastal-carolina,@,Campbell,W (58-21),13,17,76.5,241,4,44,333,7.6,4,61,574,9.4,9,18,5,32,2,20,0,1,1
15421,4,2018-09-22,coastal-carolina,@,Louisiana,W (30-28),12,17,70.6,186,2,56,311,5.6,2,73,497,6.8,9,14,2,25,7,70,1,0,1
15422,5,2018-09-29,coastal-carolina,@,Troy,L (21-45),18,22,81.8,172,1,54,145,2.7,2,76,317,4.2,9,11,1,21,4,43,1,1,2
15423,6,2018-10-13,coastal-carolina,,Louisiana-Monroe,L (20-45),12,23,52.2,167,0,52,272,5.2,2,75,439,5.9,6,13,1,20,8,71,2,1,3
15424,7,2018-10-20,coastal-carolina,@,Massachusetts,W (24-13),9,18,50.0,219,2,52,279,5.4,1,70,498,7.1,7,14,1,22,3,20,1,1,2
15425,8,2018-10-27,coastal-carolina,@,Georgia State,W (37-34),13,18,72.2,225,1,48,251,5.2,3,66,476,7.2,10,9,2,21,2,25,1,0,1
15426,9,2018-11-03,coastal-carolina,,Appalachian State,L (7-23),14,26,53.8,106,0,26,72,2.8,0,52,178,3.4,6,5,0,11,4,27,0,1,1
15427,10,2018-11-10,coastal-carolina,,Arkansas State,L (16-44),16,31,51.6,165,2,37,128,3.5,0,68,293,4.3,9,8,1,18,9,86,1,1,2
15428,11,2018-11-17,coastal-carolina,,Georgia Southern,L (17-41),12,24,50.0,115,2,34,74,2.2,0,58,189,3.3,7,4,0,11,0,0,1,0,1
15429,,11 Games,coastal-carolina,,,,143,232,61.6,1875,17,484,2292,4.7,19,716,4167,5.8,84,119,23,226,48,453,9,6,15
15430,1,2014-08-27,georgia-state,,Abilene Christian,W (38-37),31,49,63.3,413,4,33,153,4.6,1,82,566,6.9,20,10,3,33,12,99,1,2,3
15431,2,2014-09-06,georgia-state,,New Mexico State,L (31-34),21,37,56.8,294,1,39,162,4.2,3,76,456,6.0,10,10,3,23,7,59,2,2,4
15432,3,2014-09-13,georgia-state,,Air Force,L (38-48),26,42,61.9,414,2,25,135,5.4,3,67,549,8.2,18,7,1,26,7,79,0,1,1
15433,4,2014-09-20,georgia-state,@,Washington,L (14-45),22,34,64.7,205,2,41,68,1.7,0,75,273,3.6,10,5,2,17,4,25,1,3,4
15434,5,2014-10-04,georgia-state,@,Louisiana,L (31-34),20,31,64.5,287,0,37,138,3.7,4,68,425,6.3,12,6,6,24,10,79,0,0,0
15435,6,2014-10-11,georgia-state,,Arkansas State,L (10-52),20,39,51.3,198,0,34,71,2.1,1,73,269,3.7,9,8,1,18,1,5,1,1,2
15436,7,2014-10-18,georgia-state,@,South Alabama,L (27-30),23,40,57.5,311,3,37,90,2.4,1,77,401,5.2,10,8,3,21,4,30,1,0,1
15437,8,2014-10-25,georgia-state,,Georgia Southern,L (31-69),24,38,63.2,408,4,23,47,2.0,0,61,455,7.5,15,4,2,21,6,40,2,1,3
15438,9,2014-11-01,georgia-state,@,Appalachian State,L (0-44),9,19,47.4,54,0,26,8,0.3,0,45,62,1.4,2,4,0,6,0,0,2,1,3
15439,10,2014-11-08,georgia-state,@,Troy,L (21-45),23,37,62.2,293,3,34,101,3.0,0,71,394,5.5,13,8,0,21,3,25,1,2,3
15440,11,2014-11-22,georgia-state,@,Clemson,L (0-28),13,33,39.4,115,0,33,40,1.2,0,66,155,2.3,6,4,0,10,5,40,0,3,3
15441,12,2014-11-29,georgia-state,,Texas State,L (31-54),32,47,68.1,356,4,27,160,5.9,0,74,516,7.0,13,10,1,24,5,40,1,2,3
15442,,12 Games,georgia-state,,,,264,446,59.2,3348,23,389,1173,3.0,13,835,4521,5.4,138,84,22,244,64,521,12,18,30
15443,1,2015-09-04,georgia-state,,UNC Charlotte,L (20-23),25,43,58.1,299,2,26,93,3.6,0,69,392,5.7,9,6,1,16,10,79,2,1,3
15444,2,2015-09-12,georgia-state,@,New Mexico State,W (34-32),32,43,74.4,372,2,46,210,4.6,2,89,582,6.5,17,11,0,28,9,75,2,1,3
15445,3,2015-09-19,georgia-state,@,Oregon,L (28-61),25,40,62.5,318,3,36,113,3.1,1,76,431,5.7,11,8,3,22,4,23,2,2,4
15446,4,2015-10-03,georgia-state,,Liberty,L (33-41),18,29,62.1,394,3,14,11,0.8,1,43,405,9.4,10,2,2,14,5,46,0,1,1
15447,5,2015-10-10,georgia-state,,Appalachian State,L (3-37),21,39,53.8,166,0,21,59,2.8,0,60,225,3.8,8,5,1,14,7,60,1,1,2
15448,6,2015-10-17,georgia-state,@,Ball State,W (31-19),28,39,71.8,412,1,32,33,1.0,3,71,445,6.3,16,3,2,21,7,65,1,0,1
15449,7,2015-10-31,georgia-state,@,Arkansas State,L (34-48),23,43,53.5,390,2,32,101,3.2,1,75,491,6.5,13,5,3,21,10,73,1,1,2
15450,8,2015-11-07,georgia-state,,Louisiana,L (21-23),23,39,59.0,312,3,29,78,2.7,0,68,390,5.7,13,3,5,21,4,50,0,1,1
15451,9,2015-11-14,georgia-state,@,Texas State,W (41-19),23,35,65.7,471,4,37,172,4.6,1,72,643,8.9,18,8,1,27,5,35,0,2,2
15452,10,2015-11-21,georgia-state,,South Alabama,W (24-10),27,44,61.4,311,1,34,73,2.1,2,78,384,4.9,17,3,0,20,10,112,0,0,0
15453,11,2015-11-27,georgia-state,,Troy,W (31-21),29,41,70.7,368,2,43,151,3.5,2,84,519,6.2,14,7,2,23,7,56,2,0,2
15454,12,2015-12-05,georgia-state,@,Georgia Southern,W (34-7),20,32,62.5,346,3,37,143,3.9,2,69,489,7.1,14,8,1,23,8,103,0,1,1
15455,13,2015-12-19,georgia-state,N,San Jose State*,L (16-27),14,29,48.3,208,2,20,23,1.2,0,49,231,4.7,9,1,1,11,6,73,0,1,1
15456,,13 Games,georgia-state,,,,308,496,62.1,4367,28,407,1260,3.1,15,903,5627,6.2,169,70,22,261,92,850,11,12,23
15457,1,2016-09-02,georgia-state,,Ball State,L (21-31),25,40,62.5,195,1,25,77,3.1,1,65,272,4.2,11,6,2,19,6,52,1,1,2
15458,2,2016-09-10,georgia-state,@,Air Force,L (14-48),9,27,33.3,142,1,14,27,1.9,1,41,169,4.1,6,0,0,6,5,25,0,0,0
15459,3,2016-09-17,georgia-state,@,Wisconsin,L (17-23),20,30,66.7,269,1,24,33,1.4,1,54,302,5.6,10,2,0,12,5,45,0,0,0
15460,4,2016-10-01,georgia-state,@,Appalachian State,L (3-17),19,44,43.2,153,0,25,88,3.5,0,69,241,3.5,10,4,2,16,7,70,0,4,4
15461,5,2016-10-08,georgia-state,,Texas State,W (41-21),27,40,67.5,340,2,37,196,5.3,3,77,536,7.0,12,9,2,23,6,59,3,0,3
15462,6,2016-10-15,georgia-state,@,Troy,L (21-31),28,52,53.8,381,3,24,37,1.5,0,76,418,5.5,16,5,3,24,10,48,1,2,3
15463,7,2016-10-22,georgia-state,,Tennessee-Martin,W (31-6),8,16,50.0,119,1,39,166,4.3,1,55,285,5.2,4,9,0,13,7,54,0,2,2
15464,8,2016-10-29,georgia-state,@,South Alabama,L (10-13),11,18,61.1,113,0,40,127,3.2,1,58,240,4.1,5,8,1,14,5,37,1,0,1
15465,9,2016-11-03,georgia-state,,Arkansas State,L (16-31),22,46,47.8,237,1,31,94,3.0,0,77,331,4.3,10,7,2,19,7,65,0,2,2
15466,10,2016-11-12,georgia-state,,Louisiana-Monroe,L (23-37),19,30,63.3,422,3,26,42,1.6,0,56,464,8.3,11,5,0,16,6,47,0,0,0
15467,11,2016-11-19,georgia-state,,Georgia Southern,W (30-24),21,39,53.8,318,2,27,73,2.7,2,66,391,5.9,13,4,3,20,5,49,0,0,0
15468,12,2016-12-03,georgia-state,@,Idaho,L (12-37),22,37,59.5,266,2,24,92,3.8,0,61,358,5.9,12,4,3,19,4,30,2,4,6
15469,,12 Games,georgia-state,,,,231,419,55.1,2955,17,336,1052,3.1,10,755,4007,5.3,120,63,18,201,73,581,8,15,23
15470,1,2017-08-31,georgia-state,,Tennessee State,L (10-17),18,23,78.3,224,1,28,51,1.8,0,51,275,5.4,8,2,4,14,6,51,3,1,4
15471,2,2017-09-16,georgia-state,@,Penn State,L (0-56),18,32,56.3,170,0,49,150,3.1,0,81,320,4.0,9,10,2,21,3,25,2,3,5
15472,3,2017-09-23,georgia-state,@,UNC Charlotte,W (28-0),26,37,70.3,250,1,40,119,3.0,2,77,369,4.8,13,9,0,22,1,5,0,0,0
15473,4,2017-10-07,georgia-state,@,Coastal Carolina,W (27-21),18,30,60.0,273,1,40,91,2.3,2,70,364,5.2,12,7,3,22,6,45,0,1,1
15474,5,2017-10-14,georgia-state,@,Louisiana-Monroe,W (47-37),26,35,74.3,446,4,41,224,5.5,2,76,670,8.8,18,13,0,31,8,72,0,0,0
15475,6,2017-10-21,georgia-state,,Troy,L (10-34),25,40,62.5,255,1,33,52,1.6,0,73,307,4.2,10,6,0,16,2,20,0,1,1
15476,7,2017-10-26,georgia-state,,South Alabama,W (21-13),17,31,54.8,195,2,32,118,3.7,1,63,313,5.0,10,4,2,16,7,63,1,0,1
15477,8,2017-11-04,georgia-state,@,Georgia Southern,W (21-17),22,37,59.5,319,2,24,49,2.0,0,61,368,6.0,12,2,1,15,10,99,0,1,1
15478,9,2017-11-11,georgia-state,@,Texas State,W (33-30),26,40,65.0,368,2,41,162,4.0,1,81,530,6.5,11,10,0,21,7,64,2,0,2
15479,10,2017-11-25,georgia-state,,Appalachian State,L (10-31),22,35,62.9,201,0,26,91,3.5,1,61,292,4.8,8,4,2,14,6,75,0,1,1
15480,11,2017-12-02,georgia-state,,Idaho,L (10-24),27,45,60.0,271,0,39,164,4.2,1,84,435,5.2,16,9,1,26,2,20,3,1,4
15481,12,2017-12-16,georgia-state,N,Western Kentucky*,W (27-17),20,28,71.4,276,1,43,143,3.3,2,71,419,5.9,9,10,2,21,4,30,1,0,1
15482,,12 Games,georgia-state,,,,265,413,64.2,3248,15,436,1414,3.2,12,849,4662,5.5,136,86,17,239,62,569,12,9,21
15483,1,2018-08-30,georgia-state,,,W (24-20),20,28,71.4,187,3,37,130,3.5,0,65,317,4.9,12,6,3,21,3,33,1,0,1
15484,2,2018-09-08,georgia-state,@,North Carolina State,L (7-41),19,34,55.9,242,0,31,107,3.5,1,65,349,5.4,9,7,2,18,5,48,1,0,1
15485,3,2018-09-14,georgia-state,@,Memphis,L (22-59),19,34,55.9,139,0,43,173,4.0,2,77,312,4.1,10,9,3,22,2,16,0,1,1
15486,4,2018-09-22,georgia-state,,Western Michigan,L (15-34),19,29,65.5,285,0,30,58,1.9,2,59,343,5.8,12,6,0,18,2,25,2,1,3
15487,5,2018-09-29,georgia-state,,Louisiana-Monroe,W (46-14),15,18,83.3,179,1,56,308,5.5,4,74,487,6.6,7,12,1,20,7,70,1,0,1
15488,6,2018-10-04,georgia-state,@,Troy,L (20-37),20,36,55.6,272,1,35,116,3.3,1,71,388,5.5,11,9,3,23,0,0,2,0,2
15489,7,2018-10-18,georgia-state,@,Arkansas State,L (35-51),20,33,60.6,299,4,43,123,2.9,1,76,422,5.6,9,11,4,24,8,80,2,0,2
15490,8,2018-10-27,georgia-state,,Coastal Carolina,L (34-37),14,25,56.0,231,1,34,290,8.5,4,59,521,8.8,10,11,2,23,6,74,1,0,1
15491,9,2018-11-03,georgia-state,,Texas State,L (31-40),21,40,52.5,224,1,43,221,5.1,3,83,445,5.4,13,11,1,25,2,13,2,0,2
15492,10,2018-11-10,georgia-state,@,Louisiana,L (22-36),10,21,47.6,121,1,43,252,5.9,2,64,373,5.8,5,14,0,19,4,35,0,1,1
15493,11,2018-11-17,georgia-state,@,Appalachian State,L (17-45),10,21,47.6,132,1,34,197,5.8,1,55,329,6.0,5,10,0,15,6,61,0,2,2
15494,,11 Games,georgia-state,,,,187,319,58.6,2311,13,429,1975,4.6,21,748,4286,5.7,103,106,19,228,45,455,12,5,17
15495,1,2014-08-30,texas-state,,Arkansas-Pine Bluff,W (65-0),25,30,83.3,319,4,50,378,7.6,5,80,697,8.7,18,19,2,39,8,90,1,0,1
15496,2,2014-09-13,texas-state,,Navy,L (21-35),24,36,66.7,231,1,44,211,4.8,2,80,442,5.5,9,13,1,23,11,124,0,1,1
15497,3,2014-09-20,texas-state,@,Illinois,L (35-42),29,43,67.4,336,4,52,139,2.7,1,95,475,5.0,15,10,1,26,8,63,0,1,1
15498,4,2014-09-27,texas-state,@,Tulsa,W (37-34),21,31,67.7,228,2,49,181,3.7,3,80,409,5.1,10,10,1,21,7,77,0,0,0
15499,5,2014-10-04,texas-state,,Idaho,W (35-30),11,20,55.0,76,1,38,390,10.3,4,58,466,8.0,2,12,0,14,3,18,2,2,4
15500,6,2014-10-14,texas-state,,Louisiana,L (10-34),14,23,60.9,176,1,35,94,2.7,0,58,270,4.7,8,4,0,12,4,20,1,1,2
15501,7,2014-10-25,texas-state,@,Louisiana-Monroe,W (22-18),14,20,70.0,141,1,46,229,5.0,2,66,370,5.6,5,12,0,17,6,55,0,0,0
15502,8,2014-11-01,texas-state,@,New Mexico State,W (37-29),17,30,56.7,143,1,43,287,6.7,3,73,430,5.9,6,13,2,21,7,55,0,0,0
15503,9,2014-11-08,texas-state,,Georgia Southern,L (25-28),30,51,58.8,302,2,42,137,3.3,1,93,439,4.7,18,5,3,26,4,41,0,2,2
15504,10,2014-11-15,texas-state,@,South Alabama,L (20-24),25,44,56.8,300,1,40,106,2.7,1,84,406,4.8,14,7,1,22,7,72,0,0,0
15505,11,2014-11-20,texas-state,,Arkansas State,W (45-27),14,22,63.6,192,2,57,370,6.5,4,79,562,7.1,5,21,2,28,5,55,1,0,1
15506,12,2014-11-29,texas-state,@,Georgia State,W (54-31),26,32,81.3,267,2,43,340,7.9,3,75,607,8.1,13,16,0,29,5,38,0,0,0
15507,,12 Games,texas-state,,,,250,382,65.4,2711,22,539,2862,5.3,29,921,5573,6.1,123,142,13,278,75,708,5,7,12
15508,1,2015-09-05,texas-state,@,Florida State,L (16-59),26,42,61.9,168,1,33,132,4.0,1,75,300,4.0,12,5,0,17,1,5,1,0,1
15509,2,2015-09-12,texas-state,,Prairie View A&M,W (63-24),18,22,81.8,333,3,50,316,6.3,5,72,649,9.0,9,18,2,29,9,113,2,0,2
15510,3,2015-09-19,texas-state,,Southern Mississippi,L (50-56),31,46,67.4,310,3,37,281,7.6,1,83,591,7.1,16,8,5,29,7,74,0,0,0
15511,4,2015-09-26,texas-state,@,Houston,L (14-59),31,50,62.0,302,0,32,99,3.1,2,82,401,4.9,14,5,2,21,5,38,2,2,4
15512,5,2015-10-10,texas-state,@,Louisiana,L (27-49),13,33,39.4,178,1,37,173,4.7,2,70,351,5.0,7,9,0,16,9,71,1,0,1
15513,6,2015-10-24,texas-state,,South Alabama,W (36-18),13,23,56.5,105,0,43,319,7.4,4,66,424,6.4,4,13,2,19,11,111,0,1,1
15514,7,2015-10-29,texas-state,@,Georgia Southern,L (13-37),10,27,37.0,87,1,31,126,4.1,0,58,213,3.7,5,7,1,13,2,20,0,2,2
15515,8,2015-11-07,texas-state,,New Mexico State,L (21-31),21,36,58.3,287,1,37,113,3.1,2,73,400,5.5,11,7,2,20,4,30,1,2,3
15516,9,2015-11-14,texas-state,,Georgia State,L (19-41),29,52,55.8,267,1,32,186,5.8,1,84,453,5.4,13,14,1,28,4,29,0,2,2
15517,10,2015-11-19,texas-state,,Louisiana-Monroe,W (16-3),14,25,56.0,176,2,55,158,2.9,0,80,334,4.2,8,10,2,20,9,78,0,0,0
15518,11,2015-11-28,texas-state,@,Idaho,L (31-38),24,43,55.8,312,2,40,191,4.8,2,83,503,6.1,14,9,0,23,6,57,1,1,2
15519,12,2015-12-05,texas-state,@,Arkansas State,L (17-55),19,32,59.4,227,0,43,174,4.0,2,75,401,5.3,11,9,1,21,6,45,1,2,3
15520,,12 Games,texas-state,,,,249,431,57.8,2752,15,470,2268,4.8,22,901,5020,5.6,124,114,18,256,73,671,9,12,21
15521,1,2016-09-03,texas-state,@,Ohio,W (56-54),41,56,73.2,440,5,42,106,2.5,2,98,546,5.6,20,6,3,29,6,55,1,2,3
15522,2,2016-09-17,texas-state,@,Arkansas,L (3-42),11,26,42.3,83,0,26,22,0.8,0,52,105,2.0,3,5,0,8,5,45,0,1,1
15523,3,2016-09-24,texas-state,,Houston,L (3-64),20,33,60.6,109,0,23,33,1.4,0,56,142,2.5,7,1,0,8,8,87,0,1,1
15524,4,2016-10-01,texas-state,,Incarnate Word,W (48-17),32,42,76.2,540,6,50,130,2.6,1,92,670,7.3,25,7,2,34,7,40,0,0,0
15525,5,2016-10-08,texas-state,@,Georgia State,L (21-41),27,47,57.4,300,1,41,120,2.9,2,88,420,4.8,17,8,2,27,6,56,1,2,3
15526,6,2016-10-15,texas-state,@,Louisiana-Monroe,L (34-40),19,36,52.8,193,0,26,124,4.8,3,62,317,5.1,10,8,1,19,11,103,1,2,3
15527,7,2016-10-22,texas-state,,Louisiana,L (3-27),20,28,71.4,142,0,36,79,2.2,0,64,221,3.5,7,6,0,13,8,64,1,1,2
15528,8,2016-11-05,texas-state,@,Appalachian State,L (10-35),28,38,73.7,183,0,28,14,0.5,1,66,197,3.0,10,1,3,14,5,35,0,1,1
15529,9,2016-11-12,texas-state,,Idaho,L (14-47),15,19,78.9,193,1,28,-18,-0.6,1,47,175,3.7,8,1,4,13,5,25,2,0,2
15530,10,2016-11-19,texas-state,@,New Mexico State,L (10-50),18,34,52.9,189,0,41,153,3.7,1,75,342,4.6,9,7,1,17,4,34,2,3,5
15531,11,2016-11-26,texas-state,,Troy,L (7-40),12,29,41.4,147,0,39,109,2.8,1,68,256,3.8,7,9,0,15,8,82,0,2,2
15532,12,2016-12-03,texas-state,,Arkansas State,L (14-36),14,27,51.9,120,1,46,117,2.5,1,73,237,3.2,6,7,2,15,9,61,0,2,2
15533,,12 Games,texas-state,,,,257,415,61.9,2639,14,426,989,2.3,13,841,3628,4.3,129,66,18,212,82,687,8,17,25
15534,1,2017-09-02,texas-state,,,W (20-11),18,28,64.3,135,0,41,155,3.8,2,69,290,4.2,7,7,4,18,7,70,1,1,2
15535,2,2017-09-09,texas-state,@,Colorado,L (3-37),8,18,44.4,127,0,47,156,3.3,0,65,283,4.4,6,6,0,12,2,16,1,1,2
15536,3,2017-09-16,texas-state,,Appalachian State,L (13-20),23,35,65.7,260,1,37,125,3.4,0,72,385,5.3,10,9,2,21,7,67,0,1,1
15537,4,2017-09-23,texas-state,,Texas-San Antonio,L (14-44),10,27,37.0,161,1,32,37,1.2,1,59,198,3.4,7,4,6,17,4,51,1,0,1
15538,5,2017-09-30,texas-state,@,Wyoming,L (10-45),11,23,47.8,127,1,52,135,2.6,0,75,262,3.5,4,10,2,16,3,22,1,1,2
15539,6,2017-10-07,texas-state,,Louisiana-Monroe,L (27-45),14,25,56.0,205,2,39,181,4.6,2,64,386,6.0,7,9,2,18,7,39,1,0,1
15540,7,2017-10-12,texas-state,@,Louisiana,L (7-24),14,25,56.0,219,0,44,106,2.4,1,69,325,4.7,9,9,1,19,1,0,2,1,3
15541,8,2017-10-28,texas-state,@,Coastal Carolina,W (27-7),27,39,69.2,269,2,52,238,4.6,1,91,507,5.6,10,18,4,32,6,60,1,1,2
15542,9,2017-11-04,texas-state,,New Mexico State,L (35-45),33,53,62.3,400,4,36,163,4.5,1,89,563,6.3,19,9,2,30,4,47,3,1,4
15543,10,2017-11-11,texas-state,,Georgia State,L (30-33),35,55,63.6,315,3,25,75,3.0,1,80,390,4.9,15,5,3,23,2,10,0,1,1
15544,11,2017-11-18,texas-state,@,Arkansas State,L (12-30),8,25,32.0,103,1,30,85,2.8,1,55,188,3.4,5,5,1,11,5,31,1,0,1
15545,12,2017-11-24,texas-state,@,Troy,L (9-62),14,21,66.7,147,0,45,153,3.4,1,66,300,4.5,7,7,0,14,5,45,2,2,4
15546,,12 Games,texas-state,,,,215,374,57.5,2468,15,480,1609,3.4,11,854,4077,4.8,106,98,27,231,53,458,14,10,24
15547,1,2018-09-01,texas-state,@,Rutgers,L (7-35),9,24,37.5,100,0,30,69,2.3,0,54,169,3.1,5,4,3,12,15,119,2,1,3
15548,2,2018-09-08,texas-state,,Texas Southern,W (36-20),18,29,62.1,243,1,52,304,5.8,1,81,547,6.8,8,19,1,28,8,70,1,0,1
15549,3,2018-09-15,texas-state,@,South Alabama,L (31-41),17,32,53.1,214,2,52,158,3.0,2,84,372,4.4,9,8,3,20,6,50,1,2,3
15550,4,2018-09-22,texas-state,@,Texas-San Antonio,L (21-25),17,28,60.7,222,2,25,26,1.0,1,53,248,4.7,9,4,2,15,5,41,1,2,3
15551,5,2018-10-06,texas-state,,Louisiana,L (27-42),29,41,70.7,301,4,28,124,4.4,0,69,425,6.2,14,7,1,22,3,30,0,0,0
15552,6,2018-10-11,texas-state,,Georgia Southern,L (13-15),14,27,51.9,135,1,32,107,3.3,1,59,242,4.1,7,6,2,15,3,25,1,1,2
15553,7,2018-10-20,texas-state,@,Louisiana-Monroe,L (14-20),15,25,60.0,115,0,36,127,3.5,2,61,242,4.0,6,7,6,19,6,53,0,0,0
15554,8,2018-10-27,texas-state,,New Mexico State,W (27-20),9,18,50.0,113,2,48,230,4.8,2,66,343,5.2,4,9,1,14,10,79,1,0,1
15555,9,2018-11-03,texas-state,@,Georgia State,W (40-31),21,26,80.8,325,2,36,164,4.6,4,62,489,7.9,12,7,0,19,5,32,0,0,0
15556,10,2018-11-10,texas-state,,Appalachian State,L (7-38),19,30,63.3,132,1,31,86,2.8,0,61,218,3.6,8,5,2,15,3,19,2,1,3
15557,11,2018-11-17,texas-state,@,Troy,L (7-12),9,23,39.1,155,0,36,129,3.6,1,59,284,4.8,6,6,1,13,2,10,1,5,6
15558,,11 Games,texas-state,,,,177,303,58.4,2055,15,406,1524,3.8,14,709,3579,5.0,88,82,22,192,66,528,10,12,22
15559,1,2014-08-28,new-mexico-state,,Cal Poly,W (28-10),18,27,66.7,118,2,47,197,4.2,2,74,315,4.3,8,12,1,21,3,50,0,1,1
15560,2,2014-09-06,new-mexico-state,@,Georgia State,W (34-31),25,44,56.8,241,3,41,194,4.7,0,85,435,5.1,13,11,2,26,5,38,2,1,3
15561,3,2014-09-13,new-mexico-state,@,Texas-El Paso,L (24-42),23,41,56.1,335,2,21,90,4.3,1,62,425,6.9,13,6,1,20,4,17,0,2,2
15562,4,2014-09-20,new-mexico-state,,New Mexico,L (35-38),32,47,68.1,333,2,45,174,3.9,3,92,507,5.5,15,12,2,29,5,44,0,2,2
15563,5,2014-09-27,new-mexico-state,@,Louisiana State,L (7-63),16,33,48.5,102,0,37,172,4.6,1,70,274,3.9,5,7,1,13,5,35,2,2,4
15564,6,2014-10-04,new-mexico-state,,Georgia Southern,L (28-36),35,50,70.0,334,0,42,183,4.4,4,92,517,5.6,16,13,1,30,2,10,1,3,4
15565,7,2014-10-11,new-mexico-state,@,Troy,L (24-41),22,33,66.7,272,2,38,123,3.2,1,71,395,5.6,14,6,0,20,1,12,2,2,4
15566,8,2014-10-18,new-mexico-state,@,Idaho,L (17-29),9,16,56.3,100,0,34,214,6.3,2,50,314,6.3,5,4,2,11,7,39,1,3,4
15567,9,2014-11-01,new-mexico-state,,Texas State,L (29-37),36,52,69.2,404,3,48,235,4.9,1,100,639,6.4,17,15,0,32,11,76,0,2,2
15568,10,2014-11-08,new-mexico-state,,Louisiana,L (16-44),19,34,55.9,204,1,33,103,3.1,1,67,307,4.6,8,6,0,14,1,5,1,3,4
15569,11,2014-11-22,new-mexico-state,,Louisiana-Monroe,L (17-30),15,32,46.9,102,0,51,276,5.4,2,83,378,4.6,6,11,2,19,3,21,1,1,2
15570,12,2014-11-29,new-mexico-state,@,Arkansas State,L (35-68),28,43,65.1,314,4,34,178,5.2,1,77,492,6.4,14,5,3,22,10,80,0,2,2
15571,,12 Games,new-mexico-state,,,,278,452,61.5,2859,19,471,2139,4.5,19,923,4998,5.4,134,108,15,257,57,427,10,24,34
15572,1,2015-09-05,new-mexico-state,@,Florida,L (13-61),14,28,50.0,128,1,23,72,3.1,1,51,200,3.9,4,4,0,8,1,9,0,1,1
15573,2,2015-09-12,new-mexico-state,,Georgia State,L (32-34),31,55,56.4,445,3,23,84,3.7,1,78,529,6.8,17,6,3,26,7,129,0,1,1
15574,3,2015-09-19,new-mexico-state,,Texas-El Paso,L (47-50),14,28,50.0,285,3,35,266,7.6,2,63,551,8.7,8,11,2,21,13,149,0,1,1
15575,4,2015-10-03,new-mexico-state,@,New Mexico,L (29-38),12,28,42.9,108,0,39,308,7.9,3,67,416,6.2,2,11,1,14,7,39,1,2,3
15576,5,2015-10-10,new-mexico-state,@,Mississippi,L (3-52),22,37,59.5,141,0,37,98,2.6,0,74,239,3.2,7,10,1,18,3,35,0,2,2
15577,6,2015-10-17,new-mexico-state,@,Georgia Southern,L (26-56),20,37,54.1,253,3,29,133,4.6,0,66,386,5.8,9,7,3,19,4,40,0,1,1
15578,7,2015-10-24,new-mexico-state,,Troy,L (7-52),13,34,38.2,161,1,47,231,4.9,0,81,392,4.8,6,14,0,20,8,82,2,0,2
15579,8,2015-10-31,new-mexico-state,,Idaho,W (55-48),24,40,60.0,326,3,41,315,7.7,5,81,641,7.9,10,14,0,24,6,47,1,1,2
15580,9,2015-11-07,new-mexico-state,@,Texas State,W (31-21),24,45,53.3,297,2,48,230,4.8,2,93,527,5.7,11,12,3,26,5,37,0,0,0
15581,10,2015-11-21,new-mexico-state,@,Louisiana,W (37-34),16,42,38.1,261,4,46,237,5.2,0,88,498,5.7,12,12,3,27,3,30,0,0,0
15582,11,2015-11-28,new-mexico-state,,Arkansas State,L (28-52),26,41,63.4,315,4,25,119,4.8,0,66,434,6.6,13,4,3,20,9,86,1,3,4
15583,12,2015-12-05,new-mexico-state,@,Louisiana-Monroe,L (35-42),23,36,63.9,308,2,52,89,1.7,2,88,397,4.5,10,7,1,18,10,100,2,2,4
15584,,12 Games,new-mexico-state,,,,239,451,53.0,3028,26,445,2182,4.9,16,896,5210,5.8,109,112,20,241,76,783,7,14,21
15585,1,2016-09-03,new-mexico-state,@,Texas-El Paso,L (22-38),17,41,41.5,206,0,30,139,4.6,2,71,345,4.9,8,9,2,19,7,40,0,0,0
15586,2,2016-09-10,new-mexico-state,,New Mexico,W (32-31),21,35,60.0,205,2,35,102,2.9,1,70,307,4.4,10,8,4,22,7,75,0,0,0
15587,3,2016-09-17,new-mexico-state,@,Kentucky,L (42-62),17,34,50.0,277,3,45,223,5.0,3,79,500,6.3,12,12,2,26,5,33,0,2,2
15588,4,2016-09-24,new-mexico-state,@,Troy,L (6-52),29,54,53.7,445,1,33,94,2.8,0,87,539,6.2,18,6,1,25,5,45,0,5,5
15589,5,2016-10-01,new-mexico-state,,Louisiana,W (37-31),31,49,63.3,354,2,42,145,3.5,1,91,499,5.5,16,12,3,31,9,43,0,2,2
15590,6,2016-10-15,new-mexico-state,@,Idaho,L (23-55),23,36,63.9,366,3,29,62,2.1,0,65,428,6.6,10,7,0,17,6,64,2,0,2
15591,7,2016-10-22,new-mexico-state,,Georgia Southern,L (19-22),22,39,56.4,250,2,40,168,4.2,0,79,418,5.3,11,11,4,26,6,57,2,1,3
15592,8,2016-10-29,new-mexico-state,@,Texas A&M,L (10-52),21,38,55.3,147,1,39,169,4.3,0,77,316,4.1,6,8,4,18,5,30,0,0,0
15593,9,2016-11-12,new-mexico-state,@,Arkansas State,L (22-41),26,45,57.8,256,1,40,182,4.6,1,85,438,5.2,11,13,1,25,9,86,1,1,2
15594,10,2016-11-19,new-mexico-state,,Texas State,W (50-10),23,38,60.5,231,5,44,252,5.7,1,82,483,5.9,8,15,3,26,10,121,1,0,1
15595,11,2016-11-26,new-mexico-state,,Appalachian State,L (7-37),12,27,44.4,92,1,27,143,5.3,0,54,235,4.4,3,6,1,10,2,15,0,2,2
15596,12,2016-12-03,new-mexico-state,@,South Alabama,L (28-35),11,25,44.0,110,1,48,353,7.4,3,73,463,6.3,7,12,2,21,5,57,1,2,3
15597,,12 Games,new-mexico-state,,,,253,461,54.9,2939,22,452,2032,4.5,12,913,4971,5.4,120,119,27,266,76,666,7,15,22
15598,1,2017-08-31,new-mexico-state,@,Arizona State,L (31-37),40,58,69.0,398,3,30,151,5.0,2,88,549,6.2,18,9,0,27,6,59,0,2,2
15599,2,2017-09-09,new-mexico-state,@,New Mexico,W (30-28),34,57,59.6,401,4,25,104,4.2,0,82,505,6.2,17,5,1,23,10,82,1,1,2
15600,3,2017-09-16,new-mexico-state,,Troy,L (24-27),32,45,71.1,331,3,16,75,4.7,0,61,406,6.7,14,4,0,18,6,66,0,0,0
15601,4,2017-09-23,new-mexico-state,,Texas-El Paso,W (41-14),26,43,60.5,283,2,27,183,6.8,3,70,466,6.7,12,7,2,21,11,103,1,1,2
15602,5,2017-09-30,new-mexico-state,@,Arkansas,L (24-42),23,38,60.5,344,2,14,11,0.8,1,52,355,6.8,15,2,1,18,6,29,1,1,2
15603,6,2017-10-07,new-mexico-state,@,Appalachian State,L (31-45),27,50,54.0,356,2,42,176,4.2,2,92,532,5.8,13,13,2,28,10,57,0,6,6
15604,7,2017-10-14,new-mexico-state,@,Georgia Southern,W (35-27),32,52,61.5,399,4,26,92,3.5,1,78,491,6.3,16,5,4,25,2,15,0,2,2
15605,8,2017-10-28,new-mexico-state,,Arkansas State,L (21-37),20,40,50.0,221,1,32,35,1.1,2,72,256,3.6,7,4,2,13,4,39,0,2,2
15606,9,2017-11-04,new-mexico-state,@,Texas State,W (45-35),31,49,63.3,503,4,33,119,3.6,2,82,622,7.6,19,6,1,26,8,55,2,0,2
15607,10,2017-11-18,new-mexico-state,@,Louisiana,L (34-47),32,44,72.7,313,1,19,89,4.7,2,63,402,6.4,17,6,3,26,6,49,0,3,3
15608,11,2017-11-25,new-mexico-state,,Idaho,W (17-10),31,49,63.3,231,0,37,172,4.6,2,86,403,4.7,11,12,0,23,6,60,1,1,2
15609,12,2017-12-02,new-mexico-state,,South Alabama,W (22-17),40,61,65.6,451,2,23,40,1.7,0,84,491,5.8,23,3,0,26,9,55,0,1,1
15610,13,2017-12-29,new-mexico-state,N,Utah State*,W (26-20),29,54,53.7,191,1,29,184,6.3,1,83,375,4.5,9,6,1,16,4,45,1,2,3
15611,,13 Games,new-mexico-state,,,,397,640,62.0,4422,29,353,1431,4.1,18,993,5853,5.9,191,82,17,290,88,714,7,22,29
15612,1,2018-08-25,new-mexico-state,,Wyoming,L (7-29),18,33,54.5,144,1,16,-9,-0.6,0,49,135,2.8,5,2,0,7,12,57,0,0,0
15613,2,2018-08-30,new-mexico-state,@,Minnesota,L (10-48),29,58,50.0,233,1,20,38,1.9,0,78,271,3.5,10,4,5,19,5,50,0,1,1
15614,3,2018-09-08,new-mexico-state,@,Utah State,L (13-60),20,37,54.1,171,1,45,109,2.4,0,82,280,3.4,8,11,1,20,6,66,2,3,5
15615,4,2018-09-15,new-mexico-state,,New Mexico,L (25-42),22,40,55.0,249,1,36,119,3.3,1,76,368,4.8,10,6,6,22,15,114,0,5,5
15616,5,2018-09-22,new-mexico-state,@,Texas-El Paso,W (27-20),9,18,50.0,156,1,34,155,4.6,0,52,311,6.0,5,6,4,15,8,65,1,0,1
15617,6,2018-10-06,new-mexico-state,,Liberty,W (49-41),34,51,66.7,402,4,28,173,6.2,3,79,575,7.3,18,6,1,25,8,77,0,0,0
15618,7,2018-10-13,new-mexico-state,@,Louisiana,L (38-66),25,44,56.8,284,1,25,122,4.9,3,69,406,5.9,15,7,4,26,2,30,1,1,2
15619,8,2018-10-20,new-mexico-state,,Georgia Southern,L (31-48),25,38,65.8,295,0,35,148,4.2,4,73,443,6.1,12,10,4,26,5,38,2,1,3
15620,9,2018-10-27,new-mexico-state,@,Texas State,L (20-27),29,59,49.2,275,0,33,153,4.6,1,92,428,4.7,14,5,3,22,6,63,0,2,2
15621,10,2018-11-03,new-mexico-state,,Alcorn State,W (52-42),32,44,72.7,396,4,29,133,4.6,2,73,529,7.2,14,10,0,24,2,15,1,0,1
15622,11,2018-11-17,new-mexico-state,@,Brigham Young,L (10-45),25,61,41.0,264,1,26,48,1.8,0,87,312,3.6,12,7,1,20,5,39,1,2,3
15623,,11 Games,new-mexico-state,,,,268,483,55.5,2869,15,327,1189,3.6,14,810,4058,5.0,123,74,29,226,74,614,8,15,23
15624,1,2014-09-06,idaho,@,Louisiana-Monroe,L (31-38),26,47,55.3,324,3,36,118,3.3,1,83,442,5.3,15,8,2,25,12,119,1,2,3
15625,2,2014-09-13,idaho,,Western Michigan,L (33-45),27,41,65.9,362,3,31,45,1.5,1,72,407,5.7,14,4,5,23,8,79,0,1,1
15626,3,2014-09-20,idaho,@,Ohio,L (24-36),33,56,58.9,353,2,28,64,2.3,1,84,417,5.0,15,7,1,23,4,32,0,3,3
15627,4,2014-09-27,idaho,,South Alabama,L (10-34),25,40,62.5,239,1,33,30,0.9,0,73,269,3.7,10,4,4,18,7,59,0,2,2
15628,5,2014-10-04,idaho,@,Texas State,L (30-35),33,52,63.5,347,0,53,176,3.3,4,105,523,5.0,18,13,2,33,4,35,0,2,2
15629,6,2014-10-11,idaho,@,Georgia Southern,L (24-47),20,32,62.5,271,0,40,94,2.4,3,72,365,5.1,11,6,0,17,3,23,0,1,1
15630,7,2014-10-18,idaho,,New Mexico State,W (29-17),23,37,62.2,226,1,52,310,6.0,2,89,536,6.0,11,17,2,30,6,57,1,1,2
15631,8,2014-11-01,idaho,,Arkansas State,L (28-44),17,31,54.8,206,0,46,243,5.3,4,77,449,5.8,11,12,2,25,9,93,4,4,8
15632,9,2014-11-08,idaho,@,San Diego State,L (21-35),17,33,51.5,186,1,49,193,3.9,2,82,379,4.6,9,13,4,26,4,30,1,0,1
15633,10,2014-11-15,idaho,,Troy,L (17-34),14,36,38.9,269,1,27,117,4.3,1,63,386,6.1,8,8,3,19,5,40,0,3,3
15634,11,2014-11-29,idaho,@,Appalachian State,L (28-45),21,37,56.8,208,1,42,157,3.7,3,79,365,4.6,11,6,1,18,12,145,0,1,1
15635,,11 Games,idaho,,,,256,442,57.9,2991,13,437,1547,3.5,22,879,4538,5.2,133,98,26,257,74,712,7,20,27
15636,1,2015-09-03,idaho,,Ohio,L (28-45),36,48,75.0,297,1,28,100,3.6,2,76,397,5.2,18,4,3,25,3,31,1,2,3
15637,2,2015-09-12,idaho,@,Southern California,L (9-59),28,45,62.2,240,1,32,71,2.2,0,77,311,4.0,12,6,1,19,2,23,0,0,0
15638,3,2015-09-19,idaho,,Wofford,W (41-38),25,34,73.5,334,1,43,198,4.6,3,77,532,6.9,11,11,0,22,6,75,0,2,2
15639,4,2015-09-26,idaho,,Georgia Southern,L (20-44),20,36,55.6,284,2,34,111,3.3,0,70,395,5.6,10,8,2,20,2,15,0,2,2
15640,5,2015-10-03,idaho,@,Arkansas State,L (35-49),24,42,57.1,166,0,29,172,5.9,4,71,338,4.8,6,6,7,19,11,105,0,3,3
15641,6,2015-10-17,idaho,@,Troy,W (19-16),20,37,54.1,207,0,37,123,3.3,1,74,330,4.5,11,6,3,20,6,59,0,0,0
15642,7,2015-10-24,idaho,,Louisiana-Monroe,W (27-13),23,39,59.0,315,3,52,174,3.3,0,91,489,5.4,15,12,1,28,5,65,2,1,3
15643,8,2015-10-31,idaho,@,New Mexico State,L (48-55),25,42,59.5,307,2,50,262,5.2,3,92,569,6.2,14,14,2,30,4,30,0,2,2
15644,9,2015-11-07,idaho,@,South Alabama,L (45-52),26,39,66.7,317,2,45,177,3.9,4,84,494,5.9,15,9,3,27,3,24,2,1,3
15645,10,2015-11-14,idaho,,Appalachian State,L (20-47),20,32,62.5,243,2,28,56,2.0,0,60,299,5.0,11,5,1,17,5,44,0,0,0
15646,11,2015-11-21,idaho,@,Auburn,L (34-56),29,48,60.4,356,1,37,123,3.3,3,85,479,5.6,11,10,5,26,4,38,1,2,3
15647,12,2015-11-28,idaho,,Texas State,W (38-31),21,31,67.7,309,2,43,199,4.6,3,74,508,6.9,12,10,1,23,3,15,2,0,2
15648,,12 Games,idaho,,,,297,473,62.8,3375,17,458,1766,3.9,23,931,5141,5.5,146,101,29,276,54,524,8,15,23
15649,1,2016-09-01,idaho,,Montana State,W (20-17),8,22,36.4,128,0,35,225,6.4,2,57,353,6.2,6,9,0,15,5,85,1,1,2
15650,2,2016-09-10,idaho,@,Washington,L (14-59),23,38,60.5,218,1,38,104,2.7,1,76,322,4.2,9,8,0,17,4,35,2,1,3
15651,3,2016-09-17,idaho,@,Washington State,L (6-56),20,37,54.1,179,0,31,78,2.5,0,68,257,3.8,10,2,3,15,6,80,2,0,2
15652,4,2016-09-24,idaho,@,Nevada-Las Vegas,W (33-30),17,35,48.6,249,1,36,129,3.6,2,71,378,5.3,11,7,3,21,5,40,1,0,1
15653,5,2016-10-01,idaho,,Troy,L (13-34),19,34,55.9,166,1,36,89,2.5,0,70,255,3.6,10,7,2,19,4,40,0,2,2
15654,6,2016-10-08,idaho,@,Louisiana-Monroe,W (34-31),21,38,55.3,211,1,33,203,6.2,1,71,414,5.8,10,7,1,18,7,61,0,0,0
15655,7,2016-10-15,idaho,,New Mexico State,W (55-23),31,39,79.5,482,4,42,169,4.0,3,81,651,8.0,24,7,3,34,5,40,0,1,1
15656,8,2016-10-22,idaho,@,Appalachian State,L (19-37),26,41,63.4,294,1,26,63,2.4,0,67,357,5.3,16,5,3,24,3,37,0,3,3
15657,9,2016-11-05,idaho,@,Louisiana,W (23-13),20,30,66.7,227,0,40,157,3.9,2,70,384,5.5,14,7,1,22,4,45,0,0,0
15658,10,2016-11-12,idaho,@,Texas State,W (47-14),26,33,78.8,336,1,40,154,3.9,5,73,490,6.7,14,7,2,23,14,103,0,0,0
15659,11,2016-11-26,idaho,,South Alabama,W (38-31),17,34,50.0,231,2,35,176,5.0,3,69,407,5.9,11,11,5,27,4,45,0,3,3
15660,12,2016-12-03,idaho,,Georgia State,W (37-12),16,20,80.0,138,3,45,149,3.3,0,65,287,4.4,7,8,1,16,5,45,0,0,0
15661,13,2016-12-22,idaho,N,Colorado State*,W (61-50),21,31,67.7,381,4,51,225,4.4,5,82,606,7.4,16,13,1,30,7,69,0,0,0
15662,,13 Games,idaho,,,,265,432,61.3,3240,19,488,1921,3.9,24,920,5161,5.6,158,98,25,281,73,725,6,11,17
15663,1,2017-08-31,idaho,,Sacramento State,W (28-6),14,19,73.7,163,2,44,197,4.5,2,63,360,5.7,4,11,0,15,3,20,1,2,3
15664,2,2017-09-09,idaho,,Nevada-Las Vegas,L (16-44),22,34,64.7,261,1,36,123,3.4,1,70,384,5.5,11,6,1,18,4,40,0,1,1
15665,3,2017-09-16,idaho,@,Western Michigan,L (28-37),16,26,61.5,229,3,34,170,5.0,1,60,399,6.7,5,8,2,15,6,44,2,1,3
15666,4,2017-09-23,idaho,@,South Alabama,W (29-23),23,39,59.0,273,1,37,146,3.9,2,76,419,5.5,13,5,6,24,5,51,2,0,2
15667,5,2017-10-07,idaho,,Louisiana,L (16-21),13,28,46.4,149,0,39,130,3.3,1,67,279,4.2,7,6,0,13,6,60,0,0,0
15668,6,2017-10-14,idaho,,Appalachian State,L (20-23),15,28,53.6,200,2,36,112,3.1,0,64,312,4.9,6,8,0,14,7,60,2,0,2
15669,7,2017-10-21,idaho,@,Missouri,L (21-68),22,36,61.1,197,3,38,81,2.1,0,74,278,3.8,8,6,1,15,6,50,1,0,1
15670,8,2017-10-28,idaho,,Louisiana-Monroe,W (31-23),28,42,66.7,360,3,39,158,4.1,1,81,518,6.4,17,9,1,27,5,56,0,0,0
15671,9,2017-11-02,idaho,@,Troy,L (21-24),24,35,68.6,288,3,32,90,2.8,0,67,378,5.6,13,6,3,22,5,45,0,0,0
15672,10,2017-11-18,idaho,,Coastal Carolina,L (7-13),18,26,69.2,177,1,33,100,3.0,0,59,277,4.7,9,5,0,14,8,84,0,1,1
15673,11,2017-11-25,idaho,@,New Mexico State,L (10-17),19,35,54.3,174,1,38,41,1.1,0,73,215,2.9,8,6,2,16,4,20,1,2,3
15674,12,2017-12-02,idaho,@,Georgia State,W (24-10),16,30,53.3,228,1,40,147,3.7,2,70,375,5.4,11,6,1,18,5,37,0,0,0
15675,,12 Games,idaho,,,,230,378,60.8,2699,21,446,1495,3.4,10,824,4194,5.1,112,82,17,211,64,567,9,7,16
15676,1,2018-09-01,idaho,@,Fresno State,L (13-79),14,33,42.4,205,1,32,102,3.2,1,65,307,4.7,9,6,0,15,4,20,2,5,7
15677,2,2018-11-17,idaho,@,Florida,L (10-63),13,35,37.1,73,1,33,154,4.7,0,68,227,3.3,4,11,2,17,6,48,0,2,2
15678,,2 Games,idaho,,,,27,68,39.7,278,2,65,256,3.9,1,133,534,4.0,13,17,2,32,10,68,2,7,9
15679,1,2014-08-29,western-kentucky,,Bowling Green State,W (59-31),46,56,82.1,569,6,40,139,3.5,2,96,708,7.4,29,9,2,40,7,66,0,0,0
15680,2,2014-09-06,western-kentucky,@,Illinois,L (34-42),28,48,58.3,297,2,30,103,3.4,1,78,400,5.1,17,5,1,23,5,24,2,1,3
15681,3,2014-09-13,western-kentucky,@,Middle Tennessee State,L (47-50),43,66,65.2,593,4,36,125,3.5,1,102,718,7.0,22,9,2,33,10,92,0,1,1
15682,4,2014-09-27,western-kentucky,@,Navy,W (36-27),38,54,70.4,387,2,34,164,4.8,1,88,551,6.3,19,11,0,30,7,66,0,1,1
15683,5,2014-10-04,western-kentucky,,Alabama-Birmingham,L (39-42),25,37,67.6,319,2,28,184,6.6,3,65,503,7.7,14,9,2,25,6,50,0,0,0
15684,6,2014-10-18,western-kentucky,@,Florida Atlantic,L (38-45),28,44,63.6,335,3,26,67,2.6,2,70,402,5.7,16,4,3,23,3,25,1,1,2
15685,7,2014-10-25,western-kentucky,,Old Dominion,W (66-51),23,26,88.5,371,5,45,230,5.1,2,71,601,8.5,17,13,2,32,3,40,2,0,2
15686,8,2014-11-01,western-kentucky,@,Louisiana Tech,L (10-59),16,39,41.0,145,1,33,152,4.6,0,72,297,4.1,6,9,0,15,8,93,1,4,5
15687,9,2014-11-08,western-kentucky,,Texas-El Paso,W (35-27),23,34,67.6,324,3,21,34,1.6,1,55,358,6.5,13,2,1,16,3,24,0,0,0
15688,10,2014-11-15,western-kentucky,,Army,W (52-24),16,25,64.0,178,3,41,383,9.3,4,66,561,8.5,6,16,0,22,7,80,0,0,0
15689,11,2014-11-22,western-kentucky,,Texas-San Antonio,W (45-7),26,35,74.3,346,5,28,120,4.3,1,63,466,7.4,13,6,6,25,4,40,0,0,0
15690,12,2014-11-28,western-kentucky,@,Marshall,W (67-66),35,51,68.6,516,8,35,222,6.3,1,86,738,8.6,22,13,2,37,4,38,0,2,2
15691,13,2014-12-24,western-kentucky,N,Central Michigan*,W (49-48),31,42,73.8,486,5,32,161,5.0,2,74,647,8.7,22,6,2,30,9,105,2,0,2
15692,,13 Games,western-kentucky,,,,378,557,67.9,4866,49,429,2084,4.9,21,986,6950,7.0,216,112,23,351,76,743,8,10,18
15693,1,2015-09-03,western-kentucky,@,Vanderbilt,W (14-12),19,30,63.3,209,1,23,37,1.6,1,53,246,4.6,7,4,0,11,9,70,0,0,0
15694,2,2015-09-10,western-kentucky,,Louisiana Tech,W (41-38),28,38,73.7,441,1,33,149,4.5,2,71,590,8.3,18,6,0,24,10,109,1,0,1
15695,3,2015-09-19,western-kentucky,@,Indiana,L (35-38),35,46,76.1,484,3,26,84,3.2,2,72,568,7.9,21,5,2,28,6,65,0,2,2
15696,4,2015-09-26,western-kentucky,,Miami (OH),W (56-14),34,42,81.0,464,6,32,105,3.3,2,74,569,7.7,20,6,1,27,6,50,0,0,0
15697,5,2015-10-03,western-kentucky,@,Rice,W (49-10),29,39,74.4,424,4,32,80,2.5,3,71,504,7.1,16,4,4,24,3,20,0,0,0
15698,6,2015-10-10,western-kentucky,,Middle Tennessee State,W (58-28),29,37,78.4,428,6,40,165,4.1,1,77,593,7.7,14,8,2,24,3,35,1,1,2
15699,7,2015-10-15,western-kentucky,@,North Texas,W (55-28),31,43,72.1,400,4,40,283,7.1,3,83,683,8.2,17,17,1,35,7,55,0,1,1
15700,8,2015-10-24,western-kentucky,@,Louisiana State,L (20-48),37,61,60.7,325,3,23,103,4.5,0,84,428,5.1,16,7,1,24,7,62,1,1,2
15701,9,2015-10-31,western-kentucky,@,Old Dominion,W (55-30),22,29,75.9,284,3,31,239,7.7,4,60,523,8.7,12,9,1,22,1,5,0,0,0
15702,10,2015-11-07,western-kentucky,,Florida Atlantic,W (35-19),25,30,83.3,287,5,34,229,6.7,0,64,516,8.1,10,14,1,25,7,85,0,1,1
15703,11,2015-11-21,western-kentucky,@,Florida International,W (63-7),16,21,76.2,224,3,37,253,6.8,5,58,477,8.2,8,14,1,23,5,70,3,0,3
15704,12,2015-11-27,western-kentucky,,Marshall,W (49-28),27,40,67.5,370,5,43,176,4.1,1,83,546,6.6,18,10,3,31,8,102,2,0,2
15705,13,2015-12-05,western-kentucky,,Southern Mississippi,W (45-28),34,52,65.4,410,3,36,111,3.1,3,88,521,5.9,16,7,1,24,2,15,0,1,1
15706,14,2015-12-21,western-kentucky,N,South Florida*,W (45-35),32,46,69.6,461,3,33,151,4.6,3,79,612,7.7,17,9,1,27,9,66,0,2,2
15707,,14 Games,western-kentucky,,,,398,554,71.8,5211,50,463,2165,4.7,30,1017,7376,7.3,210,120,19,349,83,809,8,9,17
15708,1,2016-09-01,western-kentucky,,Rice,W (46-14),26,35,74.3,552,3,30,97,3.2,2,65,649,10.0,17,4,2,23,8,77,0,0,0
15709,2,2016-09-10,western-kentucky,@,Alabama,L (10-38),19,38,50.0,216,1,22,23,1.0,0,60,239,4.0,9,2,1,12,2,16,0,2,2
15710,3,2016-09-17,western-kentucky,@,Miami (OH),W (31-24),19,31,61.3,268,2,35,136,3.9,1,66,404,6.1,10,7,2,19,9,126,2,1,3
15711,4,2016-09-24,western-kentucky,,Vanderbilt,L (30-31),24,40,60.0,291,2,33,205,6.2,2,73,496,6.8,12,12,3,27,11,88,2,1,3
15712,5,2016-10-01,western-kentucky,,,W (50-3),16,22,72.7,283,3,30,252,8.4,3,52,535,10.3,12,11,0,23,3,35,0,0,0
15713,6,2016-10-06,western-kentucky,@,Louisiana Tech,L (52-55),36,50,72.0,340,5,23,87,3.8,1,73,427,5.8,18,7,1,26,5,58,2,0,2
15714,7,2016-10-15,western-kentucky,@,Middle Tennessee State,W (44-43),29,40,72.5,391,2,37,130,3.5,3,77,521,6.8,15,12,1,28,7,64,0,1,1
15715,8,2016-10-22,western-kentucky,,Old Dominion,W (59-24),28,33,84.8,378,4,35,246,7.0,4,68,624,9.2,17,11,1,29,7,81,0,1,1
15716,9,2016-10-29,western-kentucky,@,Florida Atlantic,W (52-3),16,25,64.0,393,5,45,268,6.0,2,70,661,9.4,11,11,0,22,8,80,1,0,1
15717,10,2016-11-05,western-kentucky,,Florida International,W (49-21),18,32,56.3,284,1,37,225,6.1,5,69,509,7.4,14,10,0,24,3,15,2,0,2
15718,11,2016-11-12,western-kentucky,,North Texas,W (45-7),17,33,51.5,329,5,41,214,5.2,1,74,543,7.3,12,11,2,25,9,55,0,0,0
15719,12,2016-11-26,western-kentucky,@,Marshall,W (60-6),16,31,51.6,233,3,30,229,7.6,3,61,462,7.6,11,14,2,27,6,80,0,0,0
15720,13,2016-12-03,western-kentucky,,Louisiana Tech,W (58-44),21,31,67.7,421,3,41,235,5.7,4,72,656,9.1,15,13,3,31,7,75,2,1,3
15721,14,2016-12-20,western-kentucky,N,Memphis*,W (51-31),20,30,66.7,336,3,48,262,5.5,4,78,598,7.7,11,14,3,28,8,84,0,1,1
15722,,14 Games,western-kentucky,,,,305,471,64.8,4715,42,487,2609,5.4,35,958,7324,7.6,184,139,21,344,93,934,11,8,19
15723,1,2017-09-02,western-kentucky,,Eastern Kentucky,W (31-17),20,31,64.5,264,1,40,100,2.5,3,71,364,5.1,10,8,2,20,3,25,1,0,1
15724,2,2017-09-09,western-kentucky,@,Illinois,L (7-20),28,43,65.1,238,0,16,6,0.4,1,59,244,4.1,8,2,4,14,11,100,1,1,2
15725,3,2017-09-16,western-kentucky,,Louisiana Tech,L (22-23),25,35,71.4,226,0,41,141,3.4,3,76,367,4.8,13,9,1,23,3,22,0,0,0
15726,4,2017-09-23,western-kentucky,,Ball State,W (33-21),28,44,63.6,319,1,30,52,1.7,2,74,371,5.0,16,5,1,22,4,35,0,2,2
15727,5,2017-10-07,western-kentucky,@,Texas-El Paso,W (15-14),24,37,64.9,208,0,33,74,2.2,2,70,282,4.0,12,4,2,18,6,49,0,0,0
15728,6,2017-10-14,western-kentucky,,UNC Charlotte,W (45-14),43,58,74.1,506,5,34,121,3.6,1,92,627,6.8,22,10,2,34,7,58,1,0,1
15729,7,2017-10-20,western-kentucky,@,Old Dominion,W (35-31),25,35,71.4,343,5,33,73,2.2,0,68,416,6.1,15,7,1,23,5,25,1,1,2
15730,8,2017-10-28,western-kentucky,,Florida Atlantic,L (28-42),32,56,57.1,371,2,33,99,3.0,2,89,470,5.3,21,8,3,32,3,35,2,2,4
15731,9,2017-11-04,western-kentucky,@,Vanderbilt,L (17-31),33,53,62.3,355,1,30,-6,-0.2,1,83,349,4.2,15,4,3,22,5,31,0,1,1
15732,10,2017-11-11,western-kentucky,@,Marshall,L (23-30),28,42,66.7,334,3,19,34,1.8,0,61,368,6.0,14,6,1,21,6,63,1,1,2
15733,11,2017-11-17,western-kentucky,,Middle Tennessee State,W (41-38),39,54,72.2,485,5,33,53,1.6,0,87,538,6.2,16,6,3,25,7,69,2,0,2
15734,12,2017-11-24,western-kentucky,@,Florida International,L (17-41),30,49,61.2,355,2,28,46,1.6,0,77,401,5.2,17,5,1,23,4,32,3,0,3
15735,13,2017-12-16,western-kentucky,N,Georgia State*,L (17-27),26,40,65.0,351,2,21,-2,-0.1,0,61,349,5.7,14,3,0,17,10,89,1,2,3
15736,,13 Games,western-kentucky,,,,381,577,66.0,4355,27,391,791,2.0,15,968,5146,5.3,193,77,24,294,74,633,13,10,23
15737,1,2018-08-31,western-kentucky,@,Wisconsin,L (3-34),17,30,56.7,181,0,34,124,3.6,0,64,305,4.8,8,6,1,15,6,65,1,1,2
15738,2,2018-09-08,western-kentucky,,Maine,L (28-31),23,41,56.1,347,3,31,42,1.4,0,72,389,5.4,6,11,0,17,4,38,2,0,2
15739,3,2018-09-15,western-kentucky,@,Louisville,L (17-20),25,38,65.8,260,1,43,168,3.9,1,81,428,5.3,14,11,1,26,8,69,0,1,1
15740,4,2018-09-22,western-kentucky,@,Ball State,W (28-20),25,35,71.4,252,2,40,192,4.8,2,75,444,5.9,12,14,3,29,11,102,0,0,0
15741,5,2018-09-29,western-kentucky,,Marshall,L (17-20),24,39,61.5,263,1,32,61,1.9,1,71,324,4.6,10,4,3,17,6,43,2,1,3
15742,6,2018-10-13,western-kentucky,@,UNC Charlotte,L (14-40),27,39,69.2,214,1,17,42,2.5,1,56,256,4.6,11,4,2,17,7,55,1,2,3
15743,7,2018-10-20,western-kentucky,,Old Dominion,L (34-37),24,32,75.0,257,2,45,207,4.6,2,77,464,6.0,14,11,4,29,10,83,0,0,0
15744,8,2018-10-27,western-kentucky,,Florida International,L (17-38),18,34,52.9,144,0,38,168,4.4,2,72,312,4.3,7,12,4,23,4,34,0,1,1
15745,9,2018-11-02,western-kentucky,@,Middle Tennessee State,L (10-29),16,47,34.0,270,1,25,109,4.4,0,72,379,5.3,10,6,1,17,7,80,1,1,2
15746,10,2018-11-10,western-kentucky,@,Florida Atlantic,L (15-34),25,42,59.5,228,1,34,123,3.6,1,76,351,4.6,15,4,2,21,2,10,0,1,1
15747,11,2018-11-17,western-kentucky,,Texas-El Paso,W (40-16),19,31,61.3,214,2,50,208,4.2,2,81,422,5.2,9,12,1,22,7,62,0,1,1
15748,,11 Games,western-kentucky,,,,243,408,59.6,2630,14,389,1444,3.7,12,797,4074,5.1,116,95,22,233,72,641,7,9,16
15749,1,2014-08-30,middle-tennessee-state,,Savannah State,W (61-7),17,20,85.0,291,1,46,228,5.0,6,66,519,7.9,8,13,1,22,9,70,2,1,3
15750,2,2014-09-06,middle-tennessee-state,@,Minnesota,L (24-35),22,38,57.9,255,1,43,190,4.4,2,81,445,5.5,15,7,1,23,9,80,0,3,3
15751,3,2014-09-13,middle-tennessee-state,,Western Kentucky,W (50-47),17,28,60.7,218,1,61,323,5.3,5,89,541,6.1,11,16,1,28,7,62,0,0,0
15752,4,2014-09-20,middle-tennessee-state,@,Memphis,L (17-36),24,35,68.6,237,0,34,88,2.6,2,69,325,4.7,12,5,0,17,4,36,2,1,3
15753,5,2014-09-26,middle-tennessee-state,@,Old Dominion,W (41-28),25,30,83.3,259,2,57,280,4.9,2,87,539,6.2,11,18,0,29,9,85,2,0,2
15754,6,2014-10-04,middle-tennessee-state,,Southern Mississippi,W (37-31),22,27,81.5,344,2,39,239,6.1,3,66,583,8.8,13,9,0,22,6,49,1,0,1
15755,7,2014-10-11,middle-tennessee-state,@,Marshall,L (24-49),25,37,67.6,201,2,37,169,4.6,1,74,370,5.0,8,10,2,20,8,101,1,1,2
15756,8,2014-10-18,middle-tennessee-state,,Alabama-Birmingham,W (34-22),6,19,31.6,141,2,41,229,5.6,3,60,370,6.2,3,8,2,13,8,70,0,0,0
15757,9,2014-11-01,middle-tennessee-state,,Brigham Young,L (7-27),16,32,50.0,119,1,37,109,2.9,0,69,228,3.3,6,9,2,17,2,12,0,2,2
15758,10,2014-11-15,middle-tennessee-state,@,Florida International,L (28-38),21,33,63.6,286,3,45,142,3.2,1,78,428,5.5,12,9,1,22,7,70,2,3,5
15759,11,2014-11-22,middle-tennessee-state,,Florida Atlantic,W (35-34),20,27,74.1,160,2,46,310,6.7,3,73,470,6.4,7,15,0,22,3,20,1,1,2
15760,12,2014-11-29,middle-tennessee-state,@,Texas-El Paso,L (21-24),9,17,52.9,99,0,44,259,5.9,3,61,358,5.9,4,14,1,19,6,35,0,1,1
15761,,12 Games,middle-tennessee-state,,,,224,343,65.3,2610,17,530,2566,4.8,31,873,5176,5.9,110,133,11,254,78,690,11,13,24
15762,1,2015-09-05,middle-tennessee-state,,Jackson State,W (70-14),25,32,78.1,351,4,63,282,4.5,4,95,633,6.7,14,20,2,36,1,15,1,1,2
15763,2,2015-09-12,middle-tennessee-state,@,Alabama,L (10-37),23,43,53.5,189,1,31,86,2.8,0,74,275,3.7,11,3,1,15,8,67,3,1,4
15764,3,2015-09-19,middle-tennessee-state,,UNC Charlotte,W (73-14),24,29,82.8,379,5,49,316,6.4,4,78,695,8.9,12,12,1,25,3,36,2,0,2
15765,4,2015-09-26,middle-tennessee-state,@,Illinois,L (25-27),29,43,67.4,330,3,37,38,1.0,0,80,368,4.6,12,6,1,19,7,59,1,0,1
15766,5,2015-10-03,middle-tennessee-state,,Vanderbilt,L (13-17),32,51,62.7,286,1,23,34,1.5,0,74,320,4.3,13,4,1,18,5,30,2,0,2
15767,6,2015-10-10,middle-tennessee-state,@,Western Kentucky,L (28-58),28,43,65.1,296,3,30,123,4.1,1,73,419,5.7,13,7,2,22,4,41,1,1,2
15768,7,2015-10-17,middle-tennessee-state,,Florida International,W (42-34),17,26,65.4,261,0,43,200,4.7,6,69,461,6.7,10,12,0,22,8,87,1,1,2
15769,8,2015-10-24,middle-tennessee-state,@,Louisiana Tech,L (16-45),36,56,64.3,381,2,24,33,1.4,0,80,414,5.2,15,5,1,21,7,59,1,2,3
15770,9,2015-11-07,middle-tennessee-state,,Marshall,W (27-24),21,35,60.0,353,3,51,201,3.9,0,86,554,6.4,15,10,2,27,7,66,2,1,3
15771,10,2015-11-14,middle-tennessee-state,@,Florida Atlantic,W (24-17),18,32,56.3,301,2,45,178,4.0,1,77,479,6.2,12,8,2,22,5,45,1,1,2
15772,11,2015-11-21,middle-tennessee-state,,North Texas,W (41-7),30,41,73.2,329,3,39,165,4.2,2,80,494,6.2,14,14,2,30,1,5,1,1,2
15773,12,2015-11-28,middle-tennessee-state,@,Texas-San Antonio,W (42-7),24,30,80.0,257,1,43,199,4.6,4,73,456,6.2,8,18,2,28,1,5,2,0,2
15774,13,2015-12-24,middle-tennessee-state,N,Western Michigan*,L (31-45),26,39,66.7,327,3,26,115,4.4,1,65,442,6.8,11,7,0,18,5,40,1,1,2
15775,,13 Games,middle-tennessee-state,,,,333,500,66.6,4040,31,504,1970,3.9,23,1004,6010,6.0,160,126,17,303,62,555,19,10,29
15776,1,2016-09-03,middle-tennessee-state,,Alabama A&M,W (55-0),40,53,75.5,435,6,40,246,6.2,1,93,681,7.3,22,12,1,35,9,87,0,2,2
15777,2,2016-09-10,middle-tennessee-state,@,Vanderbilt,L (24-47),38,65,58.5,399,3,21,96,4.6,0,86,495,5.8,19,6,0,25,9,92,1,1,2
15778,3,2016-09-17,middle-tennessee-state,@,Bowling Green State,W (41-21),18,30,60.0,278,3,37,158,4.3,3,67,436,6.5,8,8,4,20,3,36,1,1,2
15779,4,2016-09-24,middle-tennessee-state,,Louisiana Tech,W (38-34),27,46,58.7,356,2,33,197,6.0,3,79,553,7.0,15,9,1,25,4,35,0,0,0
15780,5,2016-10-01,middle-tennessee-state,@,North Texas,W (30-13),24,45,53.3,295,2,32,182,5.7,1,77,477,6.2,13,7,4,24,9,79,0,1,1
15781,6,2016-10-15,middle-tennessee-state,,Western Kentucky,L (43-44),42,54,77.8,434,3,32,171,5.3,2,86,605,7.0,22,7,3,32,4,30,0,1,1
15782,7,2016-10-22,middle-tennessee-state,@,Missouri,W (51-45),24,42,57.1,284,4,39,316,8.1,2,81,600,7.4,11,11,5,27,9,65,0,0,0
15783,8,2016-10-29,middle-tennessee-state,@,Florida International,W (42-35),22,35,62.9,332,4,19,134,7.1,1,54,466,8.6,13,10,0,23,2,30,0,0,0
15784,9,2016-11-05,middle-tennessee-state,,Texas-San Antonio,L (25-45),22,38,57.9,259,2,28,110,3.9,1,66,369,5.6,9,9,1,19,4,32,1,3,4
15785,10,2016-11-12,middle-tennessee-state,@,Marshall,L (17-42),25,37,67.6,220,1,25,63,2.5,1,62,283,4.6,11,3,1,15,5,42,2,2,4
15786,11,2016-11-19,middle-tennessee-state,@,UNC Charlotte,W (38-31),26,44,59.1,250,4,30,221,7.4,1,74,471,6.4,12,8,1,21,8,90,0,2,2
15787,12,2016-11-26,middle-tennessee-state,,Florida Atlantic,W (77-56),11,16,68.8,262,1,57,495,8.7,9,73,757,10.4,10,18,0,28,3,22,0,0,0
15788,13,2016-12-24,middle-tennessee-state,N,Hawaii*,L (35-52),30,51,58.8,432,4,23,110,4.8,1,74,542,7.3,18,6,5,29,9,90,1,2,3
15789,,13 Games,middle-tennessee-state,,,,349,556,62.8,4236,39,416,2499,6.0,26,972,6735,6.9,183,114,26,323,78,730,6,15,21
15790,1,2017-09-02,middle-tennessee-state,,Vanderbilt,L (6-28),18,31,58.1,166,1,26,64,2.5,0,57,230,4.0,9,4,3,16,4,14,0,1,1
15791,2,2017-09-09,middle-tennessee-state,@,Syracuse,W (30-23),22,36,61.1,269,3,33,94,2.8,1,69,363,5.3,11,7,2,20,9,113,2,1,3
15792,3,2017-09-16,middle-tennessee-state,@,Minnesota,L (3-34),25,42,59.5,184,0,15,46,3.1,0,57,230,4.0,9,2,0,11,6,45,0,2,2
15793,4,2017-09-23,middle-tennessee-state,,Bowling Green State,W (24-13),24,32,75.0,290,2,43,243,5.7,1,75,533,7.1,14,12,1,27,3,23,2,1,3
15794,5,2017-09-30,middle-tennessee-state,@,Florida Atlantic,L (20-38),32,52,61.5,385,2,24,69,2.9,0,76,454,6.0,18,3,2,23,7,64,0,3,3
15795,6,2017-10-07,middle-tennessee-state,,Florida International,W (37-17),25,31,80.6,250,1,34,176,5.2,3,65,426,6.6,14,12,2,25,4,35,0,0,0
15796,7,2017-10-14,middle-tennessee-state,@,Alabama-Birmingham,L (23-25),24,44,54.5,263,1,32,131,4.1,0,76,394,5.2,14,9,3,26,10,88,0,2,2
15797,8,2017-10-20,middle-tennessee-state,,Marshall,L (10-38),14,33,42.4,220,1,31,53,1.7,0,64,273,4.3,8,3,4,15,5,60,1,1,2
15798,9,2017-11-04,middle-tennessee-state,,Texas-El Paso,W (30-3),13,30,43.3,190,3,36,210,5.8,1,66,400,6.1,7,9,2,18,9,92,0,1,1
15799,10,2017-11-11,middle-tennessee-state,@,UNC Charlotte,W (35-21),18,31,58.1,255,3,41,202,4.9,2,72,457,6.3,7,12,2,21,9,85,0,0,0
15800,11,2017-11-17,middle-tennessee-state,@,Western Kentucky,L (38-41),27,46,58.7,294,1,33,137,4.2,3,79,431,5.5,13,11,3,27,5,68,1,0,1
15801,12,2017-11-25,middle-tennessee-state,,Old Dominion,W (41-10),21,30,70.0,266,3,50,320,6.4,2,80,586,7.3,13,15,2,30,4,50,0,2,2
15802,13,2017-12-16,middle-tennessee-state,N,Arkansas State*,W (35-30),19,35,54.3,232,2,29,120,4.1,2,64,352,5.5,10,5,2,17,10,87,0,3,3
15803,,13 Games,middle-tennessee-state,,,,282,473,59.6,3264,23,427,1865,4.4,15,900,5129,5.7,147,104,28,276,85,824,6,17,23
15804,1,2018-09-01,middle-tennessee-state,@,Vanderbilt,L (7-35),24,36,66.7,178,1,36,116,3.2,0,72,294,4.1,8,10,3,21,6,40,1,1,2
15805,2,2018-09-08,middle-tennessee-state,,Tennessee-Martin,W (61-37),23,32,71.9,396,5,32,79,2.5,2,64,475,7.4,14,5,1,20,6,68,1,0,1
15806,3,2018-09-15,middle-tennessee-state,@,Georgia,L (7-49),20,30,66.7,130,1,38,158,4.2,0,68,288,4.2,4,10,0,14,3,35,1,1,2
15807,4,2018-09-29,middle-tennessee-state,,Florida Atlantic,W (25-24),27,40,67.5,259,1,36,137,3.8,2,76,396,5.2,14,8,0,22,3,29,1,1,2
15808,5,2018-10-05,middle-tennessee-state,@,Marshall,W (34-24),25,40,62.5,317,2,35,103,2.9,2,75,420,5.6,13,8,4,25,11,127,1,0,1
15809,6,2018-10-13,middle-tennessee-state,@,Florida International,L (21-24),15,27,55.6,142,0,40,187,4.7,3,67,329,4.9,8,11,2,21,5,52,0,1,1
15810,7,2018-10-20,middle-tennessee-state,,UNC Charlotte,W (21-13),14,20,70.0,111,3,32,33,1.0,0,52,144,2.8,6,3,0,9,2,20,1,1,2
15811,8,2018-10-27,middle-tennessee-state,@,Old Dominion,W (51-17),25,33,75.8,280,2,38,208,5.5,3,71,488,6.9,12,9,5,26,5,38,0,1,1
15812,9,2018-11-02,middle-tennessee-state,,Western Kentucky,W (29-10),24,42,57.1,228,2,43,256,6.0,0,85,484,5.7,12,13,2,27,3,34,0,0,0
15813,10,2018-11-10,middle-tennessee-state,@,Texas-El Paso,W (48-32),31,40,77.5,352,4,36,139,3.9,2,76,491,6.5,13,8,0,21,6,63,2,0,2
15814,11,2018-11-17,middle-tennessee-state,@,Kentucky,L (23-34),30,33,90.9,293,3,38,99,2.6,0,71,392,5.5,14,8,2,24,6,57,1,1,2
15815,,11 Games,middle-tennessee-state,,,,258,373,69.2,2686,24,404,1515,3.8,14,777,4201,5.4,118,93,19,230,56,563,9,7,16
15816,1,2014-08-30,florida-atlantic,@,Nebraska,L (7-55),11,30,36.7,95,1,30,105,3.5,0,60,200,3.3,5,7,1,13,3,22,0,0,0
15817,2,2014-09-06,florida-atlantic,@,Alabama,L (0-41),12,19,63.2,88,0,24,57,2.4,0,43,145,3.4,4,3,2,9,3,23,1,0,1
15818,3,2014-09-13,florida-atlantic,,Tulsa,W (50-21),18,23,78.3,341,4,42,177,4.2,1,65,518,8.0,11,7,0,18,4,37,0,0,0
15819,4,2014-09-20,florida-atlantic,@,Wyoming,L (19-20),15,29,51.7,108,0,39,188,4.8,1,68,296,4.4,5,10,1,16,4,23,3,0,3
15820,5,2014-09-27,florida-atlantic,,Texas-San Antonio,W (41-37),24,34,70.6,295,3,33,114,3.5,2,67,409,6.1,14,9,2,25,5,52,2,0,2
15821,6,2014-10-02,florida-atlantic,@,Florida International,L (10-38),19,42,45.2,225,0,30,158,5.3,1,72,383,5.3,13,7,2,22,4,40,3,1,4
15822,7,2014-10-18,florida-atlantic,,Western Kentucky,W (45-38),24,35,68.6,341,3,54,278,5.1,3,89,619,7.0,18,10,1,29,6,59,1,0,1
15823,8,2014-10-25,florida-atlantic,@,Marshall,L (16-35),19,37,51.4,179,1,53,209,3.9,0,90,388,4.3,10,15,1,26,3,45,0,0,0
15824,9,2014-11-01,florida-atlantic,,Alabama-Birmingham,L (28-31),18,31,58.1,177,3,29,145,5.0,1,60,322,5.4,8,7,1,16,3,30,1,1,2
15825,10,2014-11-08,florida-atlantic,@,North Texas,L (10-31),15,31,48.4,102,1,32,95,3.0,0,63,197,3.1,4,7,1,12,7,55,1,1,2
15826,11,2014-11-22,florida-atlantic,@,Middle Tennessee State,L (34-35),22,35,62.9,310,2,41,230,5.6,2,76,540,7.1,11,9,0,20,2,19,0,2,2
15827,12,2014-11-29,florida-atlantic,,Old Dominion,L (28-31),9,19,47.4,133,0,36,207,5.8,3,55,340,6.2,5,9,0,14,7,69,1,0,1
15828,,12 Games,florida-atlantic,,,,206,365,56.4,2394,18,443,1963,4.4,14,808,4357,5.4,108,100,12,220,51,474,13,5,18
15829,1,2015-09-05,florida-atlantic,@,Tulsa,L (44-47),23,35,65.7,263,2,61,300,4.9,3,96,563,5.9,11,19,0,30,13,130,0,0,0
15830,2,2015-09-11,florida-atlantic,,Miami (FL),L (20-44),19,34,55.9,166,1,33,223,6.8,1,67,389,5.8,8,12,2,22,8,71,3,2,5
15831,3,2015-09-19,florida-atlantic,,Buffalo,L (15-33),26,56,46.4,385,2,34,105,3.1,0,90,490,5.4,15,9,3,27,5,35,3,2,5
15832,4,2015-09-26,florida-atlantic,@,UNC Charlotte,W (17-7),14,25,56.0,144,0,48,40,0.8,1,73,184,2.5,8,3,2,13,6,44,3,2,5
15833,5,2015-10-10,florida-atlantic,,Rice,L (26-27),15,29,51.7,249,2,32,142,4.4,1,61,391,6.4,9,5,5,19,5,50,0,0,0
15834,6,2015-10-17,florida-atlantic,,Marshall,L (17-33),14,31,45.2,203,0,34,131,3.9,1,65,334,5.1,8,9,0,17,5,30,0,1,1
15835,7,2015-10-24,florida-atlantic,@,Texas-El Paso,L (17-27),14,23,60.9,219,0,30,146,4.9,2,53,365,6.9,10,2,3,15,5,60,2,1,3
15836,8,2015-10-31,florida-atlantic,,Florida International,W (31-17),16,25,64.0,168,0,49,229,4.7,3,74,397,5.4,9,17,1,27,6,60,0,0,0
15837,9,2015-11-07,florida-atlantic,@,Western Kentucky,L (19-35),14,33,42.4,185,2,43,174,4.0,0,76,359,4.7,9,11,3,23,3,24,0,0,0
15838,10,2015-11-14,florida-atlantic,,Middle Tennessee State,L (17-24),13,27,48.1,222,2,34,75,2.2,0,61,297,4.9,8,5,1,14,6,63,0,1,1
15839,11,2015-11-21,florida-atlantic,@,Florida,L (14-20),20,39,51.3,159,1,45,140,3.1,0,84,299,3.6,6,11,1,18,7,55,2,1,3
15840,12,2015-11-28,florida-atlantic,@,Old Dominion,W (33-31),17,35,48.6,188,0,54,248,4.6,3,89,436,4.9,11,11,1,23,6,64,0,2,2
15841,,12 Games,florida-atlantic,,,,205,392,52.3,2551,12,497,1953,3.9,15,889,4504,5.1,112,114,22,248,75,686,13,12,25
15842,1,2016-09-03,florida-atlantic,,Southern Illinois,W (38-30),23,31,74.2,282,2,45,170,3.8,3,76,452,5.9,9,8,2,19,5,45,0,0,0
15843,2,2016-09-10,florida-atlantic,@,Miami (FL),L (10-38),18,37,48.6,167,0,34,47,1.4,1,71,214,3.0,7,4,2,13,6,45,0,1,1
15844,3,2016-09-17,florida-atlantic,@,Kansas State,L (7-63),15,28,53.6,129,0,37,82,2.2,1,65,211,3.2,4,8,1,13,10,93,2,2,4
15845,4,2016-09-24,florida-atlantic,,Ball State,L (27-31),25,37,67.6,324,1,36,121,3.4,2,73,445,6.1,12,8,0,20,2,20,1,1,2
15846,5,2016-10-01,florida-atlantic,@,Florida International,L (31-33),9,21,42.9,92,1,36,236,6.6,2,57,328,5.8,5,12,0,17,4,35,1,0,1
15847,6,2016-10-09,florida-atlantic,,UNC Charlotte,L (23-28),22,42,52.4,212,0,41,174,4.2,3,83,386,4.7,13,11,2,26,3,25,0,1,1
15848,7,2016-10-15,florida-atlantic,@,Marshall,L (21-27),11,20,55.0,175,0,45,281,6.2,3,65,456,7.0,7,16,1,24,5,65,1,1,2
15849,8,2016-10-29,florida-atlantic,,Western Kentucky,L (3-52),15,34,44.1,77,0,33,125,3.8,0,67,202,3.0,4,6,2,12,1,10,1,1,2
15850,9,2016-11-05,florida-atlantic,@,Rice,W (42-25),16,26,61.5,321,2,40,340,8.5,4,66,661,10.0,10,15,1,26,13,122,0,0,0
15851,10,2016-11-12,florida-atlantic,,Texas-El Paso,W (35-31),20,27,74.1,233,1,36,243,6.8,3,63,476,7.6,11,13,2,26,5,45,1,2,3
15852,11,2016-11-19,florida-atlantic,,Old Dominion,L (24-42),15,28,53.6,219,0,34,144,4.2,3,62,363,5.9,10,6,0,16,8,62,0,0,0
15853,12,2016-11-26,florida-atlantic,@,Middle Tennessee State,L (56-77),26,35,74.3,290,2,53,299,5.6,6,88,589,6.7,17,17,1,35,1,10,0,4,4
15854,,12 Games,florida-atlantic,,,,215,366,58.7,2521,9,470,2262,4.8,31,836,4783,5.7,109,124,14,247,63,577,7,13,20
15855,1,2017-09-01,florida-atlantic,,Navy,L (19-42),21,33,63.6,286,2,24,40,1.7,0,57,326,5.7,8,7,1,16,4,20,0,2,2
15856,2,2017-09-09,florida-atlantic,@,Wisconsin,L (14-31),9,19,47.4,142,1,35,106,3.0,1,54,248,4.6,4,5,0,9,8,73,0,0,0
15857,3,2017-09-16,florida-atlantic,,Bethune-Cookman,W (45-0),19,32,59.4,180,1,58,439,7.6,4,90,619,6.9,6,22,4,32,8,83,1,1,2
15858,4,2017-09-23,florida-atlantic,@,Buffalo,L (31-34),17,29,58.6,150,0,37,262,7.1,4,66,412,6.2,7,15,0,22,8,65,0,1,1
15859,5,2017-09-30,florida-atlantic,,Middle Tennessee State,W (38-20),22,29,75.9,187,1,50,252,5.0,4,79,439,5.6,10,17,2,29,4,27,0,0,0
15860,6,2017-10-07,florida-atlantic,@,Old Dominion,W (58-28),13,22,59.1,97,0,69,453,6.6,8,91,550,6.0,5,23,1,29,5,65,1,1,2
15861,7,2017-10-21,florida-atlantic,,North Texas,W (69-31),24,35,68.6,357,2,48,447,9.3,7,83,804,9.7,16,18,3,37,5,39,0,0,0
15862,8,2017-10-28,florida-atlantic,@,Western Kentucky,W (42-28),10,24,41.7,93,1,55,368,6.7,4,79,461,5.8,3,17,1,21,9,75,0,1,1
15863,9,2017-11-03,florida-atlantic,,Marshall,W (30-25),12,18,66.7,164,1,45,189,4.2,3,63,353,5.6,6,11,0,17,5,60,0,0,0
15864,10,2017-11-11,florida-atlantic,@,Louisiana Tech,W (48-23),14,17,82.4,221,2,33,194,5.9,4,50,415,8.3,7,11,1,19,2,22,1,0,1
15865,11,2017-11-18,florida-atlantic,,Florida International,W (52-24),18,25,72.0,239,4,46,333,7.2,3,71,572,8.1,9,16,2,27,8,64,0,1,1
15866,12,2017-11-25,florida-atlantic,@,UNC Charlotte,W (31-12),18,22,81.8,245,2,63,316,5.0,2,85,561,6.6,11,19,1,31,1,15,2,0,2
15867,13,2017-12-02,florida-atlantic,,North Texas,W (41-17),18,30,60.0,352,2,42,281,6.7,3,72,633,8.8,11,9,2,22,9,73,1,0,1
15868,14,2017-12-19,florida-atlantic,,Akron*,W (50-3),19,26,73.1,270,2,60,312,5.2,5,86,582,6.8,8,19,2,29,6,52,0,0,0
15869,,14 Games,florida-atlantic,,,,234,361,64.8,2983,21,665,3992,6.0,52,1026,6975,6.8,111,209,20,340,82,733,6,7,13
15870,1,2018-09-01,florida-atlantic,@,Oklahoma,L (14-63),18,32,56.3,192,0,42,132,3.1,2,74,324,4.4,11,7,2,20,6,48,0,1,1
15871,2,2018-09-08,florida-atlantic,,Air Force,W (33-27),33,40,82.5,471,3,29,54,1.9,1,69,525,7.6,21,3,1,25,8,87,1,0,1
15872,3,2018-09-15,florida-atlantic,,Bethune-Cookman,W (49-28),19,30,63.3,183,1,61,376,6.2,6,91,559,6.1,7,20,0,27,6,69,0,2,2
15873,4,2018-09-21,florida-atlantic,@,Central Florida,L (36-56),14,27,51.9,127,1,50,320,6.4,4,77,447,5.8,5,18,2,25,7,73,0,3,3
15874,5,2018-09-29,florida-atlantic,@,Middle Tennessee State,L (24-25),17,28,60.7,154,0,55,272,4.9,3,83,426,5.1,8,12,2,22,8,54,1,1,2
15875,6,2018-10-06,florida-atlantic,,Old Dominion,W (52-33),21,32,65.6,339,2,40,266,6.7,5,72,605,8.4,15,13,0,28,8,84,0,0,0
15876,7,2018-10-20,florida-atlantic,@,Marshall,L (7-31),20,42,47.6,240,1,37,119,3.2,0,79,359,4.5,9,6,1,16,8,69,1,4,5
15877,8,2018-10-26,florida-atlantic,,Louisiana Tech,L (13-21),17,29,58.6,121,0,38,227,6.0,1,67,348,5.2,6,14,3,23,11,77,1,1,2
15878,9,2018-11-03,florida-atlantic,@,Florida International,W (49-14),10,16,62.5,157,2,60,439,7.3,5,76,596,7.8,5,23,3,30,5,55,0,0,0
15879,10,2018-11-10,florida-atlantic,,Western Kentucky,W (34-15),20,25,80.0,261,0,58,315,5.4,4,83,576,6.9,10,18,0,28,6,70,1,1,2
15880,11,2018-11-15,florida-atlantic,@,North Texas,L (38-41),21,35,60.0,294,2,47,195,4.1,3,82,489,6.0,9,10,1,20,5,58,0,2,2
15881,,11 Games,florida-atlantic,,,,210,336,62.5,2539,12,517,2715,5.3,34,853,5254,6.2,106,144,15,264,78,744,5,15,20
15882,1,2014-08-30,north-texas,@,Texas,L (7-38),3,17,17.6,15,0,43,79,1.8,0,60,94,1.6,0,6,2,8,6,56,0,4,4
15883,2,2014-09-06,north-texas,,Southern Methodist,W (43-6),12,17,70.6,108,0,55,245,4.5,3,72,353,4.9,6,11,0,17,15,166,0,0,0
15884,3,2014-09-11,north-texas,,Louisiana Tech,L (21-42),18,34,52.9,175,0,36,104,2.9,3,70,279,4.0,7,7,4,18,9,90,2,0,2
15885,4,2014-09-20,north-texas,,Nicholls State,W (77-3),13,17,76.5,202,3,38,324,8.5,5,55,526,9.6,7,13,0,20,5,40,1,0,1
15886,5,2014-10-04,north-texas,@,Indiana,L (24-49),18,34,52.9,205,3,35,143,4.1,0,69,348,5.0,9,12,1,22,2,10,0,2,2
15887,6,2014-10-11,north-texas,@,Alabama-Birmingham,L (21-56),20,36,55.6,291,2,43,160,3.7,1,79,451,5.7,12,12,0,24,3,30,3,2,5
15888,7,2014-10-18,north-texas,,Southern Mississippi,L (20-30),20,35,57.1,287,0,26,108,4.2,2,61,395,6.5,11,6,4,21,4,55,0,0,0
15889,8,2014-10-25,north-texas,@,Rice,L (21-41),16,34,47.1,190,1,33,26,0.8,1,67,216,3.2,7,6,3,16,4,40,1,1,2
15890,9,2014-11-08,north-texas,,Florida Atlantic,W (31-10),13,17,76.5,107,1,52,235,4.5,3,69,342,5.0,5,13,1,19,3,35,1,1,2
15891,10,2014-11-15,north-texas,@,Texas-El Paso,L (17-35),15,27,55.6,101,1,30,100,3.3,1,57,201,3.5,6,4,3,13,5,25,0,1,1
15892,11,2014-11-22,north-texas,,Florida International,W (17-14),9,20,45.0,105,1,44,161,3.7,1,64,266,4.2,5,8,3,16,2,30,0,2,2
15893,12,2014-11-29,north-texas,@,Texas-San Antonio,L (27-34),24,43,55.8,287,1,37,150,4.1,1,80,437,5.5,11,8,0,19,5,53,1,0,1
15894,,12 Games,north-texas,,,,181,331,54.7,2073,13,472,1835,3.9,21,803,3908,4.9,86,106,21,213,63,630,9,13,22
15895,1,2015-09-12,north-texas,@,Southern Methodist,L (13-31),16,34,47.1,128,0,33,112,3.4,1,67,240,3.6,7,7,3,17,7,73,2,2,4
15896,2,2015-09-19,north-texas,,Rice,L (24-38),19,35,54.3,303,2,27,175,6.5,1,62,478,7.7,13,6,1,20,4,45,2,1,3
15897,3,2015-09-26,north-texas,@,Iowa,L (16-62),17,43,39.5,173,1,45,183,4.1,0,88,356,4.0,8,14,0,22,8,62,1,2,3
15898,4,2015-10-03,north-texas,@,Southern Mississippi,L (14-49),14,32,43.8,201,1,49,185,3.8,1,81,386,4.8,7,14,5,26,5,40,0,1,1
15899,5,2015-10-10,north-texas,,Portland State,L (7-66),16,41,39.0,122,1,31,76,2.5,0,72,198,2.8,4,7,2,13,8,74,1,0,1
15900,6,2015-10-15,north-texas,,Western Kentucky,L (28-55),17,35,48.6,228,4,35,203,5.8,0,70,431,6.2,9,13,0,22,5,37,1,1,2
15901,7,2015-10-24,north-texas,@,Marshall,L (13-30),15,37,40.5,128,1,40,209,5.2,0,77,337,4.4,5,14,3,22,5,28,0,1,1
15902,8,2015-10-31,north-texas,,Texas-San Antonio,W (30-23),11,22,50.0,104,0,38,267,7.0,3,60,371,6.2,7,12,1,20,8,79,1,0,1
15903,9,2015-11-07,north-texas,@,Louisiana Tech,L (13-56),25,45,55.6,234,2,36,82,2.3,0,81,316,3.9,11,9,0,20,3,35,3,1,4
15904,10,2015-11-14,north-texas,@,Tennessee,L (0-24),13,26,50.0,107,0,32,92,2.9,0,58,199,3.4,8,6,0,14,5,35,0,0,0
15905,11,2015-11-21,north-texas,@,Middle Tennessee State,L (7-41),17,28,60.7,133,0,39,191,4.9,1,67,324,4.8,3,15,0,18,6,52,2,1,3
15906,12,2015-11-28,north-texas,,Texas-El Paso,L (17-20),10,29,34.5,76,0,31,129,4.2,0,60,205,3.4,1,8,1,10,10,120,1,1,2
15907,,12 Games,north-texas,,,,190,407,46.7,1937,12,436,1904,4.4,7,843,3841,4.6,83,125,16,224,74,680,14,11,25
15908,1,2016-09-03,north-texas,,Southern Methodist,L (21-34),32,50,64.0,311,2,29,83,2.9,1,79,394,5.0,20,5,1,26,6,68,0,3,3
15909,2,2016-09-10,north-texas,,Bethune-Cookman,W (41-20),15,33,45.5,121,0,51,329,6.5,4,84,450,5.4,7,18,3,28,4,48,0,1,1
15910,3,2016-09-17,north-texas,@,Florida,L (0-32),6,22,27.3,66,0,28,-13,-0.5,0,50,53,1.1,3,2,3,8,7,70,0,1,1
15911,4,2016-09-24,north-texas,@,Rice,W (42-35),17,29,58.6,224,1,42,215,5.1,5,71,439,6.2,9,8,2,19,10,70,1,0,1
15912,5,2016-10-01,north-texas,,Middle Tennessee State,L (13-30),33,54,61.1,303,1,22,5,0.2,1,76,308,4.1,11,3,2,16,9,90,0,0,0
15913,6,2016-10-08,north-texas,,Marshall,W (38-21),18,28,64.3,206,1,54,252,4.7,3,82,458,5.6,10,11,2,23,10,78,2,0,2
15914,7,2016-10-22,north-texas,@,Army,W (35-18),9,17,52.9,118,1,33,202,6.1,3,50,320,6.4,6,7,2,15,10,91,0,1,1
15915,8,2016-10-29,north-texas,@,Texas-San Antonio,L (17-31),27,38,71.1,257,1,34,152,4.5,1,72,409,5.7,12,8,2,22,2,25,2,2,4
15916,9,2016-11-05,north-texas,,Louisiana Tech,L (24-45),23,34,67.6,207,1,30,82,2.7,2,64,289,4.5,10,7,1,18,10,99,0,1,1
15917,10,2016-11-12,north-texas,@,Western Kentucky,L (7-45),17,33,51.5,117,0,20,115,5.8,1,53,232,4.4,4,3,0,7,8,66,1,1,2
15918,11,2016-11-19,north-texas,,Southern Mississippi,W (29-23),14,29,48.3,267,2,29,111,3.8,1,58,378,6.5,9,6,3,18,12,95,2,1,3
15919,12,2016-11-26,north-texas,@,Texas-El Paso,L (24-52),23,42,54.8,197,2,27,107,4.0,1,69,304,4.4,9,9,3,21,3,35,0,0,0
15920,13,2016-12-27,north-texas,N,Army*,L (31-38),27,40,67.5,314,3,27,96,3.6,1,67,410,6.1,11,7,1,19,6,55,0,2,2
15921,,13 Games,north-texas,,,,261,449,58.1,2708,15,426,1736,4.1,24,875,4444,5.1,121,94,25,240,97,890,8,13,21
15922,1,2017-09-02,north-texas,,Lamar,W (59-14),17,24,70.8,232,3,59,438,7.4,5,83,670,8.1,11,21,0,31,5,40,1,0,1
15923,2,2017-09-09,north-texas,@,Southern Methodist,L (32-54),32,47,68.1,424,3,27,69,2.6,1,74,493,6.7,17,4,1,22,7,58,1,2,3
15924,3,2017-09-16,north-texas,@,Iowa,L (14-31),18,29,62.1,193,1,17,112,6.6,1,46,305,6.6,10,5,2,17,13,119,1,1,2
15925,4,2017-09-23,north-texas,,Alabama-Birmingham,W (46-43),15,29,51.7,261,3,44,287,6.5,2,73,548,7.5,11,14,3,28,4,33,2,0,2
15926,5,2017-09-30,north-texas,@,Southern Mississippi,W (43-28),24,41,58.5,366,2,46,174,3.8,3,87,540,6.2,11,10,3,24,3,19,1,1,2
15927,6,2017-10-14,north-texas,,Texas-San Antonio,W (29-26),20,35,57.1,354,3,31,104,3.4,1,66,458,6.9,14,5,0,19,3,29,0,1,1
15928,7,2017-10-21,north-texas,@,Florida Atlantic,L (31-69),31,47,66.0,283,2,33,137,4.2,2,80,420,5.3,15,9,1,25,6,41,1,2,3
15929,8,2017-10-28,north-texas,,Old Dominion,W (45-38),25,36,69.4,309,1,41,151,3.7,4,77,460,6.0,15,8,1,24,3,45,1,1,2
15930,9,2017-11-04,north-texas,@,Louisiana Tech,W (24-23),23,37,62.2,211,1,41,204,5.0,2,78,415,5.3,10,15,1,26,4,45,0,1,1
15931,10,2017-11-11,north-texas,,Texas-El Paso,W (45-10),23,35,65.7,213,4,39,259,6.6,2,74,472,6.4,10,13,4,27,4,40,1,0,1
15932,11,2017-11-18,north-texas,,Army,W (52-49),24,36,66.7,386,4,33,103,3.1,3,69,489,7.1,13,9,3,25,1,1,0,1,1
15933,12,2017-11-25,north-texas,@,Rice,W (30-14),18,25,72.0,195,1,44,188,4.3,1,69,383,5.6,11,13,1,25,3,20,0,1,1
15934,13,2017-12-02,north-texas,@,Florida Atlantic,L (17-41),28,45,62.2,356,1,35,81,2.3,1,80,437,5.5,20,5,1,26,6,57,0,2,2
15935,14,2017-12-16,north-texas,N,Troy*,L (30-50),30,54,55.6,303,3,25,-8,-0.3,0,79,295,3.7,16,2,3,21,7,66,3,2,5
15936,,14 Games,north-texas,,,,328,520,63.1,4086,32,515,2299,4.5,28,1035,6385,6.2,184,133,24,340,69,613,12,15,27
15937,1,2018-09-01,north-texas,,Southern Methodist,W (46-23),41,51,80.4,461,3,43,68,1.6,0,94,529,5.6,27,5,2,34,5,40,0,0,0
15938,2,2018-09-08,north-texas,,Incarnate Word,W (58-16),32,49,65.3,454,4,42,153,3.6,3,91,607,6.7,19,9,4,32,5,61,0,1,1
15939,3,2018-09-15,north-texas,@,Arkansas,W (44-17),24,46,52.2,281,1,29,95,3.3,2,75,376,5.0,11,3,4,18,9,102,1,0,1
15940,4,2018-09-22,north-texas,@,Liberty,W (47-7),16,27,59.3,185,2,47,346,7.4,5,74,531,7.2,10,15,0,25,4,45,0,0,0
15941,5,2018-09-29,north-texas,,Louisiana Tech,L (27-29),22,35,62.9,296,3,37,131,3.5,1,72,427,5.9,13,9,1,23,4,55,2,0,2
15942,6,2018-10-06,north-texas,@,Texas-El Paso,W (27-24),23,34,67.6,294,2,35,134,3.8,1,69,428,6.2,12,8,1,21,3,40,0,0,0
15943,7,2018-10-13,north-texas,,Southern Mississippi,W (30-7),24,38,63.2,292,1,33,165,5.0,3,71,457,6.4,13,10,1,24,5,55,1,0,1
15944,8,2018-10-20,north-texas,@,Alabama-Birmingham,L (21-29),29,40,72.5,336,3,23,64,2.8,0,63,400,6.3,16,3,5,24,4,50,1,0,1
15945,9,2018-10-27,north-texas,,Rice,W (41-17),18,35,51.4,333,2,24,164,6.8,3,59,497,8.4,13,9,5,27,2,16,2,0,2
15946,10,2018-11-10,north-texas,@,Old Dominion,L (31-34),26,44,59.1,240,2,38,155,4.1,2,82,395,4.8,12,9,2,23,4,60,1,1,2
15947,11,2018-11-15,north-texas,,Florida Atlantic,W (41-38),23,35,65.7,303,2,37,208,5.6,3,72,511,7.1,14,8,3,25,4,40,0,2,2
15948,,11 Games,north-texas,,,,278,434,64.1,3475,25,388,1683,4.3,23,822,5158,6.3,160,88,28,276,49,564,8,4,12
15949,1,2014-08-30,florida-international,,Bethune-Cookman,L (12-14),16,33,48.5,143,1,32,43,1.3,0,65,186,2.9,5,4,3,12,8,47,0,0,0
15950,2,2014-09-06,florida-international,,Wagner,W (34-3),23,33,69.7,229,2,34,148,4.4,1,67,377,5.6,9,7,3,19,9,70,3,0,3
15951,3,2014-09-13,florida-international,,Pittsburgh,L (25-42),17,35,48.6,236,2,33,57,1.7,1,68,293,4.3,9,7,1,17,8,68,1,0,1
15952,4,2014-09-20,florida-international,,Louisville,L (3-34),13,26,50.0,117,0,40,88,2.2,0,66,205,3.1,4,7,1,12,6,60,1,2,3
15953,5,2014-09-27,florida-international,@,Alabama-Birmingham,W (34-20),9,24,37.5,204,2,37,93,2.5,0,61,297,4.9,5,4,0,9,10,65,0,0,0
15954,6,2014-10-02,florida-international,,Florida Atlantic,W (38-10),18,29,62.1,160,0,41,185,4.5,4,70,345,4.9,7,13,0,20,8,51,1,0,1
15955,7,2014-10-11,florida-international,@,Texas-San Antonio,L (13-16),11,26,42.3,141,1,47,118,2.5,0,73,259,3.5,8,9,3,20,6,30,3,2,5
15956,8,2014-10-18,florida-international,,Marshall,L (13-45),18,32,56.3,208,1,53,177,3.3,1,85,385,4.5,12,10,1,23,8,88,0,2,2
15957,9,2014-11-01,florida-international,,Rice,L (17-31),10,23,43.5,159,1,46,102,2.2,1,69,261,3.8,5,9,0,14,5,30,2,0,2
15958,10,2014-11-08,florida-international,@,Old Dominion,L (35-38),8,13,61.5,132,2,55,256,4.7,2,68,388,5.7,4,17,0,21,6,59,0,1,1
15959,11,2014-11-15,florida-international,,Middle Tennessee State,W (38-28),17,24,70.8,231,3,40,144,3.6,1,64,375,5.9,9,7,1,17,3,25,1,0,1
15960,12,2014-11-22,florida-international,@,North Texas,L (14-17),11,25,44.0,56,0,30,91,3.0,0,55,147,2.7,5,6,1,12,7,80,0,3,3
15961,,12 Games,florida-international,,,,171,323,52.9,2016,15,488,1502,3.1,11,811,3518,4.3,82,100,14,196,84,673,12,10,22
15962,1,2015-09-03,florida-international,@,Central Florida,W (15-14),29,38,76.3,260,1,31,131,4.2,1,69,391,5.7,11,6,0,17,7,45,1,0,1
15963,2,2015-09-12,florida-international,@,Indiana,L (22-36),24,47,51.1,283,3,33,123,3.7,0,80,406,5.1,12,7,5,24,8,54,2,1,3
15964,3,2015-09-19,florida-international,,North Carolina Central,W (39-14),22,36,61.1,242,3,46,248,5.4,2,82,490,6.0,8,13,0,21,6,60,1,1,2
15965,4,2015-09-26,florida-international,@,Louisiana Tech,L (17-27),29,44,65.9,263,1,23,45,2.0,0,67,308,4.6,14,4,0,18,7,55,0,0,0
15966,5,2015-10-03,florida-international,@,Massachusetts,L (14-24),22,34,64.7,115,1,29,73,2.5,1,63,188,3.0,6,5,2,13,10,111,0,0,0
15967,6,2015-10-10,florida-international,,Texas-El Paso,W (52-12),15,22,68.2,368,3,31,150,4.8,3,53,518,9.8,14,7,1,22,5,38,0,0,0
15968,7,2015-10-17,florida-international,@,Middle Tennessee State,L (34-42),29,51,56.9,260,2,30,86,2.9,2,81,346,4.3,16,5,4,25,3,20,0,1,1
15969,8,2015-10-24,florida-international,,Old Dominion,W (41-12),31,39,79.5,390,3,33,58,1.8,2,72,448,6.2,13,6,1,20,3,30,1,0,1
15970,9,2015-10-31,florida-international,@,Florida Atlantic,L (17-31),19,27,70.4,196,1,32,66,2.1,1,59,262,4.4,8,9,3,20,5,38,1,1,2
15971,10,2015-11-07,florida-international,,UNC Charlotte,W (48-31),27,42,64.3,284,3,32,155,4.8,2,74,439,5.9,13,9,2,24,6,55,0,1,1
15972,11,2015-11-14,florida-international,@,Marshall,L (0-52),11,27,40.7,98,0,36,111,3.1,0,63,209,3.3,3,9,1,13,5,55,0,1,1
15973,12,2015-11-21,florida-international,,Western Kentucky,L (7-63),17,33,51.5,95,0,29,73,2.5,1,62,168,2.7,2,5,3,10,4,33,1,2,3
15974,,12 Games,florida-international,,,,275,440,62.5,2854,21,385,1319,3.4,15,825,4173,5.1,120,85,22,227,69,594,7,8,15
15975,1,2016-09-01,florida-international,,Indiana,L (13-34),24,47,51.1,268,0,21,63,3.0,1,68,331,4.9,12,2,2,16,6,36,0,3,3
15976,2,2016-09-09,florida-international,,Maryland,L (14-41),14,28,50.0,170,1,40,202,5.1,1,68,372,5.5,7,7,2,16,9,90,0,1,1
15977,3,2016-09-17,florida-international,@,Massachusetts,L (13-21),20,34,58.8,178,0,34,137,4.0,1,68,315,4.6,8,7,4,19,10,95,2,0,2
15978,4,2016-09-24,florida-international,,Central Florida,L (14-53),11,24,45.8,109,1,34,80,2.4,1,58,189,3.3,5,5,1,11,5,55,0,1,1
15979,5,2016-10-01,florida-international,,Florida Atlantic,W (33-31),15,30,50.0,199,1,49,270,5.5,3,79,469,5.9,9,14,2,25,1,5,0,2,2
15980,6,2016-10-08,florida-international,@,Texas-El Paso,W (35-21),21,31,67.7,241,3,44,258,5.9,1,75,499,6.7,10,12,1,23,6,57,0,1,1
15981,7,2016-10-15,florida-international,@,UNC Charlotte,W (27-26),26,42,61.9,315,2,21,39,1.9,1,63,354,5.6,15,1,3,19,5,55,1,2,3
15982,8,2016-10-22,florida-international,,Louisiana Tech,L (24-44),29,49,59.2,331,3,29,67,2.3,0,78,398,5.1,18,5,1,24,7,49,0,1,1
15983,9,2016-10-29,florida-international,,Middle Tennessee State,L (35-42),27,40,67.5,307,3,44,210,4.8,2,84,517,6.2,15,11,0,26,3,25,2,1,3
15984,10,2016-11-05,florida-international,@,Western Kentucky,L (21-49),22,34,64.7,210,2,30,101,3.4,1,64,311,4.9,13,4,0,17,4,30,1,2,3
15985,11,2016-11-19,florida-international,,Marshall,W (31-14),18,25,72.0,257,1,41,259,6.3,3,66,516,7.8,12,13,1,26,5,45,0,2,2
15986,12,2016-11-26,florida-international,@,Old Dominion,L (28-42),11,23,47.8,135,2,36,97,2.7,1,59,232,3.9,5,10,1,16,3,42,0,1,1
15987,,12 Games,florida-international,,,,238,407,58.5,2720,19,423,1783,4.2,16,830,4503,5.4,129,91,18,238,64,584,6,17,23
15988,1,2017-08-31,florida-international,@,Central Florida,L (17-61),18,31,58.1,201,1,26,134,5.2,1,57,335,5.9,8,5,0,13,14,163,3,1,4
15989,2,2017-09-08,florida-international,N,Alcorn State,W (17-10),21,33,63.6,328,0,40,137,3.4,2,73,465,6.4,15,9,2,26,5,30,1,0,1
15990,3,2017-09-23,florida-international,@,Rice,W (13-7),17,28,60.7,172,1,33,99,3.0,0,61,271,4.4,10,7,1,18,5,57,0,1,1
15991,4,2017-09-30,florida-international,,UNC Charlotte,W (30-29),15,27,55.6,241,2,41,234,5.7,2,68,475,7.0,10,10,0,20,5,42,0,1,1
15992,5,2017-10-07,florida-international,@,Middle Tennessee State,L (17-37),22,34,64.7,221,1,36,85,2.4,1,70,306,4.4,10,8,3,21,4,45,1,1,2
15993,6,2017-10-14,florida-international,,Tulane,W (23-10),17,31,54.8,220,1,44,218,5.0,1,75,438,5.8,11,11,1,23,11,105,0,2,2
15994,7,2017-10-28,florida-international,@,Marshall,W (41-30),14,18,77.8,177,2,48,224,4.7,2,66,401,6.1,10,9,2,21,6,60,0,0,0
15995,8,2017-11-04,florida-international,,Texas-San Antonio,W (14-7),18,25,72.0,215,2,37,100,2.7,0,62,315,5.1,11,6,1,18,6,75,2,1,3
15996,9,2017-11-11,florida-international,,Old Dominion,L (30-37),35,50,70.0,323,2,35,164,4.7,2,85,487,5.7,20,6,1,27,9,84,2,0,2
15997,10,2017-11-18,florida-international,@,Florida Atlantic,L (24-52),20,33,60.6,218,2,31,85,2.7,1,64,303,4.7,10,7,1,18,6,55,0,0,0
15998,11,2017-11-24,florida-international,,Western Kentucky,W (41-17),18,27,66.7,251,2,34,122,3.6,2,61,373,6.1,13,5,0,18,2,19,0,0,0
15999,12,2017-12-02,florida-international,,Massachusetts,W (63-45),20,25,80.0,295,3,49,379,7.7,6,74,674,9.1,12,11,3,26,5,50,1,1,2
16000,13,2017-12-21,florida-international,N,Temple*,L (3-28),17,34,50.0,169,0,40,88,2.2,0,74,257,3.5,11,5,4,20,6,59,1,2,3
16001,,13 Games,florida-international,,,,252,396,63.6,3031,19,494,2069,4.2,20,890,5100,5.7,151,99,19,269,84,844,11,10,21
16002,1,2018-09-01,florida-international,,Indiana,L (28-38),17,28,60.7,157,1,39,170,4.4,3,67,327,4.9,8,9,5,22,7,70,2,1,3
16003,2,2018-09-08,florida-international,@,Old Dominion,W (28-20),19,31,61.3,300,3,51,189,3.7,1,82,489,6.0,14,10,1,25,5,35,0,1,1
16004,3,2018-09-15,florida-international,,Massachusetts,W (63-24),16,23,69.6,207,2,53,329,6.2,5,76,536,7.1,8,22,2,32,2,30,1,1,2
16005,4,2018-09-22,florida-international,@,Miami (FL),L (17-31),13,28,46.4,170,2,24,17,0.7,0,52,187,3.6,5,1,1,7,3,23,0,1,1
16006,5,2018-09-29,florida-international,,Arkansas-Pine Bluff,W (55-9),13,19,68.4,393,4,28,222,7.9,3,47,615,13.1,11,7,0,18,5,52,0,0,0
16007,6,2018-10-13,florida-international,,Middle Tennessee State,W (24-21),27,36,75.0,311,2,34,70,2.1,0,70,381,5.4,11,6,4,21,7,49,0,0,0
16008,7,2018-10-20,florida-international,,Rice,W (36-17),20,29,69.0,229,2,38,217,5.7,2,67,446,6.7,15,8,0,23,3,15,0,0,0
16009,8,2018-10-27,florida-international,@,Western Kentucky,W (38-17),19,28,67.9,171,3,38,197,5.2,2,66,368,5.6,6,8,3,17,6,65,0,0,0
16010,9,2018-11-03,florida-international,,Florida Atlantic,L (14-49),19,34,55.9,234,2,33,96,2.9,0,67,330,4.9,13,5,1,19,2,21,1,2,3
16011,10,2018-11-10,florida-international,@,Texas-San Antonio,W (45-7),20,30,66.7,304,3,40,151,3.8,2,70,455,6.5,12,9,0,21,8,95,0,0,0
16012,11,2018-11-17,florida-international,@,UNC Charlotte,W (42-35),25,32,78.1,294,2,23,196,8.5,2,55,490,8.9,15,5,1,21,6,47,0,0,0
16013,,11 Games,florida-international,,,,208,318,65.4,2770,26,401,1854,4.6,20,719,4624,6.4,118,90,18,226,54,502,4,6,10
16014,1,2014-08-31,utah-state,@,Tennessee,L (7-38),18,35,51.4,144,1,24,100,4.2,0,59,244,4.1,6,4,1,11,5,42,1,2,3
16015,2,2014-09-06,utah-state,,Idaho State,W (40-20),13,30,43.3,116,0,45,311,6.9,3,75,427,5.7,5,14,2,21,14,160,1,1,2
16016,3,2014-09-13,utah-state,,Wake Forest,W (36-24),32,44,72.7,331,3,35,60,1.7,0,79,391,4.9,13,5,5,23,8,65,1,2,3
16017,4,2014-09-20,utah-state,@,Arkansas State,L (14-21),27,47,57.4,268,2,37,145,3.9,0,84,413,4.9,6,12,1,19,11,100,0,1,1
16018,5,2014-10-03,utah-state,@,Brigham Young,W (35-20),19,25,76.0,321,3,46,136,3.0,2,71,457,6.4,12,7,3,22,12,105,1,0,1
16019,6,2014-10-11,utah-state,,Air Force,W (34-16),22,31,71.0,311,2,28,77,2.8,2,59,388,6.6,9,5,0,14,3,43,1,0,1
16020,7,2014-10-18,utah-state,@,Colorado State,L (13-16),19,31,61.3,160,0,19,100,5.3,1,50,260,5.2,6,3,2,11,6,45,0,1,1
16021,8,2014-10-25,utah-state,,Nevada-Las Vegas,W (34-20),16,29,55.2,266,3,47,178,3.8,1,76,444,5.8,7,10,1,18,7,60,1,0,1
16022,9,2014-11-01,utah-state,@,Hawaii,W (35-14),15,16,93.8,230,4,50,235,4.7,0,66,465,7.0,6,13,2,21,12,96,0,0,0
16023,10,2014-11-07,utah-state,@,Wyoming,W (20-3),13,17,76.5,150,0,33,206,6.2,1,50,356,7.1,3,8,1,12,6,75,1,0,1
16024,11,2014-11-15,utah-state,,New Mexico,W (28-21),13,21,61.9,150,1,36,272,7.6,3,57,422,7.4,9,10,0,19,3,25,0,1,1
16025,12,2014-11-21,utah-state,,San Jose State,W (41-7),15,23,65.2,108,1,42,313,7.5,5,65,421,6.5,8,10,2,20,5,40,0,1,1
16026,13,2014-11-29,utah-state,@,Boise State,L (19-50),16,28,57.1,159,0,30,109,3.6,1,58,268,4.6,7,7,2,16,7,52,2,1,3
16027,14,2014-12-20,utah-state,N,Texas-El Paso*,W (21-6),5,12,41.7,68,0,40,279,7.0,3,52,347,6.7,2,12,2,16,2,10,1,1,2
16028,,14 Games,utah-state,,,,243,389,62.5,2782,20,512,2521,4.9,22,901,5303,5.9,99,120,24,243,101,918,10,11,21
16029,1,2015-09-03,utah-state,,Southern Utah,W (12-9),16,33,48.5,110,0,35,140,4.0,0,68,250,3.7,5,7,3,15,11,123,0,1,1
16030,2,2015-09-11,utah-state,@,Utah,L (14-24),22,35,62.9,256,2,32,117,3.7,0,67,373,5.6,12,8,1,21,6,61,1,2,3
16031,3,2015-09-19,utah-state,@,Washington,L (17-31),17,33,51.5,171,0,30,83,2.8,1,63,254,4.0,8,4,1,13,5,25,0,2,2
16032,4,2015-10-03,utah-state,,Colorado State,W (33-18),12,21,57.1,137,1,45,298,6.6,2,66,435,6.6,6,11,4,21,12,125,0,0,0
16033,5,2015-10-10,utah-state,@,Fresno State,W (56-14),19,27,70.4,281,1,43,201,4.7,7,70,482,6.9,11,9,1,21,7,59,1,0,1
16034,6,2015-10-16,utah-state,,Boise State,W (52-26),17,24,70.8,157,3,43,177,4.1,3,67,334,5.0,9,5,1,15,11,104,1,0,1
16035,7,2015-10-23,utah-state,@,San Diego State,L (14-48),9,20,45.0,95,1,36,144,4.0,1,56,239,4.3,4,8,4,16,5,55,3,1,4
16036,8,2015-10-30,utah-state,,Wyoming,W (58-27),16,19,84.2,296,4,43,296,6.9,3,62,592,9.5,13,18,3,34,3,25,1,0,1
16037,9,2015-11-07,utah-state,@,New Mexico,L (13-14),14,25,56.0,216,1,37,78,2.1,0,62,294,4.7,8,3,2,13,2,8,2,0,2
16038,10,2015-11-14,utah-state,@,Air Force,L (28-35),25,47,53.2,364,4,23,75,3.3,0,70,439,6.3,14,5,0,19,2,21,0,1,1
16039,11,2015-11-21,utah-state,,Nevada,W (31-27),14,29,48.3,109,0,42,204,4.9,2,71,313,4.4,5,12,2,19,3,30,1,2,3
16040,12,2015-11-28,utah-state,,Brigham Young,L (28-51),20,45,44.4,243,1,43,202,4.7,3,88,445,5.1,10,12,1,23,8,70,2,0,2
16041,13,2015-12-22,utah-state,N,Akron*,L (21-23),28,45,62.2,237,3,29,131,4.5,0,74,368,5.0,13,7,2,22,8,60,2,1,3
16042,,13 Games,utah-state,,,,229,403,56.8,2672,21,481,2146,4.5,22,884,4818,5.5,118,109,25,252,83,766,14,10,24
16043,1,2016-09-01,utah-state,,Weber State,W (45-6),11,17,64.7,100,0,44,428,9.7,6,61,528,8.7,7,16,0,23,4,30,0,0,0
16044,2,2016-09-10,utah-state,@,Southern California,L (7-45),25,39,64.1,204,1,26,49,1.9,0,65,253,3.9,10,1,2,13,5,38,0,1,1
16045,3,2016-09-16,utah-state,,Arkansas State,W (34-20),11,25,44.0,136,1,47,198,4.2,3,72,334,4.6,7,9,2,18,6,54,0,1,1
16046,4,2016-09-24,utah-state,,Air Force,L (20-27),30,48,62.5,372,1,32,42,1.3,1,80,414,5.2,15,4,3,22,7,46,1,1,2
16047,5,2016-10-01,utah-state,@,Boise State,L (10-21),29,51,56.9,287,1,25,71,2.8,0,76,358,4.7,10,4,4,18,12,90,0,0,0
16048,6,2016-10-08,utah-state,@,Colorado State,L (24-31),20,35,57.1,210,0,39,251,6.4,3,74,461,6.2,8,11,4,23,9,71,1,1,2
16049,7,2016-10-22,utah-state,,Fresno State,W (38-20),17,29,58.6,188,3,38,208,5.5,1,67,396,5.9,9,13,2,24,5,40,0,0,0
16050,8,2016-10-28,utah-state,,San Diego State,L (13-40),11,26,42.3,181,1,28,71,2.5,1,54,252,4.7,6,4,2,12,4,39,1,1,2
16051,9,2016-11-05,utah-state,@,Wyoming,L (28-52),24,45,53.3,303,1,24,111,4.6,3,69,414,6.0,11,4,6,21,7,58,1,1,2
16052,10,2016-11-12,utah-state,,New Mexico,L (21-24),21,27,77.8,263,1,28,128,4.6,2,55,391,7.1,10,7,4,21,7,75,0,1,1
16053,11,2016-11-19,utah-state,@,Nevada,L (37-38),10,18,55.6,127,0,50,396,7.9,4,68,523,7.7,6,15,0,21,9,74,1,1,2
16054,12,2016-11-26,utah-state,@,Brigham Young,L (10-28),12,23,52.2,103,0,28,97,3.5,1,51,200,3.9,6,4,1,11,11,94,1,1,2
16055,,12 Games,utah-state,,,,221,383,57.7,2474,10,409,2050,5.0,25,792,4524,5.7,105,92,30,227,86,709,6,9,15
16056,1,2017-09-01,utah-state,@,Wisconsin,L (10-59),25,41,61.0,219,0,27,85,3.1,1,68,304,4.5,11,3,2,16,9,93,1,3,4
16057,2,2017-09-07,utah-state,,Idaho State,W (51-13),27,32,84.4,341,2,49,255,5.2,3,81,596,7.4,17,12,1,30,9,48,1,1,2
16058,3,2017-09-16,utah-state,@,Wake Forest,L (10-46),15,37,40.5,225,1,31,42,1.4,0,68,267,3.9,7,4,0,11,4,39,0,1,1
16059,4,2017-09-23,utah-state,@,San Jose State,W (61-10),28,41,68.3,271,3,57,318,5.6,3,98,589,6.0,16,12,1,29,7,60,1,2,3
16060,5,2017-09-29,utah-state,,Brigham Young,W (40-24),16,30,53.3,176,2,44,112,2.5,1,74,288,3.9,6,7,1,14,4,38,0,1,1
16061,6,2017-10-07,utah-state,,Colorado State,L (14-27),18,34,52.9,149,1,29,63,2.2,0,63,212,3.4,5,5,3,14,7,73,0,0,0
16062,7,2017-10-14,utah-state,,Wyoming,L (23-28),20,39,51.3,232,1,37,131,3.5,1,76,363,4.8,12,9,2,23,4,50,2,3,5
16063,8,2017-10-21,utah-state,@,Nevada-Las Vegas,W (52-28),20,29,69.0,323,2,47,265,5.6,5,76,588,7.7,10,15,0,25,6,55,2,0,2
16064,9,2017-10-28,utah-state,,Boise State,L (14-41),18,34,52.9,186,1,27,93,3.4,1,61,279,4.6,7,4,2,13,7,72,0,0,0
16065,10,2017-11-04,utah-state,@,New Mexico,W (24-10),13,24,54.2,114,0,24,129,5.4,2,48,243,5.1,7,4,1,12,5,50,1,1,2
16066,11,2017-11-18,utah-state,,Hawaii,W (38-0),12,20,60.0,164,2,39,311,8.0,3,59,475,8.1,8,12,0,20,2,10,0,1,1
16067,12,2017-11-25,utah-state,@,Air Force,L (35-38),17,30,56.7,284,2,29,237,8.2,3,59,521,8.8,13,6,0,19,8,67,1,0,1
16068,13,2017-12-29,utah-state,N,New Mexico State*,L (20-26),25,44,56.8,254,0,45,187,4.2,1,89,441,5.0,12,8,2,22,8,73,2,0,2
16069,,13 Games,utah-state,,,,254,435,58.4,2938,17,485,2228,4.6,24,920,5166,5.6,131,101,15,248,80,728,11,13,24
16070,1,2018-08-31,utah-state,@,Michigan State,L (31-38),29,44,65.9,319,0,25,25,1.0,3,69,344,5.0,18,2,2,22,7,49,0,2,2
16071,2,2018-09-08,utah-state,,New Mexico State,W (60-13),17,31,54.8,172,1,46,274,6.0,3,77,446,5.8,8,11,3,22,10,91,1,1,2
16072,3,2018-09-13,utah-state,,Tennessee Tech,W (73-12),30,35,85.7,291,2,42,330,7.9,7,77,621,8.1,14,15,2,31,6,60,2,0,2
16073,4,2018-09-22,utah-state,,Air Force,W (42-32),26,38,68.4,356,2,24,133,5.5,4,62,489,7.9,19,3,0,22,5,35,2,0,2
16074,5,2018-10-05,utah-state,@,Brigham Young,W (45-20),18,28,64.3,165,4,42,223,5.3,1,70,388,5.5,8,10,1,19,12,125,0,0,0
16075,6,2018-10-13,utah-state,,Nevada-Las Vegas,W (59-28),22,31,71.0,377,5,38,221,5.8,2,69,598,8.7,14,9,1,24,5,55,1,0,1
16076,7,2018-10-20,utah-state,@,Wyoming,W (24-16),12,28,42.9,53,0,33,141,4.3,2,61,194,3.2,1,8,2,11,6,52,0,1,1
16077,8,2018-10-27,utah-state,,New Mexico,W (61-19),30,42,71.4,516,4,49,188,3.8,2,91,704,7.7,19,11,0,30,6,43,3,0,3
16078,9,2018-11-03,utah-state,@,Hawaii,W (56-17),19,24,79.2,175,1,54,426,7.9,7,78,601,7.7,11,17,1,29,12,105,1,0,1
16079,10,2018-11-10,utah-state,,San Jose State,W (62-24),35,50,70.0,510,5,39,296,7.6,3,89,806,9.1,19,11,3,33,10,82,0,0,0
16080,11,2018-11-17,utah-state,@,Colorado State,W (29-24),15,24,62.5,169,1,28,141,5.0,0,52,310,6.0,7,9,0,16,7,71,1,0,1
16081,,11 Games,utah-state,,,,253,375,67.5,3103,25,420,2398,5.7,34,795,5501,6.9,138,106,15,259,86,768,11,4,15
