Season,Gamecode,Game,Date,Team,Game_home,Opp,Result,Pass_cmp,Pass_att,Pass_pct,Pass_yds,Pass_TD,Rush_att,Rush_yds,Rush_avg,Rush_TD,TO_plays,TO_yds,TO_avg,FD_pass,FD_rush,FD_pen,FD_tot,Pen_num,Pen_yds,Turn_fum,Turn_int,Turn_tot
2018,201891AirSto,1,2018-09-01,Air Force,Home,Stony Brook,W (38-0),2,8,25.0,29,0,77,333,4.3,4,85,362,4.3,2,19,2,23,3,30,2,0,2
2018,201898AirFlo,2,2018-09-08,Air Force,Away,Florida Atlantic,L (27-33),8,13,61.5,164,1,56,209,3.7,2,69,373,5.4,5,11,3,19,5,50,0,1,1
2018,2018922AirUta,3,2018-09-22,Air Force,Away,Utah State,L (32-42),11,21,52.4,148,0,86,323,3.8,3,107,471,4.4,5,21,1,27,7,65,1,0,1
2018,2018929AirNev,4,2018-09-29,Air Force,Home,Nevada,L (25-28),8,19,42.1,96,1,51,154,3.0,1,70,250,3.6,5,10,1,16,5,40,2,0,2
2018,2018106AirNav,5,2018-10-06,Air Force,Home,Navy,W (35-7),6,10,60.0,142,1,55,257,4.7,4,65,399,6.1,6,10,1,17,3,32,0,0,0
2018,20181012AirSan,6,2018-10-12,Air Force,Away,San Diego State,L (17-21),8,17,47.1,62,0,51,214,4.2,2,68,276,4.1,4,9,1,14,5,56,0,1,1
2018,20181019AirNev,7,2018-10-19,Air Force,Away,Nevada-Las Vegas,W (41-35),9,11,81.8,217,1,52,355,6.8,4,63,572,9.1,7,17,2,26,9,76,2,0,2
2018,20181027AirBoi,8,2018-10-27,Air Force,Home,Boise State,L (38-48),11,16,68.8,242,3,51,201,3.9,2,67,443,6.6,9,13,1,23,4,25,0,0,0
2018,2018113AirArm,9,2018-11-03,Air Force,Away,Army,L (14-17),12,22,54.5,197,0,35,125,3.6,2,57,322,5.6,8,7,2,17,5,55,0,1,1
2018,20181110AirNew,10,2018-11-10,Air Force,Home,New Mexico,W (42-24),5,6,83.3,145,2,67,478,7.1,4,73,623,8.5,4,23,0,27,2,11,3,0,3
2018,20181117AirWyo,11,2018-11-17,Air Force,Away,Wyoming,L (27-35),5,9,55.6,53,0,65,362,5.6,3,74,415,5.6,3,22,0,25,5,66,0,2,2
2018,20181122AirCol,12,2018-11-22,Air Force,Home,Colorado State,W (27-19),8,16,50.0,81,1,67,393,5.9,2,83,474,5.7,4,23,3,30,1,15,0,0,0
2018,201898AkrMor,1,2018-09-08,Akron,Home,Morgan State,W (41-7),18,31,58.1,237,3,39,200,5.1,2,70,437,6.2,9,13,4,26,6,73,1,2,3
2018,2018915AkrNor,2,2018-09-15,Akron,Away,Northwestern,W (39-34),17,28,60.7,277,2,36,90,2.5,0,64,367,5.7,7,6,2,15,15,140,0,0,0
2018,2018922AkrIow,3,2018-09-22,Akron,Away,Iowa State,L (13-26),12,28,42.9,153,1,31,91,2.9,0,59,244,4.1,8,4,3,15,6,45,0,1,1
2018,2018106AkrMia,4,2018-10-06,Akron,Home,Miami (OH),L (17-41),19,35,54.3,203,1,28,56,2.0,0,63,259,4.1,9,5,2,16,8,86,2,3,5
2018,20181013AkrBuf,5,2018-10-13,Akron,Away,Buffalo,L (6-24),12,29,41.4,115,0,32,120,3.8,0,61,235,3.9,5,7,1,13,5,46,0,1,1
2018,20181020AkrKen,6,2018-10-20,Akron,Away,Kent State,W (24-23),19,35,54.3,219,1,39,143,3.7,2,74,362,4.9,13,5,1,19,7,65,0,1,1
2018,20181027AkrCen,7,2018-10-27,Akron,Home,Central Michigan,W (17-10),10,27,37.0,149,1,37,154,4.2,1,64,303,4.7,6,8,2,16,4,37,4,0,4
2018,2018111AkrNor,8,2018-11-01,Akron,Home,Northern Illinois,L (26-36),21,38,55.3,326,3,28,35,1.3,0,66,361,5.5,14,1,4,19,7,50,0,2,2
2018,20181110AkrEas,9,2018-11-10,Akron,Away,Eastern Michigan,L (7-27),4,15,26.7,29,0,30,72,2.4,0,45,101,2.2,1,4,1,6,2,25,1,3,4
2018,20181117AkrBow,10,2018-11-17,Akron,Home,Bowling Green State,L (6-21),12,28,42.9,148,0,28,79,2.8,0,56,227,4.1,7,6,2,15,8,61,0,0,0
2018,20181123AkrOhi,11,2018-11-23,Akron,Away,Ohio,L (28-49),24,41,58.5,356,4,21,32,1.5,0,62,388,6.3,16,3,4,23,9,81,0,1,1
2018,2018121AkrSou,12,2018-12-01,Akron,Away,South Carolina,L (3-28),19,39,48.7,178,0,39,106,2.7,0,78,284,3.6,10,7,1,18,3,24,2,0,2
2018,201891AlaLou,1,2018-09-01,Alabama,Neutral,Louisville,W (51-14),17,26,65.4,297,2,42,222,5.3,3,68,519,7.6,12,8,1,21,10,111,1,0,1
2018,201898AlaArk,2,2018-09-08,Alabama,Home,Arkansas State,W (57-7),20,29,69.0,321,6,44,278,6.3,1,73,599,8.2,11,13,2,26,4,35,1,0,1
2018,2018915AlaMis,3,2018-09-15,Alabama,Away,Mississippi,W (62-7),19,28,67.9,306,4,44,210,4.8,3,72,516,7.2,14,10,3,27,8,60,1,1,2
2018,2018922AlaTex,4,2018-09-22,Alabama,Home,Texas A&M,W (45-23),25,33,75.8,415,4,28,109,3.9,2,61,524,8.6,16,6,2,24,9,82,0,0,0
2018,2018929AlaLou,5,2018-09-29,Alabama,Home,Louisiana,W (56-14),13,16,81.3,340,4,46,268,5.8,3,62,608,9.8,11,14,1,26,3,15,0,0,0
2018,2018106AlaArk,6,2018-10-06,Alabama,Away,Arkansas,W (65-31),14,18,77.8,393,4,41,246,6.0,4,59,639,10.8,13,11,0,24,5,31,0,0,0
2018,20181013AlaMis,7,2018-10-13,Alabama,Home,Missouri,W (39-10),19,30,63.3,380,3,45,184,4.1,1,75,564,7.5,12,11,2,25,5,60,1,0,1
2018,20181020AlaTen,8,2018-10-20,Alabama,Away,Tennessee,W (58-21),21,32,65.6,327,4,42,218,5.2,4,74,545,7.4,16,12,2,30,5,36,0,1,1
2018,2018113AlaLou,9,2018-11-03,Alabama,Away,Louisiana State,W (29-0),25,42,59.5,295,2,37,281,7.6,2,79,576,7.3,15,14,0,29,6,60,0,1,1
2018,20181110AlaMis,10,2018-11-10,Alabama,Home,Mississippi State,W (24-0),17,27,63.0,163,1,45,142,3.2,2,72,305,4.2,9,12,2,23,0,0,1,1,2
2018,20181117AlaCit,11,2018-11-17,Alabama,Home,Citadel,W (50-17),21,26,80.8,371,4,23,190,8.3,2,49,561,11.4,15,5,1,21,6,68,2,0,2
2018,20181124AlaAub,12,2018-11-24,Alabama,Home,Auburn,W (52-21),26,33,78.8,377,6,26,123,4.7,1,59,500,8.5,14,6,3,23,8,82,0,0,0
2018,2018121AlaGeo,13,2018-12-01,Alabama,Neutral,Georgia,W (35-28),17,34,50.0,246,2,29,157,5.4,3,63,403,6.4,10,9,2,21,3,10,0,2,2
2018,201891AlcGeo,1,2018-09-01,Alcorn State,Away,Georgia Tech,L (0-41),15,23,65.2,69,0,28,77,2.8,0,51,146,2.9,3,5,1,9,3,20,1,1,2
2018,2018113AlcNew,2,2018-11-03,Alcorn State,Away,New Mexico State,L (42-52),26,37,70.3,316,4,54,338,6.3,2,91,654,7.2,13,20,0,33,5,49,1,0,1
2018,201891AppPen,1,2018-09-01,Appalachian State,Away,Penn State,L (38-45),26,39,66.7,292,2,37,159,4.3,2,76,451,5.9,13,8,1,22,9,100,0,1,1
2018,201898AppUNC,2,2018-09-08,Appalachian State,Away,UNC Charlotte,W (45-9),15,15,100.0,295,3,35,139,4.0,1,50,434,8.7,9,7,2,18,5,55,2,0,2
2018,2018922AppGar,3,2018-09-22,Appalachian State,Home,Gardner-Webb,W (72-7),20,27,74.1,260,2,48,432,9.0,6,75,692,9.2,13,18,0,31,8,85,0,0,0
2018,2018929AppSou,4,2018-09-29,Appalachian State,Home,South Alabama,W (52-7),10,20,50.0,169,3,46,348,7.6,4,66,517,7.8,8,15,5,28,4,45,0,2,2
2018,2018109AppArk,5,2018-10-09,Appalachian State,Away,Arkansas State,W (35-9),12,27,44.4,144,2,38,246,6.5,3,65,390,6.0,4,8,3,15,4,50,0,0,0
2018,20181020AppLou,6,2018-10-20,Appalachian State,Home,Louisiana,W (27-17),10,20,50.0,106,1,48,266,5.5,2,68,372,5.5,8,10,3,21,5,42,0,1,1
2018,20181025AppGeo,7,2018-10-25,Appalachian State,Away,Georgia Southern,L (14-34),12,27,44.4,139,1,36,149,4.1,1,63,288,4.6,6,8,0,14,11,91,1,4,5
2018,2018113AppCoa,8,2018-11-03,Appalachian State,Away,Coastal Carolina,W (23-7),9,19,47.4,127,1,56,278,5.0,2,75,405,5.4,6,14,1,21,6,40,0,2,2
2018,20181110AppTex,9,2018-11-10,Appalachian State,Away,Texas State,W (38-7),25,36,69.4,247,2,34,221,6.5,3,70,468,6.7,11,8,0,19,5,50,0,0,0
2018,20181117AppGeo,10,2018-11-17,Appalachian State,Home,Georgia State,W (45-17),22,26,84.6,296,3,39,228,5.8,2,65,524,8.1,13,10,2,25,0,0,0,0,0
2018,20181124AppTro,11,2018-11-24,Appalachian State,Home,Troy,W (21-10),12,24,50.0,113,2,45,201,4.5,1,69,314,4.6,6,8,1,15,13,104,1,0,1
2018,2018121AppLou,12,2018-12-01,Appalachian State,Home,Louisiana,W (30-19),6,13,46.2,75,0,44,225,5.1,3,57,300,5.3,4,8,1,13,4,35,0,0,0
2018,201891AriBri,1,2018-09-01,Arizona,Home,Brigham Young,L (23-28),17,34,50.0,197,1,35,129,3.7,2,69,326,4.7,11,7,4,22,4,26,0,0,0
2018,201898AriHou,2,2018-09-08,Arizona,Away,Houston,L (18-45),28,50,56.0,381,0,50,150,3.0,2,100,531,5.3,19,9,3,31,8,85,0,2,2
2018,2018915AriSou,3,2018-09-15,Arizona,Home,Southern Utah,W (62-31),15,22,68.2,358,5,38,268,7.1,2,60,626,10.4,11,12,3,26,10,98,1,0,1
2018,2018922AriOre,4,2018-09-22,Arizona,Away,Oregon State,W (35-14),9,17,52.9,152,2,51,442,8.7,3,68,594,8.7,8,21,0,29,7,55,1,0,1
2018,2018929AriSou,5,2018-09-29,Arizona,Home,Southern California,L (20-24),16,33,48.5,232,2,37,98,2.6,1,70,330,4.7,10,4,6,20,8,80,0,1,1
2018,2018106AriCal,6,2018-10-06,Arizona,Home,California,W (24-17),15,25,60.0,141,1,34,124,3.6,0,59,265,4.5,5,7,1,13,10,72,1,1,2
2018,20181012AriUta,7,2018-10-12,Arizona,Away,Utah,L (10-42),24,46,52.2,246,1,31,72,2.3,0,77,318,4.1,10,4,5,19,5,56,0,0,0
2018,20181020AriUCL,8,2018-10-20,Arizona,Away,UCLA,L (30-31),15,34,44.1,231,2,38,289,7.6,1,72,520,7.2,11,7,4,22,6,64,1,2,3
2018,20181027AriOre,9,2018-10-27,Arizona,Home,Oregon,W (44-15),19,33,57.6,189,3,51,276,5.4,2,84,465,5.5,10,13,4,27,11,106,0,1,1
2018,2018112AriCol,10,2018-11-02,Arizona,Home,Colorado,W (42-34),17,22,77.3,350,5,47,216,4.6,0,69,566,8.2,12,12,3,27,12,129,1,1,2
2018,20181117AriWas,11,2018-11-17,Arizona,Away,Washington State,L (28-69),20,34,58.8,304,4,37,127,3.4,0,71,431,6.1,12,7,2,21,7,75,3,1,4
2018,20181124AriAri,12,2018-11-24,Arizona,Home,Arizona State,L (40-41),21,39,53.8,282,3,44,238,5.4,1,83,520,6.3,11,12,3,26,7,62,1,1,2
2018,201891AriTex,1,2018-09-01,Arizona State,Home,Texas-San Antonio,W (49-7),16,24,66.7,237,4,35,267,7.6,2,59,504,8.5,9,12,0,21,11,95,0,0,0
2018,201898AriMic,2,2018-09-08,Arizona State,Home,Michigan State,W (16-13),30,48,62.5,380,1,29,44,1.5,0,77,424,5.5,18,6,3,27,4,40,0,1,1
2018,2018915AriSan,3,2018-09-15,Arizona State,Away,San Diego State,L (21-28),31,46,67.4,341,2,24,36,1.5,1,70,377,5.4,16,3,2,21,7,39,0,0,0
2018,2018922AriWas,4,2018-09-22,Arizona State,Away,Washington,L (20-27),17,27,63.0,104,0,40,164,4.1,2,67,268,4.0,5,9,2,16,7,72,1,0,1
2018,2018929AriOre,5,2018-09-29,Arizona State,Home,Oregon State,W (52-24),14,25,56.0,162,3,48,396,8.3,4,73,558,7.6,6,20,2,28,1,5,0,0,0
2018,2018106AriCol,6,2018-10-06,Arizona State,Away,Colorado,L (21-28),12,18,66.7,222,1,39,145,3.7,2,57,367,6.4,7,8,3,18,5,35,0,0,0
2018,20181018AriSta,7,2018-10-18,Arizona State,Home,Stanford,L (13-20),26,45,57.8,353,0,23,84,3.7,1,68,437,6.4,16,4,0,20,7,86,1,2,3
2018,20181027AriSou,8,2018-10-27,Arizona State,Away,Southern California,W (38-35),14,24,58.3,166,1,44,283,6.4,3,68,449,6.6,7,12,1,20,5,48,1,0,1
2018,2018113AriUta,9,2018-11-03,Arizona State,Home,Utah,W (38-20),19,24,79.2,285,3,50,251,5.0,2,74,536,7.2,11,12,2,25,6,60,0,1,1
2018,20181110AriUCL,10,2018-11-10,Arizona State,Home,UCLA,W (31-28),16,22,72.7,199,1,57,283,5.0,3,79,482,6.1,11,16,2,29,6,75,0,1,1
2018,20181117AriOre,11,2018-11-17,Arizona State,Away,Oregon,L (29-31),15,32,46.9,182,2,41,142,3.5,1,73,324,4.4,8,6,2,16,8,50,1,0,1
2018,20181124AriAri,12,2018-11-24,Arizona State,Away,Arizona,W (41-40),18,31,58.1,265,1,31,136,4.4,4,62,401,6.5,10,8,2,20,9,74,0,0,0
2018,201891ArkEas,1,2018-09-01,Arkansas,Home,Eastern Illinois,W (55-20),21,29,72.4,353,4,37,80,2.2,2,66,433,6.6,13,5,0,18,4,40,0,0,0
2018,201898ArkCol,2,2018-09-08,Arkansas,Away,Colorado State,L (27-34),11,22,50.0,138,2,53,299,5.6,1,75,437,5.8,5,16,3,24,6,60,0,2,2
2018,2018915ArkNor,3,2018-09-15,Arkansas,Home,North Texas,L (17-44),20,45,44.4,210,0,32,126,3.9,2,77,336,4.4,12,4,4,20,10,70,0,6,6
2018,2018922ArkAub,4,2018-09-22,Arkansas,Away,Auburn,L (3-34),13,32,40.6,141,0,38,149,3.9,0,70,290,4.1,5,6,2,13,8,57,1,1,2
2018,2018929ArkTex,5,2018-09-29,Arkansas,Neutral,Texas A&M,L (17-24),14,27,51.9,193,1,26,55,2.1,1,53,248,4.7,8,3,0,11,6,61,0,1,1
2018,2018106ArkAla,6,2018-10-06,Arkansas,Home,Alabama,L (31-65),26,40,65.0,233,3,31,172,5.5,1,71,405,5.7,12,7,3,22,2,20,2,1,3
2018,20181013ArkMis,7,2018-10-13,Arkansas,Home,Mississippi,L (33-37),15,22,68.2,177,2,48,299,6.2,1,70,476,6.8,7,17,3,27,5,65,0,1,1
2018,20181020ArkTul,8,2018-10-20,Arkansas,Home,Tulsa,W (23-0),11,19,57.9,131,1,53,196,3.7,1,72,327,4.5,6,12,2,20,3,40,1,1,2
2018,20181027ArkVan,9,2018-10-27,Arkansas,Home,Vanderbilt,L (31-45),23,36,63.9,240,2,29,207,7.1,2,65,447,6.9,12,8,1,21,6,46,0,2,2
2018,20181110ArkLou,10,2018-11-10,Arkansas,Home,Louisiana State,L (17-24),19,39,48.7,200,2,19,16,0.8,0,58,216,3.7,9,2,3,14,6,60,1,1,2
2018,20181117ArkMis,11,2018-11-17,Arkansas,Away,Mississippi State,L (6-52),19,34,55.9,150,0,35,69,2.0,0,69,219,3.2,6,10,1,17,9,85,2,1,3
2018,20181123ArkMis,12,2018-11-23,Arkansas,Away,Missouri,L (0-38),10,25,40.0,135,0,39,52,1.3,0,64,187,2.9,6,5,1,12,4,18,1,1,2
2018,201891ArkSou,1,2018-09-01,Arkansas State,Home,Southeast Missouri State,W (48-21),28,40,70.0,497,7,39,188,4.8,0,79,685,8.7,18,10,2,30,12,119,1,2,3
2018,201898ArkAla,2,2018-09-08,Arkansas State,Away,Alabama,L (7-57),22,51,43.1,218,1,31,173,5.6,0,82,391,4.8,12,6,1,19,10,84,0,1,1
2018,2018915ArkTul,3,2018-09-15,Arkansas State,Away,Tulsa,W (29-20),20,33,60.6,191,0,47,218,4.6,2,80,409,5.1,9,14,1,24,11,101,1,0,1
2018,2018922ArkNev,4,2018-09-22,Arkansas State,Home,Nevada-Las Vegas,W (27-20),19,27,70.4,199,3,36,197,5.5,1,63,396,6.3,9,8,0,17,11,87,1,0,1
2018,2018929ArkGeo,5,2018-09-29,Arkansas State,Away,Georgia Southern,L (21-28),38,51,74.5,376,1,36,117,3.3,1,87,493,5.7,18,10,0,28,5,39,1,0,1
2018,2018109ArkApp,6,2018-10-09,Arkansas State,Home,Appalachian State,L (9-35),27,45,60.0,219,0,37,117,3.2,0,82,336,4.1,10,6,2,18,7,65,0,3,3
2018,20181018ArkGeo,7,2018-10-18,Arkansas State,Home,Georgia State,W (51-35),17,28,60.7,257,3,37,273,7.4,3,65,530,8.2,10,11,2,23,11,109,0,0,0
2018,20181027ArkLou,8,2018-10-27,Arkansas State,Away,Louisiana,L (43-47),17,31,54.8,270,1,45,208,4.6,5,76,478,6.3,10,14,3,27,4,65,0,1,1
2018,2018113ArkSou,9,2018-11-03,Arkansas State,Home,South Alabama,W (38-14),27,40,67.5,354,3,37,155,4.2,2,77,509,6.6,15,8,3,26,3,15,0,0,0
2018,20181110ArkCoa,10,2018-11-10,Arkansas State,Away,Coastal Carolina,W (44-16),23,29,79.3,281,4,29,173,6.0,2,58,454,7.8,11,9,3,23,10,71,1,0,1
2018,20181117ArkLou,11,2018-11-17,Arkansas State,Home,Louisiana-Monroe,W (31-17),21,27,77.8,246,3,39,158,4.1,0,66,404,6.1,11,7,2,20,7,68,0,0,0
2018,20181124ArkTex,12,2018-11-24,Arkansas State,Away,Texas State,W (33-7),18,24,75.0,276,2,46,217,4.7,1,70,493,7.0,10,10,0,20,4,37,1,0,1
2018,2018831ArmDuk,1,2018-08-31,Army,Away,Duke,L (14-34),10,21,47.6,197,1,47,168,3.6,1,68,365,5.4,7,11,0,18,7,69,2,0,2
2018,201898ArmLib,2,2018-09-08,Army,Home,Liberty,W (38-14),2,8,25.0,61,1,74,449,6.1,4,82,510,6.2,2,24,2,28,7,100,0,0,0
2018,2018915ArmHaw,3,2018-09-15,Army,Home,Hawaii,W (28-21),6,10,60.0,162,0,66,303,4.6,4,76,465,6.1,6,12,0,18,5,70,0,0,0
2018,2018922ArmOkl,4,2018-09-22,Army,Away,Oklahoma,L (21-28),3,9,33.3,40,0,78,339,4.3,3,87,379,4.4,3,22,1,26,6,50,0,2,2
2018,2018929ArmBuf,5,2018-09-29,Army,Away,Buffalo,W (42-13),4,5,80.0,91,1,64,281,4.4,4,69,372,5.4,3,19,3,25,7,73,0,1,1
2018,20181013ArmSan,6,2018-10-13,Army,Neutral,San Jose State,W (52-3),2,5,40.0,54,1,65,341,5.2,5,70,395,5.6,2,19,2,23,3,15,0,0,0
2018,20181020ArmMia,7,2018-10-20,Army,Home,Miami (OH),W (31-30),0,2,0.0,0,0,74,347,4.7,4,76,347,4.6,0,19,1,20,1,5,0,0,0
2018,20181027ArmEas,8,2018-10-27,Army,Away,Eastern Michigan,W (37-22),7,8,87.5,126,2,73,289,4.0,2,81,415,5.1,4,18,5,27,3,25,0,0,0
2018,2018113ArmAir,9,2018-11-03,Army,Home,Air Force,W (17-14),3,5,60.0,44,0,59,242,4.1,2,64,286,4.5,0,15,1,16,5,69,0,0,0
2018,20181110ArmLaf,10,2018-11-10,Army,Home,Lafayette,W (31-13),5,6,83.3,95,0,57,313,5.5,4,63,408,6.5,3,20,0,23,6,40,1,0,1
2018,20181117ArmCol,11,2018-11-17,Army,Home,Colgate,W (28-14),2,6,33.3,25,0,59,261,4.4,4,65,286,4.4,2,18,1,21,3,25,1,0,1
2018,201891AubWas,1,2018-09-01,Auburn,Neutral,Washington,W (21-16),26,36,72.2,273,1,45,147,3.3,1,81,420,5.2,17,8,2,27,12,111,0,0,0
2018,201898AubAla,2,2018-09-08,Auburn,Home,Alabama State,W (63-9),8,14,57.1,138,1,59,429,7.3,6,73,567,7.8,4,22,2,28,4,30,4,0,4
2018,2018915AubLou,3,2018-09-15,Auburn,Home,Louisiana State,L (21-22),16,28,57.1,198,1,38,130,3.4,2,66,328,5.0,10,5,4,19,9,111,0,2,2
2018,2018922AubArk,4,2018-09-22,Auburn,Home,Arkansas,W (34-3),15,22,68.2,134,0,36,91,2.5,3,58,225,3.9,6,6,1,13,7,40,0,0,0
2018,2018929AubSou,5,2018-09-29,Auburn,Home,Southern Mississippi,W (24-13),19,33,57.6,245,2,36,96,2.7,1,69,341,4.9,8,7,2,17,9,78,1,0,1
2018,2018106AubMis,6,2018-10-06,Auburn,Away,Mississippi State,L (9-23),19,38,50.0,214,0,21,90,4.3,0,59,304,5.2,9,5,1,15,2,10,2,0,2
2018,20181013AubTen,7,2018-10-13,Auburn,Home,Tennessee,L (24-30),28,45,62.2,322,2,34,126,3.7,1,79,448,5.7,13,8,1,22,5,38,1,2,3
2018,20181020AubMis,8,2018-10-20,Auburn,Away,Mississippi,W (31-16),13,22,59.1,215,1,46,269,5.8,3,68,484,7.1,5,15,0,20,8,80,0,0,0
2018,2018113AubTex,9,2018-11-03,Auburn,Home,Texas A&M,W (28-24),19,30,63.3,259,3,21,19,0.9,1,51,278,5.5,11,2,0,13,6,39,0,0,0
2018,20181110AubGeo,10,2018-11-10,Auburn,Away,Georgia,L (10-27),25,37,67.6,172,1,20,102,5.1,0,57,274,4.8,10,6,3,19,6,52,0,0,0
2018,20181117AubLib,11,2018-11-17,Auburn,Home,Liberty,W (53-0),14,21,66.7,191,2,61,340,5.6,3,82,531,6.5,8,22,0,29,3,25,0,0,0
2018,20181124AubAla,12,2018-11-24,Auburn,Away,Alabama,L (21-52),15,32,46.9,153,2,43,130,3.0,1,75,283,3.8,5,10,4,19,9,88,0,1,1
2018,2018830BalCen,1,2018-08-30,Ball State,Home,Central Connecticut State,W (42-6),28,36,77.8,336,3,47,318,6.8,3,83,654,7.9,10,19,2,31,6,70,1,0,1
2018,201898BalNot,2,2018-09-08,Ball State,Away,Notre Dame,L (16-24),23,50,46.0,180,1,47,169,3.6,0,97,349,3.6,13,11,0,24,3,10,0,2,2
2018,2018915BalInd,3,2018-09-15,Ball State,Away,Indiana,L (10-38),14,28,50.0,143,0,39,204,5.2,1,67,347,5.2,7,11,0,18,8,75,0,1,1
2018,2018922BalWes,4,2018-09-22,Ball State,Home,Western Kentucky,L (20-28),27,45,60.0,285,1,29,120,4.1,1,74,405,5.5,14,8,2,24,10,120,0,0,0
2018,2018929BalKen,5,2018-09-29,Ball State,Home,Kent State,W (52-24),32,52,61.5,446,4,42,160,3.8,3,94,606,6.4,19,7,6,32,11,91,1,1,2
2018,2018106BalNor,6,2018-10-06,Ball State,Home,Northern Illinois,L (16-24),32,56,57.1,260,0,40,131,3.3,1,96,391,4.1,17,6,3,26,2,16,1,0,1
2018,20181013BalCen,7,2018-10-13,Ball State,Away,Central Michigan,W (24-23),20,27,74.1,202,1,51,157,3.1,2,78,359,4.6,10,11,5,26,8,80,1,0,1
2018,20181020BalEas,8,2018-10-20,Ball State,Home,Eastern Michigan,L (20-42),21,39,53.8,157,1,32,227,7.1,2,71,384,5.4,9,8,4,21,9,108,1,1,2
2018,20181025BalOhi,9,2018-10-25,Ball State,Away,Ohio,L (14-52),16,32,50.0,162,1,23,80,3.5,1,55,242,4.4,5,6,0,11,6,54,2,1,3
2018,20181031BalTol,10,2018-10-31,Ball State,Away,Toledo,L (13-45),30,48,62.5,343,1,35,94,2.7,1,83,437,5.3,14,11,1,26,10,100,3,2,5
2018,20181113BalWes,11,2018-11-13,Ball State,Home,Western Michigan,W (42-41),22,27,81.5,282,3,26,71,2.7,3,53,353,6.7,14,7,1,22,6,49,0,2,2
2018,20181120BalMia,12,2018-11-20,Ball State,Away,Miami (OH),L (21-42),23,36,63.9,239,1,34,143,4.2,2,70,382,5.5,15,6,1,22,3,30,0,2,2
2018,201891BayAbi,1,2018-09-01,Baylor,Home,Abilene Christian,W (55-27),18,28,64.3,311,2,36,295,8.2,5,64,606,9.5,12,14,0,26,5,53,0,1,1
2018,201898BayTex,2,2018-09-08,Baylor,Away,Texas-San Antonio,W (37-20),27,41,65.9,403,3,31,91,2.9,1,72,494,6.9,16,7,3,26,7,70,1,0,1
2018,2018915BayDuk,3,2018-09-15,Baylor,Home,Duke,L (27-40),24,42,57.1,270,1,32,130,4.1,2,74,400,5.4,12,9,0,21,6,62,1,1,2
2018,2018922BayKan,4,2018-09-22,Baylor,Home,Kansas,W (26-7),20,29,69.0,257,3,39,190,4.9,0,68,447,6.6,10,10,2,22,13,141,0,0,0
2018,2018929BayOkl,5,2018-09-29,Baylor,Away,Oklahoma,L (33-66),40,63,63.5,416,2,38,77,2.0,2,101,493,4.9,18,11,4,33,9,75,1,0,1
2018,2018106BayKan,6,2018-10-06,Baylor,Home,Kansas State,W (37-34),30,45,66.7,296,1,48,261,5.4,3,93,557,6.0,19,17,2,38,2,10,0,2,2
2018,20181013BayTex,7,2018-10-13,Baylor,Away,Texas,L (17-23),20,39,51.3,240,1,34,88,2.6,1,73,328,4.5,10,8,1,19,10,142,0,1,1
2018,20181025BayWes,8,2018-10-25,Baylor,Away,West Virginia,L (14-58),17,29,58.6,205,0,36,82,2.3,2,65,287,4.4,9,7,1,17,8,75,1,3,4
2018,2018113BayOkl,9,2018-11-03,Baylor,Home,Oklahoma State,W (35-31),14,26,53.8,158,2,39,244,6.3,2,65,402,6.2,6,12,8,26,6,69,0,1,1
2018,20181110BayIow,10,2018-11-10,Baylor,Away,Iowa State,L (14-28),29,48,60.4,359,2,32,146,4.6,0,80,505,6.3,15,9,1,25,7,70,0,0,0
2018,20181117BayTex,11,2018-11-17,Baylor,Home,Texas Christian,L (9-16),14,29,48.3,163,0,40,140,3.5,1,69,303,4.4,7,10,3,20,9,66,2,1,3
2018,20181124BayTex,12,2018-11-24,Baylor,Away,Texas Tech,W (35-24),22,31,71.0,308,3,51,170,3.3,2,82,478,5.8,11,13,4,28,12,80,0,2,2
2018,201891BoiTro,1,2018-09-01,Boise State,Away,Troy,W (56-20),20,28,71.4,305,4,29,111,3.8,2,57,416,7.3,10,6,0,16,4,27,1,0,1
2018,201898BoiCon,2,2018-09-08,Boise State,Home,Connecticut,W (62-7),25,33,75.8,418,4,45,400,8.9,4,78,818,10.5,18,19,1,38,7,71,0,0,0
2018,2018915BoiOkl,3,2018-09-15,Boise State,Away,Oklahoma State,L (21-44),39,56,69.6,380,3,31,34,1.1,0,87,414,4.8,21,2,0,23,5,40,1,0,1
2018,2018929BoiWyo,4,2018-09-29,Boise State,Away,Wyoming,W (34-14),29,43,67.4,345,2,46,161,3.5,2,89,506,5.7,14,11,4,29,9,71,0,0,0
2018,2018106BoiSan,5,2018-10-06,Boise State,Home,San Diego State,L (13-19),22,44,50.0,178,0,36,51,1.4,2,80,229,2.9,8,7,1,16,6,52,0,3,3
2018,20181013BoiNev,6,2018-10-13,Boise State,Away,Nevada,W (31-27),28,38,73.7,299,2,40,207,5.2,1,78,506,6.5,14,9,1,24,9,108,1,3,4
2018,20181019BoiCol,7,2018-10-19,Boise State,Home,Colorado State,W (56-28),23,27,85.2,322,4,37,150,4.1,2,64,472,7.4,16,8,2,26,5,40,0,0,0
2018,20181027BoiAir,8,2018-10-27,Boise State,Away,Air Force,W (48-38),22,36,61.1,409,5,33,121,3.7,1,69,530,7.7,16,9,1,26,1,15,0,0,0
2018,2018113BoiBri,9,2018-11-03,Boise State,Home,Brigham Young,W (21-16),23,35,65.7,214,1,37,113,3.1,2,72,327,4.5,10,10,0,20,7,81,1,1,2
2018,2018119BoiFre,10,2018-11-09,Boise State,Home,Fresno State,W (24-17),24,30,80.0,269,1,44,179,4.1,2,74,448,6.1,11,12,1,24,4,45,0,1,1
2018,20181116BoiNew,11,2018-11-16,Boise State,Away,New Mexico,W (45-14),17,27,63.0,222,3,41,227,5.5,2,68,449,6.6,14,14,2,30,5,30,0,0,0
2018,20181124BoiUta,12,2018-11-24,Boise State,Home,Utah State,W (33-24),23,32,71.9,310,1,45,199,4.4,3,77,509,6.6,11,7,2,20,7,69,0,0,0
2018,2018121BoiFre,13,2018-12-01,Boise State,Home,Fresno State,L (16-19),15,31,48.4,125,1,55,225,4.1,1,86,350,4.1,6,14,2,22,6,50,1,0,1
2018,201891BosMas,1,2018-09-01,Boston College,Home,Massachusetts,W (55-21),21,27,77.8,326,4,59,273,4.6,3,86,599,7.0,14,16,1,31,7,38,0,0,0
2018,201898BosHol,2,2018-09-08,Boston College,Home,Holy Cross,W (62-14),16,20,80.0,245,4,52,365,7.0,4,72,610,8.5,8,14,0,22,5,40,1,0,1
2018,2018913BosWak,3,2018-09-13,Boston College,Away,Wake Forest,W (41-34),16,25,64.0,304,5,44,220,5.0,1,69,524,7.6,9,9,1,19,4,35,1,0,1
2018,2018922BosPur,4,2018-09-22,Boston College,Away,Purdue,L (13-30),15,29,51.7,144,1,34,85,2.5,1,63,229,3.6,7,7,0,14,7,60,0,4,4
2018,2018929BosTem,5,2018-09-29,Boston College,Home,Temple,W (45-35),16,34,47.1,148,3,66,275,4.2,3,100,423,4.2,9,13,6,28,10,79,2,0,2
2018,2018106BosNor,6,2018-10-06,Boston College,Away,North Carolina State,L (23-28),14,25,56.0,198,1,25,120,4.8,1,50,318,6.4,6,6,0,12,6,37,1,0,1
2018,20181013BosLou,7,2018-10-13,Boston College,Home,Louisville,W (38-20),16,22,72.7,179,1,61,251,4.1,3,83,430,5.2,6,14,0,20,7,60,2,0,2
2018,20181026BosMia,8,2018-10-26,Boston College,Home,Miami (FL),W (27-14),17,30,56.7,210,1,53,223,4.2,2,83,433,5.2,10,11,1,22,8,70,0,1,1
2018,2018113BosVir,9,2018-11-03,Boston College,Away,Virginia Tech,W (31-21),15,26,57.7,177,1,49,219,4.5,3,75,396,5.3,8,10,1,19,4,39,1,0,1
2018,20181110BosCle,10,2018-11-10,Boston College,Home,Clemson,L (7-27),14,24,58.3,104,0,33,9,0.3,0,57,113,2.0,6,2,0,8,6,42,0,0,0
2018,20181117BosFlo,11,2018-11-17,Boston College,Away,Florida State,L (21-22),18,38,47.4,297,1,49,125,2.6,2,87,422,4.9,13,7,0,20,5,40,0,2,2
2018,20181124BosSyr,12,2018-11-24,Boston College,Home,Syracuse,L (21-42),17,37,45.9,251,3,32,105,3.3,0,69,356,5.2,11,5,2,18,6,50,2,2,4
2018,201891BowOre,1,2018-09-01,Bowling Green State,Away,Oregon,L (24-58),22,38,57.9,253,3,49,155,3.2,0,87,408,4.7,14,8,0,22,5,50,1,2,3
2018,201898BowMar,2,2018-09-08,Bowling Green State,Home,Maryland,L (14-45),17,27,63.0,143,2,28,15,0.5,0,55,158,2.9,6,4,3,13,10,66,0,1,1
2018,2018915BowEas,3,2018-09-15,Bowling Green State,Home,Eastern Kentucky,W (42-35),28,40,70.0,258,3,40,130,3.3,2,80,388,4.9,15,7,4,26,8,69,0,1,1
2018,2018922BowMia,4,2018-09-22,Bowling Green State,Home,Miami (OH),L (23-38),33,50,66.0,300,3,34,85,2.5,0,84,385,4.6,15,10,4,29,7,57,1,0,1
2018,2018929BowGeo,5,2018-09-29,Bowling Green State,Away,Georgia Tech,L (17-63),29,49,59.2,330,1,38,63,1.7,1,87,393,4.5,17,7,1,25,5,26,1,2,3
2018,2018106BowTol,6,2018-10-06,Bowling Green State,Away,Toledo,L (36-52),18,34,52.9,289,3,29,192,6.6,2,63,481,7.6,10,7,3,20,14,129,1,0,1
2018,20181013BowWes,7,2018-10-13,Bowling Green State,Home,Western Michigan,L (35-42),21,35,60.0,379,3,21,132,6.3,2,56,511,9.1,13,3,3,19,9,85,2,2,4
2018,20181020BowOhi,8,2018-10-20,Bowling Green State,Away,Ohio,L (14-49),19,24,79.2,214,2,26,100,3.8,0,50,314,6.3,9,4,0,13,7,78,1,1,2
2018,20181030BowKen,9,2018-10-30,Bowling Green State,Home,Kent State,L (28-35),21,38,55.3,231,3,39,86,2.2,0,77,317,4.1,11,5,2,18,11,85,0,1,1
2018,20181110BowCen,10,2018-11-10,Bowling Green State,Away,Central Michigan,W (24-13),14,24,58.3,142,1,51,178,3.5,1,75,320,4.3,9,8,0,17,5,31,0,1,1
2018,20181117BowAkr,11,2018-11-17,Bowling Green State,Away,Akron,W (21-6),19,27,70.4,178,2,41,221,5.4,1,68,399,5.9,7,12,3,22,8,72,1,1,2
2018,20181123BowBuf,12,2018-11-23,Bowling Green State,Home,Buffalo,L (14-44),9,18,50.0,147,2,18,60,3.3,0,36,207,5.8,3,3,0,6,4,40,1,1,2
2018,201891BriAri,1,2018-09-01,Brigham Young,Away,Arizona,W (28-23),18,28,64.3,209,1,43,183,4.3,3,71,392,5.5,12,11,0,23,10,94,0,0,0
2018,201898BriCal,2,2018-09-08,Brigham Young,Home,California,L (18-21),22,41,53.7,196,1,33,91,2.8,0,74,287,3.9,9,8,0,17,7,65,0,2,2
2018,2018915BriWis,3,2018-09-15,Brigham Young,Away,Wisconsin,W (24-21),13,23,56.5,120,1,28,191,6.8,2,51,311,6.1,5,8,1,14,4,36,0,0,0
2018,2018922BriMcN,4,2018-09-22,Brigham Young,Home,McNeese State,W (30-3),16,27,59.3,130,1,42,161,3.8,2,69,291,4.2,7,9,2,18,5,56,1,0,1
2018,2018929BriWas,5,2018-09-29,Brigham Young,Away,Washington,L (7-35),18,21,85.7,160,0,28,34,1.2,1,49,194,4.0,6,1,0,7,8,50,1,0,1
2018,2018105BriUta,6,2018-10-05,Brigham Young,Home,Utah State,L (20-45),30,49,61.2,322,3,16,39,2.4,0,65,361,5.6,14,2,7,23,6,50,2,1,3
2018,20181013BriHaw,7,2018-10-13,Brigham Young,Home,Hawaii,W (49-23),16,24,66.7,194,3,47,280,6.0,4,71,474,6.7,11,14,1,26,6,55,0,1,1
2018,20181027BriNor,8,2018-10-27,Brigham Young,Home,Northern Illinois,L (6-7),18,30,60.0,208,0,37,93,2.5,0,67,301,4.5,9,5,3,17,7,52,0,1,1
2018,2018113BriBoi,9,2018-11-03,Brigham Young,Away,Boise State,L (16-21),19,29,65.5,292,0,38,96,2.5,1,67,388,5.8,12,7,2,21,8,58,3,0,3
2018,20181110BriMas,10,2018-11-10,Brigham Young,Away,Massachusetts,W (35-16),14,23,60.9,167,2,38,225,5.9,3,61,392,6.4,7,12,0,19,2,20,1,0,1
2018,20181117BriNew,11,2018-11-17,Brigham Young,Home,New Mexico State,W (45-10),13,29,44.8,193,0,51,317,6.2,6,80,510,6.4,9,15,1,25,2,20,1,1,2
2018,20181124BriUta,12,2018-11-24,Brigham Young,Away,Utah,L (27-35),20,29,69.0,204,2,47,153,3.3,2,76,357,4.7,8,9,0,17,3,22,0,1,1
2018,201891BufDel,1,2018-09-01,Buffalo,Home,Delaware State,W (48-10),19,29,65.5,200,6,37,154,4.2,1,66,354,5.4,9,9,3,21,5,42,0,0,0
2018,201898BufTem,2,2018-09-08,Buffalo,Away,Temple,W (36-29),26,45,57.8,275,3,41,152,3.7,2,86,427,5.0,17,7,3,27,4,29,0,1,1
2018,2018915BufEas,3,2018-09-15,Buffalo,Home,Eastern Michigan,W (35-28),21,26,80.8,325,3,41,164,4.0,2,67,489,7.3,10,6,2,18,7,47,1,0,1
2018,2018922BufRut,4,2018-09-22,Buffalo,Away,Rutgers,W (42-13),14,28,50.0,263,3,36,182,5.1,3,64,445,7.0,10,5,4,19,3,25,0,2,2
2018,2018929BufArm,5,2018-09-29,Buffalo,Home,Army,L (13-42),10,24,41.7,152,1,31,103,3.3,1,55,255,4.6,5,5,4,14,7,78,0,0,0
2018,2018106BufCen,6,2018-10-06,Buffalo,Away,Central Michigan,W (34-24),10,20,50.0,127,1,48,295,6.1,3,68,422,6.2,8,12,1,21,4,38,0,1,1
2018,20181013BufAkr,7,2018-10-13,Buffalo,Home,Akron,W (24-6),16,30,53.3,212,1,46,223,4.8,2,76,435,5.7,9,10,1,20,5,45,0,1,1
2018,20181020BufTol,8,2018-10-20,Buffalo,Away,Toledo,W (31-17),25,46,54.3,326,2,50,137,2.7,2,96,463,4.8,14,10,8,32,5,44,0,3,3
2018,20181030BufMia,9,2018-10-30,Buffalo,Home,Miami (OH),W (51-42),20,35,57.1,358,3,37,149,4.0,4,72,507,7.0,11,10,5,26,11,100,0,0,0
2018,2018116BufKen,10,2018-11-06,Buffalo,Home,Kent State,W (48-14),9,21,42.9,120,1,57,358,6.3,6,78,478,6.1,6,15,1,22,3,20,1,0,1
2018,20181114BufOhi,11,2018-11-14,Buffalo,Away,Ohio,L (17-52),10,23,43.5,120,0,22,157,7.1,2,45,277,6.2,4,7,2,13,3,20,2,3,5
2018,20181123BufBow,12,2018-11-23,Buffalo,Away,Bowling Green State,W (44-14),12,22,54.5,151,1,60,336,5.6,4,82,487,5.9,4,24,2,30,4,25,0,1,1
2018,20181130BufNor,13,2018-11-30,Buffalo,Neutral,Northern Illinois,L (29-30),18,35,51.4,252,2,42,142,3.4,2,77,394,5.1,10,11,5,26,3,20,0,0,0
2018,201891CalNor,1,2018-09-01,California,Home,North Carolina,W (24-17),16,32,50.0,119,1,49,160,3.3,1,81,279,3.4,6,9,4,19,5,35,0,0,0
2018,201898CalBri,2,2018-09-08,California,Away,Brigham Young,W (21-18),23,35,65.7,214,2,38,172,4.5,1,73,386,5.3,10,10,2,22,9,65,2,1,3
2018,2018915CalIda,3,2018-09-15,California,Home,Idaho State,W (45-23),24,32,75.0,269,4,43,213,5.0,1,75,482,6.4,12,11,1,24,11,111,1,1,2
2018,2018929CalOre,4,2018-09-29,California,Home,Oregon,L (24-42),16,31,51.6,186,1,41,241,5.9,2,72,427,5.9,7,15,3,25,4,30,1,4,5
2018,2018106CalAri,5,2018-10-06,California,Away,Arizona,L (17-24),32,43,74.4,315,0,34,161,4.7,2,77,476,6.2,15,7,3,25,13,115,1,3,4
2018,20181013CalUCL,6,2018-10-13,California,Home,UCLA,L (7-37),23,42,54.8,179,0,33,131,4.0,1,75,310,4.1,9,10,1,20,3,36,3,2,5
2018,20181020CalOre,7,2018-10-20,California,Away,Oregon State,W (49-7),17,26,65.4,234,3,43,305,7.1,3,69,539,7.8,9,17,1,27,4,50,1,0,1
2018,20181027CalWas,8,2018-10-27,California,Home,Washington,W (12-10),17,24,70.8,151,0,36,91,2.5,0,60,242,4.0,8,6,0,14,4,24,0,0,0
2018,2018113CalWas,9,2018-11-03,California,Away,Washington State,L (13-19),18,33,54.5,179,1,36,112,3.1,0,69,291,4.2,8,6,6,20,2,25,0,2,2
2018,20181110CalSou,10,2018-11-10,California,Away,Southern California,W (15-14),14,26,53.8,93,1,32,114,3.6,1,58,207,3.6,6,3,2,11,4,35,1,0,1
2018,20181124CalCol,11,2018-11-24,California,Home,Colorado,W (33-21),14,26,53.8,116,2,38,95,2.5,0,64,211,3.3,6,3,3,12,9,75,0,0,0
2018,2018121CalSta,12,2018-12-01,California,Home,Stanford,L (13-23),22,39,56.4,197,1,35,155,4.4,0,74,352,4.8,9,8,1,18,3,30,1,2,3
2018,201891CenKen,1,2018-09-01,Central Michigan,Away,Kentucky,L (20-35),17,27,63.0,137,0,39,118,3.0,1,66,255,3.9,3,7,1,11,12,106,0,0,0
2018,201898CenKan,2,2018-09-08,Central Michigan,Home,Kansas,L (7-31),18,32,56.3,177,1,28,103,3.7,0,60,280,4.7,7,5,0,12,6,52,2,4,6
2018,2018915CenNor,3,2018-09-15,Central Michigan,Away,Northern Illinois,L (16-24),18,33,54.5,158,1,46,164,3.6,1,79,322,4.1,11,10,0,21,4,31,1,1,2
2018,2018922CenMai,4,2018-09-22,Central Michigan,Home,Maine,W (17-5),7,16,43.8,82,1,41,95,2.3,1,57,177,3.1,2,5,5,12,9,83,1,1,2
2018,2018929CenMic,5,2018-09-29,Central Michigan,Away,Michigan State,L (20-31),20,35,57.1,182,2,22,63,2.9,0,57,245,4.3,8,2,3,13,7,64,0,2,2
2018,2018106CenBuf,6,2018-10-06,Central Michigan,Home,Buffalo,L (24-34),14,33,42.4,172,2,35,168,4.8,1,68,340,5.0,9,8,2,19,10,60,0,4,4
2018,20181013CenBal,7,2018-10-13,Central Michigan,Home,Ball State,L (23-24),11,23,47.8,127,1,50,261,5.2,1,73,388,5.3,5,15,3,23,11,115,0,0,0
2018,20181020CenWes,8,2018-10-20,Central Michigan,Home,Western Michigan,L (10-35),11,28,39.3,122,0,44,147,3.3,1,72,269,3.7,5,9,1,15,7,59,1,2,3
2018,20181027CenAkr,9,2018-10-27,Central Michigan,Away,Akron,L (10-17),19,39,48.7,169,0,49,131,2.7,1,88,300,3.4,9,9,0,18,7,75,1,0,1
2018,2018113CenEas,10,2018-11-03,Central Michigan,Away,Eastern Michigan,L (7-17),12,32,37.5,61,0,32,77,2.4,0,64,138,2.2,4,4,2,10,7,61,2,2,4
2018,20181110CenBow,11,2018-11-10,Central Michigan,Home,Bowling Green State,L (13-24),11,21,52.4,94,1,29,72,2.5,1,50,166,3.3,6,4,1,11,2,13,1,1,2
2018,20181123CenTol,12,2018-11-23,Central Michigan,Away,Toledo,L (13-51),18,43,41.9,133,1,32,48,1.5,0,75,181,2.4,8,6,2,16,16,132,0,1,1
2018,201891ChaFor,1,2018-09-01,Charlotte,Home,Fordham,W (34-10),13,20,65.0,267,1,47,221,4.7,2,67,488,7.3,8,11,1,20,4,45,1,0,1
2018,201898ChaApp,2,2018-09-08,Charlotte,Home,Appalachian State,L (9-45),12,25,48.0,108,0,43,95,2.2,0,68,203,3.0,4,8,3,15,9,80,1,1,2
2018,2018913ChaOld,3,2018-09-13,Charlotte,Home,Old Dominion,W (28-25),23,34,67.6,202,2,46,171,3.7,1,80,373,4.7,11,14,2,27,3,22,1,0,1
2018,2018922ChaMas,4,2018-09-22,Charlotte,Away,Massachusetts,L (31-49),23,36,63.9,283,3,41,81,2.0,1,77,364,4.7,12,7,3,22,4,32,1,0,1
2018,2018929ChaAla,5,2018-09-29,Charlotte,Away,Alabama-Birmingham,L (7-28),17,25,68.0,194,0,34,69,2.0,1,59,263,4.5,9,4,3,16,7,76,1,1,2
2018,20181013ChaWes,6,2018-10-13,Charlotte,Home,Western Kentucky,W (40-14),17,26,65.4,237,1,50,211,4.2,4,76,448,5.9,12,13,3,28,4,30,1,0,1
2018,20181020ChaMid,7,2018-10-20,Charlotte,Away,Middle Tennessee State,L (13-21),20,40,50.0,209,1,39,150,3.8,1,79,359,4.5,8,10,1,19,5,40,0,2,2
2018,20181027ChaSou,8,2018-10-27,Charlotte,Home,Southern Mississippi,W (20-17),8,14,57.1,78,0,41,146,3.6,1,55,224,4.1,5,7,1,13,5,50,0,1,1
2018,2018113ChaTen,9,2018-11-03,Charlotte,Away,Tennessee,L (3-14),13,25,52.0,152,0,37,92,2.5,0,62,244,3.9,7,4,2,13,8,55,0,1,1
2018,20181110ChaMar,10,2018-11-10,Charlotte,Away,Marshall,L (13-30),10,20,50.0,72,0,41,113,2.8,1,61,185,3.0,3,10,0,13,3,15,0,0,0
2018,20181117ChaFlo,11,2018-11-17,Charlotte,Home,Florida International,L (35-42),16,22,72.7,253,1,57,281,4.9,4,79,534,6.8,9,16,3,28,7,65,1,1,2
2018,20181124ChaFlo,12,2018-11-24,Charlotte,Away,Florida Atlantic,W (27-24),10,16,62.5,111,1,49,322,6.6,2,65,433,6.7,7,13,0,23,5,55,0,1,1
2018,20181117ChaSou,1,2018-11-17,Chattanooga,Away,South Carolina,L (9-49),18,37,48.6,256,1,24,78,3.3,0,61,334,5.5,9,4,4,17,6,49,1,1,2
2018,201891CinUCL,1,2018-09-01,Cincinnati,Away,UCLA,W (26-17),14,26,53.8,110,0,51,194,3.8,3,77,304,3.9,7,11,0,18,7,45,1,0,1
2018,201898CinMia,2,2018-09-08,Cincinnati,Away,Miami (OH),W (21-0),6,11,54.5,45,1,51,188,3.7,2,62,233,3.8,3,9,1,13,8,86,0,0,0
2018,2018915CinAla,3,2018-09-15,Cincinnati,Home,Alabama A&M,W (63-7),21,26,80.8,332,3,55,409,7.4,5,81,741,9.1,12,26,0,38,7,75,0,1,1
2018,2018922CinOhi,4,2018-09-22,Cincinnati,Home,Ohio,W (34-30),19,31,61.3,274,2,34,150,4.4,3,65,424,6.5,12,10,2,24,14,150,0,1,1
2018,2018929CinCon,5,2018-09-29,Cincinnati,Away,Connecticut,W (49-7),23,29,79.3,339,2,53,320,6.0,5,82,659,8.0,18,13,0,31,11,113,1,0,1
2018,2018106CinTul,6,2018-10-06,Cincinnati,Home,Tulane,W (37-21),15,25,60.0,174,2,48,272,5.7,3,73,446,6.1,8,10,4,22,7,65,2,1,3
2018,20181020CinTem,7,2018-10-20,Cincinnati,Away,Temple,L (17-24),14,34,41.2,111,0,47,200,4.3,2,81,311,3.8,8,11,1,20,7,65,2,1,3
2018,20181027CinSou,8,2018-10-27,Cincinnati,Away,Southern Methodist,W (26-20),33,50,66.0,352,2,39,125,3.2,0,89,477,5.4,15,9,1,25,6,51,1,2,3
2018,2018113CinNav,9,2018-11-03,Cincinnati,Home,Navy,W (42-0),14,20,70.0,189,2,41,262,6.4,4,61,451,7.4,8,14,0,22,4,30,0,0,0
2018,20181110CinSou,10,2018-11-10,Cincinnati,Home,South Florida,W (35-23),17,24,70.8,194,2,52,238,4.6,3,76,432,5.7,8,14,2,24,5,22,2,0,2
2018,20181117CinCen,11,2018-11-17,Cincinnati,Away,Central Florida,L (13-38),11,26,42.3,127,0,55,252,4.6,1,81,379,4.7,6,13,1,20,9,70,3,0,3
2018,20181123CinEas,12,2018-11-23,Cincinnati,Home,East Carolina,W (56-6),25,40,62.5,394,5,38,247,6.5,2,78,641,8.2,16,8,1,25,9,90,1,0,1
2018,20181117CitAla,1,2018-11-17,Citadel,Away,Alabama,L (17-50),0,2,0.0,0,0,60,275,4.6,2,62,275,4.4,0,11,2,13,6,50,1,0,1
2018,201891CleFur,1,2018-09-01,Clemson,Home,Furman,W (48-7),22,35,62.9,277,4,34,266,7.8,2,69,543,7.9,15,8,0,23,0,0,0,0,0
2018,201898CleTex,2,2018-09-08,Clemson,Away,Texas A&M,W (28-26),17,27,63.0,298,2,32,115,3.6,2,59,413,7.0,7,6,1,14,4,49,0,0,0
2018,2018915CleGeo,3,2018-09-15,Clemson,Home,Georgia Southern,W (38-7),21,31,67.7,286,1,46,309,6.7,4,77,595,7.7,14,13,0,27,7,65,1,2,3
2018,2018922CleGeo,4,2018-09-22,Clemson,Away,Georgia Tech,W (49-21),19,30,63.3,232,4,36,248,6.9,2,66,480,7.3,10,14,1,25,6,68,0,2,2
2018,2018929CleSyr,5,2018-09-29,Clemson,Home,Syracuse,W (27-23),17,29,58.6,176,0,53,293,5.5,3,82,469,5.7,8,19,1,28,3,16,2,1,3
2018,2018106CleWak,6,2018-10-06,Clemson,Away,Wake Forest,W (63-3),25,30,83.3,227,3,40,471,11.8,6,70,698,10.0,8,12,2,22,3,28,1,0,1
2018,20181020CleNor,7,2018-10-20,Clemson,Home,North Carolina State,W (41-7),32,48,66.7,380,1,32,91,2.8,4,80,471,5.9,19,4,1,24,8,67,1,0,1
2018,20181027CleFlo,8,2018-10-27,Clemson,Away,Florida State,W (59-10),24,44,54.5,404,5,33,120,3.6,3,77,524,6.8,16,6,3,25,5,50,0,1,1
2018,2018113CleLou,9,2018-11-03,Clemson,Home,Louisville,W (77-16),14,20,70.0,169,5,37,492,13.3,5,57,661,11.6,8,17,2,28,3,15,1,1,2
2018,20181110CleBos,10,2018-11-10,Clemson,Away,Boston College,W (27-7),29,41,70.7,295,1,30,129,4.3,1,71,424,6.0,13,5,1,19,2,15,1,1,2
2018,20181117CleDuk,11,2018-11-17,Clemson,Home,Duke,W (35-6),21,39,53.8,251,2,36,208,5.8,3,75,459,6.1,12,12,1,25,7,54,0,0,0
2018,20181124CleSou,12,2018-11-24,Clemson,Home,South Carolina,W (56-35),27,37,73.0,393,1,55,351,6.4,7,92,744,8.1,19,17,2,38,8,79,1,0,1
2018,2018121ClePit,13,2018-12-01,Clemson,Neutral,Pittsburgh,W (42-10),12,24,50.0,118,2,35,301,8.6,4,59,419,7.1,4,9,0,13,6,41,0,0,0
2018,201891CoaSou,1,2018-09-01,Coastal Carolina,Away,South Carolina,L (15-49),13,18,72.2,112,1,38,131,3.4,0,56,243,4.3,5,10,5,20,4,36,1,0,1
2018,201898CoaAla,2,2018-09-08,Coastal Carolina,Home,Alabama-Birmingham,W (47-24),11,18,61.1,167,2,43,296,6.9,5,61,463,7.6,7,13,5,25,5,55,0,0,0
2018,2018912CoaCam,3,2018-09-12,Coastal Carolina,Away,Campbell,W (58-21),13,17,76.5,241,4,44,333,7.6,4,61,574,9.4,9,18,5,32,2,20,0,1,1
2018,2018922CoaLou,4,2018-09-22,Coastal Carolina,Away,Louisiana,W (30-28),12,17,70.6,186,2,56,311,5.6,2,73,497,6.8,9,14,2,25,7,70,1,0,1
2018,2018929CoaTro,5,2018-09-29,Coastal Carolina,Away,Troy,L (21-45),18,22,81.8,172,1,54,145,2.7,2,76,317,4.2,9,11,1,21,4,43,1,1,2
2018,20181013CoaLou,6,2018-10-13,Coastal Carolina,Home,Louisiana-Monroe,L (20-45),12,23,52.2,167,0,52,272,5.2,2,75,439,5.9,6,13,1,20,8,71,2,1,3
2018,20181020CoaMas,7,2018-10-20,Coastal Carolina,Away,Massachusetts,W (24-13),9,18,50.0,219,2,52,279,5.4,1,70,498,7.1,7,14,1,22,3,20,1,1,2
2018,20181027CoaGeo,8,2018-10-27,Coastal Carolina,Away,Georgia State,W (37-34),13,18,72.2,225,1,48,251,5.2,3,66,476,7.2,10,9,2,21,2,25,1,0,1
2018,2018113CoaApp,9,2018-11-03,Coastal Carolina,Home,Appalachian State,L (7-23),14,26,53.8,106,0,26,72,2.8,0,52,178,3.4,6,5,0,11,4,27,0,1,1
2018,20181110CoaArk,10,2018-11-10,Coastal Carolina,Home,Arkansas State,L (16-44),16,31,51.6,165,2,37,128,3.5,0,68,293,4.3,9,8,1,18,9,86,1,1,2
2018,20181117CoaGeo,11,2018-11-17,Coastal Carolina,Home,Georgia Southern,L (17-41),12,24,50.0,115,2,34,74,2.2,0,58,189,3.3,7,4,0,11,0,0,1,0,1
2018,20181123CoaSou,12,2018-11-23,Coastal Carolina,Away,South Alabama,L (28-31),21,33,63.6,293,2,30,92,3.1,2,63,385,6.1,12,8,2,22,4,40,2,1,3
2018,20181117ColArm,1,2018-11-17,Colgate,Away,Army,L (14-28),11,16,68.8,63,0,28,188,6.7,1,44,251,5.7,3,9,1,13,7,55,1,0,1
2018,2018831ColCol,1,2018-08-31,Colorado,Neutral,Colorado State,W (45-13),22,25,88.0,338,4,40,258,6.5,2,65,596,9.2,11,12,0,23,6,44,1,1,2
2018,201898ColNeb,2,2018-09-08,Colorado,Away,Nebraska,W (33-28),33,50,66.0,351,3,35,44,1.3,1,85,395,4.6,16,7,3,26,8,46,0,0,0
2018,2018915ColNew,3,2018-09-15,Colorado,Home,New Hampshire,W (45-14),17,24,70.8,180,1,51,311,6.1,4,75,491,6.5,9,12,0,21,6,60,0,2,2
2018,2018928ColUCL,4,2018-09-28,Colorado,Home,UCLA,W (38-16),23,27,85.2,268,1,48,209,4.4,4,75,477,6.4,12,11,3,26,6,60,0,0,0
2018,2018106ColAri,5,2018-10-06,Colorado,Home,Arizona State,W (28-21),24,33,72.7,328,2,45,166,3.7,2,78,494,6.3,12,12,1,25,6,60,0,0,0
2018,20181013ColSou,6,2018-10-13,Colorado,Away,Southern California,L (20-31),26,47,55.3,170,0,37,95,2.6,3,84,265,3.2,7,6,4,17,8,81,0,1,1
2018,20181020ColWas,7,2018-10-20,Colorado,Away,Washington,L (13-27),17,28,60.7,144,1,35,119,3.4,0,63,263,4.2,8,6,1,15,4,48,0,1,1
2018,20181027ColOre,8,2018-10-27,Colorado,Home,Oregon State,L (34-41),24,39,61.5,319,2,36,217,6.0,1,75,536,7.1,13,8,2,23,7,70,0,0,0
2018,2018112ColAri,9,2018-11-02,Colorado,Away,Arizona,L (34-42),27,43,62.8,343,3,32,40,1.3,1,75,383,5.1,18,3,6,27,5,52,1,1,2
2018,20181110ColWas,10,2018-11-10,Colorado,Home,Washington State,L (7-31),21,38,55.3,222,0,16,75,4.7,1,54,297,5.5,10,2,0,12,4,51,2,1,3
2018,20181117ColUta,11,2018-11-17,Colorado,Home,Utah,L (7-30),21,33,63.6,162,0,34,34,1.0,1,67,196,2.9,8,3,3,14,4,38,1,2,3
2018,20181124ColCal,12,2018-11-24,Colorado,Away,California,L (21-33),16,33,48.5,170,2,43,148,3.4,1,76,318,4.2,9,9,1,19,7,54,2,3,5
2018,2018825ColHaw,1,2018-08-25,Colorado State,Home,Hawaii,L (34-43),34,50,68.0,537,5,25,116,4.6,0,75,653,8.7,22,5,2,29,12,120,0,1,1
2018,2018831ColCol,2,2018-08-31,Colorado State,Neutral,Colorado,L (13-45),19,37,51.4,181,1,39,103,2.6,0,76,284,3.7,10,8,2,20,5,35,0,1,1
2018,201898ColArk,3,2018-09-08,Colorado State,Home,Arkansas,W (34-27),32,50,64.0,389,2,23,40,1.7,1,73,429,5.9,14,5,2,21,6,54,1,1,2
2018,2018915ColFlo,4,2018-09-15,Colorado State,Away,Florida,L (10-48),23,41,56.1,240,1,41,73,1.8,0,82,313,3.8,11,8,3,22,6,33,3,0,3
2018,2018922ColIll,5,2018-09-22,Colorado State,Home,Illinois State,L (19-35),24,44,54.5,257,3,31,134,4.3,0,75,391,5.2,12,10,3,25,9,79,0,2,2
2018,2018106ColSan,6,2018-10-06,Colorado State,Away,San Jose State,W (42-30),15,29,51.7,172,4,45,219,4.9,1,74,391,5.3,8,11,2,21,8,61,0,2,2
2018,20181013ColNew,7,2018-10-13,Colorado State,Home,New Mexico,W (20-18),24,42,57.1,311,1,41,112,2.7,1,83,423,5.1,12,10,2,24,10,65,0,0,0
2018,20181019ColBoi,8,2018-10-19,Colorado State,Away,Boise State,L (28-56),31,44,70.5,373,3,25,116,4.6,1,69,489,7.1,16,9,2,27,7,60,1,2,3
2018,20181026ColWyo,9,2018-10-26,Colorado State,Home,Wyoming,L (21-34),34,54,63.0,333,0,20,20,1.0,3,74,353,4.8,19,3,1,23,3,26,1,2,3
2018,20181110ColNev,10,2018-11-10,Colorado State,Away,Nevada,L (10-49),23,40,57.5,186,1,33,74,2.2,0,73,260,3.6,9,3,1,13,9,73,0,1,1
2018,20181117ColUta,11,2018-11-17,Colorado State,Home,Utah State,L (24-29),25,38,65.8,307,2,44,199,4.5,1,82,506,6.2,17,8,4,29,11,108,0,2,2
2018,20181122ColAir,12,2018-11-22,Colorado State,Away,Air Force,L (19-27),19,32,59.4,373,3,24,64,2.7,0,56,437,7.8,15,4,1,20,8,75,0,2,2
2018,2018830ConCen,1,2018-08-30,Connecticut,Home,Central Florida,L (17-56),27,41,65.9,266,1,46,220,4.8,1,87,486,5.6,9,16,2,27,7,93,2,1,3
2018,201898ConBoi,2,2018-09-08,Connecticut,Away,Boise State,L (7-62),11,21,52.4,71,1,25,122,4.9,0,46,193,4.2,3,6,0,9,7,44,0,1,1
2018,2018915ConRho,3,2018-09-15,Connecticut,Home,Rhode Island,W (56-49),20,27,74.1,308,4,54,265,4.9,4,81,573,7.1,16,11,5,32,4,35,2,1,3
2018,2018922ConSyr,4,2018-09-22,Connecticut,Away,Syracuse,L (21-51),19,29,65.5,217,2,39,178,4.6,1,68,395,5.8,7,7,2,16,5,42,2,1,3
2018,2018929ConCin,5,2018-09-29,Connecticut,Home,Cincinnati,L (7-49),14,35,40.0,181,1,29,77,2.7,0,64,258,4.0,7,5,7,19,2,15,0,1,1
2018,2018106ConMem,6,2018-10-06,Connecticut,Away,Memphis,L (14-55),24,43,55.8,215,1,30,112,3.7,1,73,327,4.5,14,4,1,19,3,25,1,3,4
2018,20181020ConSou,7,2018-10-20,Connecticut,Away,South Florida,L (30-38),10,21,47.6,133,0,51,322,6.3,4,72,455,6.3,5,17,2,24,4,25,0,1,1
2018,20181027ConMas,8,2018-10-27,Connecticut,Home,Massachusetts,L (17-22),4,6,66.7,15,0,44,250,5.7,2,50,265,5.3,0,11,0,11,2,25,0,1,1
2018,2018113ConTul,9,2018-11-03,Connecticut,Away,Tulsa,L (19-49),14,28,50.0,232,2,50,255,5.1,0,78,487,6.2,8,13,2,23,5,45,2,1,3
2018,20181110ConSou,10,2018-11-10,Connecticut,Home,Southern Methodist,L (50-62),25,40,62.5,215,4,49,365,7.4,3,89,580,6.5,12,17,5,34,9,77,0,1,1
2018,20181117ConEas,11,2018-11-17,Connecticut,Away,East Carolina,L (21-55),17,33,51.5,183,3,29,91,3.1,0,62,274,4.4,11,4,1,16,5,30,1,2,3
2018,20181124ConTem,12,2018-11-24,Connecticut,Home,Temple,L (7-57),14,26,53.8,100,1,53,138,2.6,0,79,238,3.0,6,12,2,20,1,15,1,3,4
2018,2018121DraIow,1,2018-12-01,Drake,Away,Iowa State,L (24-27),20,29,69.0,221,3,30,58,1.9,0,59,279,4.7,9,5,0,14,5,50,0,1,1
2018,2018831DukArm,1,2018-08-31,Duke,Home,Army,W (34-14),13,17,76.5,197,1,35,184,5.3,3,52,381,7.3,8,9,2,19,4,30,1,0,1
2018,201898DukNor,2,2018-09-08,Duke,Away,Northwestern,W (21-7),18,24,75.0,204,3,39,97,2.5,0,63,301,4.8,8,6,1,15,4,42,0,0,0
2018,2018915DukBay,3,2018-09-15,Duke,Away,Baylor,W (40-27),12,30,40.0,174,3,44,225,5.1,1,74,399,5.4,7,12,1,20,0,0,0,0,0
2018,2018922DukNor,4,2018-09-22,Duke,Home,North Carolina Central,W (55-13),20,39,51.3,256,4,59,372,6.3,4,98,628,6.4,11,19,2,32,8,75,1,0,1
2018,2018929DukVir,5,2018-09-29,Duke,Home,Virginia Tech,L (14-31),25,39,64.1,256,1,36,71,2.0,1,75,327,4.4,12,6,0,18,3,15,0,1,1
2018,20181013DukGeo,6,2018-10-13,Duke,Away,Georgia Tech,W (28-14),17,27,63.0,206,3,33,98,3.0,1,60,304,5.1,9,10,0,19,3,15,2,1,3
2018,20181020DukVir,7,2018-10-20,Duke,Home,Virginia,L (14-28),23,42,54.8,262,2,27,58,2.1,0,69,320,4.6,13,5,1,19,6,67,0,2,2
2018,20181027DukPit,8,2018-10-27,Duke,Away,Pittsburgh,L (45-54),27,43,62.8,396,4,34,223,6.6,2,77,619,8.0,19,8,1,28,4,36,1,0,1
2018,2018113DukMia,9,2018-11-03,Duke,Away,Miami (FL),W (20-12),19,37,51.4,144,1,30,146,4.9,1,67,290,4.3,6,5,2,13,3,25,0,1,1
2018,20181110DukNor,10,2018-11-10,Duke,Home,North Carolina,W (42-35),31,54,57.4,361,3,35,268,7.7,3,89,629,7.1,15,10,4,29,6,40,2,1,3
2018,20181117DukCle,11,2018-11-17,Duke,Away,Clemson,L (6-35),24,44,54.5,158,0,35,104,3.0,0,79,262,3.3,5,10,2,17,6,52,0,0,0
2018,20181124DukWak,12,2018-11-24,Duke,Home,Wake Forest,L (7-59),17,36,47.2,145,1,34,106,3.1,0,70,251,3.6,9,6,1,16,3,25,3,1,4
2018,2018825DuqMas,1,2018-08-25,Duquesne,Away,Massachusetts,L (15-63),16,30,53.3,123,1,36,130,3.6,1,66,253,3.8,6,5,2,13,3,22,1,3,4
2018,2018922DuqHaw,2,2018-09-22,Duquesne,Away,Hawaii,L (21-42),14,26,53.8,142,3,27,24,0.9,0,53,166,3.1,7,1,3,11,8,83,0,1,1
2018,201892EasNor,1,2018-09-02,East Carolina,Home,North Carolina A&T,L (23-28),38,66,57.6,314,2,29,68,2.3,0,95,382,4.0,16,6,6,28,5,45,1,2,3
2018,201898EasNor,2,2018-09-08,East Carolina,Home,North Carolina,W (41-19),19,33,57.6,290,1,49,220,4.5,4,82,510,6.2,15,9,2,26,4,40,0,0,0
2018,2018922EasSou,3,2018-09-22,East Carolina,Away,South Florida,L (13-20),22,50,44.0,256,0,46,156,3.4,1,96,412,4.3,11,10,3,24,2,10,0,1,1
2018,2018929EasOld,4,2018-09-29,East Carolina,Home,Old Dominion,W (37-35),25,45,55.6,313,3,38,179,4.7,2,83,492,5.9,17,6,2,25,8,86,0,2,2
2018,2018106EasTem,5,2018-10-06,East Carolina,Away,Temple,L (6-49),18,39,46.2,120,0,28,76,2.7,0,67,196,2.9,4,5,3,12,2,25,0,0,0
2018,20181013EasHou,6,2018-10-13,East Carolina,Home,Houston,L (20-42),38,63,60.3,374,1,31,41,1.3,1,94,415,4.4,20,4,3,27,8,69,1,3,4
2018,20181020EasCen,7,2018-10-20,East Carolina,Home,Central Florida,L (10-37),29,56,51.8,406,1,38,90,2.4,0,94,496,5.3,18,9,2,29,8,60,4,1,5
2018,2018113EasMem,8,2018-11-03,East Carolina,Home,Memphis,L (41-59),34,62,54.8,449,3,29,107,3.7,2,91,556,6.1,18,8,3,29,4,45,1,0,1
2018,20181110EasTul,9,2018-11-10,East Carolina,Away,Tulane,L (18-24),21,68,30.9,360,2,26,90,3.5,0,94,450,4.8,13,6,4,23,7,69,0,1,1
2018,20181117EasCon,10,2018-11-17,East Carolina,Home,Connecticut,W (55-21),22,33,66.7,242,4,54,415,7.7,3,87,657,7.6,9,23,2,34,5,48,0,0,0
2018,20181123EasCin,11,2018-11-23,East Carolina,Away,Cincinnati,L (6-56),10,28,35.7,220,1,33,83,2.5,0,61,303,5.0,7,3,2,12,3,30,2,3,5
2018,2018121EasNor,12,2018-12-01,East Carolina,Away,North Carolina State,L (3-58),9,25,36.0,73,0,26,31,1.2,0,51,104,2.0,2,2,0,4,2,20,1,2,3
2018,201898EasTen,1,2018-09-08,East Tennessee State,Away,Tennessee,L (3-59),12,29,41.4,69,0,29,125,4.3,0,58,194,3.3,4,5,0,9,6,39,1,2,3
2018,2018831EasMon,1,2018-08-31,Eastern Michigan,Home,Monmouth,W (51-17),22,27,81.5,302,5,39,171,4.4,2,66,473,7.2,15,9,3,27,7,65,0,0,0
2018,201898EasPur,2,2018-09-08,Eastern Michigan,Away,Purdue,W (20-19),22,34,64.7,347,1,31,69,2.2,1,65,416,6.4,13,3,3,19,10,71,0,1,1
2018,2018915EasBuf,3,2018-09-15,Eastern Michigan,Away,Buffalo,L (28-35),25,38,65.8,348,2,43,142,3.3,2,81,490,6.0,12,8,2,22,11,98,1,0,1
2018,2018922EasSan,4,2018-09-22,Eastern Michigan,Away,San Diego State,L (20-23),17,27,63.0,236,1,39,119,3.1,1,66,355,5.4,7,6,1,14,6,45,1,1,2
2018,2018929EasNor,5,2018-09-29,Eastern Michigan,Home,Northern Illinois,L (23-26),17,41,41.5,180,1,33,62,1.9,1,74,242,3.3,9,5,2,16,11,85,1,0,1
2018,2018106EasWes,6,2018-10-06,Eastern Michigan,Away,Western Michigan,L (24-27),18,31,58.1,206,2,48,178,3.7,1,79,384,4.9,11,10,2,23,4,31,1,0,1
2018,20181013EasTol,7,2018-10-13,Eastern Michigan,Home,Toledo,W (28-26),17,23,73.9,183,0,38,229,6.0,4,61,412,6.8,8,10,0,18,11,138,0,0,0
2018,20181020EasBal,8,2018-10-20,Eastern Michigan,Away,Ball State,W (42-20),22,28,78.6,257,3,49,163,3.3,3,77,420,5.5,11,10,2,23,5,65,1,0,1
2018,20181027EasArm,9,2018-10-27,Eastern Michigan,Home,Army,L (22-37),19,29,65.5,201,2,11,34,3.1,1,40,235,5.9,7,1,2,10,8,75,1,0,1
2018,2018113EasCen,10,2018-11-03,Eastern Michigan,Home,Central Michigan,W (17-7),21,33,63.6,212,1,43,137,3.2,1,76,349,4.6,10,7,1,18,8,81,2,1,3
2018,20181110EasAkr,11,2018-11-10,Eastern Michigan,Home,Akron,W (27-7),16,24,66.7,132,0,50,261,5.2,2,74,393,5.3,7,12,1,20,7,65,1,0,1
2018,20181123EasKen,12,2018-11-23,Eastern Michigan,Away,Kent State,W (28-20),13,26,50.0,139,0,44,237,5.4,4,70,376,5.4,5,8,1,14,3,45,1,1,2
2018,201891FloCha,1,2018-09-01,Florida,Home,Charleston Southern,W (53-6),19,27,70.4,241,5,39,203,5.2,1,66,444,6.7,12,12,1,25,3,20,0,0,0
2018,201898FloKen,2,2018-09-08,Florida,Home,Kentucky,L (16-27),17,38,44.7,232,2,29,128,4.4,0,67,360,5.4,14,5,5,24,6,55,1,1,2
2018,2018915FloCol,3,2018-09-15,Florida,Home,Colorado State,W (48-10),8,15,53.3,119,2,29,222,7.7,2,44,341,7.8,3,10,1,14,8,75,0,1,1
2018,2018922FloTen,4,2018-09-22,Florida,Away,Tennessee,W (47-21),10,19,52.6,186,3,34,201,5.9,3,53,387,7.3,6,7,1,14,10,79,1,0,1
2018,2018929FloMis,5,2018-09-29,Florida,Away,Mississippi State,W (13-6),23,32,71.9,239,1,34,118,3.5,0,66,357,5.4,13,7,0,20,11,90,0,1,1
2018,2018106FloLou,6,2018-10-06,Florida,Home,Louisiana State,W (27-19),13,28,46.4,176,1,43,215,5.0,2,71,391,5.5,6,11,2,19,11,115,0,1,1
2018,20181013FloVan,7,2018-10-13,Florida,Away,Vanderbilt,W (37-27),19,29,65.5,284,2,63,292,4.6,2,92,576,6.3,13,18,0,31,7,89,2,1,3
2018,20181027FloGeo,8,2018-10-27,Florida,Neutral,Georgia,L (17-36),13,21,61.9,105,1,37,170,4.6,1,58,275,4.7,5,9,2,16,7,27,2,1,3
2018,2018113FloMis,9,2018-11-03,Florida,Home,Missouri,L (17-38),19,40,47.5,210,1,28,113,4.0,1,68,323,4.8,8,7,2,17,8,66,0,0,0
2018,20181110FloSou,10,2018-11-10,Florida,Home,South Carolina,W (35-31),15,21,71.4,161,1,62,367,5.9,4,83,528,6.4,11,22,0,33,7,55,1,0,1
2018,20181117FloIda,11,2018-11-17,Florida,Home,Idaho,W (63-10),31,43,72.1,399,5,35,204,5.8,2,78,603,7.7,16,15,1,32,5,55,1,0,1
2018,20181124FloFlo,12,2018-11-24,Florida,Away,Florida State,W (41-14),16,27,59.3,254,3,52,282,5.4,2,79,536,6.8,11,11,2,24,7,49,0,0,0
2018,201898FloTro,1,2018-09-08,Florida A&M,Away,Troy,L (7-59),17,31,54.8,219,0,32,68,2.1,1,63,287,4.6,6,6,1,13,8,65,2,2,4
2018,201891FloOkl,1,2018-09-01,Florida Atlantic,Away,Oklahoma,L (14-63),18,32,56.3,192,0,42,132,3.1,2,74,324,4.4,11,7,2,20,6,48,0,1,1
2018,201898FloAir,2,2018-09-08,Florida Atlantic,Home,Air Force,W (33-27),33,40,82.5,471,3,29,54,1.9,1,69,525,7.6,21,3,1,25,8,87,1,0,1
2018,2018915FloBet,3,2018-09-15,Florida Atlantic,Home,Bethune-Cookman,W (49-28),19,30,63.3,183,1,61,376,6.2,6,91,559,6.1,7,20,0,27,6,69,0,2,2
2018,2018921FloCen,4,2018-09-21,Florida Atlantic,Away,Central Florida,L (36-56),14,27,51.9,127,1,50,320,6.4,4,77,447,5.8,5,18,2,25,7,73,0,3,3
2018,2018929FloMid,5,2018-09-29,Florida Atlantic,Away,Middle Tennessee State,L (24-25),17,28,60.7,154,0,55,272,4.9,3,83,426,5.1,8,12,2,22,8,54,1,1,2
2018,2018106FloOld,6,2018-10-06,Florida Atlantic,Home,Old Dominion,W (52-33),21,32,65.6,339,2,40,266,6.7,5,72,605,8.4,15,13,0,28,8,84,0,0,0
2018,20181020FloMar,7,2018-10-20,Florida Atlantic,Away,Marshall,L (7-31),20,42,47.6,240,1,37,119,3.2,0,79,359,4.5,9,6,1,16,8,69,1,4,5
2018,20181026FloLou,8,2018-10-26,Florida Atlantic,Home,Louisiana Tech,L (13-21),17,29,58.6,121,0,38,227,6.0,1,67,348,5.2,6,14,3,23,11,77,1,1,2
2018,2018113FloFlo,9,2018-11-03,Florida Atlantic,Away,Florida International,W (49-14),10,16,62.5,157,2,60,439,7.3,5,76,596,7.8,5,23,3,30,5,55,0,0,0
2018,20181110FloWes,10,2018-11-10,Florida Atlantic,Home,Western Kentucky,W (34-15),20,25,80.0,261,0,58,315,5.4,4,83,576,6.9,10,18,0,28,6,70,1,1,2
2018,20181115FloNor,11,2018-11-15,Florida Atlantic,Away,North Texas,L (38-41),21,35,60.0,294,2,47,195,4.1,3,82,489,6.0,9,10,1,20,5,58,0,2,2
2018,20181124FloUNC,12,2018-11-24,Florida Atlantic,Home,UNC Charlotte,L (24-27),16,28,57.1,305,2,49,187,3.8,1,77,492,6.4,9,12,2,23,1,10,1,0,1
2018,201891FloInd,1,2018-09-01,Florida International,Home,Indiana,L (28-38),17,28,60.7,157,1,39,170,4.4,3,67,327,4.9,8,9,5,22,7,70,2,1,3
2018,201898FloOld,2,2018-09-08,Florida International,Away,Old Dominion,W (28-20),19,31,61.3,300,3,51,189,3.7,1,82,489,6.0,14,10,1,25,5,35,0,1,1
2018,2018915FloMas,3,2018-09-15,Florida International,Home,Massachusetts,W (63-24),16,23,69.6,207,2,53,329,6.2,5,76,536,7.1,8,22,2,32,2,30,1,1,2
2018,2018922FloMia,4,2018-09-22,Florida International,Away,Miami (FL),L (17-31),13,28,46.4,170,2,24,17,0.7,0,52,187,3.6,5,1,1,7,3,23,0,1,1
2018,2018929FloArk,5,2018-09-29,Florida International,Home,Arkansas-Pine Bluff,W (55-9),13,19,68.4,393,4,28,222,7.9,3,47,615,13.1,11,7,0,18,5,52,0,0,0
2018,20181013FloMid,6,2018-10-13,Florida International,Home,Middle Tennessee State,W (24-21),27,36,75.0,311,2,34,70,2.1,0,70,381,5.4,11,6,4,21,7,49,0,0,0
2018,20181020FloRic,7,2018-10-20,Florida International,Home,Rice,W (36-17),20,29,69.0,229,2,38,217,5.7,2,67,446,6.7,15,8,0,23,3,15,0,0,0
2018,20181027FloWes,8,2018-10-27,Florida International,Away,Western Kentucky,W (38-17),19,28,67.9,171,3,38,197,5.2,2,66,368,5.6,6,8,3,17,6,65,0,0,0
2018,2018113FloFlo,9,2018-11-03,Florida International,Home,Florida Atlantic,L (14-49),19,34,55.9,234,2,33,96,2.9,0,67,330,4.9,13,5,1,19,2,21,1,2,3
2018,20181110FloTex,10,2018-11-10,Florida International,Away,Texas-San Antonio,W (45-7),20,30,66.7,304,3,40,151,3.8,2,70,455,6.5,12,9,0,21,8,95,0,0,0
2018,20181117FloUNC,11,2018-11-17,Florida International,Away,UNC Charlotte,W (42-35),25,32,78.1,294,2,23,196,8.5,2,55,490,8.9,15,5,1,21,6,47,0,0,0
2018,20181124FloMar,12,2018-11-24,Florida International,Home,Marshall,L (25-28),25,38,65.8,201,0,37,190,5.1,3,75,391,5.2,12,8,5,25,3,17,0,2,2
2018,201893FloVir,1,2018-09-03,Florida State,Home,Virginia Tech,L (3-24),22,35,62.9,233,0,28,94,3.4,0,63,327,5.2,8,3,1,12,7,36,2,3,5
2018,201898FloSam,2,2018-09-08,Florida State,Home,Samford,W (36-26),31,46,67.4,320,3,35,134,3.8,1,81,454,5.6,16,6,3,25,9,69,1,0,1
2018,2018915FloSyr,3,2018-09-15,Florida State,Away,Syracuse,L (7-30),18,37,48.6,178,0,23,62,2.7,1,60,240,4.0,7,3,1,11,11,90,0,1,1
2018,2018922FloNor,4,2018-09-22,Florida State,Home,Northern Illinois,W (37-19),23,32,71.9,352,2,57,121,2.1,2,89,473,5.3,13,10,0,23,9,60,3,1,4
2018,2018929FloLou,5,2018-09-29,Florida State,Away,Louisville,W (28-24),16,27,59.3,294,4,31,76,2.5,0,58,370,6.4,10,5,1,16,7,55,1,0,1
2018,2018106FloMia,6,2018-10-06,Florida State,Away,Miami (FL),L (27-28),16,32,50.0,130,2,33,70,2.1,0,65,200,3.1,9,5,0,14,7,80,1,1,2
2018,20181020FloWak,7,2018-10-20,Florida State,Home,Wake Forest,W (38-17),28,41,68.3,341,2,28,130,4.6,3,69,471,6.8,13,4,2,19,6,55,1,0,1
2018,20181027FloCle,8,2018-10-27,Florida State,Home,Clemson,L (10-59),20,40,50.0,268,1,35,-21,-0.6,0,75,247,3.3,11,1,2,14,16,134,1,1,2
2018,2018113FloNor,9,2018-11-03,Florida State,Away,North Carolina State,L (28-47),29,48,60.4,421,4,20,24,1.2,0,68,445,6.5,13,3,1,17,16,121,1,1,2
2018,20181110FloNot,10,2018-11-10,Florida State,Away,Notre Dame,L (13-42),23,48,47.9,216,0,30,106,3.5,2,78,322,4.1,11,6,3,20,5,35,1,1,2
2018,20181117FloBos,11,2018-11-17,Florida State,Home,Boston College,W (22-21),19,39,48.7,322,1,36,156,4.3,1,75,478,6.4,11,7,1,19,7,56,0,2,2
2018,20181124FloFlo,12,2018-11-24,Florida State,Home,Florida,L (14-41),14,30,46.7,154,1,35,139,4.0,1,65,293,4.5,6,7,2,15,10,60,1,2,3
2018,201891ForUNC,1,2018-09-01,Fordham,Away,UNC Charlotte,L (10-34),22,47,46.8,296,1,16,-9,-0.6,0,63,287,4.6,11,0,1,12,6,30,0,1,1
2018,201891FreIda,1,2018-09-01,Fresno State,Home,Idaho,W (79-13),21,29,72.4,247,1,42,241,5.7,7,71,488,6.9,11,13,0,24,3,27,0,0,0
2018,201898FreMin,2,2018-09-08,Fresno State,Away,Minnesota,L (14-21),24,34,70.6,212,2,24,87,3.6,0,58,299,5.2,9,3,1,13,4,40,0,2,2
2018,2018915FreUCL,3,2018-09-15,Fresno State,Away,UCLA,W (38-14),22,33,66.7,270,1,49,156,3.2,4,82,426,5.2,12,8,4,24,8,53,2,0,2
2018,2018929FreTol,4,2018-09-29,Fresno State,Home,Toledo,W (49-27),24,32,75.0,368,4,38,186,4.9,2,70,554,7.9,16,7,1,24,3,45,0,1,1
2018,2018106FreNev,5,2018-10-06,Fresno State,Away,Nevada,W (21-3),20,28,71.4,241,2,24,30,1.3,1,52,271,5.2,9,3,0,12,4,30,1,0,1
2018,20181013FreWyo,6,2018-10-13,Fresno State,Home,Wyoming,W (27-3),22,32,68.8,287,2,33,104,3.2,2,65,391,6.0,11,6,0,17,5,45,0,0,0
2018,20181020FreNew,7,2018-10-20,Fresno State,Away,New Mexico,W (38-7),20,30,66.7,280,3,43,153,3.6,2,73,433,5.9,16,9,4,29,6,35,0,0,0
2018,20181027FreHaw,8,2018-10-27,Fresno State,Home,Hawaii,W (50-20),26,38,68.4,348,4,33,214,6.5,1,71,562,7.9,14,10,0,24,8,69,0,0,0
2018,2018113FreNev,9,2018-11-03,Fresno State,Away,Nevada-Las Vegas,W (48-3),26,35,74.3,274,2,34,192,5.6,4,69,466,6.8,16,8,1,25,5,40,0,1,1
2018,2018119FreBoi,10,2018-11-09,Fresno State,Away,Boise State,L (17-24),24,35,68.6,283,1,28,107,3.8,1,63,390,6.2,14,6,2,22,9,61,0,0,0
2018,20181117FreSan,11,2018-11-17,Fresno State,Home,San Diego State,W (23-14),17,24,70.8,267,1,43,123,2.9,2,67,390,5.8,6,9,2,17,3,40,0,0,0
2018,20181124FreSan,12,2018-11-24,Fresno State,Home,San Jose State,W (31-13),20,29,69.0,317,2,36,198,5.5,1,65,515,7.9,10,8,1,19,5,58,2,0,2
2018,2018121FreBoi,13,2018-12-01,Fresno State,Away,Boise State,W (19-16),20,32,62.5,170,1,33,118,3.6,1,65,288,4.4,8,4,2,14,6,50,2,0,2
2018,201891FurCle,1,2018-09-01,Furman,Away,Clemson,L (7-48),4,9,44.4,46,1,52,201,3.9,0,61,247,4.0,3,7,3,13,3,22,2,0,2
2018,201891GeoAus,1,2018-09-01,Georgia,Home,Austin Peay,W (45-0),21,27,77.8,224,3,33,284,8.6,3,60,508,8.5,13,8,0,21,3,40,1,0,1
2018,201898GeoSou,2,2018-09-08,Georgia,Away,South Carolina,W (41-17),16,19,84.2,202,1,52,271,5.2,3,71,473,6.7,12,15,3,30,4,47,0,1,1
2018,2018915GeoMid,3,2018-09-15,Georgia,Home,Middle Tennessee State,W (49-7),17,21,81.0,223,4,35,261,7.5,2,56,484,8.6,10,11,2,23,7,54,0,0,0
2018,2018922GeoMis,4,2018-09-22,Georgia,Away,Missouri,W (43-29),13,23,56.5,260,3,40,185,4.6,0,63,445,7.1,8,10,0,18,7,66,0,1,1
2018,2018929GeoTen,5,2018-09-29,Georgia,Home,Tennessee,W (38-12),17,24,70.8,190,0,50,251,5.0,5,74,441,6.0,10,16,0,26,6,40,0,0,0
2018,2018106GeoVan,6,2018-10-06,Georgia,Home,Vanderbilt,W (41-13),21,31,67.7,341,3,34,219,6.4,2,65,560,8.6,12,14,2,28,13,115,0,0,0
2018,20181013GeoLou,7,2018-10-13,Georgia,Away,Louisiana State,L (16-36),16,34,47.1,209,1,30,113,3.8,1,64,322,5.0,10,7,1,18,4,20,2,2,4
2018,20181027GeoFlo,8,2018-10-27,Georgia,Neutral,Florida,W (36-17),17,24,70.8,240,3,41,189,4.6,1,65,429,6.6,10,8,2,20,4,53,0,0,0
2018,2018113GeoKen,9,2018-11-03,Georgia,Away,Kentucky,W (34-17),14,20,70.0,113,1,50,331,6.6,3,70,444,6.3,6,16,3,25,4,45,2,0,2
2018,20181110GeoAub,10,2018-11-10,Georgia,Home,Auburn,W (27-10),15,23,65.2,213,2,44,309,7.0,1,67,522,7.8,8,13,3,24,12,85,0,1,1
2018,20181117GeoMas,11,2018-11-17,Georgia,Home,Massachusetts,W (66-27),14,17,82.4,275,3,45,426,9.5,6,62,701,11.3,8,20,2,30,2,20,1,0,1
2018,20181124GeoGeo,12,2018-11-24,Georgia,Home,Georgia Tech,W (45-21),15,19,78.9,162,4,42,285,6.8,2,61,447,7.3,8,17,0,25,2,10,1,0,1
2018,2018121GeoAla,13,2018-12-01,Georgia,Neutral,Alabama,L (28-35),25,40,62.5,301,3,39,153,3.9,1,79,454,5.7,14,8,1,23,6,50,0,0,0
2018,201891GeoSou,1,2018-09-01,Georgia Southern,Home,South Carolina State,W (37-6),5,7,71.4,29,0,53,319,6.0,5,60,348,5.8,1,17,1,19,2,10,0,0,0
2018,201898GeoMas,2,2018-09-08,Georgia Southern,Home,Massachusetts,W (34-13),6,9,66.7,154,2,55,341,6.2,2,64,495,7.7,5,18,1,24,3,35,1,0,1
2018,2018915GeoCle,3,2018-09-15,Georgia Southern,Away,Clemson,L (7-38),3,9,33.3,60,0,43,80,1.9,1,52,140,2.7,3,3,1,7,4,20,1,0,1
2018,2018929GeoArk,4,2018-09-29,Georgia Southern,Home,Arkansas State,W (28-21),1,3,33.3,61,1,49,348,7.1,3,52,409,7.9,1,14,0,15,8,70,0,0,0
2018,2018106GeoSou,5,2018-10-06,Georgia Southern,Home,South Alabama,W (48-13),5,8,62.5,99,1,43,295,6.9,4,51,394,7.7,3,13,2,18,9,83,0,0,0
2018,20181011GeoTex,6,2018-10-11,Georgia Southern,Away,Texas State,W (15-13),7,12,58.3,51,0,52,164,3.2,1,64,215,3.4,3,8,1,12,5,49,1,0,1
2018,20181020GeoNew,7,2018-10-20,Georgia Southern,Away,New Mexico State,W (48-31),4,4,100.0,77,0,61,389,6.4,6,65,466,7.2,3,23,1,27,4,36,0,0,0
2018,20181025GeoApp,8,2018-10-25,Georgia Southern,Home,Appalachian State,W (34-14),1,3,33.3,57,1,49,278,5.7,3,52,335,6.4,1,11,2,14,2,11,0,0,0
2018,2018113GeoLou,9,2018-11-03,Georgia Southern,Away,Louisiana-Monroe,L (25-44),8,15,53.3,78,1,46,138,3.0,0,61,216,3.5,5,10,3,17,6,52,1,0,1
2018,20181110GeoTro,10,2018-11-10,Georgia Southern,Home,Troy,L (21-35),14,23,60.9,190,2,34,101,3.0,1,57,291,5.1,6,6,1,13,4,47,0,0,0
2018,20181117GeoCoa,11,2018-11-17,Georgia Southern,Away,Coastal Carolina,W (41-17),4,6,66.7,33,0,54,409,7.6,5,60,442,7.4,2,17,0,19,2,17,1,0,1
2018,20181124GeoGeo,12,2018-11-24,Georgia Southern,Away,Georgia State,W (35-14),8,11,72.7,105,2,41,276,6.7,2,52,381,7.3,3,13,0,16,8,70,0,0,0
2018,2018830Geo,1,2018-08-30,Georgia State,Home,,W (24-20),20,28,71.4,187,3,37,130,3.5,0,65,317,4.9,12,6,3,21,3,33,1,0,1
2018,201898GeoNor,2,2018-09-08,Georgia State,Away,North Carolina State,L (7-41),19,34,55.9,242,0,31,107,3.5,1,65,349,5.4,9,7,2,18,5,48,1,0,1
2018,2018914GeoMem,3,2018-09-14,Georgia State,Away,Memphis,L (22-59),19,34,55.9,139,0,43,173,4.0,2,77,312,4.1,10,9,3,22,2,16,0,1,1
2018,2018922GeoWes,4,2018-09-22,Georgia State,Home,Western Michigan,L (15-34),19,29,65.5,285,0,30,58,1.9,2,59,343,5.8,12,6,0,18,2,25,2,1,3
2018,2018929GeoLou,5,2018-09-29,Georgia State,Home,Louisiana-Monroe,W (46-14),15,18,83.3,179,1,56,308,5.5,4,74,487,6.6,7,12,1,20,7,70,1,0,1
2018,2018104GeoTro,6,2018-10-04,Georgia State,Away,Troy,L (20-37),20,36,55.6,272,1,35,116,3.3,1,71,388,5.5,11,9,3,23,0,0,2,0,2
2018,20181018GeoArk,7,2018-10-18,Georgia State,Away,Arkansas State,L (35-51),20,33,60.6,299,4,43,123,2.9,1,76,422,5.6,9,11,4,24,8,80,2,0,2
2018,20181027GeoCoa,8,2018-10-27,Georgia State,Home,Coastal Carolina,L (34-37),14,25,56.0,231,1,34,290,8.5,4,59,521,8.8,10,11,2,23,6,74,1,0,1
2018,2018113GeoTex,9,2018-11-03,Georgia State,Home,Texas State,L (31-40),21,40,52.5,224,1,43,221,5.1,3,83,445,5.4,13,11,1,25,2,13,2,0,2
2018,20181110GeoLou,10,2018-11-10,Georgia State,Away,Louisiana,L (22-36),10,21,47.6,121,1,43,252,5.9,2,64,373,5.8,5,14,0,19,4,35,0,1,1
2018,20181117GeoApp,11,2018-11-17,Georgia State,Away,Appalachian State,L (17-45),10,21,47.6,132,1,34,197,5.8,1,55,329,6.0,5,10,0,15,6,61,0,2,2
2018,20181124GeoGeo,12,2018-11-24,Georgia State,Home,Georgia Southern,L (14-35),20,33,60.6,170,2,32,94,2.9,0,65,264,4.1,7,8,2,17,3,24,0,1,1
2018,201891GeoAlc,1,2018-09-01,Georgia Tech,Home,Alcorn State,W (41-0),9,18,50.0,104,1,54,439,8.1,4,72,543,7.5,4,20,1,25,3,30,2,1,3
2018,201898GeoSou,2,2018-09-08,Georgia Tech,Away,South Florida,L (38-49),9,18,50.0,183,1,57,419,7.4,4,75,602,8.0,6,19,2,27,8,80,1,2,3
2018,2018915GeoPit,3,2018-09-15,Georgia Tech,Away,Pittsburgh,L (19-24),6,15,40.0,66,0,56,320,5.7,3,71,386,5.4,4,16,2,22,5,35,1,1,2
2018,2018922GeoCle,4,2018-09-22,Georgia Tech,Home,Clemson,L (21-49),3,8,37.5,57,1,56,146,2.6,2,64,203,3.2,2,10,3,15,4,30,1,0,1
2018,2018929GeoBow,5,2018-09-29,Georgia Tech,Home,Bowling Green State,W (63-17),5,7,71.4,160,0,49,372,7.6,7,56,532,9.5,5,16,2,23,3,54,0,0,0
2018,2018105GeoLou,6,2018-10-05,Georgia Tech,Away,Louisville,W (66-31),1,2,50.0,12,0,65,542,8.3,8,67,554,8.3,1,27,0,28,4,50,0,0,0
2018,20181013GeoDuk,7,2018-10-13,Georgia Tech,Home,Duke,L (14-28),7,17,41.2,125,1,61,229,3.8,1,78,354,4.5,5,14,1,20,3,18,3,0,3
2018,20181025GeoVir,8,2018-10-25,Georgia Tech,Away,Virginia Tech,W (49-28),0,1,0.0,0,0,78,465,6.0,7,79,465,5.9,0,31,4,35,6,50,0,0,0
2018,2018113GeoNor,9,2018-11-03,Georgia Tech,Away,North Carolina,W (38-28),2,2,100.0,104,1,74,461,6.2,4,76,565,7.4,2,24,1,27,3,20,3,0,3
2018,20181110GeoMia,10,2018-11-10,Georgia Tech,Home,Miami (FL),W (27-21),3,4,75.0,73,1,53,231,4.4,2,57,304,5.3,3,12,0,15,3,35,1,0,1
2018,20181117GeoVir,11,2018-11-17,Georgia Tech,Home,Virginia,W (30-27),1,8,12.5,37,0,52,268,5.2,1,60,305,5.1,1,11,1,13,3,25,0,0,0
2018,20181124GeoGeo,12,2018-11-24,Georgia Tech,Away,Georgia,L (21-45),5,14,35.7,91,1,46,128,2.8,1,60,219,3.7,4,8,0,12,2,20,0,0,0
2018,201891GraLou,1,2018-09-01,Grambling State,Away,Louisiana,L (17-49),16,29,55.2,159,0,36,147,4.1,2,65,306,4.7,9,5,1,15,9,86,0,0,0
2018,2018825HawCol,1,2018-08-25,Hawaii,Away,Colorado State,W (43-34),26,37,70.3,418,3,36,199,5.5,2,73,617,8.5,19,9,2,30,10,65,1,0,1
2018,201891HawNav,2,2018-09-01,Hawaii,Home,Navy,W (59-41),31,42,73.8,436,6,26,90,3.5,1,68,526,7.7,17,6,2,25,1,5,1,0,1
2018,201898HawRic,3,2018-09-08,Hawaii,Home,Rice,W (43-29),22,33,66.7,319,4,29,162,5.6,2,62,481,7.8,16,6,1,23,6,60,0,0,0
2018,2018915HawArm,4,2018-09-15,Hawaii,Away,Army,L (21-28),20,32,62.5,321,2,13,41,3.2,1,45,362,8.0,11,3,1,15,5,30,0,0,0
2018,2018922HawDuq,5,2018-09-22,Hawaii,Home,Duquesne,W (42-21),24,40,60.0,273,5,37,245,6.6,1,77,518,6.7,13,14,7,34,8,95,1,1,2
2018,2018929HawSan,6,2018-09-29,Hawaii,Away,San Jose State,W (44-41),34,57,59.6,341,4,42,134,3.2,1,99,475,4.8,16,11,1,28,6,65,1,1,2
2018,2018106HawWyo,7,2018-10-06,Hawaii,Home,Wyoming,W (17-13),19,29,65.5,148,2,37,156,4.2,0,66,304,4.6,6,13,0,19,2,25,1,1,2
2018,20181013HawBri,8,2018-10-13,Hawaii,Away,Brigham Young,L (23-49),22,38,57.9,248,2,28,63,2.3,1,66,311,4.7,13,4,1,18,4,25,1,1,2
2018,20181020HawNev,9,2018-10-20,Hawaii,Home,Nevada,L (22-40),19,38,50.0,259,3,35,112,3.2,0,73,371,5.1,10,5,1,16,7,73,0,0,0
2018,20181027HawFre,10,2018-10-27,Hawaii,Away,Fresno State,L (20-50),20,35,57.1,286,2,26,88,3.4,0,61,374,6.1,12,6,1,19,3,14,1,1,2
2018,2018113HawUta,11,2018-11-03,Hawaii,Home,Utah State,L (17-56),19,48,39.6,347,2,20,43,2.2,0,68,390,5.7,13,1,4,18,10,75,0,2,2
2018,20181117HawNev,12,2018-11-17,Hawaii,Home,Nevada-Las Vegas,W (35-28),18,36,50.0,328,3,31,83,2.7,1,67,411,6.1,11,6,1,18,3,15,0,2,2
2018,20181124HawSan,13,2018-11-24,Hawaii,Away,San Diego State,W (31-30),29,46,63.0,452,3,24,64,2.7,1,70,516,7.4,17,4,1,22,6,50,2,0,2
2018,201898HolBos,1,2018-09-08,Holy Cross,Away,Boston College,L (14-62),12,22,54.5,66,0,43,197,4.6,0,65,263,4.0,2,9,2,13,8,51,0,2,2
2018,201891HouRic,1,2018-09-01,Houston,Away,Rice,W (45-27),18,25,72.0,320,3,37,251,6.8,3,62,571,9.2,11,10,2,23,5,38,2,0,2
2018,201898HouAri,2,2018-09-08,Houston,Home,Arizona,W (45-18),19,40,47.5,254,4,40,297,7.4,2,80,551,6.9,11,14,3,28,7,56,0,0,0
2018,2018915HouTex,3,2018-09-15,Houston,Away,Texas Tech,L (49-63),31,52,59.6,462,5,40,173,4.3,2,92,635,6.9,18,8,2,28,9,68,0,0,0
2018,2018922HouTex,4,2018-09-22,Houston,Home,Texas Southern,W (70-14),33,49,67.3,386,5,41,285,7.0,5,90,671,7.5,18,17,1,36,2,10,0,1,1
2018,2018104HouTul,5,2018-10-04,Houston,Home,Tulsa,W (41-26),19,27,70.4,165,3,39,314,8.1,2,66,479,7.3,8,11,2,21,8,55,1,2,3
2018,20181013HouEas,6,2018-10-13,Houston,Away,East Carolina,W (42-20),16,28,57.1,249,3,43,157,3.7,2,71,406,5.7,8,8,2,18,12,115,0,0,0
2018,20181020HouNav,7,2018-10-20,Houston,Away,Navy,W (49-36),25,39,64.1,413,3,25,157,6.3,3,64,570,8.9,18,11,0,29,3,20,1,1,2
2018,20181027HouSou,8,2018-10-27,Houston,Home,South Florida,W (57-36),28,40,70.0,419,5,49,263,5.4,3,89,682,7.7,16,16,3,35,5,50,0,2,2
2018,2018113HouSou,9,2018-11-03,Houston,Away,Southern Methodist,L (31-45),11,22,50.0,175,2,47,190,4.0,1,69,365,5.3,6,9,0,15,6,50,2,0,2
2018,20181110HouTem,10,2018-11-10,Houston,Home,Temple,L (49-59),28,47,59.6,322,5,44,205,4.7,2,91,527,5.8,14,11,6,31,12,90,2,1,3
2018,20181115HouTul,11,2018-11-15,Houston,Home,Tulane,W (48-17),17,30,56.7,190,3,48,298,6.2,3,78,488,6.3,9,13,2,24,6,54,0,1,1
2018,20181123HouMem,12,2018-11-23,Houston,Away,Memphis,L (31-52),18,43,41.9,256,3,41,138,3.4,0,84,394,4.7,12,9,2,23,7,44,0,1,1
2018,201891IdaFre,1,2018-09-01,Idaho,Away,Fresno State,L (13-79),14,33,42.4,205,1,32,102,3.2,1,65,307,4.7,9,6,0,15,4,20,2,5,7
2018,20181117IdaFlo,2,2018-11-17,Idaho,Away,Florida,L (10-63),13,35,37.1,73,1,33,154,4.7,0,68,227,3.3,4,11,2,17,6,48,0,2,2
2018,2018915IdaCal,1,2018-09-15,Idaho State,Away,California,L (23-45),15,23,65.2,179,1,45,140,3.1,2,68,319,4.7,3,8,6,17,3,27,0,1,1
2018,20181020IdaLib,2,2018-10-20,Idaho State,Away,Liberty,L (41-48),20,44,45.5,397,4,42,234,5.6,1,86,631,7.3,18,9,1,28,4,24,1,2,3
2018,201891IllKen,1,2018-09-01,Illinois,Home,Kent State,W (31-24),13,23,56.5,190,0,47,284,6.0,4,70,474,6.8,10,12,0,22,3,25,1,0,1
2018,201898IllWes,2,2018-09-08,Illinois,Home,Western Illinois,W (34-14),14,23,60.9,138,2,47,238,5.1,1,70,376,5.4,8,9,3,20,14,145,0,0,0
2018,2018915IllSou,3,2018-09-15,Illinois,Neutral,South Florida,L (19-25),20,31,64.5,168,0,48,212,4.4,1,79,380,4.8,8,10,3,21,6,65,1,0,1
2018,2018921IllPen,4,2018-09-21,Illinois,Home,Penn State,L (24-63),18,31,58.1,166,2,45,245,5.4,1,76,411,5.4,11,12,3,26,7,81,0,2,2
2018,2018106IllRut,5,2018-10-06,Illinois,Away,Rutgers,W (38-17),10,19,52.6,89,1,43,330,7.7,4,62,419,6.8,4,11,2,17,7,80,0,0,0
2018,20181013IllPur,6,2018-10-13,Illinois,Home,Purdue,L (7-46),15,29,51.7,181,0,31,69,2.2,1,60,250,4.2,7,7,0,14,7,57,0,1,1
2018,20181020IllWis,7,2018-10-20,Illinois,Away,Wisconsin,L (20-49),9,21,42.9,90,0,36,210,5.8,2,57,300,5.3,2,9,2,13,3,25,2,3,5
2018,20181027IllMar,8,2018-10-27,Illinois,Away,Maryland,L (33-63),14,32,43.8,261,2,35,232,6.6,1,67,493,7.4,8,11,1,20,2,25,0,1,1
2018,2018113IllMin,9,2018-11-03,Illinois,Home,Minnesota,W (55-31),18,25,72.0,216,2,35,430,12.3,5,60,646,10.8,9,11,0,20,7,70,2,1,3
2018,20181110IllNeb,10,2018-11-10,Illinois,Away,Nebraska,L (35-54),11,25,44.0,126,0,48,384,8.0,5,73,510,7.0,7,16,2,25,7,66,3,2,5
2018,20181117IllIow,11,2018-11-17,Illinois,Home,Iowa,L (0-63),12,30,40.0,82,0,43,149,3.5,0,73,231,3.2,3,8,0,11,6,68,1,3,4
2018,20181124IllNor,12,2018-11-24,Illinois,Away,Northwestern,L (16-24),23,39,59.0,281,1,32,154,4.8,0,71,435,6.1,14,9,1,24,7,66,0,1,1
2018,2018922IllCol,1,2018-09-22,Illinois State,Away,Colorado State,W (35-19),14,29,48.3,271,2,42,267,6.4,3,71,538,7.6,10,11,1,22,9,81,0,0,0
2018,201891IndFlo,1,2018-09-01,Indiana,Away,Florida International,W (38-28),28,37,75.7,252,4,45,213,4.7,0,82,465,5.7,14,12,5,31,8,90,0,1,1
2018,201898IndVir,2,2018-09-08,Indiana,Home,Virginia,W (20-16),16,22,72.7,150,2,44,237,5.4,1,66,387,5.9,7,12,2,21,6,42,0,1,1
2018,2018915IndBal,3,2018-09-15,Indiana,Home,Ball State,W (38-10),24,32,75.0,202,0,44,255,5.8,4,76,457,6.0,9,13,4,26,5,45,1,0,1
2018,2018922IndMic,4,2018-09-22,Indiana,Home,Michigan State,L (21-35),32,46,69.6,272,2,32,29,0.9,0,78,301,3.9,15,1,2,18,6,85,0,2,2
2018,2018929IndRut,5,2018-09-29,Indiana,Away,Rutgers,W (24-17),27,40,67.5,288,1,42,163,3.9,2,82,451,5.5,14,8,2,24,5,60,1,1,2
2018,2018106IndOhi,6,2018-10-06,Indiana,Away,Ohio State,L (26-49),26,49,53.1,322,3,21,84,4.0,0,70,406,5.8,14,4,4,22,3,35,2,0,2
2018,20181013IndIow,7,2018-10-13,Indiana,Home,Iowa,L (16-42),31,42,73.8,263,1,25,67,2.7,1,67,330,4.9,10,8,4,22,10,99,0,2,2
2018,20181020IndPen,8,2018-10-20,Indiana,Home,Penn State,L (28-33),35,55,63.6,330,1,45,224,5.0,3,100,554,5.5,17,13,2,32,7,55,2,1,3
2018,20181026IndMin,9,2018-10-26,Indiana,Away,Minnesota,L (31-38),29,44,65.9,232,2,30,153,5.1,1,74,385,5.2,11,9,0,20,5,37,1,2,3
2018,20181110IndMar,10,2018-11-10,Indiana,Home,Maryland,W (34-32),16,28,57.1,243,2,30,131,4.4,2,58,374,6.4,8,7,3,18,3,39,0,1,1
2018,20181117IndMic,11,2018-11-17,Indiana,Away,Michigan,L (20-31),16,35,45.7,195,1,40,190,4.8,1,75,385,5.1,8,10,3,21,7,62,1,1,2
2018,20181124IndPur,12,2018-11-24,Indiana,Home,Purdue,L (21-28),36,51,70.6,345,1,30,142,4.7,2,81,487,6.0,16,9,2,27,6,80,0,1,1
2018,201898IndLou,1,2018-09-08,Indiana State,Away,Louisville,L (7-31),3,12,25.0,37,0,50,174,3.5,1,62,211,3.4,2,8,2,12,6,45,0,0,0
2018,201891IowNor,1,2018-09-01,Iowa,Home,Northern Illinois,W (33-7),13,25,52.0,143,1,48,209,4.4,3,73,352,4.8,6,8,4,18,8,66,0,1,1
2018,201898IowIow,2,2018-09-08,Iowa,Home,Iowa State,W (13-3),16,28,57.1,166,0,36,105,2.9,1,64,271,4.2,7,6,1,14,6,55,0,0,0
2018,2018915IowNor,3,2018-09-15,Iowa,Home,Northern Iowa,W (38-14),25,31,80.6,338,2,50,207,4.1,3,81,545,6.7,15,12,0,27,10,88,0,2,2
2018,2018922IowWis,4,2018-09-22,Iowa,Home,Wisconsin,L (17-28),14,23,60.9,256,2,31,148,4.8,0,54,404,7.5,11,5,3,19,1,5,2,1,3
2018,2018106IowMin,5,2018-10-06,Iowa,Away,Minnesota,W (48-31),23,39,59.0,314,4,40,106,2.7,2,79,420,5.3,13,5,0,18,5,45,1,1,2
2018,20181013IowInd,6,2018-10-13,Iowa,Away,Indiana,W (42-16),21,33,63.6,320,6,32,159,5.0,0,65,479,7.4,12,7,7,26,11,110,0,1,1
2018,20181020IowMar,7,2018-10-20,Iowa,Home,Maryland,W (23-0),11,24,45.8,86,1,52,224,4.3,0,76,310,4.1,7,14,1,22,0,0,0,1,1
2018,20181027IowPen,8,2018-10-27,Iowa,Away,Penn State,L (24-30),19,50,38.0,215,1,38,135,3.6,0,88,350,4.0,13,8,2,23,6,25,0,2,2
2018,2018113IowPur,9,2018-11-03,Iowa,Away,Purdue,L (36-38),21,32,65.6,275,1,37,118,3.2,4,69,393,5.7,15,5,2,22,8,75,1,0,1
2018,20181110IowNor,10,2018-11-10,Iowa,Home,Northwestern,L (10-14),27,41,65.9,269,1,22,64,2.9,0,63,333,5.3,12,3,1,16,3,35,2,0,2
2018,20181117IowIll,11,2018-11-17,Iowa,Away,Illinois,W (63-0),14,23,60.9,197,3,37,203,5.5,4,60,400,6.7,9,11,0,20,2,28,0,1,1
2018,20181123IowNeb,12,2018-11-23,Iowa,Home,Nebraska,W (31-28),17,28,60.7,153,2,45,266,5.9,2,73,419,5.7,11,14,0,25,2,20,0,0,0
2018,201898IowIow,1,2018-09-08,Iowa State,Away,Iowa,L (3-13),19,31,61.3,169,0,25,19,0.8,0,56,188,3.4,6,4,1,11,7,65,1,0,1
2018,2018915IowOkl,2,2018-09-15,Iowa State,Home,Oklahoma,L (27-37),25,36,69.4,360,2,29,87,3.0,1,65,447,6.9,12,6,2,20,4,35,0,1,1
2018,2018922IowAkr,3,2018-09-22,Iowa State,Home,Akron,W (26-13),26,34,76.5,233,1,35,132,3.8,1,69,365,5.3,12,8,1,21,5,50,2,0,2
2018,2018929IowTex,4,2018-09-29,Iowa State,Away,Texas Christian,L (14-17),14,28,50.0,79,1,28,119,4.3,1,56,198,3.5,6,6,3,15,1,15,1,0,1
2018,2018106IowOkl,5,2018-10-06,Iowa State,Away,Oklahoma State,W (48-42),19,25,76.0,325,4,38,140,3.7,2,63,465,7.4,11,7,3,21,5,36,1,1,2
2018,20181013IowWes,6,2018-10-13,Iowa State,Home,West Virginia,W (30-14),18,25,72.0,254,3,47,244,5.2,1,72,498,6.9,11,10,4,25,10,95,0,1,1
2018,20181027IowTex,7,2018-10-27,Iowa State,Home,Texas Tech,W (40-31),13,27,48.1,250,2,51,172,3.4,2,78,422,5.4,9,10,5,24,4,25,1,0,1
2018,2018113IowKan,8,2018-11-03,Iowa State,Away,Kansas,W (27-3),17,24,70.8,273,3,38,121,3.2,0,62,394,6.4,10,9,1,20,2,12,0,0,0
2018,20181110IowBay,9,2018-11-10,Iowa State,Home,Baylor,W (28-14),18,23,78.3,230,1,30,127,4.2,2,53,357,6.7,12,8,1,21,4,30,0,0,0
2018,20181117IowTex,10,2018-11-17,Iowa State,Away,Texas,L (10-24),13,29,44.8,148,0,30,62,2.1,1,59,210,3.6,5,7,0,12,3,20,1,1,2
2018,20181124IowKan,11,2018-11-24,Iowa State,Home,Kansas State,W (42-38),20,27,74.1,337,2,32,156,4.9,3,59,493,8.4,11,9,2,20,5,56,1,2,3
2018,2018121IowDra,12,2018-12-01,Iowa State,Home,Drake,W (27-24),17,25,68.0,159,1,42,114,2.7,3,67,273,4.1,8,8,1,17,2,15,1,1,2
2018,201891JacSou,1,2018-09-01,Jackson State,Away,Southern Mississippi,L (7-55),19,37,51.4,98,1,22,101,4.6,0,59,199,3.4,6,3,1,10,5,35,2,2,4
2018,201891KanNic,1,2018-09-01,Kansas,Home,Nicholls State,L (23-26),21,38,55.3,199,2,32,56,1.8,0,70,255,3.6,8,5,1,14,7,54,1,0,1
2018,201898KanCen,2,2018-09-08,Kansas,Away,Central Michigan,W (31-7),18,27,66.7,145,1,45,216,4.8,2,72,361,5.0,8,10,2,20,7,55,0,0,0
2018,2018915KanRut,3,2018-09-15,Kansas,Home,Rutgers,W (55-14),15,25,60.0,144,1,48,400,8.3,4,73,544,7.5,9,12,1,22,7,67,0,0,0
2018,2018922KanBay,4,2018-09-22,Kansas,Away,Baylor,L (7-26),16,27,59.3,149,1,28,122,4.4,0,55,271,4.9,5,5,4,14,7,55,0,0,0
2018,2018929KanOkl,5,2018-09-29,Kansas,Home,Oklahoma State,L (28-48),24,32,75.0,247,3,32,121,3.8,1,64,368,5.8,11,5,2,18,4,43,1,0,1
2018,2018106KanWes,6,2018-10-06,Kansas,Away,West Virginia,L (22-38),21,34,61.8,206,2,26,80,3.1,1,60,286,4.8,9,5,2,16,6,45,1,2,3
2018,20181020KanTex,7,2018-10-20,Kansas,Away,Texas Tech,L (16-48),18,41,43.9,221,2,29,98,3.4,0,70,319,4.6,9,6,1,16,6,62,1,1,2
2018,20181027KanTex,8,2018-10-27,Kansas,Home,Texas Christian,W (27-26),19,29,65.5,249,2,38,58,1.5,1,67,307,4.6,12,4,1,17,8,59,0,0,0
2018,2018113KanIow,9,2018-11-03,Kansas,Home,Iowa State,L (3-27),19,43,44.2,185,0,40,147,3.7,0,83,332,4.0,11,8,1,20,3,25,1,0,1
2018,20181110KanKan,10,2018-11-10,Kansas,Away,Kansas State,L (17-21),21,34,61.8,232,2,35,115,3.3,0,69,347,5.0,13,4,2,19,8,53,2,0,2
2018,20181117KanOkl,11,2018-11-17,Kansas,Away,Oklahoma,L (40-55),20,28,71.4,176,1,36,348,9.7,4,64,524,8.2,8,17,0,25,6,53,0,0,0
2018,20181123KanTex,12,2018-11-23,Kansas,Home,Texas,L (17-24),18,35,51.4,159,1,33,137,4.2,1,68,296,4.4,8,5,1,14,9,98,0,1,1
2018,201891KanSou,1,2018-09-01,Kansas State,Home,South Dakota,W (27-24),13,28,46.4,152,1,47,256,5.4,0,75,408,5.4,8,10,1,19,13,129,2,2,4
2018,201898KanMis,2,2018-09-08,Kansas State,Home,Mississippi State,L (10-31),9,21,42.9,100,1,35,113,3.2,0,56,213,3.8,5,7,3,15,2,15,0,1,1
2018,2018915KanTex,3,2018-09-15,Kansas State,Home,Texas-San Antonio,W (41-17),14,19,73.7,285,3,44,164,3.7,2,63,449,7.1,11,8,1,20,4,41,2,0,2
2018,2018922KanWes,4,2018-09-22,Kansas State,Away,West Virginia,L (6-35),18,29,62.1,227,0,36,91,2.5,0,65,318,4.9,9,7,1,17,8,69,1,0,1
2018,2018929KanTex,5,2018-09-29,Kansas State,Home,Texas,L (14-19),11,25,44.0,110,0,39,107,2.7,2,64,217,3.4,6,7,4,17,0,0,0,0,0
2018,2018106KanBay,6,2018-10-06,Kansas State,Away,Baylor,L (34-37),15,26,57.7,149,1,35,319,9.1,4,61,468,7.7,5,15,0,20,6,55,1,2,3
2018,20181013KanOkl,7,2018-10-13,Kansas State,Home,Oklahoma State,W (31-12),11,22,50.0,130,0,55,291,5.3,4,77,421,5.5,7,13,3,23,4,40,0,0,0
2018,20181027KanOkl,8,2018-10-27,Kansas State,Away,Oklahoma,L (14-51),13,21,61.9,108,0,32,137,4.3,2,53,245,4.6,5,6,2,13,4,50,1,0,1
2018,2018113KanTex,9,2018-11-03,Kansas State,Away,Texas Christian,L (13-14),16,28,57.1,162,1,47,139,3.0,1,75,301,4.0,8,11,2,21,2,3,2,1,3
2018,20181110KanKan,10,2018-11-10,Kansas State,Home,Kansas,W (21-17),11,18,61.1,126,0,40,175,4.4,3,58,301,5.2,7,8,2,17,7,55,0,0,0
2018,20181117KanTex,11,2018-11-17,Kansas State,Home,Texas Tech,W (21-6),17,26,65.4,213,1,50,154,3.1,0,76,367,4.8,11,9,2,22,2,20,0,1,1
2018,20181124KanIow,12,2018-11-24,Kansas State,Away,Iowa State,L (38-42),18,27,66.7,183,3,47,245,5.2,2,74,428,5.8,5,15,1,21,7,61,1,0,1
2018,201891KenIll,1,2018-09-01,Kent State,Away,Illinois,L (24-31),28,41,68.3,270,2,42,184,4.4,1,83,454,5.5,12,12,0,24,5,38,0,2,2
2018,201898KenHow,2,2018-09-08,Kent State,Home,Howard,W (54-14),13,29,44.8,156,1,52,355,6.8,6,81,511,6.3,8,16,2,26,15,150,3,1,4
2018,2018915KenPen,3,2018-09-15,Kent State,Away,Penn State,L (10-63),21,40,52.5,180,1,37,41,1.1,0,77,221,2.9,8,7,3,18,10,83,0,0,0
2018,2018922KenMis,4,2018-09-22,Kent State,Away,Mississippi,L (17-38),25,43,58.1,242,1,41,148,3.6,1,84,390,4.6,9,11,3,23,7,55,1,1,2
2018,2018929KenBal,5,2018-09-29,Kent State,Away,Ball State,L (24-52),30,44,68.2,314,1,41,147,3.6,2,85,461,5.4,16,6,2,24,17,142,2,1,3
2018,2018106KenOhi,6,2018-10-06,Kent State,Home,Ohio,L (26-27),27,35,77.1,271,2,36,201,5.6,0,71,472,6.6,12,10,3,25,11,100,1,2,3
2018,20181013KenMia,7,2018-10-13,Kent State,Away,Miami (OH),L (6-31),15,29,51.7,149,0,31,125,4.0,1,60,274,4.6,7,6,1,14,10,70,0,1,1
2018,20181020KenAkr,8,2018-10-20,Kent State,Home,Akron,L (23-24),17,31,54.8,198,1,43,173,4.0,2,74,371,5.0,8,8,2,18,6,46,0,0,0
2018,20181030KenBow,9,2018-10-30,Kent State,Away,Bowling Green State,W (35-28),14,24,58.3,157,2,50,225,4.5,3,74,382,5.2,6,13,2,21,11,86,1,0,1
2018,2018116KenBuf,10,2018-11-06,Kent State,Away,Buffalo,L (14-48),14,28,50.0,83,1,40,100,2.5,1,68,183,2.7,5,7,0,12,4,35,0,0,0
2018,20181115KenTol,11,2018-11-15,Kent State,Home,Toledo,L (34-56),24,41,58.5,314,2,35,183,5.2,2,76,497,6.5,11,6,6,23,8,69,0,1,1
2018,20181123KenEas,12,2018-11-23,Kent State,Home,Eastern Michigan,L (20-28),19,35,54.3,209,0,45,179,4.0,1,80,388,4.9,6,11,4,21,4,45,2,1,3
2018,201891KenCen,1,2018-09-01,Kentucky,Home,Central Michigan,W (35-20),15,27,55.6,128,1,43,299,7.0,4,70,427,6.1,8,15,4,27,3,40,2,2,4
2018,201898KenFlo,2,2018-09-08,Kentucky,Away,Florida,W (27-16),11,16,68.8,151,2,41,303,7.4,1,57,454,8.0,5,15,0,20,12,114,1,1,2
2018,2018915KenMur,3,2018-09-15,Kentucky,Home,Murray State,W (48-10),24,31,77.4,283,2,43,245,5.7,4,74,528,7.1,13,14,1,28,7,67,0,0,0
2018,2018922KenMis,4,2018-09-22,Kentucky,Home,Mississippi State,W (28-7),8,14,57.1,71,0,47,229,4.9,4,61,300,4.9,3,11,4,18,5,42,0,1,1
2018,2018929KenSou,5,2018-09-29,Kentucky,Home,South Carolina,W (24-10),13,20,65.0,132,0,44,221,5.0,3,64,353,5.5,7,12,1,20,11,115,0,1,1
2018,2018106KenTex,6,2018-10-06,Kentucky,Away,Texas A&M,L (14-20),13,20,65.0,108,1,30,70,2.3,0,50,178,3.6,3,5,0,8,8,52,0,0,0
2018,20181020KenVan,7,2018-10-20,Kentucky,Home,Vanderbilt,W (14-7),3,9,33.3,18,1,53,280,5.3,1,62,298,4.8,2,15,0,17,4,35,2,0,2
2018,20181027KenMis,8,2018-10-27,Kentucky,Away,Missouri,W (15-14),25,39,64.1,294,1,35,91,2.6,0,74,385,5.2,13,5,3,21,5,31,0,1,1
2018,2018113KenGeo,9,2018-11-03,Kentucky,Home,Georgia,L (17-34),23,29,79.3,226,1,35,84,2.4,1,64,310,4.8,11,8,2,21,6,64,2,0,2
2018,20181110KenTen,10,2018-11-10,Kentucky,Away,Tennessee,L (7-24),23,38,60.5,185,1,34,85,2.5,0,72,270,3.8,10,8,1,19,3,20,1,2,3
2018,20181117KenMid,11,2018-11-17,Kentucky,Home,Middle Tennessee State,W (34-23),10,14,71.4,121,1,40,203,5.1,2,54,324,6.0,5,10,0,15,6,51,0,0,0
2018,20181124KenLou,12,2018-11-24,Kentucky,Away,Louisville,W (56-10),17,24,70.8,261,3,46,340,7.4,5,70,601,8.6,11,13,5,29,6,63,0,2,2
2018,20181110LafArm,1,2018-11-10,Lafayette,Away,Army,L (13-31),9,16,56.3,76,1,24,83,3.5,0,40,159,4.0,4,5,0,9,1,5,0,0,0
2018,201898LamTex,1,2018-09-08,Lamar,Away,Texas Tech,L (0-77),10,32,31.3,80,0,42,102,2.4,0,74,182,2.5,3,8,2,13,4,15,1,3,4
2018,2018915LehNav,1,2018-09-15,Lehigh,Away,Navy,L (21-51),22,40,55.0,174,1,25,162,6.5,2,65,336,5.2,9,6,1,16,3,25,2,3,5
2018,201891LibOld,1,2018-09-01,Liberty,Home,Old Dominion,W (52-10),26,37,70.3,353,4,38,238,6.3,3,75,591,7.9,14,9,6,29,6,58,1,0,1
2018,201898LibArm,2,2018-09-08,Liberty,Away,Army,L (14-38),19,37,51.4,307,2,23,110,4.8,0,60,417,7.0,14,5,2,21,6,27,2,1,3
2018,2018922LibNor,3,2018-09-22,Liberty,Home,North Texas,L (7-47),16,40,40.0,222,1,42,122,2.9,0,82,344,4.2,11,9,3,23,5,45,0,1,1
2018,2018929LibNew,4,2018-09-29,Liberty,Away,New Mexico,W (52-43),27,47,57.4,472,3,43,96,2.2,4,90,568,6.3,15,5,3,23,3,30,0,1,1
2018,2018106LibNew,5,2018-10-06,Liberty,Away,New Mexico State,L (41-49),31,54,57.4,365,2,42,153,3.6,4,96,518,5.4,19,9,2,30,4,40,1,1,2
2018,20181013LibTro,6,2018-10-13,Liberty,Home,Troy,W (22-16),17,32,53.1,238,2,45,103,2.3,1,77,341,4.4,13,4,0,17,3,45,0,1,1
2018,20181020LibIda,7,2018-10-20,Liberty,Home,Idaho State,W (48-41),32,48,66.7,362,2,41,190,4.6,5,89,552,6.2,18,9,2,29,6,55,0,2,2
2018,2018113LibMas,8,2018-11-03,Liberty,Away,Massachusetts,L (59-62),16,35,45.7,272,2,51,216,4.2,5,86,488,5.7,13,16,2,31,7,45,0,4,4
2018,20181110LibVir,9,2018-11-10,Liberty,Away,Virginia,L (24-45),15,27,55.6,149,0,44,205,4.7,3,71,354,5.0,10,10,0,20,3,30,0,3,3
2018,20181117LibAub,10,2018-11-17,Liberty,Away,Auburn,L (0-53),9,28,32.1,79,0,28,55,2.0,0,56,134,2.4,6,1,1,7,1,5,2,2,4
2018,20181124LibNew,11,2018-11-24,Liberty,Home,New Mexico State,W (28-21),18,31,58.1,154,2,47,141,3.0,0,78,295,3.8,9,7,1,17,6,63,0,2,2
2018,2018121LibNor,12,2018-12-01,Liberty,Home,Norfolk State,W (52-17),19,32,59.4,165,1,43,308,7.2,5,75,473,6.3,11,17,1,29,1,15,0,0,0
2018,201891LouGra,1,2018-09-01,Louisiana,Home,Grambling State,W (49-17),23,30,76.7,241,4,43,315,7.3,3,73,556,7.6,12,12,3,27,6,40,0,1,1
2018,2018915LouMis,2,2018-09-15,Louisiana,Away,Mississippi State,L (10-56),23,34,67.6,245,1,26,65,2.5,0,60,310,5.2,10,3,0,13,4,25,0,1,1
2018,2018922LouCoa,3,2018-09-22,Louisiana,Home,Coastal Carolina,L (28-30),10,18,55.6,143,1,31,238,7.7,3,49,381,7.8,6,9,2,17,6,64,0,0,0
2018,2018929LouAla,4,2018-09-29,Louisiana,Away,Alabama,L (14-56),11,20,55.0,88,1,38,200,5.3,1,58,288,5.0,4,11,0,15,4,30,0,2,2
2018,2018106LouTex,5,2018-10-06,Louisiana,Away,Texas State,W (42-27),14,23,60.9,230,2,49,327,6.7,4,72,557,7.7,9,13,1,23,3,30,0,1,1
2018,20181013LouNew,6,2018-10-13,Louisiana,Home,New Mexico State,W (66-38),22,29,75.9,415,6,56,344,6.1,3,85,759,8.9,18,17,2,37,7,72,1,0,1
2018,20181020LouApp,7,2018-10-20,Louisiana,Away,Appalachian State,L (17-27),17,27,63.0,188,1,41,140,3.4,1,68,328,4.8,8,8,0,16,6,52,1,0,1
2018,20181027LouArk,8,2018-10-27,Louisiana,Home,Arkansas State,W (47-43),19,28,67.9,319,2,39,228,5.8,4,67,547,8.2,10,10,2,22,6,51,0,2,2
2018,2018113LouTro,9,2018-11-03,Louisiana,Away,Troy,L (16-26),14,29,48.3,170,0,36,100,2.8,2,65,270,4.2,7,9,2,18,5,39,1,2,3
2018,20181110LouGeo,10,2018-11-10,Louisiana,Home,Georgia State,W (36-22),16,23,69.6,170,1,37,356,9.6,4,60,526,8.8,9,11,2,22,1,8,0,0,0
2018,20181117LouSou,11,2018-11-17,Louisiana,Home,South Alabama,W (48-38),13,19,68.4,197,3,33,210,6.4,3,52,407,7.8,8,9,0,17,6,66,0,1,1
2018,20181124LouLou,12,2018-11-24,Louisiana,Away,Louisiana-Monroe,W (31-28),17,21,81.0,213,4,49,240,4.9,0,70,453,6.5,6,13,3,22,9,78,0,1,1
2018,2018121LouApp,13,2018-12-01,Louisiana,Away,Appalachian State,L (19-30),10,22,45.5,85,0,44,216,4.9,1,66,301,4.6,5,10,1,16,5,35,0,2,2
2018,201891LouSou,1,2018-09-01,Louisiana Tech,Away,South Alabama,W (30-26),19,29,65.5,209,2,48,231,4.8,2,77,440,5.7,8,11,3,22,6,55,0,3,3
2018,201898LouSou,2,2018-09-08,Louisiana Tech,Home,Southern,W (54-17),27,42,64.3,427,3,33,186,5.6,4,75,613,8.2,18,11,3,32,4,34,1,0,1
2018,2018922LouLou,3,2018-09-22,Louisiana Tech,Away,Louisiana State,L (21-38),27,50,54.0,330,3,26,87,3.3,0,76,417,5.5,14,5,2,21,6,48,1,1,2
2018,2018929LouNor,4,2018-09-29,Louisiana Tech,Away,North Texas,W (29-27),20,39,51.3,230,2,32,129,4.0,0,71,359,5.1,10,6,3,19,1,10,0,0,0
2018,2018106LouAla,5,2018-10-06,Louisiana Tech,Home,Alabama-Birmingham,L (7-28),9,23,39.1,107,0,41,151,3.7,1,64,258,4.0,5,9,1,15,2,17,2,1,3
2018,20181013LouTex,6,2018-10-13,Louisiana Tech,Away,Texas-San Antonio,W (31-3),25,37,67.6,309,1,38,75,2.0,3,75,384,5.1,14,6,1,21,4,40,1,1,2
2018,20181020LouTex,7,2018-10-20,Louisiana Tech,Home,Texas-El Paso,W (31-24),17,29,58.6,156,1,31,169,5.5,2,60,325,5.4,8,8,3,19,6,55,0,0,0
2018,20181026LouFlo,8,2018-10-26,Louisiana Tech,Away,Florida Atlantic,W (21-13),17,35,48.6,217,1,40,113,2.8,2,75,330,4.4,11,7,3,21,4,44,0,0,0
2018,2018113LouMis,9,2018-11-03,Louisiana Tech,Away,Mississippi State,L (3-45),14,31,45.2,98,0,32,140,4.4,0,63,238,3.8,5,10,0,15,5,35,0,1,1
2018,20181110LouRic,10,2018-11-10,Louisiana Tech,Home,Rice,W (28-13),21,34,61.8,314,1,33,110,3.3,3,67,424,6.3,10,10,0,20,5,37,1,2,3
2018,20181117LouSou,11,2018-11-17,Louisiana Tech,Away,Southern Mississippi,L (20-21),27,43,62.8,243,1,23,68,3.0,1,66,311,4.7,13,4,3,20,3,45,0,0,0
2018,20181124LouWes,12,2018-11-24,Louisiana Tech,Home,Western Kentucky,L (15-30),28,53,52.8,319,0,23,61,2.7,1,76,380,5.0,16,5,3,23,5,67,0,1,1
2018,2018830LouSou,1,2018-08-30,Louisiana-Monroe,Home,Southeastern Louisiana,W (34-31),35,53,66.0,346,2,43,208,4.8,2,96,554,5.8,15,14,2,31,10,75,1,1,2
2018,201898LouSou,2,2018-09-08,Louisiana-Monroe,Away,Southern Mississippi,W (21-20),15,28,53.6,195,2,30,159,5.3,0,58,354,6.1,7,6,0,13,8,55,1,1,2
2018,2018915LouTex,3,2018-09-15,Louisiana-Monroe,Away,Texas A&M,L (10-48),15,28,53.6,225,1,29,103,3.6,0,57,328,5.8,7,6,1,14,4,38,0,1,1
2018,2018922LouTro,4,2018-09-22,Louisiana-Monroe,Home,Troy,L (27-35),29,48,60.4,290,2,36,200,5.6,2,84,490,5.8,15,11,1,27,10,94,0,1,1
2018,2018929LouGeo,5,2018-09-29,Louisiana-Monroe,Away,Georgia State,L (14-46),20,34,58.8,137,0,20,125,6.3,2,54,262,4.9,6,5,2,13,3,11,2,2,4
2018,2018106LouMis,6,2018-10-06,Louisiana-Monroe,Away,Mississippi,L (21-70),23,38,60.5,297,1,38,130,3.4,1,76,427,5.6,13,10,2,25,2,15,2,0,2
2018,20181013LouCoa,7,2018-10-13,Louisiana-Monroe,Away,Coastal Carolina,W (45-20),16,22,72.7,224,1,34,242,7.1,5,56,466,8.3,8,11,1,20,2,30,1,0,1
2018,20181020LouTex,8,2018-10-20,Louisiana-Monroe,Home,Texas State,W (20-14),13,29,44.8,124,1,43,229,5.3,1,72,353,4.9,8,12,3,23,7,67,2,0,2
2018,2018113LouGeo,9,2018-11-03,Louisiana-Monroe,Home,Georgia Southern,W (44-25),13,22,59.1,337,2,42,236,5.6,4,64,573,9.0,9,10,2,21,8,75,0,2,2
2018,20181110LouSou,10,2018-11-10,Louisiana-Monroe,Away,South Alabama,W (38-10),28,33,84.8,376,2,38,175,4.6,3,71,551,7.8,16,8,2,26,1,15,1,0,1
2018,20181117LouArk,11,2018-11-17,Louisiana-Monroe,Away,Arkansas State,L (17-31),17,28,60.7,218,1,26,58,2.2,1,54,276,5.1,10,4,2,16,5,63,0,3,3
2018,20181124LouLou,12,2018-11-24,Louisiana-Monroe,Home,Louisiana,L (28-31),15,24,62.5,201,2,35,143,4.1,1,59,344,5.8,8,9,0,17,4,50,1,1,2
2018,201891LouAla,1,2018-09-01,Louisville,Neutral,Alabama,L (14-51),20,39,51.3,252,2,25,27,1.1,0,64,279,4.4,13,1,5,19,11,93,0,2,2
2018,201898LouInd,2,2018-09-08,Louisville,Home,Indiana State,W (31-7),14,22,63.6,164,1,38,199,5.2,2,60,363,6.1,6,12,1,19,7,75,1,1,2
2018,2018915LouWes,3,2018-09-15,Louisville,Home,Western Kentucky,W (20-17),10,21,47.6,88,0,38,204,5.4,2,59,292,4.9,4,11,2,17,5,40,0,1,1
2018,2018922LouVir,4,2018-09-22,Louisville,Away,Virginia,L (3-27),16,28,57.1,148,0,29,66,2.3,0,57,214,3.8,11,3,0,14,6,52,1,2,3
2018,2018929LouFlo,5,2018-09-29,Louisville,Home,Florida State,L (24-28),24,45,53.3,306,2,38,115,3.0,1,83,421,5.1,11,11,2,24,8,75,1,2,3
2018,2018105LouGeo,6,2018-10-05,Louisville,Home,Georgia Tech,L (31-66),27,44,61.4,370,3,23,113,4.9,1,67,483,7.2,14,7,2,23,4,35,2,1,3
2018,20181013LouBos,7,2018-10-13,Louisville,Away,Boston College,L (20-38),17,35,48.6,170,0,32,47,1.5,3,67,217,3.2,10,4,1,15,4,33,0,1,1
2018,20181027LouWak,8,2018-10-27,Louisville,Home,Wake Forest,L (35-56),30,54,55.6,358,1,36,174,4.8,4,90,532,5.9,19,11,1,31,5,31,1,0,1
2018,2018113LouCle,9,2018-11-03,Louisville,Away,Clemson,L (16-77),17,34,50.0,231,0,36,81,2.3,1,70,312,4.5,8,8,0,16,10,100,1,2,3
2018,2018119LouSyr,10,2018-11-09,Louisville,Away,Syracuse,L (23-54),14,31,45.2,210,1,39,203,5.2,2,70,413,5.9,7,9,2,18,17,125,2,2,4
2018,20181117LouNor,11,2018-11-17,Louisville,Home,North Carolina State,L (10-52),13,25,52.0,157,0,38,254,6.7,1,63,411,6.5,8,11,0,19,12,68,1,1,2
2018,20181124LouKen,12,2018-11-24,Louisville,Home,Kentucky,L (10-56),8,16,50.0,79,0,30,226,7.5,1,46,305,6.6,3,7,0,10,12,134,0,0,0
2018,201892LSUMia,1,2018-09-02,LSU,Neutral,Miami (FL),W (33-17),11,24,45.8,140,0,37,156,4.2,2,61,296,4.9,5,8,4,17,6,62,0,0,0
2018,201898LSUSou,2,2018-09-08,LSU,Home,Southeastern Louisiana,W (31-0),10,20,50.0,151,2,35,184,5.3,2,55,335,6.1,5,10,0,15,7,84,0,0,0
2018,2018915LSUAub,3,2018-09-15,LSU,Away,Auburn,W (22-21),15,35,42.9,249,1,42,121,2.9,1,77,370,4.8,11,4,6,21,9,91,0,0,0
2018,2018922LSULou,4,2018-09-22,LSU,Home,Louisiana Tech,W (38-21),16,28,57.1,191,0,48,218,4.5,5,76,409,5.4,8,16,1,25,4,45,1,0,1
2018,2018929LSUMis,5,2018-09-29,LSU,Home,Mississippi,W (45-16),18,25,72.0,292,3,50,281,5.6,3,75,573,7.6,10,16,7,33,5,40,2,0,2
2018,2018106LSUFlo,6,2018-10-06,LSU,Away,Florida,L (19-27),19,34,55.9,192,0,41,180,4.4,2,75,372,5.0,8,9,3,20,8,75,1,2,3
2018,20181013LSUGeo,7,2018-10-13,LSU,Home,Georgia,W (36-16),15,30,50.0,200,0,51,275,5.4,3,81,475,5.9,9,10,1,20,2,19,0,0,0
2018,20181020LSUMis,8,2018-10-20,LSU,Home,Mississippi State,W (19-3),16,28,57.1,129,0,44,110,2.5,1,72,239,3.3,6,9,2,17,5,53,0,1,1
2018,2018113LSUAla,9,2018-11-03,LSU,Home,Alabama,L (0-29),18,35,51.4,184,0,25,12,0.5,0,60,196,3.3,8,3,2,13,3,15,0,1,1
2018,20181110LSUArk,10,2018-11-10,LSU,Away,Arkansas,W (24-17),15,21,71.4,195,1,48,164,3.4,2,69,359,5.2,9,9,2,20,7,69,1,0,1
2018,20181117LSURic,11,2018-11-17,LSU,Home,Rice,W (42-10),24,34,70.6,372,2,35,180,5.1,4,69,552,8.0,20,10,1,31,3,26,1,0,1
2018,20181124LSUTex,12,2018-11-24,LSU,Away,Texas A&M,L (72-74),26,39,66.7,281,4,51,215,4.2,4,90,496,5.5,17,13,1,31,10,70,1,0,1
2018,201898MaiWes,1,2018-09-08,Maine,Away,Western Kentucky,W (31-28),12,29,41.4,182,3,41,142,3.5,0,70,324,4.6,7,6,1,14,6,40,0,1,1
2018,2018922MaiCen,2,2018-09-22,Maine,Away,Central Michigan,L (5-17),19,36,52.8,183,0,37,82,2.2,0,73,265,3.6,9,6,3,18,11,113,0,2,2
2018,201891MarMia,1,2018-09-01,Marshall,Away,Miami (OH),W (35-28),24,37,64.9,272,2,38,171,4.5,3,75,443,5.9,11,11,2,24,7,62,0,0,0
2018,201898MarEas,2,2018-09-08,Marshall,Home,Eastern Kentucky,W (32-16),23,39,59.0,278,3,28,89,3.2,1,67,367,5.5,10,6,1,17,8,70,3,1,4
2018,2018922MarNor,3,2018-09-22,Marshall,Home,North Carolina State,L (20-37),22,43,51.2,270,1,22,54,2.5,0,65,324,5.0,11,3,1,15,4,20,1,2,3
2018,2018929MarWes,4,2018-09-29,Marshall,Away,Western Kentucky,W (20-17),18,39,46.2,288,2,33,113,3.4,0,72,401,5.6,11,6,0,17,6,70,1,3,4
2018,2018105MarMid,5,2018-10-05,Marshall,Home,Middle Tennessee State,L (24-34),17,35,48.6,173,2,53,209,3.9,1,88,382,4.3,9,14,5,28,6,59,2,1,3
2018,20181013MarOld,6,2018-10-13,Marshall,Away,Old Dominion,W (42-20),18,29,62.1,182,1,45,319,7.1,5,74,501,6.8,9,13,2,24,8,101,0,1,1
2018,20181020MarFlo,7,2018-10-20,Marshall,Home,Florida Atlantic,W (31-7),13,24,54.2,102,2,48,233,4.9,2,72,335,4.7,4,14,0,18,5,55,0,0,0
2018,2018113MarSou,8,2018-11-03,Marshall,Away,Southern Mississippi,L (24-26),17,38,44.7,218,1,22,31,1.4,1,60,249,4.2,9,4,2,15,7,79,3,2,5
2018,20181110MarUNC,9,2018-11-10,Marshall,Home,UNC Charlotte,W (30-13),15,26,57.7,178,1,38,147,3.9,2,64,325,5.1,8,8,0,16,3,20,1,0,1
2018,20181117MarTex,10,2018-11-17,Marshall,Home,Texas-San Antonio,W (23-0),19,36,52.8,387,2,37,118,3.2,0,73,505,6.9,14,6,2,22,6,49,0,0,0
2018,20181124MarFlo,11,2018-11-24,Marshall,Away,Florida International,W (28-25),18,27,66.7,176,2,32,154,4.8,0,59,330,5.6,10,10,1,21,6,60,0,2,2
2018,2018121MarVir,12,2018-12-01,Marshall,Away,Virginia Tech,L (20-41),19,34,55.9,220,1,35,232,6.6,2,69,452,6.6,11,7,1,19,11,67,1,1,2
2018,201891MarTex,1,2018-09-01,Maryland,Neutral,Texas,W (34-29),21,34,61.8,264,2,46,143,3.1,2,80,407,5.1,8,8,5,21,8,70,0,0,0
2018,201898MarBow,2,2018-09-08,Maryland,Away,Bowling Green State,W (45-14),8,16,50.0,121,1,53,444,8.4,5,69,565,8.2,4,19,1,24,14,139,1,0,1
2018,2018915MarTem,3,2018-09-15,Maryland,Home,Temple,L (14-35),8,21,38.1,63,0,31,132,4.3,0,52,195,3.8,2,7,2,11,5,35,0,2,2
2018,2018922MarMin,4,2018-09-22,Maryland,Home,Minnesota,W (42-13),10,14,71.4,117,1,37,315,8.5,4,51,432,8.5,2,12,1,15,10,118,0,0,0
2018,2018106MarMic,5,2018-10-06,Maryland,Away,Michigan,L (21-42),7,13,53.8,73,0,37,147,4.0,2,50,220,4.4,5,5,1,11,12,107,0,1,1
2018,20181013MarRut,6,2018-10-13,Maryland,Home,Rutgers,W (34-7),9,20,45.0,85,3,40,290,7.3,1,60,375,6.3,4,12,0,16,9,85,1,0,1
2018,20181020MarIow,7,2018-10-20,Maryland,Away,Iowa,L (0-23),6,16,37.5,47,0,23,68,3.0,0,39,115,2.9,3,4,0,7,6,46,1,1,2
2018,20181027MarIll,8,2018-10-27,Maryland,Home,Illinois,W (63-33),13,21,61.9,281,3,48,431,9.0,5,69,712,10.3,10,19,1,30,7,85,0,0,0
2018,2018113MarMic,9,2018-11-03,Maryland,Home,Michigan State,L (3-24),8,24,33.3,74,0,29,26,0.9,0,53,100,1.9,4,3,2,9,3,25,2,0,2
2018,20181110MarInd,10,2018-11-10,Maryland,Away,Indiana,L (32-34),14,25,56.0,189,1,59,353,6.0,2,84,542,6.5,8,18,1,27,10,93,3,1,4
2018,20181117MarOhi,11,2018-11-17,Maryland,Home,Ohio State,L (51-52),7,14,50.0,196,1,47,340,7.2,4,61,536,8.8,5,12,2,19,9,88,1,0,1
2018,20181124MarPen,12,2018-11-24,Maryland,Away,Penn State,L (3-38),14,23,60.9,185,0,36,74,2.1,0,59,259,4.4,7,5,1,13,7,65,0,0,0
2018,2018825MasDuq,1,2018-08-25,Massachusetts,Home,Duquesne,W (63-15),19,28,67.9,290,4,38,284,7.5,4,66,574,8.7,12,11,1,24,4,30,1,0,1
2018,201891MasBos,2,2018-09-01,Massachusetts,Away,Boston College,L (21-55),21,34,61.8,249,1,34,66,1.9,2,68,315,4.6,12,5,1,18,2,8,1,2,3
2018,201898MasGeo,3,2018-09-08,Massachusetts,Away,Georgia Southern,L (13-34),23,36,63.9,216,0,24,108,4.5,1,60,324,5.4,12,6,1,19,8,55,1,1,2
2018,2018915MasFlo,4,2018-09-15,Massachusetts,Away,Florida International,L (24-63),15,32,46.9,224,1,34,199,5.9,2,66,423,6.4,11,11,2,24,5,40,1,2,3
2018,2018922MasUNC,5,2018-09-22,Massachusetts,Home,UNC Charlotte,W (49-31),12,19,63.2,189,2,35,142,4.1,4,54,331,6.1,9,5,2,16,6,59,1,0,1
2018,2018929MasOhi,6,2018-09-29,Massachusetts,Away,Ohio,L (42-58),30,43,69.8,410,5,22,41,1.9,0,65,451,6.9,19,3,1,23,8,77,0,1,1
2018,2018106MasSou,7,2018-10-06,Massachusetts,Home,South Florida,L (42-58),33,52,63.5,401,5,34,85,2.5,1,86,486,5.7,19,6,4,29,8,80,4,1,5
2018,20181020MasCoa,8,2018-10-20,Massachusetts,Home,Coastal Carolina,L (13-24),25,43,58.1,390,1,22,63,2.9,0,65,453,7.0,18,4,0,22,8,70,2,0,2
2018,20181027MasCon,9,2018-10-27,Massachusetts,Away,Connecticut,W (22-17),8,15,53.3,197,2,53,247,4.7,1,68,444,6.5,7,12,1,20,2,15,1,1,2
2018,2018113MasLib,10,2018-11-03,Massachusetts,Home,Liberty,W (62-59),29,44,65.9,540,4,54,237,4.4,4,98,777,7.9,17,15,2,34,9,79,2,1,3
2018,20181110MasBri,11,2018-11-10,Massachusetts,Home,Brigham Young,L (16-35),23,33,69.7,183,0,36,102,2.8,2,69,285,4.1,9,5,1,15,1,10,0,0,0
2018,20181117MasGeo,12,2018-11-17,Massachusetts,Away,Georgia,L (27-66),24,32,75.0,287,2,22,103,4.7,1,54,390,7.2,10,5,1,16,7,59,0,1,1
2018,2018922McNBri,1,2018-09-22,McNeese State,Away,Brigham Young,L (3-30),18,26,69.2,134,0,28,73,2.6,0,54,207,3.8,4,4,2,10,10,70,2,2,4
2018,201891MemMer,1,2018-09-01,Memphis,Home,Mercer,W (66-14),28,39,71.8,428,5,47,324,6.9,3,86,752,8.7,19,11,2,32,7,57,1,0,1
2018,201898MemNav,2,2018-09-08,Memphis,Away,Navy,L (21-22),15,25,60.0,145,0,24,233,9.7,3,49,378,7.7,8,6,0,14,4,20,3,1,4
2018,2018914MemGeo,3,2018-09-14,Memphis,Home,Georgia State,W (59-22),19,27,70.4,269,5,35,410,11.7,3,62,679,11.0,14,13,0,27,10,79,0,1,1
2018,2018922MemSou,4,2018-09-22,Memphis,Home,South Alabama,W (52-35),22,30,73.3,292,2,46,271,5.9,5,76,563,7.4,14,14,3,31,5,50,0,0,0
2018,2018928MemTul,5,2018-09-28,Memphis,Away,Tulane,L (24-40),14,30,46.7,246,2,21,31,1.5,1,51,277,5.4,8,2,3,13,4,20,0,0,0
2018,2018106MemCon,6,2018-10-06,Memphis,Home,Connecticut,W (55-14),17,19,89.5,256,2,40,378,9.5,6,59,634,10.7,9,16,1,26,9,90,0,0,0
2018,20181013MemCen,7,2018-10-13,Memphis,Home,Central Florida,L (30-31),17,29,58.6,209,0,52,281,5.4,3,81,490,6.0,10,14,3,27,7,43,2,0,2
2018,20181020MemMis,8,2018-10-20,Memphis,Away,Missouri,L (33-65),15,38,39.5,208,2,43,200,4.7,2,81,408,5.0,12,9,4,25,8,65,0,2,2
2018,2018113MemEas,9,2018-11-03,Memphis,Away,East Carolina,W (59-41),21,30,70.0,362,3,52,277,5.3,5,82,639,7.8,11,14,1,26,9,56,0,0,0
2018,20181110MemTul,10,2018-11-10,Memphis,Home,Tulsa,W (47-21),16,23,69.6,202,2,55,297,5.4,3,78,499,6.4,10,14,2,26,8,79,1,0,1
2018,20181116MemSou,11,2018-11-16,Memphis,Away,Southern Methodist,W (28-18),18,31,58.1,226,2,43,208,4.8,2,74,434,5.9,12,7,2,21,12,143,0,2,2
2018,20181123MemHou,12,2018-11-23,Memphis,Home,Houston,W (52-31),21,33,63.6,209,1,59,401,6.8,6,92,610,6.6,10,19,2,31,5,32,0,2,2
2018,2018121MemCen,13,2018-12-01,Memphis,Away,Central Florida,L (41-56),18,30,60.0,182,1,45,401,8.9,4,75,583,7.8,9,14,0,23,10,79,0,1,1
2018,201891MerMem,1,2018-09-01,Mercer,Away,Memphis,L (14-66),14,27,51.9,114,2,24,60,2.5,0,51,174,3.4,6,2,0,8,7,60,0,2,2
2018,201892MiaLou,1,2018-09-02,Miami (FL),Neutral,Louisiana State,L (17-33),15,35,42.9,259,1,34,83,2.4,1,69,342,5.0,9,6,3,18,11,85,0,2,2
2018,201898MiaSav,2,2018-09-08,Miami (FL),Home,Savannah State,W (77-0),19,31,61.3,255,5,37,239,6.5,5,68,494,7.3,8,11,1,20,1,15,1,1,2
2018,2018915MiaTol,3,2018-09-15,Miami (FL),Away,Toledo,W (49-24),13,23,56.5,205,2,53,268,5.1,5,76,473,6.2,7,16,1,24,0,0,0,0,0
2018,2018922MiaFlo,4,2018-09-22,Miami (FL),Home,Florida International,W (31-17),20,29,69.0,240,3,49,248,5.1,1,78,488,6.3,11,15,1,27,6,60,1,1,2
2018,2018927MiaNor,5,2018-09-27,Miami (FL),Home,North Carolina,W (47-10),8,12,66.7,125,1,34,229,6.7,2,46,354,7.7,4,10,0,14,7,65,1,1,2
2018,2018106MiaFlo,6,2018-10-06,Miami (FL),Home,Florida State,W (28-27),13,32,40.6,204,4,46,102,2.2,0,78,306,3.9,8,9,3,20,6,50,1,0,1
2018,20181013MiaVir,7,2018-10-13,Miami (FL),Away,Virginia,L (13-16),15,29,51.7,190,0,29,149,5.1,1,58,339,5.8,9,6,1,16,8,71,0,3,3
2018,20181026MiaBos,8,2018-10-26,Miami (FL),Away,Boston College,L (14-27),19,39,48.7,150,1,36,155,4.3,1,75,305,4.1,8,10,1,19,6,28,0,2,2
2018,2018113MiaDuk,9,2018-11-03,Miami (FL),Home,Duke,L (12-20),13,28,46.4,111,0,44,300,6.8,2,72,411,5.7,5,10,1,16,6,73,2,0,2
2018,20181110MiaGeo,10,2018-11-10,Miami (FL),Away,Georgia Tech,L (21-27),14,23,60.9,165,0,30,134,4.5,3,53,299,5.6,6,7,0,13,7,49,3,0,3
2018,20181117MiaVir,11,2018-11-17,Miami (FL),Away,Virginia Tech,W (38-14),21,34,61.8,171,2,32,168,5.3,2,66,339,5.1,7,8,2,17,11,71,0,0,0
2018,20181124MiaPit,12,2018-11-24,Miami (FL),Home,Pittsburgh,W (24-3),6,24,25.0,52,0,32,293,9.2,2,56,345,6.2,4,6,2,12,3,30,2,0,2
2018,201891MiaMar,1,2018-09-01,Miami (OH),Home,Marshall,L (28-35),25,46,54.3,357,3,27,87,3.2,1,73,444,6.1,16,5,2,23,8,71,0,0,0
2018,201898MiaCin,2,2018-09-08,Miami (OH),Home,Cincinnati,L (0-21),22,41,53.7,139,0,19,59,3.1,0,60,198,3.3,9,1,1,11,4,45,0,1,1
2018,2018915MiaMin,3,2018-09-15,Miami (OH),Away,Minnesota,L (3-26),11,23,47.8,108,0,31,91,2.9,0,54,199,3.7,5,3,2,10,6,55,2,1,3
2018,2018922MiaBow,4,2018-09-22,Miami (OH),Away,Bowling Green State,W (38-23),10,15,66.7,119,2,52,289,5.6,3,67,408,6.1,6,10,1,17,8,85,0,0,0
2018,2018929MiaWes,5,2018-09-29,Miami (OH),Home,Western Michigan,L (39-40),22,32,68.8,294,3,27,55,2.0,1,59,349,5.9,11,6,3,20,8,45,0,0,0
2018,2018106MiaAkr,6,2018-10-06,Miami (OH),Away,Akron,W (41-17),24,33,72.7,214,1,38,208,5.5,3,71,422,5.9,10,9,0,19,6,60,1,1,2
2018,20181013MiaKen,7,2018-10-13,Miami (OH),Home,Kent State,W (31-6),16,25,64.0,209,1,51,295,5.8,3,76,504,6.6,9,13,3,25,6,40,1,0,1
2018,20181020MiaArm,8,2018-10-20,Miami (OH),Away,Army,L (30-31),30,53,56.6,329,4,27,77,2.9,0,80,406,5.1,17,6,0,23,8,56,0,0,0
2018,20181030MiaBuf,9,2018-10-30,Miami (OH),Away,Buffalo,L (42-51),20,35,57.1,313,1,41,140,3.4,5,76,453,6.0,12,9,2,23,13,139,1,0,1
2018,2018117MiaOhi,10,2018-11-07,Miami (OH),Home,Ohio,W (30-28),20,32,62.5,199,1,34,160,4.7,3,66,359,5.4,11,8,0,19,6,45,0,0,0
2018,20181114MiaNor,11,2018-11-14,Miami (OH),Away,Northern Illinois,W (13-7),15,24,62.5,107,0,41,94,2.3,0,65,201,3.1,9,4,3,16,2,15,0,0,0
2018,20181120MiaBal,12,2018-11-20,Miami (OH),Home,Ball State,W (42-21),11,17,64.7,159,1,53,364,6.9,5,70,523,7.5,8,12,2,22,3,40,0,1,1
2018,201891MicNot,1,2018-09-01,Michigan,Away,Notre Dame,L (17-24),24,36,66.7,249,0,33,58,1.8,1,69,307,4.4,14,4,2,20,7,52,1,1,2
2018,201898MicWes,2,2018-09-08,Michigan,Home,Western Michigan,W (49-3),13,18,72.2,143,4,35,308,8.8,3,53,451,8.5,7,12,1,20,7,55,0,0,0
2018,2018915MicSou,3,2018-09-15,Michigan,Home,Southern Methodist,W (45-20),14,18,77.8,237,3,41,197,4.8,2,59,434,7.4,8,10,3,21,13,137,0,1,1
2018,2018922MicNeb,4,2018-09-22,Michigan,Home,Nebraska,W (56-10),18,31,58.1,206,2,45,285,6.3,4,76,491,6.5,9,12,1,22,8,77,0,1,1
2018,2018929MicNor,5,2018-09-29,Michigan,Away,Northwestern,W (20-17),15,24,62.5,196,0,42,180,4.3,2,66,376,5.7,7,10,1,18,11,100,0,0,0
2018,2018106MicMar,6,2018-10-06,Michigan,Home,Maryland,W (42-21),20,28,71.4,294,3,40,171,4.3,1,68,465,6.8,11,11,2,24,6,52,0,1,1
2018,20181013MicWis,7,2018-10-13,Michigan,Home,Wisconsin,W (38-13),14,21,66.7,124,0,48,320,6.7,3,69,444,6.4,5,14,2,21,1,15,0,0,0
2018,20181020MicMic,8,2018-10-20,Michigan,Away,Michigan State,W (21-7),14,25,56.0,212,2,53,183,3.5,1,78,395,5.1,8,11,0,19,9,99,2,0,2
2018,2018113MicPen,9,2018-11-03,Michigan,Home,Penn State,W (42-7),11,17,64.7,144,2,52,259,5.0,3,69,403,5.8,6,14,0,20,9,80,0,0,0
2018,20181110MicRut,10,2018-11-10,Michigan,Away,Rutgers,W (42-7),18,27,66.7,260,3,40,193,4.8,3,67,453,6.8,14,10,0,24,2,20,0,0,0
2018,20181117MicInd,11,2018-11-17,Michigan,Home,Indiana,W (31-20),16,28,57.1,250,1,50,257,5.1,1,78,507,6.5,10,13,2,25,4,45,0,1,1
2018,20181124MicOhi,12,2018-11-24,Michigan,Away,Ohio State,L (39-62),23,38,60.5,240,3,40,161,4.0,2,78,401,5.1,12,10,6,28,7,72,0,2,2
2018,2018831MicUta,1,2018-08-31,Michigan State,Home,Utah State,W (38-31),23,33,69.7,287,2,42,165,3.9,2,75,452,6.0,11,9,3,23,9,62,1,1,2
2018,201898MicAri,2,2018-09-08,Michigan State,Away,Arizona State,L (13-16),27,39,69.2,314,1,27,63,2.3,0,66,377,5.7,17,5,1,23,9,82,0,1,1
2018,2018922MicInd,3,2018-09-22,Michigan State,Away,Indiana,W (35-21),15,26,57.7,219,2,40,131,3.3,2,66,350,5.3,11,6,2,19,8,72,2,2,4
2018,2018929MicCen,4,2018-09-29,Michigan State,Home,Central Michigan,W (31-20),16,25,64.0,185,0,47,160,3.4,4,72,345,4.8,9,11,3,23,5,55,0,1,1
2018,2018106MicNor,5,2018-10-06,Michigan State,Home,Northwestern,L (19-29),31,51,60.8,329,1,24,96,4.0,1,75,425,5.7,17,4,1,22,5,49,0,1,1
2018,20181013MicPen,6,2018-10-13,Michigan State,Away,Penn State,W (21-17),25,53,47.2,295,2,36,123,3.4,1,89,418,4.7,17,5,3,25,3,20,0,1,1
2018,20181020MicMic,7,2018-10-20,Michigan State,Home,Michigan,L (7-21),7,28,25.0,79,1,23,15,0.7,0,51,94,1.8,4,2,5,11,4,40,1,0,1
2018,20181027MicPur,8,2018-10-27,Michigan State,Home,Purdue,W (23-13),26,46,56.5,318,2,40,108,2.7,0,86,426,5.0,18,8,0,26,6,61,1,0,1
2018,2018113MicMar,9,2018-11-03,Michigan State,Away,Maryland,W (24-3),11,22,50.0,87,0,46,269,5.8,3,68,356,5.2,5,13,1,19,4,33,0,2,2
2018,20181110MicOhi,10,2018-11-10,Michigan State,Home,Ohio State,L (6-26),18,48,37.5,220,0,18,54,3.0,0,66,274,4.2,9,3,0,12,7,46,2,1,3
2018,20181117MicNeb,11,2018-11-17,Michigan State,Away,Nebraska,L (6-9),15,41,36.6,146,0,38,143,3.8,0,79,289,3.7,7,8,3,18,7,87,1,1,2
2018,20181124MicRut,12,2018-11-24,Michigan State,Home,Rutgers,W (14-10),19,44,43.2,173,1,38,137,3.6,1,82,310,3.8,12,8,3,23,6,69,0,2,2
2018,201891MidVan,1,2018-09-01,Middle Tennessee State,Away,Vanderbilt,L (7-35),24,36,66.7,178,1,36,116,3.2,0,72,294,4.1,8,10,3,21,6,40,1,1,2
2018,201898MidTen,2,2018-09-08,Middle Tennessee State,Home,Tennessee-Martin,W (61-37),23,32,71.9,396,5,32,79,2.5,2,64,475,7.4,14,5,1,20,6,68,1,0,1
2018,2018915MidGeo,3,2018-09-15,Middle Tennessee State,Away,Georgia,L (7-49),20,30,66.7,130,1,38,158,4.2,0,68,288,4.2,4,10,0,14,3,35,1,1,2
2018,2018929MidFlo,4,2018-09-29,Middle Tennessee State,Home,Florida Atlantic,W (25-24),27,40,67.5,259,1,36,137,3.8,2,76,396,5.2,14,8,0,22,3,29,1,1,2
2018,2018105MidMar,5,2018-10-05,Middle Tennessee State,Away,Marshall,W (34-24),25,40,62.5,317,2,35,103,2.9,2,75,420,5.6,13,8,4,25,11,127,1,0,1
2018,20181013MidFlo,6,2018-10-13,Middle Tennessee State,Away,Florida International,L (21-24),15,27,55.6,142,0,40,187,4.7,3,67,329,4.9,8,11,2,21,5,52,0,1,1
2018,20181020MidUNC,7,2018-10-20,Middle Tennessee State,Home,UNC Charlotte,W (21-13),14,20,70.0,111,3,32,33,1.0,0,52,144,2.8,6,3,0,9,2,20,1,1,2
2018,20181027MidOld,8,2018-10-27,Middle Tennessee State,Away,Old Dominion,W (51-17),25,33,75.8,280,2,38,208,5.5,3,71,488,6.9,12,9,5,26,5,38,0,1,1
2018,2018112MidWes,9,2018-11-02,Middle Tennessee State,Home,Western Kentucky,W (29-10),24,42,57.1,228,2,43,256,6.0,0,85,484,5.7,12,13,2,27,3,34,0,0,0
2018,20181110MidTex,10,2018-11-10,Middle Tennessee State,Away,Texas-El Paso,W (48-32),31,40,77.5,352,4,36,139,3.9,2,76,491,6.5,13,8,0,21,6,63,2,0,2
2018,20181117MidKen,11,2018-11-17,Middle Tennessee State,Away,Kentucky,L (23-34),30,33,90.9,293,3,38,99,2.6,0,71,392,5.5,14,8,2,24,6,57,1,1,2
2018,20181124MidAla,12,2018-11-24,Middle Tennessee State,Home,Alabama-Birmingham,W (27-3),22,29,75.9,261,2,35,133,3.8,1,64,394,6.2,10,7,2,19,4,45,0,0,0
2018,2018121MidAla,13,2018-12-01,Middle Tennessee State,Home,Alabama-Birmingham,L (25-27),29,45,64.4,362,2,24,94,3.9,0,69,456,6.6,13,4,1,18,3,15,0,2,2
2018,2018830MinNew,1,2018-08-30,Minnesota,Home,New Mexico State,W (48-10),17,34,50.0,227,2,46,300,6.5,3,80,527,6.6,9,14,0,23,9,92,1,0,1
2018,201898MinFre,2,2018-09-08,Minnesota,Home,Fresno State,W (21-14),16,26,61.5,175,0,45,132,2.9,2,71,307,4.3,12,7,1,20,3,30,1,0,1
2018,2018915MinMia,3,2018-09-15,Minnesota,Home,Miami (OH),W (26-3),14,26,53.8,177,3,44,118,2.7,0,70,295,4.2,8,12,2,22,5,52,1,1,2
2018,2018922MinMar,4,2018-09-22,Minnesota,Away,Maryland,L (13-42),14,32,43.8,169,1,40,94,2.4,0,72,263,3.7,9,8,6,23,1,15,1,2,3
2018,2018106MinIow,5,2018-10-06,Minnesota,Home,Iowa,L (31-48),18,36,50.0,234,3,31,86,2.8,1,67,320,4.8,9,8,3,20,2,10,0,4,4
2018,20181013MinOhi,6,2018-10-13,Minnesota,Away,Ohio State,L (14-30),13,23,56.5,218,0,33,178,5.4,2,56,396,7.1,10,7,2,19,4,60,1,2,3
2018,20181020MinNeb,7,2018-10-20,Minnesota,Away,Nebraska,L (28-53),20,36,55.6,349,1,36,125,3.5,3,72,474,6.6,16,5,1,22,8,80,0,1,1
2018,20181026MinInd,8,2018-10-26,Minnesota,Home,Indiana,W (38-31),17,24,70.8,302,3,40,180,4.5,2,64,482,7.5,12,8,2,22,3,20,3,1,4
2018,2018113MinIll,9,2018-11-03,Minnesota,Away,Illinois,L (31-55),15,28,53.6,260,2,42,178,4.2,2,70,438,6.3,7,10,3,20,2,15,2,0,2
2018,20181110MinPur,10,2018-11-10,Minnesota,Home,Purdue,W (41-10),11,20,55.0,150,2,41,265,6.5,2,61,415,6.8,6,11,5,22,5,50,0,1,1
2018,20181117MinNor,11,2018-11-17,Minnesota,Home,Northwestern,L (14-24),19,32,59.4,197,1,35,109,3.1,1,67,306,4.6,9,7,2,18,3,34,1,2,3
2018,20181124MinWis,12,2018-11-24,Minnesota,Away,Wisconsin,W (37-15),9,16,56.3,124,0,47,201,4.3,3,63,325,5.2,7,11,1,19,2,20,0,0,0
2018,201891MisSte,1,2018-09-01,Mississippi State,Home,Stephen F. Austin,W (63-6),15,34,44.1,398,5,37,220,5.9,4,71,618,8.7,12,12,1,25,7,80,0,0,0
2018,201898MisKan,2,2018-09-08,Mississippi State,Away,Kansas State,W (31-10),11,27,40.7,154,2,39,384,9.8,2,66,538,8.2,6,18,0,24,11,84,0,1,1
2018,2018915MisLou,3,2018-09-15,Mississippi State,Home,Louisiana,W (56-10),16,24,66.7,276,2,47,331,7.0,6,71,607,8.5,11,18,0,29,3,15,0,1,1
2018,2018922MisKen,4,2018-09-22,Mississippi State,Away,Kentucky,L (7-28),16,32,50.0,145,0,28,56,2.0,1,60,201,3.4,6,5,0,11,16,139,0,1,1
2018,2018929MisFlo,5,2018-09-29,Mississippi State,Home,Florida,L (6-13),11,26,42.3,98,0,32,104,3.3,0,58,202,3.5,6,7,2,15,2,15,0,0,0
2018,2018106MisAub,6,2018-10-06,Mississippi State,Home,Auburn,W (23-9),9,17,52.9,69,0,57,349,6.1,2,74,418,5.6,3,18,1,22,1,15,0,1,1
2018,20181020MisLou,7,2018-10-20,Mississippi State,Away,Louisiana State,L (3-19),8,24,33.3,59,0,37,201,5.4,0,61,260,4.3,3,9,3,15,5,45,0,4,4
2018,20181027MisTex,8,2018-10-27,Mississippi State,Home,Texas A&M,W (28-13),14,22,63.6,241,2,31,143,4.6,2,53,384,7.2,7,7,1,15,10,95,0,0,0
2018,2018113MisLou,9,2018-11-03,Mississippi State,Home,Louisiana Tech,W (45-3),17,29,58.6,243,4,36,289,8.0,2,65,532,8.2,11,13,2,26,3,25,0,0,0
2018,20181110MisAla,10,2018-11-10,Mississippi State,Away,Alabama,L (0-24),11,20,55.0,125,0,30,44,1.5,0,50,169,3.4,3,3,0,6,7,50,1,0,1
2018,20181117MisArk,11,2018-11-17,Mississippi State,Home,Arkansas,W (52-6),12,18,66.7,188,5,47,287,6.1,2,65,475,7.3,9,16,4,29,7,60,1,0,1
2018,20181122MisMis,12,2018-11-22,Mississippi State,Away,Mississippi,W (35-3),11,18,61.1,111,1,51,309,6.1,4,69,420,6.1,6,16,1,23,3,35,0,0,0
2018,201891MisTen,1,2018-09-01,Missouri,Home,Tennessee-Martin,W (51-14),23,34,67.6,394,4,44,164,3.7,2,78,558,7.2,13,8,5,26,4,45,0,0,0
2018,201898MisWyo,2,2018-09-08,Missouri,Home,Wyoming,W (40-13),33,45,73.3,398,4,46,203,4.4,1,91,601,6.6,23,10,0,33,8,79,1,0,1
2018,2018915MisPur,3,2018-09-15,Missouri,Away,Purdue,W (40-37),26,43,60.5,375,3,46,233,5.1,1,89,608,6.8,14,14,3,31,4,27,0,1,1
2018,2018922MisGeo,4,2018-09-22,Missouri,Home,Georgia,L (29-43),23,48,47.9,221,0,37,172,4.6,4,85,393,4.6,15,9,2,26,5,30,2,1,3
2018,2018106MisSou,5,2018-10-06,Missouri,Away,South Carolina,L (35-37),17,36,47.2,204,0,46,286,6.2,3,82,490,6.0,9,10,4,23,10,83,0,2,2
2018,20181013MisAla,6,2018-10-13,Missouri,Away,Alabama,L (10-39),13,26,50.0,142,1,35,70,2.0,0,61,212,3.5,6,5,2,13,5,53,1,2,3
2018,20181020MisMem,7,2018-10-20,Missouri,Home,Memphis,W (65-33),24,32,75.0,373,4,40,273,6.8,4,72,646,9.0,13,14,3,30,12,122,0,0,0
2018,20181027MisKen,8,2018-10-27,Missouri,Home,Kentucky,L (14-15),15,27,55.6,165,0,35,84,2.4,2,62,249,4.0,7,3,3,13,8,69,0,0,0
2018,2018113MisFlo,9,2018-11-03,Missouri,Away,Florida,W (38-17),24,32,75.0,250,3,42,221,5.3,2,74,471,6.4,12,10,0,22,11,84,0,0,0
2018,20181110MisVan,10,2018-11-10,Missouri,Home,Vanderbilt,W (33-28),22,33,66.7,253,2,49,253,5.2,2,82,506,6.2,12,17,1,30,2,15,0,2,2
2018,20181117MisTen,11,2018-11-17,Missouri,Away,Tennessee,W (50-17),21,30,70.0,257,2,49,227,4.6,3,79,484,6.1,14,12,3,29,10,79,1,0,1
2018,20181123MisArk,12,2018-11-23,Missouri,Home,Arkansas,W (38-0),17,27,63.0,227,2,42,181,4.3,2,69,408,5.9,8,8,1,17,5,49,1,0,1
2018,201891NavHaw,1,2018-09-01,Navy,Away,Hawaii,L (41-59),6,13,46.2,85,1,49,326,6.7,5,62,411,6.6,6,13,0,19,2,18,0,0,0
2018,201898NavMem,2,2018-09-08,Navy,Home,Memphis,W (22-21),4,6,66.7,52,0,73,264,3.6,3,79,316,4.0,3,16,1,20,1,10,1,0,1
2018,2018915NavLeh,3,2018-09-15,Navy,Home,Lehigh,W (51-21),6,14,42.9,145,0,62,484,7.8,6,76,629,8.3,4,21,1,26,8,63,1,1,2
2018,2018922NavSou,4,2018-09-22,Navy,Away,Southern Methodist,L (30-31),1,4,25.0,25,1,78,349,4.5,3,82,374,4.6,1,22,0,23,2,25,3,0,3
2018,2018106NavAir,5,2018-10-06,Navy,Away,Air Force,L (7-35),3,12,25.0,49,0,41,129,3.1,1,53,178,3.4,2,7,0,9,4,40,0,0,0
2018,20181013NavTem,6,2018-10-13,Navy,Home,Temple,L (17-24),3,11,27.3,14,0,53,270,5.1,2,64,284,4.4,1,14,3,18,6,40,1,0,1
2018,20181020NavHou,7,2018-10-20,Navy,Home,Houston,L (36-49),10,16,62.5,178,1,68,344,5.1,4,84,522,6.2,6,19,1,26,3,32,0,1,1
2018,20181027NavNot,8,2018-10-27,Navy,Neutral,Notre Dame,L (22-44),4,12,33.3,52,0,48,292,6.1,3,60,344,5.7,2,11,1,14,4,16,1,1,2
2018,2018113NavCin,9,2018-11-03,Navy,Away,Cincinnati,L (0-42),3,4,75.0,47,0,52,124,2.4,0,56,171,3.1,2,9,2,13,3,31,1,0,1
2018,20181110NavCen,10,2018-11-10,Navy,Away,Central Florida,L (24-35),0,2,0.0,0,0,62,375,6.0,3,64,375,5.9,0,19,1,20,4,30,1,0,1
2018,20181117NavTul,11,2018-11-17,Navy,Home,Tulsa,W (37-29),1,2,50.0,15,0,61,395,6.5,5,63,410,6.5,1,18,2,21,4,45,1,0,1
2018,20181124NavTul,12,2018-11-24,Navy,Away,Tulane,L (28-29),8,16,50.0,204,2,45,117,2.6,1,61,321,5.3,6,7,0,13,2,10,0,0,0
2018,201898NebCol,1,2018-09-08,Nebraska,Home,Colorado,L (28-33),19,29,65.5,236,1,54,329,6.1,3,83,565,6.8,9,13,3,25,11,95,2,1,3
2018,2018915NebTro,2,2018-09-15,Nebraska,Home,Troy,L (19-24),19,27,70.4,177,2,48,187,3.9,0,75,364,4.9,7,12,3,22,10,77,1,2,3
2018,2018922NebMic,3,2018-09-22,Nebraska,Away,Michigan,L (10-56),13,24,54.2,93,0,30,39,1.3,1,54,132,2.4,4,5,3,12,10,79,1,1,2
2018,2018929NebPur,4,2018-09-29,Nebraska,Home,Purdue,L (28-42),25,42,59.5,323,2,39,259,6.6,2,81,582,7.2,16,14,1,31,11,136,0,1,1
2018,2018106NebWis,5,2018-10-06,Nebraska,Away,Wisconsin,L (24-41),26,44,59.1,407,2,24,111,4.6,1,68,518,7.6,17,7,2,26,10,100,1,0,1
2018,20181013NebNor,6,2018-10-13,Nebraska,Away,Northwestern,L (31-34),25,35,71.4,251,1,47,231,4.9,3,82,482,5.9,9,15,0,24,9,89,1,2,3
2018,20181020NebMin,7,2018-10-20,Nebraska,Home,Minnesota,W (53-28),25,30,83.3,276,3,43,383,8.9,4,73,659,9.0,9,18,1,28,6,43,1,0,1
2018,20181027NebBet,8,2018-10-27,Nebraska,Home,Bethune-Cookman,W (45-9),17,31,54.8,242,2,33,226,6.8,3,64,468,7.3,11,12,0,23,5,35,0,2,2
2018,2018113NebOhi,9,2018-11-03,Nebraska,Away,Ohio State,L (31-36),22,33,66.7,266,1,49,184,3.8,3,82,450,5.5,14,11,2,27,5,44,1,0,1
2018,20181110NebIll,10,2018-11-10,Nebraska,Home,Illinois,W (54-35),24,34,70.6,290,3,34,316,9.3,4,68,606,8.9,12,9,1,22,7,72,1,1,2
2018,20181117NebMic,11,2018-11-17,Nebraska,Home,Michigan State,W (9-6),16,37,43.2,145,0,30,103,3.4,0,67,248,3.7,8,5,1,14,5,45,2,0,2
2018,20181123NebIow,12,2018-11-23,Nebraska,Away,Iowa,L (28-31),26,38,68.4,260,2,33,140,4.2,1,71,400,5.6,14,9,1,24,3,35,0,1,1
2018,2018831NevPor,1,2018-08-31,Nevada,Home,Portland State,W (72-19),18,28,64.3,420,4,35,216,6.2,4,63,636,10.1,12,12,1,25,9,106,0,1,1
2018,201898NevVan,2,2018-09-08,Nevada,Away,Vanderbilt,L (10-41),22,39,56.4,216,1,25,34,1.4,0,64,250,3.9,8,6,0,14,6,67,2,2,4
2018,2018915NevOre,3,2018-09-15,Nevada,Home,Oregon State,W (37-35),18,37,48.6,201,2,30,156,5.2,2,67,357,5.3,10,6,1,17,5,60,0,1,1
2018,2018922NevTol,4,2018-09-22,Nevada,Away,Toledo,L (44-63),29,50,58.0,320,1,35,262,7.5,5,85,582,6.8,14,11,2,27,10,70,1,1,2
2018,2018929NevAir,5,2018-09-29,Nevada,Away,Air Force,W (28-25),24,33,72.7,259,4,34,177,5.2,0,67,436,6.5,12,7,0,19,13,103,1,1,2
2018,2018106NevFre,6,2018-10-06,Nevada,Home,Fresno State,L (3-21),22,43,51.2,195,0,43,132,3.1,0,86,327,3.8,13,7,1,21,1,5,0,3,3
2018,20181013NevBoi,7,2018-10-13,Nevada,Home,Boise State,L (27-31),24,42,57.1,304,2,24,82,3.4,1,66,386,5.8,11,7,5,23,4,20,2,1,3
2018,20181020NevHaw,8,2018-10-20,Nevada,Away,Hawaii,W (40-22),23,31,74.2,261,1,36,220,6.1,4,67,481,7.2,11,12,2,25,5,55,3,0,3
2018,20181027NevSan,9,2018-10-27,Nevada,Home,San Diego State,W (28-24),23,43,53.5,235,2,23,62,2.7,1,66,297,4.5,10,3,1,14,5,75,0,0,0
2018,20181110NevCol,10,2018-11-10,Nevada,Home,Colorado State,W (49-10),28,36,77.8,404,4,35,235,6.7,3,71,639,9.0,20,8,1,29,6,61,1,1,2
2018,20181117NevSan,11,2018-11-17,Nevada,Away,San Jose State,W (21-12),19,32,59.4,314,1,47,149,3.2,2,79,463,5.9,13,10,1,24,3,15,1,1,2
2018,20181124NevNev,12,2018-11-24,Nevada,Away,Nevada-Las Vegas,L (29-34),27,45,60.0,295,2,27,169,6.3,1,72,464,6.4,13,6,0,19,4,50,0,3,3
2018,201891NevSou,1,2018-09-01,Nevada-Las Vegas,Away,Southern California,L (21-43),12,27,44.4,97,2,43,308,7.2,1,70,405,5.8,4,13,0,17,4,35,1,0,1
2018,201898NevTex,2,2018-09-08,Nevada-Las Vegas,Home,Texas-El Paso,W (52-24),6,14,42.9,119,3,56,414,7.4,4,70,533,7.6,5,21,3,29,3,29,0,0,0
2018,2018915NevPra,3,2018-09-15,Nevada-Las Vegas,Home,Prairie View A&M,W (46-17),11,21,52.4,130,1,64,318,5.0,5,85,448,5.3,8,18,2,28,4,29,2,1,3
2018,2018922NevArk,4,2018-09-22,Nevada-Las Vegas,Away,Arkansas State,L (20-27),5,21,23.8,23,0,49,310,6.3,3,70,333,4.8,2,11,2,15,6,40,1,3,4
2018,2018106NevNew,5,2018-10-06,Nevada-Las Vegas,Home,New Mexico,L (14-50),15,35,42.9,123,2,27,43,1.6,0,62,166,2.7,8,3,2,13,3,25,1,1,2
2018,20181013NevUta,6,2018-10-13,Nevada-Las Vegas,Away,Utah State,L (28-59),18,36,50.0,250,3,48,154,3.2,1,84,404,4.8,10,8,3,21,9,70,0,1,1
2018,20181019NevAir,7,2018-10-19,Nevada-Las Vegas,Home,Air Force,L (35-41),26,38,68.4,261,3,33,139,4.2,2,71,400,5.6,12,6,5,23,6,40,0,1,1
2018,20181027NevSan,8,2018-10-27,Nevada-Las Vegas,Away,San Jose State,L (37-50),28,50,56.0,387,4,37,167,4.5,1,87,554,6.4,14,9,2,25,4,35,0,3,3
2018,2018113NevFre,9,2018-11-03,Nevada-Las Vegas,Home,Fresno State,L (3-48),15,35,42.9,105,0,41,197,4.8,0,76,302,4.0,6,12,0,18,8,57,0,1,1
2018,20181110NevSan,10,2018-11-10,Nevada-Las Vegas,Away,San Diego State,W (27-24),16,24,66.7,237,1,43,199,4.6,2,67,436,6.5,9,9,1,19,5,51,1,1,2
2018,20181117NevHaw,11,2018-11-17,Nevada-Las Vegas,Away,Hawaii,L (28-35),10,24,41.7,87,2,53,221,4.2,2,77,308,4.0,4,12,0,16,8,97,0,0,0
2018,20181124NevNev,12,2018-11-24,Nevada-Las Vegas,Home,Nevada,W (34-29),15,23,65.2,183,3,50,226,4.5,2,73,409,5.6,7,13,2,22,5,40,1,0,1
2018,2018915NewCol,1,2018-09-15,New Hampshire,Away,Colorado,L (14-45),16,39,41.0,228,1,31,42,1.4,0,70,270,3.9,6,7,2,15,6,35,2,1,3
2018,201891NewInc,1,2018-09-01,New Mexico,Home,Incarnate Word,W (62-30),15,25,60.0,361,5,66,319,4.8,4,91,680,7.5,10,19,3,32,7,48,1,1,2
2018,201898NewWis,2,2018-09-08,New Mexico,Away,Wisconsin,L (14-45),14,24,58.3,134,2,30,77,2.6,0,54,211,3.9,8,5,1,14,1,10,1,2,3
2018,2018915NewNew,3,2018-09-15,New Mexico,Away,New Mexico State,W (42-25),12,19,63.2,127,0,62,198,3.2,5,81,325,4.0,6,14,2,22,15,133,1,1,2
2018,2018929NewLib,4,2018-09-29,New Mexico,Home,Liberty,L (43-52),21,41,51.2,369,4,37,211,5.7,2,78,580,7.4,13,10,1,24,6,57,0,4,4
2018,2018106NewNev,5,2018-10-06,New Mexico,Away,Nevada-Las Vegas,W (50-14),13,21,61.9,250,4,60,252,4.2,3,81,502,6.2,9,14,2,25,3,40,1,0,1
2018,20181013NewCol,6,2018-10-13,New Mexico,Away,Colorado State,L (18-20),12,20,60.0,165,2,35,134,3.8,0,55,299,5.4,7,7,1,15,5,45,1,0,1
2018,20181020NewFre,7,2018-10-20,New Mexico,Home,Fresno State,L (7-38),15,32,46.9,132,1,33,148,4.5,0,65,280,4.3,8,9,2,19,8,110,0,1,1
2018,20181027NewUta,8,2018-10-27,New Mexico,Away,Utah State,L (19-61),18,37,48.6,220,1,30,71,2.4,0,67,291,4.3,10,3,0,13,3,35,1,4,5
2018,2018113NewSan,9,2018-11-03,New Mexico,Home,San Diego State,L (23-31),9,20,45.0,41,2,37,101,2.7,0,57,142,2.5,3,7,1,11,2,30,0,1,1
2018,20181110NewAir,10,2018-11-10,New Mexico,Away,Air Force,L (24-42),13,18,72.2,186,0,36,119,3.3,2,54,305,5.6,5,9,0,14,0,0,1,1,2
2018,20181116NewBoi,11,2018-11-16,New Mexico,Home,Boise State,L (14-45),8,14,57.1,103,0,45,159,3.5,1,59,262,4.4,5,10,0,15,4,41,2,1,3
2018,20181124NewWyo,12,2018-11-24,New Mexico,Home,Wyoming,L (3-31),3,17,17.6,34,0,34,49,1.4,0,51,83,1.6,1,3,2,6,2,20,0,1,1
2018,2018825NewWyo,1,2018-08-25,New Mexico State,Home,Wyoming,L (7-29),18,33,54.5,144,1,16,-9,-0.6,0,49,135,2.8,5,2,0,7,12,57,0,0,0
2018,2018830NewMin,2,2018-08-30,New Mexico State,Away,Minnesota,L (10-48),29,58,50.0,233,1,20,38,1.9,0,78,271,3.5,10,4,5,19,5,50,0,1,1
2018,201898NewUta,3,2018-09-08,New Mexico State,Away,Utah State,L (13-60),20,37,54.1,171,1,45,109,2.4,0,82,280,3.4,8,11,1,20,6,66,2,3,5
2018,2018915NewNew,4,2018-09-15,New Mexico State,Home,New Mexico,L (25-42),22,40,55.0,249,1,36,119,3.3,1,76,368,4.8,10,6,6,22,15,114,0,5,5
2018,2018922NewTex,5,2018-09-22,New Mexico State,Away,Texas-El Paso,W (27-20),9,18,50.0,156,1,34,155,4.6,0,52,311,6.0,5,6,4,15,8,65,1,0,1
2018,2018106NewLib,6,2018-10-06,New Mexico State,Home,Liberty,W (49-41),34,51,66.7,402,4,28,173,6.2,3,79,575,7.3,18,6,1,25,8,77,0,0,0
2018,20181013NewLou,7,2018-10-13,New Mexico State,Away,Louisiana,L (38-66),25,44,56.8,284,1,25,122,4.9,3,69,406,5.9,15,7,4,26,2,30,1,1,2
2018,20181020NewGeo,8,2018-10-20,New Mexico State,Home,Georgia Southern,L (31-48),25,38,65.8,295,0,35,148,4.2,4,73,443,6.1,12,10,4,26,5,38,2,1,3
2018,20181027NewTex,9,2018-10-27,New Mexico State,Away,Texas State,L (20-27),29,59,49.2,275,0,33,153,4.6,1,92,428,4.7,14,5,3,22,6,63,0,2,2
2018,2018113NewAlc,10,2018-11-03,New Mexico State,Home,Alcorn State,W (52-42),32,44,72.7,396,4,29,133,4.6,2,73,529,7.2,14,10,0,24,2,15,1,0,1
2018,20181117NewBri,11,2018-11-17,New Mexico State,Away,Brigham Young,L (10-45),25,61,41.0,264,1,26,48,1.8,0,87,312,3.6,12,7,1,20,5,39,1,2,3
2018,20181124NewLib,12,2018-11-24,New Mexico State,Away,Liberty,L (21-28),29,54,53.7,313,1,27,83,3.1,0,81,396,4.9,16,4,0,20,2,20,1,1,2
2018,201891NorCal,1,2018-09-01,North Carolina,Away,California,L (17-24),15,35,42.9,137,1,38,164,4.3,1,73,301,4.1,5,10,1,16,13,124,0,4,4
2018,201898NorEas,2,2018-09-08,North Carolina,Away,East Carolina,L (19-41),25,44,56.8,234,0,25,161,6.4,1,69,395,5.7,9,8,2,19,7,65,0,0,0
2018,2018922NorPit,3,2018-09-22,North Carolina,Home,Pittsburgh,W (38-35),22,31,71.0,313,2,40,173,4.3,3,71,486,6.8,13,9,1,23,5,45,1,0,1
2018,2018927NorMia,4,2018-09-27,North Carolina,Away,Miami (FL),L (10-47),20,35,57.1,114,0,40,215,5.4,1,75,329,4.4,8,14,2,24,4,40,3,3,6
2018,20181013NorVir,5,2018-10-13,North Carolina,Home,Virginia Tech,L (19-22),22,35,62.9,287,1,38,235,6.2,0,73,522,7.2,12,6,3,21,7,35,2,0,2
2018,20181020NorSyr,6,2018-10-20,North Carolina,Away,Syracuse,L (37-40),34,54,63.0,321,2,41,179,4.4,1,95,500,5.3,14,10,0,24,5,34,1,1,2
2018,20181027NorVir,7,2018-10-27,North Carolina,Away,Virginia,L (21-31),22,38,57.9,271,2,22,66,3.0,1,60,337,5.6,11,3,0,14,4,19,1,0,1
2018,2018113NorGeo,8,2018-11-03,North Carolina,Home,Georgia Tech,L (28-38),18,31,58.1,208,1,36,166,4.6,1,67,374,5.6,10,9,0,19,1,10,0,3,3
2018,20181110NorDuk,9,2018-11-10,North Carolina,Away,Duke,L (35-42),27,43,62.8,221,1,37,315,8.5,4,80,536,6.7,11,14,0,25,10,115,0,0,0
2018,20181117NorWes,10,2018-11-17,North Carolina,Home,Western Carolina,W (49-26),20,28,71.4,358,3,50,296,5.9,4,78,654,8.4,14,14,2,30,7,85,1,2,3
2018,20181124NorNor,11,2018-11-24,North Carolina,Home,North Carolina State,L (28-34),19,40,47.5,276,1,35,153,4.4,2,75,429,5.7,10,8,1,19,3,40,0,1,1
2018,201891NorJam,1,2018-09-01,North Carolina State,Home,James Madison,W (24-13),29,43,67.4,309,2,29,83,2.9,1,72,392,5.4,18,6,1,25,5,50,1,0,1
2018,201898NorGeo,2,2018-09-08,North Carolina State,Home,Georgia State,W (41-7),32,39,82.1,426,2,31,117,3.8,3,70,543,7.8,19,3,2,24,6,52,0,1,1
2018,2018922NorMar,3,2018-09-22,North Carolina State,Away,Marshall,W (37-20),23,40,57.5,377,1,36,125,3.5,2,76,502,6.6,17,6,1,24,4,25,1,0,1
2018,2018929NorVir,4,2018-09-29,North Carolina State,Home,Virginia,W (35-21),22,32,68.8,257,3,39,176,4.5,1,71,433,6.1,12,10,3,25,7,80,0,0,0
2018,2018106NorBos,5,2018-10-06,North Carolina State,Home,Boston College,W (28-23),25,34,73.5,308,2,53,225,4.2,2,87,533,6.1,17,14,3,34,1,5,2,2,4
2018,20181020NorCle,6,2018-10-20,North Carolina State,Away,Clemson,L (7-41),22,35,62.9,193,0,32,104,3.3,1,67,297,4.4,5,7,4,16,6,49,1,2,3
2018,20181027NorSyr,7,2018-10-27,North Carolina State,Away,Syracuse,L (41-51),26,44,59.1,473,3,29,68,2.3,2,73,541,7.4,13,6,2,21,9,95,0,1,1
2018,2018113NorFlo,8,2018-11-03,North Carolina State,Home,Florida State,W (47-28),21,28,75.0,240,3,49,177,3.6,2,77,417,5.4,10,10,5,25,4,50,0,0,0
2018,2018118NorWak,9,2018-11-08,North Carolina State,Home,Wake Forest,L (23-27),35,53,66.0,374,1,27,47,1.7,1,80,421,5.3,18,3,2,23,6,55,0,1,1
2018,20181117NorLou,10,2018-11-17,North Carolina State,Away,Louisville,W (52-10),31,42,73.8,354,4,36,164,4.6,3,78,518,6.6,19,9,1,29,2,25,0,0,0
2018,20181124NorNor,11,2018-11-24,North Carolina State,Away,North Carolina,W (34-28),16,29,55.2,200,0,48,206,4.3,5,77,406,5.3,10,9,3,22,3,35,0,1,1
2018,2018121NorEas,12,2018-12-01,North Carolina State,Home,East Carolina,W (58-3),33,45,73.3,421,3,38,234,6.2,4,83,655,7.9,21,10,1,32,3,30,2,1,3
2018,201891NorSou,1,2018-09-01,North Texas,Home,Southern Methodist,W (46-23),41,51,80.4,461,3,43,68,1.6,0,94,529,5.6,27,5,2,34,5,40,0,0,0
2018,201898NorInc,2,2018-09-08,North Texas,Home,Incarnate Word,W (58-16),32,49,65.3,454,4,42,153,3.6,3,91,607,6.7,19,9,4,32,5,61,0,1,1
2018,2018915NorArk,3,2018-09-15,North Texas,Away,Arkansas,W (44-17),24,46,52.2,281,1,29,95,3.3,2,75,376,5.0,11,3,4,18,9,102,1,0,1
2018,2018922NorLib,4,2018-09-22,North Texas,Away,Liberty,W (47-7),16,27,59.3,185,2,47,346,7.4,5,74,531,7.2,10,15,0,25,4,45,0,0,0
2018,2018929NorLou,5,2018-09-29,North Texas,Home,Louisiana Tech,L (27-29),22,35,62.9,296,3,37,131,3.5,1,72,427,5.9,13,9,1,23,4,55,2,0,2
2018,2018106NorTex,6,2018-10-06,North Texas,Away,Texas-El Paso,W (27-24),23,34,67.6,294,2,35,134,3.8,1,69,428,6.2,12,8,1,21,3,40,0,0,0
2018,20181013NorSou,7,2018-10-13,North Texas,Home,Southern Mississippi,W (30-7),24,38,63.2,292,1,33,165,5.0,3,71,457,6.4,13,10,1,24,5,55,1,0,1
2018,20181020NorAla,8,2018-10-20,North Texas,Away,Alabama-Birmingham,L (21-29),29,40,72.5,336,3,23,64,2.8,0,63,400,6.3,16,3,5,24,4,50,1,0,1
2018,20181027NorRic,9,2018-10-27,North Texas,Home,Rice,W (41-17),18,35,51.4,333,2,24,164,6.8,3,59,497,8.4,13,9,5,27,2,16,2,0,2
2018,20181110NorOld,10,2018-11-10,North Texas,Away,Old Dominion,L (31-34),26,44,59.1,240,2,38,155,4.1,2,82,395,4.8,12,9,2,23,4,60,1,1,2
2018,20181115NorFlo,11,2018-11-15,North Texas,Home,Florida Atlantic,W (41-38),23,35,65.7,303,2,37,208,5.6,3,72,511,7.1,14,8,3,25,4,40,0,2,2
2018,20181124NorTex,12,2018-11-24,North Texas,Away,Texas-San Antonio,W (24-21),26,36,72.2,320,2,33,196,5.9,1,69,516,7.5,16,9,1,26,6,60,0,1,1
2018,201891NorTex,1,2018-09-01,Northern Arizona,Away,Texas-El Paso,W (30-10),19,26,73.1,211,2,35,109,3.1,2,61,320,5.2,9,4,1,14,7,70,0,1,1
2018,201891NorIow,1,2018-09-01,Northern Illinois,Away,Iowa,L (7-33),15,26,57.7,110,1,36,101,2.8,0,62,211,3.4,6,8,1,15,7,65,1,1,2
2018,201898NorUta,2,2018-09-08,Northern Illinois,Home,Utah,L (6-17),18,33,54.5,111,0,43,117,2.7,0,76,228,3.0,6,8,1,15,4,43,1,1,2
2018,2018915NorCen,3,2018-09-15,Northern Illinois,Home,Central Michigan,W (24-16),12,20,60.0,104,3,48,180,3.8,0,68,284,4.2,5,8,2,15,4,44,0,1,1
2018,2018922NorFlo,4,2018-09-22,Northern Illinois,Away,Florida State,L (19-37),20,41,48.8,215,2,20,6,0.3,1,61,221,3.6,9,3,1,13,3,15,0,0,0
2018,2018929NorEas,5,2018-09-29,Northern Illinois,Away,Eastern Michigan,W (26-23),20,35,57.1,121,1,62,235,3.8,2,97,356,3.7,5,17,2,24,8,68,1,2,3
2018,2018106NorBal,6,2018-10-06,Northern Illinois,Away,Ball State,W (24-16),18,29,62.1,143,1,43,227,5.3,2,72,370,5.1,10,13,0,23,6,38,0,1,1
2018,20181013NorOhi,7,2018-10-13,Northern Illinois,Home,Ohio,W (24-21),17,33,51.5,145,0,46,255,5.5,3,79,400,5.1,10,13,2,25,12,109,0,0,0
2018,20181027NorBri,8,2018-10-27,Northern Illinois,Away,Brigham Young,W (7-6),10,21,47.6,115,0,36,89,2.5,1,57,204,3.6,5,4,2,11,10,80,0,0,0
2018,2018111NorAkr,9,2018-11-01,Northern Illinois,Away,Akron,W (36-26),21,28,75.0,188,1,61,296,4.9,2,89,484,5.4,12,20,2,34,7,85,1,0,1
2018,2018117NorTol,10,2018-11-07,Northern Illinois,Home,Toledo,W (38-15),13,19,68.4,131,1,44,296,6.7,3,63,427,6.8,7,13,0,20,5,58,1,1,2
2018,20181114NorMia,11,2018-11-14,Northern Illinois,Home,Miami (OH),L (7-13),15,33,45.5,157,0,37,212,5.7,1,70,369,5.3,6,8,1,15,9,90,1,1,2
2018,20181120NorWes,12,2018-11-20,Northern Illinois,Away,Western Michigan,L (21-28),14,21,66.7,156,1,43,106,2.5,1,64,262,4.1,8,8,0,16,5,45,1,2,3
2018,20181130NorBuf,13,2018-11-30,Northern Illinois,Neutral,Buffalo,W (30-29),21,33,63.6,300,4,34,109,3.2,0,67,409,6.1,14,9,0,23,7,91,0,1,1
2018,2018830NorPur,1,2018-08-30,Northwestern,Away,Purdue,W (31-27),23,37,62.2,235,0,42,166,4.0,4,79,401,5.1,11,7,4,22,6,56,0,0,0
2018,201898NorDuk,2,2018-09-08,Northwestern,Home,Duke,L (7-21),31,56,55.4,282,0,32,99,3.1,1,88,381,4.3,16,5,3,24,2,20,0,2,2
2018,2018915NorAkr,3,2018-09-15,Northwestern,Home,Akron,L (34-39),37,58,63.8,405,3,36,86,2.4,2,94,491,5.2,19,7,4,30,3,35,1,2,3
2018,2018929NorMic,4,2018-09-29,Northwestern,Home,Michigan,L (17-20),16,29,55.2,174,0,34,28,0.8,2,63,202,3.2,7,5,3,15,2,25,0,0,0
2018,2018106NorMic,5,2018-10-06,Northwestern,Away,Michigan State,W (29-19),31,47,66.0,373,3,20,8,0.4,1,67,381,5.7,14,3,2,19,3,35,0,2,2
2018,20181013NorNeb,6,2018-10-13,Northwestern,Home,Nebraska,W (34-31),41,64,64.1,455,3,23,32,1.4,0,87,487,5.6,21,4,5,30,1,5,0,2,2
2018,20181020NorRut,7,2018-10-20,Northwestern,Away,Rutgers,W (18-15),17,34,50.0,150,0,47,128,2.7,2,81,278,3.4,8,8,4,20,6,49,1,0,1
2018,20181027NorWis,8,2018-10-27,Northwestern,Home,Wisconsin,W (31-17),17,30,56.7,167,1,49,182,3.7,3,79,349,4.4,8,9,2,19,3,20,0,3,3
2018,2018113NorNot,9,2018-11-03,Northwestern,Home,Notre Dame,L (21-31),16,29,55.2,141,1,40,108,2.7,2,69,249,3.6,10,5,1,16,0,0,0,0,0
2018,20181110NorIow,10,2018-11-10,Northwestern,Away,Iowa,W (14-10),15,30,50.0,122,1,46,184,4.0,1,76,306,4.0,6,12,1,19,5,40,0,2,2
2018,20181117NorMin,11,2018-11-17,Northwestern,Away,Minnesota,W (24-14),15,21,71.4,230,0,39,95,2.4,3,60,325,5.4,11,4,1,16,2,20,0,0,0
2018,20181124NorIll,12,2018-11-24,Northwestern,Home,Illinois,W (24-16),12,18,66.7,110,2,46,261,5.7,1,64,371,5.8,6,12,1,19,1,15,0,0,0
2018,2018121NorOhi,13,2018-12-01,Northwestern,Neutral,Ohio State,L (24-45),27,44,61.4,267,1,24,151,6.3,2,68,418,6.1,13,6,2,21,3,15,1,2,3
2018,2018830NorTex,1,2018-08-30,Northwestern State,Away,Texas A&M,L (7-59),18,35,51.4,230,1,13,21,1.6,0,48,251,5.2,5,2,6,13,11,93,0,0,0
2018,201891NotMic,1,2018-09-01,Notre Dame,Home,Michigan,W (24-17),12,22,54.5,170,1,47,132,2.8,2,69,302,4.4,7,10,4,21,4,40,0,1,1
2018,201898NotBal,2,2018-09-08,Notre Dame,Home,Ball State,W (24-16),17,31,54.8,297,0,39,121,3.1,3,70,418,6.0,13,7,0,20,2,20,0,3,3
2018,2018915NotVan,3,2018-09-15,Notre Dame,Home,Vanderbilt,W (22-17),16,26,61.5,135,1,48,245,5.1,1,74,380,5.1,7,14,3,24,6,63,0,0,0
2018,2018922NotWak,4,2018-09-22,Notre Dame,Away,Wake Forest,W (56-27),25,36,69.4,325,2,40,241,6.0,6,76,566,7.4,11,15,2,28,4,37,1,0,1
2018,2018929NotSta,5,2018-09-29,Notre Dame,Home,Stanford,W (38-17),24,33,72.7,278,4,55,272,4.9,1,88,550,6.3,16,12,1,29,6,67,0,0,0
2018,2018106NotVir,6,2018-10-06,Notre Dame,Away,Virginia Tech,W (45-23),25,35,71.4,271,2,32,167,5.2,3,67,438,6.5,12,6,1,19,5,19,0,1,1
2018,20181013NotPit,7,2018-10-13,Notre Dame,Home,Pittsburgh,W (19-14),26,32,81.3,264,2,38,80,2.1,0,70,344,4.9,12,8,3,23,4,35,0,2,2
2018,20181027NotNav,8,2018-10-27,Notre Dame,Neutral,Navy,W (44-22),27,33,81.8,330,2,43,254,5.9,4,76,584,7.7,14,13,1,28,3,40,1,1,2
2018,2018113NotNor,9,2018-11-03,Notre Dame,Away,Northwestern,W (31-21),22,34,64.7,343,2,40,121,3.0,2,74,464,6.3,18,7,0,25,8,58,1,0,1
2018,20181110NotFlo,10,2018-11-10,Notre Dame,Home,Florida State,W (42-13),12,25,48.0,130,3,50,365,7.3,2,75,495,6.6,8,15,1,24,8,74,0,2,2
2018,20181117NotSyr,11,2018-11-17,Notre Dame,Neutral,Syracuse,W (36-3),23,38,60.5,292,2,36,171,4.8,2,74,463,6.3,14,7,2,23,7,55,0,1,1
2018,20181124NotSou,12,2018-11-24,Notre Dame,Away,Southern California,W (24-17),22,39,56.4,352,2,31,121,3.9,1,70,473,6.8,16,6,1,23,3,38,0,1,1
2018,201891OhiHow,1,2018-09-01,Ohio,Home,Howard,W (38-32),19,33,57.6,277,2,39,148,3.8,2,72,425,5.9,11,10,1,22,5,50,0,0,0
2018,2018915OhiVir,2,2018-09-15,Ohio,Neutral,Virginia,L (31-45),16,31,51.6,246,2,30,118,3.9,2,61,364,6.0,9,4,0,13,5,35,2,0,2
2018,2018922OhiCin,3,2018-09-22,Ohio,Away,Cincinnati,L (30-34),12,27,44.4,178,1,45,234,5.2,2,72,412,5.7,7,10,8,25,8,85,1,1,2
2018,2018929OhiMas,4,2018-09-29,Ohio,Home,Massachusetts,W (58-42),23,32,71.9,270,3,44,394,9.0,4,76,664,8.7,15,16,3,34,4,45,0,1,1
2018,2018106OhiKen,5,2018-10-06,Ohio,Away,Kent State,W (27-26),18,20,90.0,284,1,38,130,3.4,3,58,414,7.1,13,8,4,25,6,61,3,1,4
2018,20181013OhiNor,6,2018-10-13,Ohio,Away,Northern Illinois,L (21-24),15,23,65.2,275,2,32,46,1.4,1,55,321,5.8,9,3,7,19,6,59,2,1,3
2018,20181020OhiBow,7,2018-10-20,Ohio,Home,Bowling Green State,W (49-14),9,13,69.2,205,4,50,392,7.8,3,63,597,9.5,8,24,0,32,4,29,1,0,1
2018,20181025OhiBal,8,2018-10-25,Ohio,Home,Ball State,W (52-14),12,22,54.5,143,1,57,411,7.2,6,79,554,7.0,7,21,2,30,3,20,0,1,1
2018,2018111OhiWes,9,2018-11-01,Ohio,Away,Western Michigan,W (59-14),13,19,68.4,164,3,41,256,6.2,4,60,420,7.0,10,13,1,24,8,75,0,0,0
2018,2018117OhiMia,10,2018-11-07,Ohio,Away,Miami (OH),L (28-30),16,28,57.1,163,2,32,201,6.3,1,60,364,6.1,8,7,1,16,3,43,1,0,1
2018,20181114OhiBuf,11,2018-11-14,Ohio,Home,Buffalo,W (52-17),17,27,63.0,209,3,56,437,7.8,4,83,646,7.8,8,23,1,32,4,55,0,1,1
2018,20181123OhiAkr,12,2018-11-23,Ohio,Home,Akron,W (49-28),5,14,35.7,87,0,51,381,7.5,6,65,468,7.2,4,20,1,25,8,95,0,1,1
2018,201891OhiOre,1,2018-09-01,Ohio State,Home,Oregon State,W (77-31),25,34,73.5,346,5,52,377,7.3,5,86,723,8.4,14,18,3,35,6,50,1,1,2
2018,201898OhiRut,2,2018-09-08,Ohio State,Home,Rutgers,W (52-3),30,33,90.9,354,5,40,225,5.6,2,73,579,7.9,15,12,5,32,11,120,0,0,0
2018,2018915OhiTex,3,2018-09-15,Ohio State,Neutral,Texas Christian,W (40-28),24,38,63.2,344,2,42,182,4.3,1,80,526,6.6,14,13,2,29,5,39,0,0,0
2018,2018922OhiTul,4,2018-09-22,Ohio State,Home,Tulane,W (49-6),31,38,81.6,419,5,38,151,4.0,2,76,570,7.5,22,8,2,32,10,89,0,0,0
2018,2018929OhiPen,5,2018-09-29,Ohio State,Away,Penn State,W (27-26),22,39,56.4,270,3,37,119,3.2,1,76,389,5.1,11,8,2,21,10,105,0,1,1
2018,2018106OhiInd,6,2018-10-06,Ohio State,Home,Indiana,W (49-26),33,44,75.0,455,6,48,154,3.2,1,92,609,6.6,19,13,1,33,9,82,1,2,3
2018,20181013OhiMin,7,2018-10-13,Ohio State,Home,Minnesota,W (30-14),33,44,75.0,412,3,32,92,2.9,0,76,504,6.6,20,6,3,29,5,36,0,0,0
2018,20181020OhiPur,8,2018-10-20,Ohio State,Away,Purdue,L (20-49),49,73,67.1,470,2,25,76,3.0,0,98,546,5.6,24,4,3,31,10,86,0,1,1
2018,2018113OhiNeb,9,2018-11-03,Ohio State,Home,Nebraska,W (36-31),18,32,56.3,252,2,40,229,5.7,3,72,481,6.7,10,11,2,23,6,46,2,1,3
2018,20181110OhiMic,10,2018-11-10,Ohio State,Away,Michigan State,W (26-6),24,39,61.5,227,1,45,120,2.7,1,84,347,4.1,12,8,1,21,4,30,1,0,1
2018,20181117OhiMar,11,2018-11-17,Ohio State,Away,Maryland,W (52-51),28,38,73.7,405,3,56,283,5.1,4,94,688,7.3,17,12,7,36,10,79,2,1,3
2018,20181124OhiMic,12,2018-11-24,Ohio State,Home,Michigan,W (62-39),19,30,63.3,318,5,37,249,6.7,2,67,567,8.5,14,10,4,28,12,150,1,0,1
2018,2018121OhiNor,13,2018-12-01,Ohio State,Neutral,Northwestern,W (45-24),34,41,82.9,499,5,46,108,2.3,1,87,607,7.0,25,6,0,31,9,90,1,1,2
2018,201891OklFlo,1,2018-09-01,Oklahoma,Home,Florida Atlantic,W (63-14),19,23,82.6,334,3,39,316,8.1,5,62,650,10.5,13,12,1,26,6,70,0,0,0
2018,201898OklUCL,2,2018-09-08,Oklahoma,Home,UCLA,W (49-21),19,35,54.3,306,3,35,179,5.1,4,70,485,6.9,14,9,4,27,6,40,0,1,1
2018,2018915OklIow,3,2018-09-15,Oklahoma,Away,Iowa State,W (37-27),21,29,72.4,348,3,39,171,4.4,1,68,519,7.6,13,10,1,24,5,60,1,0,1
2018,2018922OklArm,4,2018-09-22,Oklahoma,Home,Army,W (28-21),11,15,73.3,165,3,25,190,7.6,1,40,355,8.9,8,10,1,19,4,20,0,1,1
2018,2018929OklBay,5,2018-09-29,Oklahoma,Home,Baylor,W (66-33),17,23,73.9,432,6,31,175,5.6,3,54,607,11.2,12,8,2,22,7,80,0,0,0
2018,2018106OklTex,6,2018-10-06,Oklahoma,Neutral,Texas,L (45-48),20,27,74.1,310,4,31,222,7.2,2,58,532,9.2,12,9,0,21,7,73,2,1,3
2018,20181020OklTex,7,2018-10-20,Oklahoma,Away,Texas Christian,W (52-27),19,25,76.0,213,4,47,323,6.9,3,72,536,7.4,11,15,0,26,8,60,0,0,0
2018,20181027OklKan,8,2018-10-27,Oklahoma,Home,Kansas State,W (51-14),22,29,75.9,380,3,39,322,8.3,3,68,702,10.3,15,15,2,32,5,69,0,0,0
2018,2018113OklTex,9,2018-11-03,Oklahoma,Away,Texas Tech,W (51-46),20,35,57.1,360,3,44,323,7.3,4,79,683,8.6,15,16,1,32,10,113,0,2,2
2018,20181110OklOkl,10,2018-11-10,Oklahoma,Home,Oklahoma State,W (48-47),21,30,70.0,349,1,47,353,7.5,5,77,702,9.1,15,14,0,29,8,70,0,0,0
2018,20181117OklKan,11,2018-11-17,Oklahoma,Home,Kansas,W (55-40),21,32,65.6,272,2,38,296,7.8,5,70,568,8.1,15,14,2,31,2,25,1,1,2
2018,20181123OklWes,12,2018-11-23,Oklahoma,Away,West Virginia,W (59-56),20,27,74.1,364,3,35,308,8.8,2,62,672,10.8,14,11,0,25,6,60,1,1,2
2018,2018121OklTex,13,2018-12-01,Oklahoma,Neutral,Texas,W (39-27),25,34,73.5,379,3,40,129,3.2,1,74,508,6.9,16,8,5,29,5,60,1,0,1
2018,2018830OklMis,1,2018-08-30,Oklahoma State,Home,Missouri State,W (58-17),25,37,67.6,296,5,55,436,7.9,3,92,732,8.0,15,15,3,33,7,55,1,1,2
2018,201898OklSou,2,2018-09-08,Oklahoma State,Home,South Alabama,W (55-13),26,42,61.9,453,2,44,164,3.7,4,86,617,7.2,21,7,4,32,9,112,1,2,3
2018,2018915OklBoi,3,2018-09-15,Oklahoma State,Home,Boise State,W (44-21),16,27,59.3,246,1,38,176,4.6,3,65,422,6.5,9,10,0,19,4,25,0,0,0
2018,2018922OklTex,4,2018-09-22,Oklahoma State,Home,Texas Tech,L (17-41),18,38,47.4,258,1,24,128,5.3,1,62,386,6.2,12,6,0,18,8,73,1,1,2
2018,2018929OklKan,5,2018-09-29,Oklahoma State,Away,Kansas,W (48-28),15,20,75.0,312,4,46,256,5.6,2,66,568,8.6,10,14,1,25,8,92,0,1,1
2018,2018106OklIow,6,2018-10-06,Oklahoma State,Home,Iowa State,L (42-48),19,33,57.6,289,4,43,126,2.9,2,76,415,5.5,13,8,1,22,9,87,1,1,2
2018,20181013OklKan,7,2018-10-13,Oklahoma State,Away,Kansas State,L (12-31),17,35,48.6,184,0,28,127,4.5,1,63,311,4.9,8,6,1,15,7,70,0,2,2
2018,20181027OklTex,8,2018-10-27,Oklahoma State,Home,Texas,W (38-35),23,34,67.6,321,3,51,181,3.5,2,85,502,5.9,14,10,3,27,4,52,0,0,0
2018,2018113OklBay,9,2018-11-03,Oklahoma State,Away,Baylor,L (31-35),25,42,59.5,301,1,47,212,4.5,3,89,513,5.8,16,13,3,32,12,133,1,0,1
2018,20181110OklOkl,10,2018-11-10,Oklahoma State,Away,Oklahoma,L (47-48),34,53,64.2,501,3,33,139,4.2,4,86,640,7.4,27,9,3,39,5,31,1,0,1
2018,20181117OklWes,11,2018-11-17,Oklahoma State,Home,West Virginia,W (45-41),30,46,65.2,338,5,43,266,6.2,1,89,604,6.8,15,19,1,35,3,35,2,2,4
2018,20181124OklTex,12,2018-11-24,Oklahoma State,Away,Texas Christian,L (24-31),17,40,42.5,181,0,32,99,3.1,3,72,280,3.9,9,5,1,15,6,76,1,1,2
2018,201891OldLib,1,2018-09-01,Old Dominion,Away,Liberty,L (10-52),18,34,52.9,172,0,39,129,3.3,1,73,301,4.1,9,6,3,18,8,75,2,0,2
2018,201898OldFlo,2,2018-09-08,Old Dominion,Home,Florida International,L (20-28),19,37,51.4,303,2,27,93,3.4,0,64,396,6.2,11,4,1,16,3,35,0,0,0
2018,2018913OldUNC,3,2018-09-13,Old Dominion,Away,UNC Charlotte,L (25-28),16,28,57.1,215,1,28,123,4.4,3,56,338,6.0,9,5,2,16,3,28,0,2,2
2018,2018922OldVir,4,2018-09-22,Old Dominion,Home,Virginia Tech,W (49-35),30,50,60.0,495,4,34,137,4.0,3,84,632,7.5,19,7,4,30,2,10,0,0,0
2018,2018929OldEas,5,2018-09-29,Old Dominion,Away,East Carolina,L (35-37),21,36,58.3,250,2,35,21,0.6,2,71,271,3.8,10,3,5,18,5,50,0,1,1
2018,2018106OldFlo,6,2018-10-06,Old Dominion,Away,Florida Atlantic,L (33-52),39,51,76.5,390,2,36,118,3.3,3,87,508,5.8,22,8,4,34,3,25,0,2,2
2018,20181013OldMar,7,2018-10-13,Old Dominion,Home,Marshall,L (20-42),31,54,57.4,296,2,31,106,3.4,0,85,402,4.7,15,6,4,25,7,70,1,1,2
2018,20181020OldWes,8,2018-10-20,Old Dominion,Away,Western Kentucky,W (37-34),21,33,63.6,327,1,42,181,4.3,3,75,508,6.8,12,13,5,30,9,95,2,0,2
2018,20181027OldMid,9,2018-10-27,Old Dominion,Home,Middle Tennessee State,L (17-51),26,35,74.3,333,2,35,187,5.3,0,70,520,7.4,11,9,1,21,9,101,2,3,5
2018,20181110OldNor,10,2018-11-10,Old Dominion,Home,North Texas,W (34-31),21,43,48.8,301,2,34,58,1.7,2,77,359,4.7,12,4,3,19,5,45,0,1,1
2018,20181117OldVir,11,2018-11-17,Old Dominion,Home,Virginia Military Institute,W (77-14),18,25,72.0,170,2,58,339,5.8,7,83,509,6.1,10,20,2,32,4,27,0,0,0
2018,20181124OldRic,12,2018-11-24,Old Dominion,Away,Rice,L (13-27),33,54,61.1,312,1,26,77,3.0,0,80,389,4.9,16,4,1,21,4,34,1,2,3
2018,201891OleTex,1,2018-09-01,Ole Miss,Neutral,Texas Tech,W (47-27),22,32,68.8,336,2,28,210,7.5,2,60,546,9.1,12,7,3,22,7,49,1,0,1
2018,201898OleSou,2,2018-09-08,Ole Miss,Home,Southern Illinois,W (76-41),24,35,68.6,479,5,32,167,5.2,4,67,646,9.6,17,8,1,26,9,75,0,0,0
2018,2018915OleAla,3,2018-09-15,Ole Miss,Home,Alabama,L (7-62),7,22,31.8,133,1,37,115,3.1,0,59,248,4.2,3,5,1,9,8,67,1,2,3
2018,2018922OleKen,4,2018-09-22,Ole Miss,Home,Kent State,W (38-17),28,38,73.7,442,2,37,209,5.6,3,75,651,8.7,16,9,1,26,8,90,0,1,1
2018,2018929OleLou,5,2018-09-29,Ole Miss,Away,Louisiana State,L (16-45),19,38,50.0,178,0,31,150,4.8,1,69,328,4.8,8,9,1,18,17,167,0,1,1
2018,2018106OleLou,6,2018-10-06,Ole Miss,Home,Louisiana-Monroe,W (70-21),31,34,91.2,517,5,38,309,8.1,5,72,826,11.5,22,12,1,35,7,73,0,0,0
2018,20181013OleArk,7,2018-10-13,Ole Miss,Away,Arkansas,W (37-33),26,35,74.3,387,2,38,224,5.9,3,73,611,8.4,15,15,2,32,4,50,0,1,1
2018,20181020OleAub,8,2018-10-20,Ole Miss,Home,Auburn,L (16-31),27,47,57.4,324,1,39,123,3.2,0,86,447,5.2,14,11,2,27,6,35,0,0,0
2018,2018113OleSou,9,2018-11-03,Ole Miss,Home,South Carolina,L (44-48),31,48,64.6,379,0,50,237,4.7,5,98,616,6.3,18,14,2,34,4,35,1,0,1
2018,20181110OleTex,10,2018-11-10,Ole Miss,Away,Texas A&M,L (24-38),22,35,62.9,373,1,30,67,2.2,1,65,440,6.8,13,4,2,19,5,48,1,0,1
2018,20181117OleVan,11,2018-11-17,Ole Miss,Away,Vanderbilt,L (29-36),32,52,61.5,457,2,30,121,4.0,0,82,578,7.0,18,7,3,28,10,89,0,2,2
2018,20181122OleMis,12,2018-11-22,Ole Miss,Home,Mississippi State,L (3-35),13,25,52.0,152,0,28,47,1.7,0,53,199,3.8,7,4,2,13,3,24,1,2,3
2018,201891OreBow,1,2018-09-01,Oregon,Home,Bowling Green State,W (58-24),11,26,42.3,292,5,42,212,5.0,2,68,504,7.4,8,11,4,23,3,35,1,2,3
2018,201898OrePor,2,2018-09-08,Oregon,Home,Portland State,W (62-14),23,29,79.3,266,4,47,296,6.3,5,76,562,7.4,14,17,1,32,5,55,0,0,0
2018,2018915OreSan,3,2018-09-15,Oregon,Home,San Jose State,W (35-22),16,36,44.4,309,3,49,134,2.7,2,85,443,5.2,12,7,1,20,6,59,0,2,2
2018,2018922OreSta,4,2018-09-22,Oregon,Home,Stanford,L (31-38),26,33,78.8,346,1,49,178,3.6,3,82,524,6.4,15,10,2,27,4,32,1,1,2
2018,2018929OreCal,5,2018-09-29,Oregon,Away,California,W (42-24),16,22,72.7,225,2,42,260,6.2,2,64,485,7.6,9,11,1,21,7,72,1,0,1
2018,20181013OreWas,6,2018-10-13,Oregon,Home,Washington,W (30-27),18,32,56.3,202,2,49,177,3.6,2,81,379,4.7,11,11,2,24,7,70,1,0,1
2018,20181020OreWas,7,2018-10-20,Oregon,Away,Washington State,L (20-34),25,44,56.8,270,1,23,65,2.8,1,67,335,5.0,13,5,3,21,6,44,0,0,0
2018,20181027OreAri,8,2018-10-27,Oregon,Away,Arizona,L (15-44),24,48,50.0,186,2,23,84,3.7,0,71,270,3.8,12,4,2,18,6,53,2,1,3
2018,2018113OreUCL,9,2018-11-03,Oregon,Home,UCLA,W (42-21),19,33,57.6,292,2,42,200,4.8,3,75,492,6.6,11,8,1,20,1,15,0,0,0
2018,20181110OreUta,10,2018-11-10,Oregon,Away,Utah,L (25-32),20,33,60.6,288,3,32,117,3.7,0,65,405,6.2,11,5,1,17,7,63,1,0,1
2018,20181117OreAri,11,2018-11-17,Oregon,Home,Arizona State,W (31-29),19,34,55.9,262,2,39,199,5.1,2,73,461,6.3,10,10,1,21,6,55,2,2,4
2018,20181123OreOre,12,2018-11-23,Oregon,Away,Oregon State,W (55-15),10,14,71.4,118,1,62,392,6.3,6,76,510,6.7,6,19,1,26,0,0,0,0,0
2018,201891OreOhi,1,2018-09-01,Oregon State,Away,Ohio State,L (31-77),14,24,58.3,196,2,39,196,5.0,2,63,392,6.2,7,6,2,15,5,49,2,0,2
2018,201898OreSou,2,2018-09-08,Oregon State,Home,Southern Utah,W (48-25),19,31,61.3,289,1,45,360,8.0,5,76,649,8.5,13,14,0,27,5,70,1,0,1
2018,2018915OreNev,3,2018-09-15,Oregon State,Away,Nevada,L (35-37),35,56,62.5,459,2,40,81,2.0,3,96,540,5.6,17,9,2,28,7,60,1,2,3
2018,2018922OreAri,4,2018-09-22,Oregon State,Home,Arizona,L (14-35),18,26,69.2,141,2,44,97,2.2,0,70,238,3.4,7,9,2,18,5,50,0,0,0
2018,2018929OreAri,5,2018-09-29,Oregon State,Away,Arizona State,L (24-52),14,24,58.3,145,1,53,261,4.9,2,77,406,5.3,7,17,0,24,5,50,1,0,1
2018,2018106OreWas,6,2018-10-06,Oregon State,Home,Washington State,L (37-56),18,26,69.2,221,0,50,276,5.5,5,76,497,6.5,10,11,1,22,11,104,1,0,1
2018,20181020OreCal,7,2018-10-20,Oregon State,Home,California,L (7-49),17,33,51.5,146,0,41,95,2.3,1,74,241,3.3,7,8,3,18,5,43,0,2,2
2018,20181027OreCol,8,2018-10-27,Oregon State,Away,Colorado,W (41-34),34,54,63.0,345,3,45,114,2.5,2,99,459,4.6,20,5,3,28,7,62,0,1,1
2018,2018113OreSou,9,2018-11-03,Oregon State,Home,Southern California,L (21-38),31,46,67.4,301,1,32,31,1.0,2,78,332,4.3,17,5,2,24,4,28,0,0,0
2018,20181110OreSta,10,2018-11-10,Oregon State,Away,Stanford,L (17-48),17,35,48.6,236,2,33,168,5.1,0,68,404,5.9,8,9,1,18,6,34,0,1,1
2018,20181117OreWas,11,2018-11-17,Oregon State,Away,Washington,L (23-42),21,36,58.3,229,1,35,134,3.8,1,71,363,5.1,12,8,0,20,3,25,2,0,2
2018,20181123OreOre,12,2018-11-23,Oregon State,Home,Oregon,L (15-55),21,39,53.8,282,2,28,54,1.9,0,67,336,5.0,13,5,3,21,0,0,1,3,4
2018,201891PenApp,1,2018-09-01,Penn State,Home,Appalachian State,W (45-38),21,36,58.3,230,1,43,204,4.7,5,79,434,5.5,11,10,3,24,2,10,0,0,0
2018,201898PenPit,2,2018-09-08,Penn State,Away,Pittsburgh,W (51-6),15,31,48.4,179,3,33,211,6.4,3,64,390,6.1,8,10,5,23,4,45,2,0,2
2018,2018915PenKen,3,2018-09-15,Penn State,Home,Kent State,W (63-10),14,25,56.0,346,3,45,297,6.6,6,70,643,9.2,9,14,3,26,9,85,0,1,1
2018,2018921PenIll,4,2018-09-21,Penn State,Away,Illinois,W (63-24),13,20,65.0,204,3,51,387,7.6,6,71,591,8.3,7,20,4,31,8,72,1,1,2
2018,2018929PenOhi,5,2018-09-29,Penn State,Home,Ohio State,L (26-27),16,32,50.0,286,2,44,206,4.7,1,76,492,6.5,9,9,4,22,7,64,1,0,1
2018,20181013PenMic,6,2018-10-13,Penn State,Home,Michigan State,L (17-21),19,32,59.4,192,1,32,205,6.4,1,64,397,6.2,9,5,0,14,6,41,1,0,1
2018,20181020PenInd,7,2018-10-20,Penn State,Away,Indiana,W (33-28),20,37,54.1,243,1,36,174,4.8,3,73,417,5.7,12,8,0,20,3,40,1,1,2
2018,20181027PenIow,8,2018-10-27,Penn State,Home,Iowa,W (30-24),13,29,44.8,194,1,35,118,3.4,2,64,312,4.9,10,6,0,16,6,47,1,1,2
2018,2018113PenMic,9,2018-11-03,Penn State,Away,Michigan,L (7-42),8,17,47.1,118,0,30,68,2.3,1,47,186,4.0,5,5,1,11,4,35,1,2,3
2018,20181110PenWis,10,2018-11-10,Penn State,Home,Wisconsin,W (22-10),19,25,76.0,160,1,47,183,3.9,1,72,343,4.8,8,13,2,23,3,22,2,0,2
2018,20181117PenRut,11,2018-11-17,Penn State,Away,Rutgers,W (20-7),17,37,45.9,183,2,39,139,3.6,0,76,322,4.2,8,9,2,19,3,43,1,1,2
2018,20181124PenMar,12,2018-11-24,Penn State,Home,Maryland,W (38-3),14,24,58.3,255,1,44,310,7.0,4,68,565,8.3,11,13,4,28,3,23,1,0,1
2018,201891PitAlb,1,2018-09-01,Pitt,Home,Albany,W (33-7),17,23,73.9,169,2,37,238,6.4,2,60,407,6.8,7,14,0,21,6,55,1,1,2
2018,201898PitPen,2,2018-09-08,Pitt,Home,Penn State,L (6-51),9,18,50.0,55,0,52,245,4.7,1,70,300,4.3,1,13,1,15,14,116,2,1,3
2018,2018915PitGeo,3,2018-09-15,Pitt,Home,Georgia Tech,W (24-19),16,23,69.6,197,0,31,138,4.5,3,54,335,6.2,8,6,2,16,4,38,0,1,1
2018,2018922PitNor,4,2018-09-22,Pitt,Away,North Carolina,L (35-38),19,33,57.6,174,2,36,228,6.3,3,69,402,5.8,8,12,0,20,5,45,1,0,1
2018,2018929PitCen,5,2018-09-29,Pitt,Away,Central Florida,L (14-45),16,26,61.5,163,1,33,109,3.3,0,59,272,4.6,6,8,2,16,11,125,0,1,1
2018,2018106PitSyr,6,2018-10-06,Pitt,Home,Syracuse,W (44-37),11,20,55.0,137,1,47,265,5.6,3,67,402,6.0,4,13,1,18,3,25,2,1,3
2018,20181013PitNot,7,2018-10-13,Pitt,Away,Notre Dame,L (14-19),19,30,63.3,126,0,30,116,3.9,1,60,242,4.0,6,6,2,14,8,80,0,0,0
2018,20181027PitDuk,8,2018-10-27,Pitt,Home,Duke,W (54-45),8,19,42.1,150,2,52,484,9.3,4,71,634,8.9,6,22,1,29,4,50,0,0,0
2018,2018112PitVir,9,2018-11-02,Pitt,Away,Virginia,W (23-13),7,14,50.0,61,0,42,254,6.0,3,56,315,5.6,1,12,3,15,7,72,0,0,0
2018,20181110PitVir,10,2018-11-10,Pitt,Home,Virginia Tech,W (52-22),7,11,63.6,162,1,36,492,13.7,6,47,654,13.9,4,13,0,17,5,65,1,0,1
2018,20181117PitWak,11,2018-11-17,Pitt,Away,Wake Forest,W (34-13),23,30,76.7,316,3,47,154,3.3,2,77,470,6.1,10,9,1,20,10,78,0,0,0
2018,20181124PitMia,12,2018-11-24,Pitt,Away,Miami (FL),L (3-24),15,24,62.5,131,0,38,69,1.8,0,62,200,3.2,5,4,2,11,10,100,1,0,1
2018,2018121PitCle,13,2018-12-01,Pitt,Neutral,Clemson,L (10-42),4,16,25.0,8,0,48,192,4.0,1,64,200,3.1,1,10,0,11,8,54,2,1,3
2018,2018825PraRic,1,2018-08-25,Prairie View A&M,Away,Rice,L (28-31),16,29,55.2,244,3,27,140,5.2,1,56,384,6.9,10,6,2,18,6,60,1,0,1
2018,2018915PraNev,2,2018-09-15,Prairie View A&M,Away,Nevada-Las Vegas,L (17-46),11,38,28.9,238,2,32,99,3.1,0,70,337,4.8,9,6,0,15,7,75,3,0,3
2018,2018830PurNor,1,2018-08-30,Purdue,Home,Northwestern,L (27-31),30,46,65.2,270,1,25,202,8.1,2,71,472,6.6,13,8,2,23,9,95,0,3,3
2018,201898PurEas,2,2018-09-08,Purdue,Home,Eastern Michigan,L (19-20),14,24,58.3,135,1,42,341,8.1,1,66,476,7.2,6,13,0,19,7,85,2,0,2
2018,2018915PurMis,3,2018-09-15,Purdue,Home,Missouri,L (37-40),39,55,70.9,572,3,16,42,2.6,1,71,614,8.6,21,2,0,23,7,65,0,1,1
2018,2018922PurBos,4,2018-09-22,Purdue,Home,Boston College,W (30-13),21,28,75.0,296,3,41,76,1.9,1,69,372,5.4,10,6,1,17,2,25,2,0,2
2018,2018929PurNeb,5,2018-09-29,Purdue,Away,Nebraska,W (42-28),25,42,59.5,328,1,37,188,5.1,4,79,516,6.5,11,10,6,27,10,75,0,0,0
2018,20181013PurIll,6,2018-10-13,Purdue,Away,Illinois,W (46-7),26,37,70.3,384,4,44,227,5.2,2,81,611,7.5,14,11,4,29,5,45,0,1,1
2018,20181020PurOhi,7,2018-10-20,Purdue,Home,Ohio State,W (49-20),25,43,58.1,378,3,29,161,5.6,3,72,539,7.5,12,9,3,24,7,95,0,0,0
2018,20181027PurMic,8,2018-10-27,Purdue,Away,Michigan State,L (13-23),29,49,59.2,277,0,13,62,4.8,1,62,339,5.5,13,2,1,16,4,30,0,3,3
2018,2018113PurIow,9,2018-11-03,Purdue,Home,Iowa,W (38-36),23,32,71.9,333,4,31,101,3.3,1,63,434,6.9,9,10,2,21,6,60,0,2,2
2018,20181110PurMin,10,2018-11-10,Purdue,Away,Minnesota,L (10-41),21,32,65.6,145,1,30,88,2.9,0,62,233,3.8,7,6,1,14,7,81,1,0,1
2018,20181117PurWis,11,2018-11-17,Purdue,Home,Wisconsin,L (44-47),31,48,64.6,386,4,31,76,2.5,1,79,462,5.8,16,6,6,28,5,48,1,0,1
2018,20181124PurInd,12,2018-11-24,Purdue,Away,Indiana,W (28-21),27,35,77.1,310,3,34,130,3.8,1,69,440,6.4,14,9,3,26,6,73,0,1,1
2018,2018825RicPra,1,2018-08-25,Rice,Home,Prairie View A&M,W (31-28),12,24,50.0,87,0,50,310,6.2,3,74,397,5.4,4,16,2,22,7,54,0,0,0
2018,201891RicHou,2,2018-09-01,Rice,Home,Houston,L (27-45),24,41,58.5,292,3,43,147,3.4,0,84,439,5.2,14,5,3,22,6,57,0,1,1
2018,201898RicHaw,3,2018-09-08,Rice,Away,Hawaii,L (29-43),20,33,60.6,299,2,39,147,3.8,1,72,446,6.2,11,8,2,21,5,54,1,1,2
2018,2018922RicSou,4,2018-09-22,Rice,Away,Southern Mississippi,L (22-40),13,26,50.0,125,2,29,137,4.7,1,55,262,4.8,7,5,0,12,3,30,0,2,2
2018,2018929RicWak,5,2018-09-29,Rice,Away,Wake Forest,L (24-56),17,32,53.1,103,2,44,267,6.1,1,76,370,4.9,9,9,1,19,6,55,1,2,3
2018,2018106RicTex,6,2018-10-06,Rice,Home,Texas-San Antonio,L (3-20),16,30,53.3,175,0,37,47,1.3,0,67,222,3.3,8,2,1,11,4,20,2,2,4
2018,20181013RicAla,7,2018-10-13,Rice,Home,Alabama-Birmingham,L (0-42),13,28,46.4,136,0,37,50,1.4,0,65,186,2.9,7,1,1,9,5,42,1,0,1
2018,20181020RicFlo,8,2018-10-20,Rice,Away,Florida International,L (17-36),12,21,57.1,115,0,29,125,4.3,2,50,240,4.8,6,10,0,16,0,0,0,3,3
2018,20181027RicNor,9,2018-10-27,Rice,Away,North Texas,L (17-41),21,37,56.8,204,1,37,95,2.6,1,74,299,4.0,12,6,0,18,8,99,1,0,1
2018,2018113RicTex,10,2018-11-03,Rice,Home,Texas-El Paso,L (26-34),17,32,53.1,313,2,28,70,2.5,1,60,383,6.4,10,4,2,16,7,45,1,2,3
2018,20181110RicLou,11,2018-11-10,Rice,Away,Louisiana Tech,L (13-28),19,35,54.3,226,1,29,100,3.4,0,64,326,5.1,8,7,0,15,1,3,0,3,3
2018,20181117RicLou,12,2018-11-17,Rice,Away,Louisiana State,L (10-42),7,15,46.7,101,0,43,97,2.3,1,58,198,3.4,6,8,1,15,3,22,0,0,0
2018,20181124RicOld,13,2018-11-24,Rice,Home,Old Dominion,W (27-13),6,14,42.9,96,0,45,275,6.1,4,59,371,6.3,4,10,0,14,3,32,0,0,0
2018,201891RicVir,1,2018-09-01,Richmond,Away,Virginia,L (13-42),12,29,41.4,191,0,19,34,1.8,0,48,225,4.7,8,1,0,9,5,69,0,2,2
2018,201891RutTex,1,2018-09-01,Rutgers,Home,Texas State,W (35-7),20,29,69.0,205,1,46,218,4.7,3,75,423,5.6,11,10,2,23,7,50,1,3,4
2018,201898RutOhi,2,2018-09-08,Rutgers,Away,Ohio State,L (3-52),11,30,36.7,65,0,31,69,2.2,0,61,134,2.2,4,4,4,12,7,72,0,2,2
2018,2018915RutKan,3,2018-09-15,Rutgers,Away,Kansas,L (14-55),14,31,45.2,124,0,33,150,4.5,1,64,274,4.3,6,7,1,14,5,60,3,3,6
2018,2018922RutBuf,4,2018-09-22,Rutgers,Home,Buffalo,L (13-42),18,37,48.6,168,0,38,116,3.1,1,75,284,3.8,7,6,1,14,9,97,0,0,0
2018,2018929RutInd,5,2018-09-29,Rutgers,Home,Indiana,L (17-24),19,36,52.8,193,1,23,98,4.3,1,59,291,4.9,10,6,3,19,6,63,0,1,1
2018,2018106RutIll,6,2018-10-06,Rutgers,Home,Illinois,L (17-38),29,46,63.0,267,1,30,119,4.0,1,76,386,5.1,14,8,3,25,10,105,0,3,3
2018,20181013RutMar,7,2018-10-13,Rutgers,Away,Maryland,L (7-34),2,17,11.8,8,0,45,171,3.8,1,62,179,2.9,0,11,3,14,4,23,0,5,5
2018,20181020RutNor,8,2018-10-20,Rutgers,Home,Northwestern,L (15-18),15,31,48.4,81,0,26,107,4.1,1,57,188,3.3,2,7,1,10,7,60,0,0,0
2018,2018113RutWis,9,2018-11-03,Rutgers,Away,Wisconsin,L (17-31),20,39,51.3,261,1,26,72,2.8,1,65,333,5.1,10,2,1,13,4,50,0,0,0
2018,20181110RutMic,10,2018-11-10,Rutgers,Home,Michigan,L (7-42),9,20,45.0,59,0,33,193,5.8,1,53,252,4.8,3,7,1,11,3,30,1,1,2
2018,20181117RutPen,11,2018-11-17,Rutgers,Home,Penn State,L (7-20),5,16,31.3,46,0,55,188,3.4,1,71,234,3.3,1,13,3,17,5,62,1,2,3
2018,20181124RutMic,12,2018-11-24,Rutgers,Away,Michigan State,L (10-14),9,18,50.0,109,1,35,108,3.1,0,53,217,4.1,4,5,1,10,8,76,1,2,3
2018,201898SamFlo,1,2018-09-08,Samford,Away,Florida State,L (26-36),39,60,65.0,475,2,19,50,2.6,1,79,525,6.6,18,2,3,23,5,51,1,4,5
2018,2018831SanSta,1,2018-08-31,San Diego State,Away,Stanford,L (10-31),10,15,66.7,113,0,37,150,4.1,1,52,263,5.1,5,6,0,11,11,125,1,0,1
2018,201898SanSac,2,2018-09-08,San Diego State,Home,Sacramento State,W (28-14),17,28,60.7,271,0,45,158,3.5,3,73,429,5.9,15,8,2,25,8,53,0,2,2
2018,2018915SanAri,3,2018-09-15,San Diego State,Home,Arizona State,W (28-21),12,24,50.0,129,1,58,311,5.4,2,82,440,5.4,7,18,2,27,9,85,1,0,1
2018,2018922SanEas,4,2018-09-22,San Diego State,Home,Eastern Michigan,W (23-20),12,22,54.5,176,2,37,174,4.7,0,59,350,5.9,8,6,1,15,5,56,0,1,1
2018,2018106SanBoi,5,2018-10-06,San Diego State,Away,Boise State,W (19-13),8,15,53.3,113,0,44,154,3.5,2,59,267,4.5,4,4,1,9,8,55,2,0,2
2018,20181012SanAir,6,2018-10-12,San Diego State,Home,Air Force,W (21-17),9,25,36.0,213,1,34,84,2.5,1,59,297,5.0,8,5,0,13,8,55,0,1,1
2018,20181020SanSan,7,2018-10-20,San Diego State,Home,San Jose State,W (16-13),7,11,63.6,86,0,47,207,4.4,1,58,293,5.1,4,10,2,16,8,67,1,0,1
2018,20181027SanNev,8,2018-10-27,San Diego State,Away,Nevada,L (24-28),20,41,48.8,283,3,36,173,4.8,0,77,456,5.9,14,7,3,24,8,68,2,0,2
2018,2018113SanNew,9,2018-11-03,San Diego State,Away,New Mexico,W (31-23),17,25,68.0,240,1,40,161,4.0,3,65,401,6.2,10,6,1,17,9,80,3,0,3
2018,20181110SanNev,10,2018-11-10,San Diego State,Home,Nevada-Las Vegas,L (24-27),22,36,61.1,279,2,34,89,2.6,1,70,368,5.3,10,10,1,21,4,45,0,2,2
2018,20181117SanFre,11,2018-11-17,San Diego State,Away,Fresno State,L (14-23),8,21,38.1,218,2,27,64,2.4,0,48,282,5.9,5,2,1,8,6,41,0,0,0
2018,20181124SanHaw,12,2018-11-24,San Diego State,Home,Hawaii,L (30-31),12,23,52.2,178,2,44,224,5.1,2,67,402,6.0,7,13,1,21,5,38,0,0,0
2018,2018830SanCal,1,2018-08-30,San Jose State,Home,California-Davis,L (38-44),28,52,53.8,365,3,38,141,3.7,2,90,506,5.6,17,8,2,27,12,125,1,2,3
2018,201898SanWas,2,2018-09-08,San Jose State,Away,Washington State,L (0-31),14,28,50.0,100,0,23,9,0.4,0,51,109,2.1,5,2,1,8,9,56,0,1,1
2018,2018915SanOre,3,2018-09-15,San Jose State,Away,Oregon,L (22-35),20,41,48.8,267,1,28,29,1.0,1,69,296,4.3,12,1,3,16,3,25,0,2,2
2018,2018929SanHaw,4,2018-09-29,San Jose State,Home,Hawaii,L (41-44),28,49,57.1,451,3,37,39,1.1,2,86,490,5.7,17,5,2,24,10,75,0,0,0
2018,2018106SanCol,5,2018-10-06,San Jose State,Home,Colorado State,L (30-42),18,43,41.9,237,3,34,48,1.4,1,77,285,3.7,8,6,2,16,6,45,0,2,2
2018,20181013SanArm,6,2018-10-13,San Jose State,Neutral,Army,L (3-52),13,18,72.2,135,0,30,36,1.2,0,48,171,3.6,7,3,0,10,7,55,4,0,4
2018,20181020SanSan,7,2018-10-20,San Jose State,Away,San Diego State,L (13-16),27,37,73.0,233,0,34,62,1.8,1,71,295,4.2,13,3,2,18,6,52,0,1,1
2018,20181027SanNev,8,2018-10-27,San Jose State,Home,Nevada-Las Vegas,W (50-37),26,37,70.3,349,4,40,157,3.9,1,77,506,6.6,18,7,0,25,4,36,0,1,1
2018,2018113SanWyo,9,2018-11-03,San Jose State,Away,Wyoming,L (9-24),19,32,59.4,173,1,24,71,3.0,0,56,244,4.4,9,5,1,15,6,45,0,0,0
2018,20181110SanUta,10,2018-11-10,San Jose State,Away,Utah State,L (24-62),22,42,52.4,344,2,20,56,2.8,0,62,400,6.5,12,1,1,14,9,80,1,2,3
2018,20181117SanNev,11,2018-11-17,San Jose State,Home,Nevada,L (12-21),18,27,66.7,170,2,26,30,1.2,0,53,200,3.8,10,1,0,11,5,21,0,1,1
2018,20181124SanFre,12,2018-11-24,San Jose State,Away,Fresno State,L (13-31),25,43,58.1,307,2,22,60,2.7,0,65,367,5.6,12,2,2,16,5,40,0,1,1
2018,201891SMUNor,1,2018-09-01,SMU,Away,North Texas,L (23-46),12,24,50.0,252,2,19,4,0.2,1,43,256,6.0,7,2,0,9,4,40,0,1,1
2018,201897SMUTex,2,2018-09-07,SMU,Home,Texas Christian,L (12-42),18,39,46.2,111,0,33,131,4.0,1,72,242,3.4,3,9,1,13,8,68,1,0,1
2018,2018915SMUMic,3,2018-09-15,SMU,Away,Michigan,L (20-45),19,34,55.9,209,3,31,110,3.5,0,65,319,4.9,10,5,7,22,6,60,0,1,1
2018,2018922SMUNav,4,2018-09-22,SMU,Home,Navy,W (31-30),24,32,75.0,166,3,37,158,4.3,0,69,324,4.7,10,7,0,17,3,16,1,0,1
2018,2018929SMU,5,2018-09-29,SMU,Home,,W (63-27),24,37,64.9,409,4,50,244,4.9,5,87,653,7.5,13,15,2,30,7,71,1,1,2
2018,2018106SMUCen,6,2018-10-06,SMU,Away,Central Florida,L (20-48),24,42,57.1,237,2,39,83,2.1,0,81,320,4.0,12,5,4,21,2,15,1,0,1
2018,20181020SMUTul,7,2018-10-20,SMU,Away,Tulane,W (27-23),21,40,52.5,291,3,32,36,1.1,1,72,327,4.5,12,3,2,17,7,43,0,1,1
2018,20181027SMUCin,8,2018-10-27,SMU,Home,Cincinnati,L (20-26),22,43,51.2,328,2,24,23,1.0,0,67,351,5.2,11,0,2,13,7,72,0,1,1
2018,2018113SMUHou,9,2018-11-03,SMU,Home,Houston,W (45-31),28,44,63.6,318,4,40,196,4.9,2,84,514,6.1,16,9,0,25,2,19,0,0,0
2018,20181110SMUCon,10,2018-11-10,SMU,Away,Connecticut,W (62-50),20,30,66.7,279,2,38,316,8.3,6,68,595,8.8,12,9,3,24,6,83,0,0,0
2018,20181116SMUMem,11,2018-11-16,SMU,Home,Memphis,L (18-28),30,57,52.6,341,2,26,25,1.0,0,83,366,4.4,13,5,7,25,5,33,2,1,3
2018,20181124SMUTul,12,2018-11-24,SMU,Away,Tulsa,L (24-27),26,46,56.5,319,1,31,61,2.0,1,77,380,4.9,16,6,2,24,6,30,0,2,2
2018,201891SouLou,1,2018-09-01,South Alabama,Home,Louisiana Tech,L (26-30),11,23,47.8,91,1,43,217,5.0,3,66,308,4.7,4,10,1,15,7,82,2,2,4
2018,201898SouOkl,2,2018-09-08,South Alabama,Away,Oklahoma State,L (13-55),17,34,50.0,136,1,37,78,2.1,1,71,214,3.0,5,5,5,15,12,85,0,1,1
2018,2018915SouTex,3,2018-09-15,South Alabama,Home,Texas State,W (41-31),24,33,72.7,266,2,27,116,4.3,2,60,382,6.4,7,4,2,13,15,143,3,0,3
2018,2018922SouMem,4,2018-09-22,South Alabama,Away,Memphis,L (35-52),24,32,75.0,360,3,36,107,3.0,2,68,467,6.9,11,7,1,19,8,83,2,0,2
2018,2018929SouApp,5,2018-09-29,South Alabama,Away,Appalachian State,L (7-52),20,33,60.6,225,0,35,83,2.4,1,68,308,4.5,10,4,2,16,9,91,0,1,1
2018,2018106SouGeo,6,2018-10-06,South Alabama,Away,Georgia Southern,L (13-48),19,31,61.3,197,0,39,129,3.3,1,70,326,4.7,7,7,3,17,10,90,2,2,4
2018,20181013SouAla,7,2018-10-13,South Alabama,Home,Alabama State,W (45-7),13,17,76.5,211,2,44,185,4.2,3,61,396,6.5,7,13,1,21,7,75,0,0,0
2018,20181023SouTro,8,2018-10-23,South Alabama,Home,Troy,L (17-38),18,30,60.0,275,2,45,110,2.4,0,75,385,5.1,14,8,1,23,7,91,0,3,3
2018,2018113SouArk,9,2018-11-03,South Alabama,Away,Arkansas State,L (14-38),12,22,54.5,93,2,46,156,3.4,0,68,249,3.7,8,7,1,16,6,64,0,0,0
2018,20181110SouLou,10,2018-11-10,South Alabama,Home,Louisiana-Monroe,L (10-38),14,23,60.9,129,1,31,89,2.9,0,54,218,4.0,5,5,1,11,5,36,0,0,0
2018,20181117SouLou,11,2018-11-17,South Alabama,Away,Louisiana,L (38-48),18,28,64.3,254,2,57,223,3.9,3,85,477,5.6,10,13,4,27,9,61,2,1,3
2018,20181123SouCoa,12,2018-11-23,South Alabama,Home,Coastal Carolina,W (31-28),10,13,76.9,202,3,51,331,6.5,1,64,533,8.3,6,13,1,20,12,101,1,0,1
2018,201891SouCoa,1,2018-09-01,South Carolina,Home,Coastal Carolina,W (49-15),25,35,71.4,294,5,37,267,7.2,2,72,561,7.8,15,16,1,32,9,99,0,0,0
2018,201898SouGeo,2,2018-09-08,South Carolina,Home,Georgia,L (17-41),31,48,64.6,282,2,20,54,2.7,0,68,336,4.9,16,1,2,19,3,40,0,2,2
2018,2018922SouVan,3,2018-09-22,South Carolina,Away,Vanderbilt,W (37-14),19,28,67.9,261,1,48,273,5.7,3,76,534,7.0,14,12,2,28,8,54,2,1,3
2018,2018929SouKen,4,2018-09-29,South Carolina,Away,Kentucky,L (10-24),17,34,50.0,193,1,35,133,3.8,0,69,326,4.7,8,11,1,20,11,94,1,3,4
2018,2018106SouMis,5,2018-10-06,South Carolina,Home,Missouri,W (37-35),20,35,57.1,249,3,47,128,2.7,0,82,377,4.6,13,4,1,18,9,83,1,0,1
2018,20181013SouTex,6,2018-10-13,South Carolina,Home,Texas A&M,L (23-26),17,35,48.6,223,3,18,76,4.2,0,53,299,5.6,8,6,5,19,4,39,1,1,2
2018,20181027SouTen,7,2018-10-27,South Carolina,Home,Tennessee,W (27-24),11,16,68.8,152,1,40,224,5.6,2,56,376,6.7,6,12,1,19,2,9,0,1,1
2018,2018113SouMis,8,2018-11-03,South Carolina,Away,Mississippi,W (48-44),22,32,68.8,363,2,36,145,4.0,3,68,508,7.5,12,6,0,18,5,51,0,0,0
2018,20181110SouFlo,9,2018-11-10,South Carolina,Away,Florida,L (31-35),18,28,64.3,239,2,36,147,4.1,2,64,386,6.0,10,7,1,18,7,41,0,1,1
2018,20181117SouCha,10,2018-11-17,South Carolina,Home,Chattanooga,W (49-9),29,36,80.6,364,4,42,238,5.7,3,78,602,7.7,13,17,3,33,6,48,0,0,0
2018,20181124SouCle,11,2018-11-24,South Carolina,Away,Clemson,L (35-56),32,50,64.0,510,5,25,90,3.6,0,75,600,8.0,23,4,2,29,7,48,0,1,1
2018,2018121SouAkr,12,2018-12-01,South Carolina,Home,Akron,W (28-3),14,27,51.9,199,3,38,185,4.9,0,65,384,5.9,9,6,1,16,6,41,2,2,4
2018,201891SouElo,1,2018-09-01,South Florida,Home,Elon,W (34-14),29,46,63.0,367,3,38,148,3.9,1,84,515,6.1,17,10,0,27,7,55,0,0,0
2018,201898SouGeo,2,2018-09-08,South Florida,Home,Georgia Tech,W (49-38),21,31,67.7,202,2,44,224,5.1,3,75,426,5.7,13,13,3,29,5,36,0,1,1
2018,2018915SouIll,3,2018-09-15,South Florida,Neutral,Illinois,W (25-19),23,40,57.5,411,2,44,215,4.9,1,84,626,7.5,19,11,1,31,14,124,0,2,2
2018,2018922SouEas,4,2018-09-22,South Florida,Home,East Carolina,W (20-13),12,20,60.0,181,1,32,115,3.6,2,52,296,5.7,5,4,0,9,3,33,1,0,1
2018,2018106SouMas,5,2018-10-06,South Florida,Away,Massachusetts,W (58-42),17,24,70.8,209,1,41,365,8.9,5,65,574,8.8,8,9,1,18,11,100,1,1,2
2018,20181012SouTul,6,2018-10-12,South Florida,Away,Tulsa,W (25-24),17,40,42.5,237,0,47,250,5.3,3,87,487,5.6,11,12,3,26,8,70,0,1,1
2018,20181020SouCon,7,2018-10-20,South Florida,Home,Connecticut,W (38-30),20,28,71.4,265,1,37,346,9.4,4,65,611,9.4,8,16,0,24,9,90,1,2,3
2018,20181027SouHou,8,2018-10-27,South Florida,Away,Houston,L (36-57),26,39,66.7,263,1,42,204,4.9,3,81,467,5.8,14,13,2,29,8,85,1,1,2
2018,2018113SouTul,9,2018-11-03,South Florida,Home,Tulane,L (15-41),29,49,59.2,322,0,33,102,3.1,2,82,424,5.2,17,8,2,27,10,91,2,1,3
2018,20181110SouCin,10,2018-11-10,South Florida,Away,Cincinnati,L (23-35),14,32,43.8,232,3,29,81,2.8,0,61,313,5.1,8,4,0,12,8,80,0,0,0
2018,20181117SouTem,11,2018-11-17,South Florida,Away,Temple,L (17-27),14,23,60.9,82,0,48,184,3.8,2,71,266,3.7,3,10,2,15,7,55,3,2,5
2018,20181123SouCen,12,2018-11-23,South Florida,Home,Central Florida,L (10-38),15,29,51.7,113,1,46,221,4.8,0,75,334,4.5,5,11,1,17,4,34,0,1,1
2018,201891SouTex,1,2018-09-01,Southern,Away,Texas Christian,L (7-55),5,18,27.8,101,1,34,84,2.5,0,52,185,3.6,2,5,2,9,5,40,1,2,3
2018,201898SouLou,2,2018-09-08,Southern,Away,Louisiana Tech,L (17-54),18,25,72.0,216,1,40,70,1.8,1,65,286,4.4,9,7,1,17,6,68,1,0,1
2018,201898SouMis,1,2018-09-08,Southern Illinois,Away,Mississippi,L (41-76),30,48,62.5,388,4,45,241,5.4,1,93,629,6.8,15,11,3,29,8,48,1,2,3
2018,201891SouJac,1,2018-09-01,Southern Mississippi,Home,Jackson State,W (55-7),25,33,75.8,255,4,45,202,4.5,1,78,457,5.9,15,13,1,29,4,35,1,2,3
2018,201898SouLou,2,2018-09-08,Southern Mississippi,Home,Louisiana-Monroe,L (20-21),31,46,67.4,378,2,34,58,1.7,0,80,436,5.5,18,4,1,23,4,45,2,2,4
2018,2018922SouRic,3,2018-09-22,Southern Mississippi,Home,Rice,W (40-22),25,34,73.5,428,4,31,138,4.5,1,65,566,8.7,16,9,0,25,5,39,0,1,1
2018,2018929SouAub,4,2018-09-29,Southern Mississippi,Away,Auburn,L (13-24),30,44,68.2,215,1,21,45,2.1,0,65,260,4.0,11,2,2,15,7,46,1,2,3
2018,20181013SouNor,5,2018-10-13,Southern Mississippi,Away,North Texas,L (7-30),30,44,68.2,317,1,28,50,1.8,0,72,367,5.1,14,4,2,20,3,32,1,1,2
2018,20181020SouTex,6,2018-10-20,Southern Mississippi,Home,Texas-San Antonio,W (27-17),28,33,84.8,269,1,46,218,4.7,2,79,487,6.2,14,10,0,24,7,60,2,1,3
2018,20181027SouUNC,7,2018-10-27,Southern Mississippi,Away,UNC Charlotte,L (17-20),27,39,69.2,297,2,34,129,3.8,0,73,426,5.8,14,8,3,25,6,43,0,3,3
2018,2018113SouMar,8,2018-11-03,Southern Mississippi,Home,Marshall,W (26-24),16,25,64.0,134,1,45,88,2.0,1,70,222,3.2,4,4,5,13,10,90,2,0,2
2018,20181110SouAla,9,2018-11-10,Southern Mississippi,Away,Alabama-Birmingham,L (23-26),16,39,41.0,160,1,34,5,0.1,1,73,165,2.3,6,5,4,15,8,58,0,1,1
2018,20181117SouLou,10,2018-11-17,Southern Mississippi,Home,Louisiana Tech,W (21-20),26,31,83.9,226,1,33,54,1.6,2,64,280,4.4,14,3,2,19,4,38,1,0,1
2018,20181124SouTex,11,2018-11-24,Southern Mississippi,Away,Texas-El Paso,W (39-7),15,21,71.4,126,1,48,252,5.3,3,69,378,5.5,6,15,0,21,2,15,0,0,0
2018,2018831StaSan,1,2018-08-31,Stanford,Home,San Diego State,W (31-10),21,31,67.7,332,4,28,50,1.8,0,59,382,6.5,11,3,5,19,3,20,0,1,1
2018,201898StaSou,2,2018-09-08,Stanford,Home,Southern California,W (17-3),16,27,59.3,183,1,29,159,5.5,1,56,342,6.1,9,4,0,13,7,50,0,0,0
2018,2018915StaCal,3,2018-09-15,Stanford,Home,California-Davis,W (30-10),17,33,51.5,214,2,33,137,4.2,1,66,351,5.3,10,6,1,17,10,64,0,2,2
2018,2018922StaOre,4,2018-09-22,Stanford,Away,Oregon,W (38-31),19,26,73.1,327,3,24,71,3.0,1,50,398,8.0,13,3,1,17,5,23,0,0,0
2018,2018929StaNot,5,2018-09-29,Stanford,Away,Notre Dame,L (17-38),15,27,55.6,174,1,24,55,2.3,1,51,229,4.5,7,1,2,10,7,50,0,1,1
2018,2018106StaUta,6,2018-10-06,Stanford,Home,Utah,L (21-40),26,42,61.9,381,1,28,42,1.5,2,70,423,6.0,18,4,4,26,2,20,2,2,4
2018,20181018StaAri,7,2018-10-18,Stanford,Away,Arizona State,W (20-13),22,29,75.9,231,1,43,127,3.0,1,72,358,5.0,10,8,6,24,5,60,0,0,0
2018,20181027StaWas,8,2018-10-27,Stanford,Home,Washington State,L (38-41),34,43,79.1,323,4,23,120,5.2,1,66,443,6.7,16,6,5,27,3,18,1,0,1
2018,2018113StaWas,9,2018-11-03,Stanford,Away,Washington,L (23-27),29,44,65.9,347,2,23,77,3.3,1,67,424,6.3,15,3,4,22,4,28,0,3,3
2018,20181110StaOre,10,2018-11-10,Stanford,Home,Oregon State,W (48-17),25,38,65.8,352,4,30,244,8.1,3,68,596,8.8,11,11,2,24,8,70,0,1,1
2018,20181124StaUCL,11,2018-11-24,Stanford,Away,UCLA,W (49-42),23,37,62.2,344,5,30,126,4.2,1,67,470,7.0,16,5,3,24,7,64,0,1,1
2018,2018121StaCal,12,2018-12-01,Stanford,Away,California,W (23-13),18,29,62.1,237,1,35,92,2.6,1,64,329,5.1,10,5,1,16,5,40,1,0,1
2018,2018831SyrWes,1,2018-08-31,Syracuse,Away,Western Michigan,W (55-42),11,28,39.3,226,2,62,334,5.4,5,90,560,6.2,7,17,2,26,5,45,1,0,1
2018,201898SyrWag,2,2018-09-08,Syracuse,Home,Wagner,W (62-10),24,37,64.9,241,5,43,215,5.0,2,80,456,5.7,13,13,0,26,5,50,0,1,1
2018,2018915SyrFlo,3,2018-09-15,Syracuse,Home,Florida State,W (30-7),18,31,58.1,219,1,57,222,3.9,2,88,441,5.0,10,11,4,25,8,33,0,0,0
2018,2018922SyrCon,4,2018-09-22,Syracuse,Home,Connecticut,W (51-21),22,32,68.8,295,2,46,341,7.4,3,78,636,8.2,11,15,0,26,11,100,1,0,1
2018,2018929SyrCle,5,2018-09-29,Syracuse,Away,Clemson,L (23-27),26,41,63.4,250,0,26,61,2.3,2,67,311,4.6,8,4,0,12,5,31,0,1,1
2018,2018106SyrPit,6,2018-10-06,Syracuse,Away,Pittsburgh,L (37-44),18,38,47.4,195,1,40,189,4.7,3,78,384,4.9,9,10,1,20,5,24,1,2,3
2018,20181020SyrNor,7,2018-10-20,Syracuse,Home,North Carolina,W (40-37),28,52,53.8,406,3,33,140,4.2,2,85,546,6.4,15,8,2,25,6,53,1,1,2
2018,20181027SyrNor,8,2018-10-27,Syracuse,Home,North Carolina State,W (51-41),30,42,71.4,480,3,37,81,2.2,3,79,561,7.1,19,5,6,30,9,65,0,0,0
2018,2018113SyrWak,9,2018-11-03,Syracuse,Away,Wake Forest,W (41-24),23,35,65.7,157,0,60,264,4.4,5,95,421,4.4,7,15,3,25,9,77,0,0,0
2018,2018119SyrLou,10,2018-11-09,Syracuse,Home,Louisville,W (54-23),14,27,51.9,192,1,54,344,6.4,5,81,536,6.6,6,13,4,23,7,65,2,1,3
2018,20181117SyrNot,11,2018-11-17,Syracuse,Neutral,Notre Dame,L (3-36),15,35,42.9,115,0,38,119,3.1,0,73,234,3.2,6,9,1,16,3,45,0,3,3
2018,20181124SyrBos,12,2018-11-24,Syracuse,Away,Boston College,W (42-21),21,35,60.0,362,3,54,213,3.9,3,89,575,6.5,13,11,4,29,10,90,0,1,1
2018,2018830UCFCon,1,2018-08-30,UCF,Away,Connecticut,W (56-17),26,34,76.5,356,5,36,296,8.2,3,70,652,9.3,15,14,3,32,3,27,0,0,0
2018,201898UCFSou,2,2018-09-08,UCF,Home,South Carolina State,W (38-0),22,43,51.2,250,1,47,316,6.7,4,90,566,6.3,10,18,1,29,11,101,0,3,3
2018,2018921UCFFlo,3,2018-09-21,UCF,Home,Florida Atlantic,W (56-36),21,32,65.6,306,3,50,239,4.8,4,82,545,6.6,14,14,4,32,4,49,0,0,0
2018,2018929UCFPit,4,2018-09-29,UCF,Home,Pittsburgh,W (45-14),18,34,52.9,328,4,45,240,5.3,2,79,568,7.2,12,13,6,31,8,71,0,0,0
2018,2018106UCFSou,5,2018-10-06,UCF,Home,Southern Methodist,W (48-20),19,37,51.4,285,2,43,256,6.0,4,80,541,6.8,12,13,0,25,7,75,0,1,1
2018,20181013UCFMem,6,2018-10-13,UCF,Away,Memphis,W (31-30),17,29,58.6,296,1,37,165,4.5,3,66,461,7.0,11,6,1,18,12,103,1,0,1
2018,20181020UCFEas,7,2018-10-20,UCF,Away,East Carolina,W (37-10),13,21,61.9,111,1,55,316,5.7,2,76,427,5.6,6,14,2,22,14,120,0,0,0
2018,2018111UCFTem,8,2018-11-01,UCF,Home,Temple,W (52-40),17,33,51.5,312,3,43,318,7.4,4,76,630,8.3,11,18,6,35,8,50,0,1,1
2018,20181110UCFNav,9,2018-11-10,UCF,Home,Navy,W (35-24),17,21,81.0,200,2,51,300,5.9,3,72,500,6.9,12,16,0,28,3,25,1,0,1
2018,20181117UCFCin,10,2018-11-17,UCF,Home,Cincinnati,W (38-13),13,25,52.0,268,3,36,134,3.7,2,61,402,6.6,11,7,0,18,5,45,1,0,1
2018,20181123UCFSou,11,2018-11-23,UCF,Away,South Florida,W (38-10),10,24,41.7,167,1,58,399,6.9,4,82,566,6.9,9,17,1,27,5,34,0,1,1
2018,2018121UCFMem,12,2018-12-01,UCF,Home,Memphis,W (56-41),19,28,67.9,348,2,62,350,5.6,5,90,698,7.8,13,18,3,34,5,44,3,0,3
2018,201891UCLCin,1,2018-09-01,UCLA,Home,Cincinnati,L (17-26),23,37,62.2,162,0,31,144,4.6,2,68,306,4.5,10,4,1,15,6,26,0,1,1
2018,201898UCLOkl,2,2018-09-08,UCLA,Away,Oklahoma,L (21-49),16,26,61.5,254,1,50,129,2.6,2,76,383,5.0,11,9,0,20,6,77,0,0,0
2018,2018915UCLFre,3,2018-09-15,UCLA,Home,Fresno State,L (14-38),10,24,41.7,151,1,31,119,3.8,1,55,270,4.9,6,5,3,14,11,96,2,2,4
2018,2018928UCLCol,4,2018-09-28,UCLA,Away,Colorado,L (16-38),17,35,48.6,138,1,28,151,5.4,0,63,289,4.6,5,8,2,15,8,67,0,0,0
2018,2018106UCLWas,5,2018-10-06,UCLA,Home,Washington,L (24-31),27,38,71.1,272,2,27,150,5.6,1,65,422,6.5,12,8,0,20,4,45,0,1,1
2018,20181013UCLCal,6,2018-10-13,UCLA,Away,California,W (37-7),13,15,86.7,141,0,55,207,3.8,3,70,348,5.0,6,12,2,20,4,30,0,0,0
2018,20181020UCLAri,7,2018-10-20,UCLA,Home,Arizona,W (31-30),22,35,62.9,307,3,47,153,3.3,1,82,460,5.6,14,6,3,23,12,103,1,0,1
2018,20181026UCLUta,8,2018-10-26,UCLA,Home,Utah,L (10-41),20,40,50.0,164,0,26,127,4.9,1,66,291,4.4,7,9,1,17,5,40,1,2,3
2018,2018113UCLOre,9,2018-11-03,UCLA,Away,Oregon,L (21-42),23,49,46.9,297,2,38,199,5.2,1,87,496,5.7,14,15,0,29,11,64,2,1,3
2018,20181110UCLAri,10,2018-11-10,UCLA,Away,Arizona State,L (28-31),26,35,74.3,335,2,29,104,3.6,1,64,439,6.9,17,4,3,24,7,58,0,1,1
2018,20181117UCLSou,11,2018-11-17,UCLA,Home,Southern California,W (34-27),13,22,59.1,166,1,51,318,6.2,3,73,484,6.6,10,12,3,25,2,15,0,1,1
2018,20181124UCLSta,12,2018-11-24,UCLA,Home,Stanford,L (42-49),29,47,61.7,466,0,37,62,1.7,4,84,528,6.3,22,6,3,31,6,63,1,1,2
2018,201891USCNev,1,2018-09-01,USC,Home,Nevada-Las Vegas,W (43-21),22,35,62.9,282,1,38,219,5.8,3,73,501,6.9,11,10,2,23,6,58,0,0,0
2018,201898USCSta,2,2018-09-08,USC,Away,Stanford,L (3-17),17,36,47.2,218,0,37,114,3.1,0,73,332,4.5,9,11,0,20,4,35,0,2,2
2018,2018915USCTex,3,2018-09-15,USC,Away,Texas,L (14-37),30,48,62.5,322,0,16,-5,-0.3,2,64,317,5.0,13,2,1,16,10,99,0,1,1
2018,2018921USCWas,4,2018-09-21,USC,Home,Washington State,W (39-36),17,26,65.4,241,3,31,113,3.6,2,57,354,6.2,10,6,7,23,8,65,0,0,0
2018,2018929USCAri,5,2018-09-29,USC,Away,Arizona,W (24-20),16,24,66.7,197,0,47,253,5.4,3,71,450,6.3,7,9,2,18,18,169,3,0,3
2018,20181013USCCol,6,2018-10-13,USC,Home,Colorado,W (31-20),17,34,50.0,272,3,27,62,2.3,0,61,334,5.5,8,6,2,16,13,123,1,2,3
2018,20181020USCUta,7,2018-10-20,USC,Away,Utah,L (28-41),12,23,52.2,132,2,31,73,2.4,1,54,205,3.8,5,3,2,10,2,20,0,2,2
2018,20181027USCAri,8,2018-10-27,USC,Home,Arizona State,L (35-38),21,30,70.0,271,3,33,149,4.5,1,63,420,6.7,11,6,2,19,7,73,1,0,1
2018,2018113USCOre,9,2018-11-03,USC,Away,Oregon State,W (38-21),14,26,53.8,177,1,44,332,7.5,4,70,509,7.3,11,12,2,25,6,52,1,0,1
2018,20181110USCCal,10,2018-11-10,USC,Home,California,L (14-15),21,34,61.8,180,2,38,97,2.6,0,72,277,3.8,11,6,1,18,5,55,1,1,2
2018,20181117USCUCL,11,2018-11-17,USC,Away,UCLA,L (27-34),20,34,58.8,337,2,27,112,4.1,0,61,449,7.4,12,6,1,19,9,63,0,2,2
2018,20181124USCNot,12,2018-11-24,USC,Home,Notre Dame,L (17-24),37,51,72.5,349,1,24,94,3.9,1,75,443,5.9,16,7,1,24,8,71,2,0,2
2018,2018830UtaWeb,1,2018-08-30,Utah,Home,Weber State,W (41-10),26,41,63.4,293,4,36,294,8.2,1,77,587,7.6,12,11,2,25,4,20,3,1,4
2018,201898UtaNor,2,2018-09-08,Utah,Away,Northern Illinois,W (17-6),20,31,64.5,286,0,39,68,1.7,1,70,354,5.1,13,4,2,19,6,60,2,0,2
2018,2018915UtaWas,3,2018-09-15,Utah,Home,Washington,L (7-21),20,39,51.3,138,0,29,123,4.2,1,68,261,3.8,6,7,0,13,6,55,2,1,3
2018,2018929UtaWas,4,2018-09-29,Utah,Away,Washington State,L (24-28),12,21,57.1,118,0,50,204,4.1,3,71,322,4.5,4,11,5,20,9,76,0,0,0
2018,2018106UtaSta,5,2018-10-06,Utah,Away,Stanford,W (40-21),17,21,81.0,199,1,43,222,5.2,2,64,421,6.6,8,12,2,22,7,65,0,0,0
2018,20181012UtaAri,6,2018-10-12,Utah,Home,Arizona,W (42-10),16,22,72.7,265,3,46,230,5.0,3,68,495,7.3,8,12,3,23,9,94,0,1,1
2018,20181020UtaSou,7,2018-10-20,Utah,Home,Southern California,W (41-28),22,30,73.3,341,4,51,200,3.9,1,81,541,6.7,12,15,0,27,7,69,2,0,2
2018,20181026UtaUCL,8,2018-10-26,Utah,Away,UCLA,W (41-10),14,22,63.6,145,1,50,325,6.5,4,72,470,6.5,9,17,0,26,5,45,0,1,1
2018,2018113UtaAri,9,2018-11-03,Utah,Away,Arizona State,L (20-38),11,26,42.3,147,1,32,178,5.6,1,58,325,5.6,6,9,2,17,3,28,0,3,3
2018,20181110UtaOre,10,2018-11-10,Utah,Home,Oregon,W (32-25),18,31,58.1,262,0,46,244,5.3,2,77,506,6.6,12,10,2,24,3,25,0,0,0
2018,20181117UtaCol,11,2018-11-17,Utah,Away,Colorado,W (30-7),11,23,47.8,221,2,47,169,3.6,1,70,390,5.6,8,11,0,19,5,64,0,0,0
2018,20181124UtaBri,12,2018-11-24,Utah,Home,Brigham Young,W (35-27),19,28,67.9,141,1,37,155,4.2,3,65,296,4.6,6,11,1,18,1,10,1,0,1
2018,20181130UtaWas,13,2018-11-30,Utah,Neutral,Washington,L (3-10),17,27,63.0,137,0,25,51,2.0,0,52,188,3.6,9,2,1,12,2,10,0,3,3
2018,2018831UtaMic,1,2018-08-31,Utah State,Away,Michigan State,L (31-38),29,44,65.9,319,0,25,25,1.0,3,69,344,5.0,18,2,2,22,7,49,0,2,2
2018,201898UtaNew,2,2018-09-08,Utah State,Home,New Mexico State,W (60-13),17,31,54.8,172,1,46,274,6.0,3,77,446,5.8,8,11,3,22,10,91,1,1,2
2018,2018913UtaTen,3,2018-09-13,Utah State,Home,Tennessee Tech,W (73-12),30,35,85.7,291,2,42,330,7.9,7,77,621,8.1,14,15,2,31,6,60,2,0,2
2018,2018922UtaAir,4,2018-09-22,Utah State,Home,Air Force,W (42-32),26,38,68.4,356,2,24,133,5.5,4,62,489,7.9,19,3,0,22,5,35,2,0,2
2018,2018105UtaBri,5,2018-10-05,Utah State,Away,Brigham Young,W (45-20),18,28,64.3,165,4,42,223,5.3,1,70,388,5.5,8,10,1,19,12,125,0,0,0
2018,20181013UtaNev,6,2018-10-13,Utah State,Home,Nevada-Las Vegas,W (59-28),22,31,71.0,377,5,38,221,5.8,2,69,598,8.7,14,9,1,24,5,55,1,0,1
2018,20181020UtaWyo,7,2018-10-20,Utah State,Away,Wyoming,W (24-16),12,28,42.9,53,0,33,141,4.3,2,61,194,3.2,1,8,2,11,6,52,0,1,1
2018,20181027UtaNew,8,2018-10-27,Utah State,Home,New Mexico,W (61-19),30,42,71.4,516,4,49,188,3.8,2,91,704,7.7,19,11,0,30,6,43,3,0,3
2018,2018113UtaHaw,9,2018-11-03,Utah State,Away,Hawaii,W (56-17),19,24,79.2,175,1,54,426,7.9,7,78,601,7.7,11,17,1,29,12,105,1,0,1
2018,20181110UtaSan,10,2018-11-10,Utah State,Home,San Jose State,W (62-24),35,50,70.0,510,5,39,296,7.6,3,89,806,9.1,19,11,3,33,10,82,0,0,0
2018,20181117UtaCol,11,2018-11-17,Utah State,Away,Colorado State,W (29-24),15,24,62.5,169,1,28,141,5.0,0,52,310,6.0,7,9,0,16,7,71,1,0,1
2018,20181124UtaBoi,12,2018-11-24,Utah State,Away,Boise State,L (24-33),29,47,61.7,363,3,19,62,3.3,0,66,425,6.4,12,5,1,18,8,72,1,1,2
2018,201891UTENor,1,2018-09-01,UTEP,Home,Northern Arizona,L (10-30),15,31,48.4,127,0,36,102,2.8,1,67,229,3.4,6,6,3,15,10,76,1,2,3
2018,201898UTENev,2,2018-09-08,UTEP,Away,Nevada-Las Vegas,L (24-52),11,29,37.9,123,0,37,265,7.2,3,66,388,5.9,6,13,0,19,8,67,2,1,3
2018,2018915UTETen,3,2018-09-15,UTEP,Away,Tennessee,L (0-24),9,23,39.1,39,0,28,95,3.4,0,51,134,2.6,2,4,1,7,6,42,0,0,0
2018,2018922UTENew,4,2018-09-22,UTEP,Home,New Mexico State,L (20-27),10,16,62.5,194,1,64,235,3.7,1,80,429,5.4,8,14,2,24,10,73,2,1,3
2018,2018929UTETex,5,2018-09-29,UTEP,Away,Texas-San Antonio,L (21-30),11,19,57.9,143,1,44,154,3.5,2,63,297,4.7,6,8,1,15,5,41,1,1,2
2018,2018106UTENor,6,2018-10-06,UTEP,Home,North Texas,L (24-27),16,33,48.5,313,2,28,104,3.7,1,61,417,6.8,10,7,2,19,4,26,0,2,2
2018,20181020UTELou,7,2018-10-20,UTEP,Away,Louisiana Tech,L (24-31),19,33,57.6,284,1,37,72,1.9,2,70,356,5.1,13,3,2,18,6,60,0,1,1
2018,20181027UTEAla,8,2018-10-27,UTEP,Home,Alabama-Birmingham,L (0-19),12,20,60.0,101,0,28,19,0.7,0,48,120,2.5,4,3,3,10,6,60,0,0,0
2018,2018113UTERic,9,2018-11-03,UTEP,Away,Rice,W (34-26),14,24,58.3,210,0,45,200,4.4,5,69,410,5.9,10,10,0,20,3,13,1,1,2
2018,20181110UTEMid,10,2018-11-10,UTEP,Home,Middle Tennessee State,L (32-48),18,39,46.2,218,2,29,115,4.0,2,68,333,4.9,9,5,2,16,1,15,1,2,3
2018,20181117UTEWes,11,2018-11-17,UTEP,Away,Western Kentucky,L (16-40),15,34,44.1,342,2,20,50,2.5,0,54,392,7.3,9,2,0,11,3,30,0,5,5
2018,20181124UTESou,12,2018-11-24,UTEP,Home,Southern Mississippi,L (7-39),11,23,47.8,114,1,31,73,2.4,0,54,187,3.5,7,4,1,12,2,15,1,3,4
2018,201891UTSAri,1,2018-09-01,UTSA,Away,Arizona State,L (7-49),19,43,44.2,218,0,33,3,0.1,1,76,221,2.9,11,5,2,18,5,29,2,1,3
2018,201898UTSBay,2,2018-09-08,UTSA,Home,Baylor,L (20-37),18,33,54.5,157,1,26,98,3.8,1,59,255,4.3,11,5,0,16,6,30,0,1,1
2018,2018915UTSKan,3,2018-09-15,UTSA,Away,Kansas State,L (17-41),19,34,55.9,157,2,39,143,3.7,0,73,300,4.1,8,8,1,17,7,41,1,0,1
2018,2018922UTSTex,4,2018-09-22,UTSA,Home,Texas State,W (25-21),19,35,54.3,127,1,41,145,3.5,0,76,272,3.6,8,7,0,15,5,50,1,0,1
2018,2018929UTSTex,5,2018-09-29,UTSA,Home,Texas-El Paso,W (30-21),20,35,57.1,187,2,24,91,3.8,1,59,278,4.7,10,5,2,17,4,45,1,0,1
2018,2018106UTSRic,6,2018-10-06,UTSA,Away,Rice,W (20-3),8,22,36.4,43,0,38,135,3.6,2,60,178,3.0,3,8,0,11,7,55,0,0,0
2018,20181013UTSLou,7,2018-10-13,UTSA,Home,Louisiana Tech,L (3-31),19,40,47.5,201,0,23,85,3.7,0,63,286,4.5,9,6,1,16,4,47,1,1,2
2018,20181020UTSSou,8,2018-10-20,UTSA,Away,Southern Mississippi,L (17-27),12,28,42.9,117,1,26,57,2.2,0,54,174,3.2,5,4,0,9,2,15,0,0,0
2018,2018113UTSAla,9,2018-11-03,UTSA,Away,Alabama-Birmingham,L (3-52),15,35,42.9,136,0,26,84,3.2,0,61,220,3.6,6,7,6,19,2,20,1,1,2
2018,20181110UTSFlo,10,2018-11-10,UTSA,Home,Florida International,L (7-45),18,32,56.3,143,1,26,102,3.9,0,58,245,4.2,6,6,3,15,4,23,0,4,4
2018,20181117UTSMar,11,2018-11-17,UTSA,Away,Marshall,L (0-23),17,34,50.0,163,0,21,-26,-1.2,0,55,137,2.5,9,0,1,10,10,73,1,1,2
2018,20181124UTSNor,12,2018-11-24,UTSA,Home,North Texas,L (21-24),20,33,60.6,269,1,30,131,4.4,2,63,400,6.3,11,9,0,20,9,71,0,1,1
2018,201891VanMid,1,2018-09-01,Vanderbilt,Home,Middle Tennessee State,W (35-7),10,17,58.8,170,2,37,177,4.8,2,54,347,6.4,8,10,1,19,7,49,0,0,0
2018,201898VanNev,2,2018-09-08,Vanderbilt,Home,Nevada,W (41-10),24,34,70.6,270,2,39,198,5.1,3,73,468,6.4,13,9,3,25,6,44,2,0,2
2018,2018915VanNot,3,2018-09-15,Vanderbilt,Away,Notre Dame,L (17-22),26,43,60.5,326,1,27,94,3.5,1,70,420,6.0,14,5,4,23,5,60,2,1,3
2018,2018922VanSou,4,2018-09-22,Vanderbilt,Home,South Carolina,L (14-37),19,40,47.5,192,1,33,92,2.8,1,73,284,3.9,11,9,2,22,4,21,1,1,2
2018,2018929VanTen,5,2018-09-29,Vanderbilt,Home,Tennessee State,W (31-27),22,30,73.3,297,3,34,256,7.5,1,64,553,8.6,13,8,2,23,2,15,0,2,2
2018,2018106VanGeo,6,2018-10-06,Vanderbilt,Away,Georgia,L (13-41),16,30,53.3,183,0,29,138,4.8,1,59,321,5.4,9,6,3,18,9,69,0,0,0
2018,20181013VanFlo,7,2018-10-13,Vanderbilt,Home,Florida,L (27-37),18,36,50.0,229,2,22,107,4.9,1,58,336,5.8,9,3,5,17,5,28,0,1,1
2018,20181020VanKen,8,2018-10-20,Vanderbilt,Away,Kentucky,L (7-14),15,23,65.2,216,1,31,68,2.2,0,54,284,5.3,7,4,1,12,5,25,2,0,2
2018,20181027VanArk,9,2018-10-27,Vanderbilt,Away,Arkansas,W (45-31),13,19,68.4,192,2,49,250,5.1,4,68,442,6.5,8,15,2,25,7,60,0,0,0
2018,20181110VanMis,10,2018-11-10,Vanderbilt,Away,Missouri,L (28-33),24,36,66.7,249,3,29,216,7.4,1,65,465,7.2,10,9,0,19,5,45,0,0,0
2018,20181117VanMis,11,2018-11-17,Vanderbilt,Home,Mississippi,W (36-29),22,35,62.9,191,3,36,196,5.4,1,71,387,5.5,8,10,3,21,10,83,0,1,1
2018,20181124VanTen,12,2018-11-24,Vanderbilt,Home,Tennessee,W (38-13),31,35,88.6,367,3,43,100,2.3,2,78,467,6.0,18,9,2,29,3,43,0,0,0
2018,201891VilTem,1,2018-09-01,Villanova,Away,Temple,W (19-17),29,40,72.5,254,3,37,151,4.1,0,77,405,5.3,14,9,3,26,9,82,0,1,1
2018,201891VirRic,1,2018-09-01,Virginia,Home,Richmond,W (42-13),14,26,53.8,191,2,48,301,6.3,4,74,492,6.6,8,17,0,25,4,24,0,1,1
2018,201898VirInd,2,2018-09-08,Virginia,Away,Indiana,L (16-20),12,25,48.0,106,2,39,188,4.8,0,64,294,4.6,6,7,2,15,5,56,1,0,1
2018,2018915VirOhi,3,2018-09-15,Virginia,Neutral,Ohio,W (45-31),25,30,83.3,379,3,31,173,5.6,3,61,552,9.0,14,8,1,23,3,20,3,0,3
2018,2018922VirLou,4,2018-09-22,Virginia,Home,Louisville,W (27-3),17,26,65.4,197,2,39,204,5.2,1,65,401,6.2,10,9,1,20,3,29,0,1,1
2018,2018929VirNor,5,2018-09-29,Virginia,Away,North Carolina State,L (21-35),20,35,57.1,258,2,29,93,3.2,1,64,351,5.5,10,7,3,20,6,62,0,2,2
2018,20181013VirMia,6,2018-10-13,Virginia,Home,Miami (FL),W (16-13),12,21,57.1,92,0,41,139,3.4,1,62,231,3.7,3,12,3,18,6,60,0,3,3
2018,20181020VirDuk,7,2018-10-20,Virginia,Away,Duke,W (28-14),21,34,61.8,198,1,44,178,4.0,2,78,376,4.8,12,8,1,21,6,55,0,0,0
2018,20181027VirNor,8,2018-10-27,Virginia,Home,North Carolina,W (31-21),18,27,66.7,217,3,44,208,4.7,1,71,425,6.0,11,12,0,23,1,5,0,1,1
2018,2018112VirPit,9,2018-11-02,Virginia,Home,Pittsburgh,L (13-23),17,24,70.8,205,1,26,44,1.7,0,50,249,5.0,6,6,1,13,10,80,1,0,1
2018,20181110VirLib,10,2018-11-10,Virginia,Home,Liberty,W (45-24),14,22,63.6,168,2,39,221,5.7,3,61,389,6.4,8,15,1,24,1,10,0,1,1
2018,20181117VirGeo,11,2018-11-17,Virginia,Away,Georgia Tech,L (27-30),22,28,78.6,273,2,33,130,3.9,1,61,403,6.6,14,10,0,24,4,35,1,0,1
2018,20181123VirVir,12,2018-11-23,Virginia,Away,Virginia Tech,L (31-34),14,29,48.3,259,3,38,164,4.3,1,67,423,6.3,9,11,2,22,7,62,3,0,3
2018,201891VirTol,1,2018-09-01,Virginia Military Institute,Away,Toledo,L (3-66),29,47,61.7,174,0,30,48,1.6,0,77,222,2.9,7,5,2,14,3,11,1,2,3
2018,20181117VirOld,2,2018-11-17,Virginia Military Institute,Away,Old Dominion,L (14-77),18,42,42.9,216,1,26,72,2.8,1,68,288,4.2,10,2,3,15,3,40,2,2,4
2018,201893VirFlo,1,2018-09-03,Virginia Tech,Away,Florida State,W (24-3),16,26,61.5,207,2,37,112,3.0,0,63,319,5.1,8,7,0,15,5,55,0,0,0
2018,201898VirWil,2,2018-09-08,Virginia Tech,Home,William & Mary,W (62-17),16,23,69.6,281,1,46,305,6.6,7,69,586,8.5,14,16,2,32,2,20,1,0,1
2018,2018922VirOld,3,2018-09-22,Virginia Tech,Away,Old Dominion,L (35-49),17,34,50.0,282,3,49,318,6.5,2,83,600,7.2,11,15,0,26,7,95,0,1,1
2018,2018929VirDuk,4,2018-09-29,Virginia Tech,Away,Duke,W (31-14),17,28,60.7,332,3,41,81,2.0,1,69,413,6.0,13,4,0,17,4,26,0,0,0
2018,2018106VirNot,5,2018-10-06,Virginia Tech,Home,Notre Dame,L (23-45),31,52,59.6,309,2,33,132,4.0,0,85,441,5.2,18,6,1,25,6,41,1,1,2
2018,20181013VirNor,6,2018-10-13,Virginia Tech,Away,North Carolina,W (22-19),20,36,55.6,221,2,41,154,3.8,1,77,375,4.9,12,8,0,20,8,59,0,2,2
2018,20181025VirGeo,7,2018-10-25,Virginia Tech,Home,Georgia Tech,L (28-49),15,22,68.2,201,2,25,122,4.9,2,47,323,6.9,8,7,1,16,8,87,1,0,1
2018,2018113VirBos,8,2018-11-03,Virginia Tech,Home,Boston College,L (21-31),25,43,58.1,281,3,36,111,3.1,0,79,392,5.0,14,8,1,23,8,59,1,1,2
2018,20181110VirPit,9,2018-11-10,Virginia Tech,Away,Pittsburgh,L (22-52),23,38,60.5,240,3,48,192,4.0,0,86,432,5.0,10,15,3,28,3,34,0,0,0
2018,20181117VirMia,10,2018-11-17,Virginia Tech,Home,Miami (FL),L (14-38),18,36,50.0,216,1,33,119,3.6,1,69,335,4.9,12,8,2,22,3,35,1,2,3
2018,20181123VirVir,11,2018-11-23,Virginia Tech,Home,Virginia,W (34-31),14,34,41.2,199,1,45,254,5.6,2,79,453,5.7,7,13,1,21,7,70,0,2,2
2018,2018121VirMar,12,2018-12-01,Virginia Tech,Home,Marshall,W (41-20),18,26,69.2,312,4,38,142,3.7,1,64,454,7.1,9,9,3,21,4,41,0,0,0
2018,2018830WakTul,1,2018-08-30,Wake Forest,Away,Tulane,W (23-17),31,51,60.8,378,2,43,170,4.0,1,94,548,5.8,20,10,2,32,6,70,1,2,3
2018,201898WakTow,2,2018-09-08,Wake Forest,Home,Towson,W (51-20),17,27,63.0,242,2,54,340,6.3,2,81,582,7.2,13,16,3,32,0,0,1,1,2
2018,2018913WakBos,3,2018-09-13,Wake Forest,Home,Boston College,L (34-41),20,45,44.4,214,2,60,298,5.0,1,105,512,4.9,10,16,1,27,3,35,0,2,2
2018,2018922WakNot,4,2018-09-22,Wake Forest,Home,Notre Dame,L (27-56),16,31,51.6,139,0,61,259,4.2,3,92,398,4.3,9,15,3,27,3,23,0,1,1
2018,2018929WakRic,5,2018-09-29,Wake Forest,Home,Rice,W (56-24),17,20,85.0,243,4,41,171,4.2,2,61,414,6.8,8,9,3,20,3,25,1,1,2
2018,2018106WakCle,6,2018-10-06,Wake Forest,Home,Clemson,L (3-63),7,27,25.9,74,0,51,175,3.4,0,78,249,3.2,4,7,0,11,5,55,0,1,1
2018,20181020WakFlo,7,2018-10-20,Wake Forest,Away,Florida State,L (17-38),26,56,46.4,261,2,51,119,2.3,0,107,380,3.6,14,10,1,25,5,65,0,1,1
2018,20181027WakLou,8,2018-10-27,Wake Forest,Away,Louisville,W (56-35),16,24,66.7,223,2,48,368,7.7,5,72,591,8.2,10,18,0,28,3,35,0,0,0
2018,2018113WakSyr,9,2018-11-03,Wake Forest,Home,Syracuse,L (24-41),21,37,56.8,275,2,44,159,3.6,1,81,434,5.4,12,10,4,26,10,95,2,1,3
2018,2018118WakNor,10,2018-11-08,Wake Forest,Away,North Carolina State,W (27-23),22,33,66.7,297,3,38,138,3.6,0,71,435,6.1,11,10,1,22,5,50,1,0,1
2018,20181117WakPit,11,2018-11-17,Wake Forest,Home,Pittsburgh,L (13-34),15,30,50.0,206,1,28,79,2.8,0,58,285,4.9,9,6,1,16,1,15,0,2,2
2018,20181124WakDuk,12,2018-11-24,Wake Forest,Away,Duke,W (59-7),18,23,78.3,177,4,57,340,6.0,3,80,517,6.5,9,19,1,29,4,30,0,0,0
2018,201891WasAub,1,2018-09-01,Washington,Neutral,Auburn,L (16-21),18,32,56.3,296,1,33,102,3.1,0,65,398,6.1,12,8,4,24,10,95,1,1,2
2018,201898WasNor,2,2018-09-08,Washington,Home,North Dakota,W (45-3),31,45,68.9,437,3,34,195,5.7,2,79,632,8.0,17,8,0,25,5,45,0,2,2
2018,2018915WasUta,3,2018-09-15,Washington,Away,Utah,W (21-7),14,24,58.3,155,1,41,172,4.2,2,65,327,5.0,10,6,2,18,5,35,0,1,1
2018,2018922WasAri,4,2018-09-22,Washington,Home,Arizona State,W (27-20),15,23,65.2,202,3,39,171,4.4,0,62,373,6.0,11,12,3,26,3,30,0,1,1
2018,2018929WasBri,5,2018-09-29,Washington,Home,Brigham Young,W (35-7),23,25,92.0,277,1,37,187,5.1,4,62,464,7.5,15,10,1,26,5,40,1,0,1
2018,2018106WasUCL,6,2018-10-06,Washington,Away,UCLA,W (31-24),18,26,69.2,265,1,55,197,3.6,3,81,462,5.7,11,13,2,26,1,10,0,1,1
2018,20181013WasOre,7,2018-10-13,Washington,Away,Oregon,L (27-30),15,25,60.0,243,1,45,194,4.3,2,70,437,6.2,13,7,2,22,5,38,0,1,1
2018,20181020WasCol,8,2018-10-20,Washington,Home,Colorado,W (27-13),15,25,60.0,150,1,40,201,5.0,2,65,351,5.4,8,12,3,23,3,45,1,1,2
2018,20181027WasCal,9,2018-10-27,Washington,Away,California,L (10-12),12,25,48.0,159,1,33,91,2.8,0,58,250,4.3,8,4,1,13,4,18,0,2,2
2018,2018113WasSta,10,2018-11-03,Washington,Home,Stanford,W (27-23),16,27,59.3,194,1,45,177,3.9,2,72,371,5.2,11,6,2,19,8,85,0,0,0
2018,20181117WasOre,11,2018-11-17,Washington,Home,Oregon State,W (42-23),18,25,72.0,228,3,42,275,6.5,3,67,503,7.5,11,10,1,22,4,40,0,0,0
2018,20181123WasWas,12,2018-11-23,Washington,Away,Washington State,W (28-15),12,15,80.0,229,1,44,258,5.9,3,59,487,8.3,7,13,0,20,6,47,2,1,3
2018,20181130WasUta,13,2018-11-30,Washington,Neutral,Utah,W (10-3),21,33,63.6,187,0,40,119,3.0,0,73,306,4.2,8,11,0,19,4,45,0,1,1
2018,201891WasWyo,1,2018-09-01,Washington State,Away,Wyoming,W (41-19),38,57,66.7,319,3,21,75,3.6,2,78,394,5.1,15,5,4,24,10,75,1,1,2
2018,201898WasSan,2,2018-09-08,Washington State,Home,San Jose State,W (31-0),35,54,64.8,420,3,31,124,4.0,1,85,544,6.4,14,7,2,27,8,60,0,3,3
2018,2018915WasEas,3,2018-09-15,Washington State,Home,Eastern Washington,W (59-24),51,65,78.5,524,3,15,41,2.7,4,80,565,7.1,32,1,2,35,7,87,0,0,0
2018,2018921WasSou,4,2018-09-21,Washington State,Away,Southern California,L (36-39),37,52,71.2,344,3,24,91,3.8,2,76,435,5.7,19,4,1,24,11,118,0,0,0
2018,2018929WasUta,5,2018-09-29,Washington State,Home,Utah,W (28-24),31,56,55.4,445,3,10,13,1.3,1,66,458,6.9,16,1,4,21,9,104,0,1,1
2018,2018106WasOre,6,2018-10-06,Washington State,Away,Oregon State,W (56-37),30,40,75.0,430,5,22,100,4.5,2,62,530,8.5,18,6,0,24,5,46,1,0,1
2018,20181020WasOre,7,2018-10-20,Washington State,Home,Oregon,W (34-20),39,51,76.5,323,4,24,77,3.2,1,75,400,5.3,19,5,1,25,5,55,0,2,2
2018,20181027WasSta,8,2018-10-27,Washington State,Away,Stanford,W (41-38),40,50,80.0,438,3,19,59,3.1,2,69,497,7.2,19,4,1,24,9,89,0,0,0
2018,2018113WasCal,9,2018-11-03,Washington State,Home,California,W (19-13),35,51,68.6,334,1,15,79,5.3,1,66,413,6.3,19,4,0,23,7,80,1,1,2
2018,20181110WasCol,10,2018-11-10,Washington State,Away,Colorado,W (31-7),37,61,60.7,346,2,33,131,4.0,2,94,477,5.1,17,7,2,26,2,10,0,0,0
2018,20181117WasAri,11,2018-11-17,Washington State,Home,Arizona,W (69-28),44,56,78.6,482,7,23,123,5.3,2,79,605,7.7,20,6,5,31,3,35,0,0,0
2018,20181123WasWas,12,2018-11-23,Washington State,Home,Washington,L (15-28),26,35,74.3,152,0,24,85,3.5,2,59,237,4.0,8,6,1,15,4,21,0,2,2
2018,201891WesTen,1,2018-09-01,West Virginia,Neutral,Tennessee,W (40-14),25,34,73.5,429,5,27,118,4.4,0,61,547,9.0,18,6,2,26,4,35,1,0,1
2018,201898WesYou,2,2018-09-08,West Virginia,Home,Youngstown State,W (52-17),22,29,75.9,336,4,46,289,6.3,3,75,625,8.3,17,11,1,29,12,114,0,1,1
2018,2018922WesKan,3,2018-09-22,West Virginia,Home,Kansas State,W (35-6),25,36,69.4,356,5,28,108,3.9,0,64,464,7.3,16,3,1,20,3,35,1,3,4
2018,2018929WesTex,4,2018-09-29,West Virginia,Away,Texas Tech,W (42-34),27,41,65.9,370,3,32,119,3.7,2,73,489,6.7,15,8,3,26,12,115,0,0,0
2018,2018106WesKan,5,2018-10-06,West Virginia,Home,Kansas,W (38-22),28,41,68.3,332,4,39,177,4.5,1,80,509,6.4,14,15,0,29,7,50,1,3,4
2018,20181013WesIow,6,2018-10-13,West Virginia,Away,Iowa State,L (14-30),11,15,73.3,100,1,27,52,1.9,0,42,152,3.6,2,7,0,9,9,103,0,1,1
2018,20181025WesBay,7,2018-10-25,West Virginia,Home,Baylor,W (58-14),21,31,67.7,396,4,33,172,5.2,3,64,568,8.9,13,5,4,22,6,64,0,0,0
2018,2018113WesTex,8,2018-11-03,West Virginia,Away,Texas,W (42-41),28,42,66.7,346,3,33,232,7.0,2,75,578,7.7,16,9,3,28,14,120,0,0,0
2018,20181110WesTex,9,2018-11-10,West Virginia,Home,Texas Christian,W (47-10),26,41,63.4,371,3,40,164,4.1,3,81,535,6.6,15,11,0,26,2,15,1,1,2
2018,20181117WesOkl,10,2018-11-17,West Virginia,Away,Oklahoma State,L (41-45),27,48,56.3,364,2,43,189,4.4,3,91,553,6.1,17,7,1,25,5,24,1,0,1
2018,20181123WesOkl,11,2018-11-23,West Virginia,Home,Oklahoma,L (56-59),32,49,65.3,539,4,41,165,4.0,4,90,704,7.8,20,10,3,33,5,60,2,0,2
2018,20181117WesNor,1,2018-11-17,Western Carolina,Away,North Carolina,L (26-49),19,36,52.8,300,0,34,133,3.9,2,70,433,6.2,12,7,5,24,7,50,2,0,2
2018,2018831WesWis,1,2018-08-31,Western Kentucky,Away,Wisconsin,L (3-34),17,30,56.7,181,0,34,124,3.6,0,64,305,4.8,8,6,1,15,6,65,1,1,2
2018,201898WesMai,2,2018-09-08,Western Kentucky,Home,Maine,L (28-31),23,41,56.1,347,3,31,42,1.4,0,72,389,5.4,6,11,0,17,4,38,2,0,2
2018,2018915WesLou,3,2018-09-15,Western Kentucky,Away,Louisville,L (17-20),25,38,65.8,260,1,43,168,3.9,1,81,428,5.3,14,11,1,26,8,69,0,1,1
2018,2018922WesBal,4,2018-09-22,Western Kentucky,Away,Ball State,W (28-20),25,35,71.4,252,2,40,192,4.8,2,75,444,5.9,12,14,3,29,11,102,0,0,0
2018,2018929WesMar,5,2018-09-29,Western Kentucky,Home,Marshall,L (17-20),24,39,61.5,263,1,32,61,1.9,1,71,324,4.6,10,4,3,17,6,43,2,1,3
2018,20181013WesUNC,6,2018-10-13,Western Kentucky,Away,UNC Charlotte,L (14-40),27,39,69.2,214,1,17,42,2.5,1,56,256,4.6,11,4,2,17,7,55,1,2,3
2018,20181020WesOld,7,2018-10-20,Western Kentucky,Home,Old Dominion,L (34-37),24,32,75.0,257,2,45,207,4.6,2,77,464,6.0,14,11,4,29,10,83,0,0,0
2018,20181027WesFlo,8,2018-10-27,Western Kentucky,Home,Florida International,L (17-38),18,34,52.9,144,0,38,168,4.4,2,72,312,4.3,7,12,4,23,4,34,0,1,1
2018,2018112WesMid,9,2018-11-02,Western Kentucky,Away,Middle Tennessee State,L (10-29),16,47,34.0,270,1,25,109,4.4,0,72,379,5.3,10,6,1,17,7,80,1,1,2
2018,20181110WesFlo,10,2018-11-10,Western Kentucky,Away,Florida Atlantic,L (15-34),25,42,59.5,228,1,34,123,3.6,1,76,351,4.6,15,4,2,21,2,10,0,1,1
2018,20181117WesTex,11,2018-11-17,Western Kentucky,Home,Texas-El Paso,W (40-16),19,31,61.3,214,2,50,208,4.2,2,81,422,5.2,9,12,1,22,7,62,0,1,1
2018,20181124WesLou,12,2018-11-24,Western Kentucky,Away,Louisiana Tech,W (30-15),11,23,47.8,92,1,51,196,3.8,3,74,288,3.9,4,12,2,18,6,50,0,1,1
2018,2018831WesSyr,1,2018-08-31,Western Michigan,Home,Syracuse,L (42-55),19,36,52.8,379,3,28,242,8.6,3,64,621,9.7,14,7,3,24,6,45,0,2,2
2018,201898WesMic,2,2018-09-08,Western Michigan,Away,Michigan,L (3-49),16,34,47.1,85,0,40,123,3.1,0,74,208,2.8,5,9,3,17,4,30,0,1,1
2018,2018915WesDel,3,2018-09-15,Western Michigan,Home,Delaware State,W (68-0),23,33,69.7,286,2,41,241,5.9,4,74,527,7.1,14,13,4,31,6,65,0,0,0
2018,2018922WesGeo,4,2018-09-22,Western Michigan,Away,Georgia State,W (34-15),20,25,80.0,234,3,45,294,6.5,1,70,528,7.5,12,12,1,25,5,50,0,0,0
2018,2018929WesMia,5,2018-09-29,Western Michigan,Away,Miami (OH),W (40-39),27,42,64.3,439,5,37,123,3.3,1,79,562,7.1,20,7,4,31,9,96,2,0,2
2018,2018106WesEas,6,2018-10-06,Western Michigan,Home,Eastern Michigan,W (27-24),16,27,59.3,235,1,41,152,3.7,3,68,387,5.7,10,8,0,18,10,67,1,1,2
2018,20181013WesBow,7,2018-10-13,Western Michigan,Away,Bowling Green State,W (42-35),22,37,59.5,286,2,54,282,5.2,4,91,568,6.2,11,18,4,33,5,67,0,2,2
2018,20181020WesCen,8,2018-10-20,Western Michigan,Away,Central Michigan,W (35-10),5,9,55.6,51,0,55,305,5.5,5,64,356,5.6,2,12,2,16,5,55,0,0,0
2018,20181025WesTol,9,2018-10-25,Western Michigan,Home,Toledo,L (24-51),25,32,78.1,307,2,34,125,3.7,1,66,432,6.5,11,4,2,17,8,76,1,0,1
2018,2018111WesOhi,10,2018-11-01,Western Michigan,Home,Ohio,L (14-59),10,19,52.6,152,1,40,118,3.0,1,59,270,4.6,4,7,2,13,6,51,4,2,6
2018,20181113WesBal,11,2018-11-13,Western Michigan,Away,Ball State,L (41-42),20,29,69.0,187,1,67,361,5.4,4,96,548,5.7,11,19,3,33,6,50,1,0,1
2018,20181120WesNor,12,2018-11-20,Western Michigan,Home,Northern Illinois,W (28-21),19,35,54.3,285,0,46,94,2.0,3,81,379,4.7,14,7,1,22,2,10,1,0,1
2018,201898WilVir,1,2018-09-08,William & Mary,Away,Virginia Tech,L (17-62),18,30,60.0,232,1,29,34,1.2,1,59,266,4.5,10,1,1,12,4,22,2,0,2
2018,2018831WisWes,1,2018-08-31,Wisconsin,Home,Western Kentucky,W (34-3),17,31,54.8,257,2,39,234,6.0,2,70,491,7.0,14,9,1,24,8,70,1,0,1
2018,201898WisNew,2,2018-09-08,Wisconsin,Home,New Mexico,W (45-14),9,13,69.2,151,2,59,417,7.1,4,72,568,7.9,5,24,0,29,4,39,1,1,2
2018,2018915WisBri,3,2018-09-15,Wisconsin,Home,Brigham Young,L (21-24),18,28,64.3,190,0,43,204,4.7,3,71,394,5.5,9,13,1,23,6,33,0,1,1
2018,2018922WisIow,4,2018-09-22,Wisconsin,Away,Iowa,W (28-17),17,22,77.3,205,3,44,210,4.8,1,66,415,6.3,8,11,0,19,8,68,0,0,0
2018,2018106WisNeb,5,2018-10-06,Wisconsin,Home,Nebraska,W (41-24),13,24,54.2,163,1,48,370,7.7,4,72,533,7.4,9,15,2,26,5,50,1,0,1
2018,20181013WisMic,6,2018-10-13,Wisconsin,Away,Michigan,L (13-38),7,20,35.0,100,1,29,183,6.3,1,49,283,5.8,4,7,0,11,3,30,0,2,2
2018,20181020WisIll,7,2018-10-20,Wisconsin,Home,Illinois,W (49-20),13,22,59.1,188,3,54,357,6.6,4,76,545,7.2,10,20,1,31,5,50,0,2,2
2018,20181027WisNor,8,2018-10-27,Wisconsin,Away,Northwestern,L (17-31),20,33,60.6,158,1,32,165,5.2,1,65,323,5.0,6,11,0,17,5,54,3,0,3
2018,2018113WisRut,9,2018-11-03,Wisconsin,Home,Rutgers,W (31-17),12,23,52.2,156,1,46,317,6.9,3,69,473,6.9,9,16,1,26,4,19,0,2,2
2018,20181110WisPen,10,2018-11-10,Wisconsin,Away,Penn State,L (10-22),9,20,45.0,60,0,37,209,5.6,1,57,269,4.7,4,7,1,12,6,50,2,2,4
2018,20181117WisPur,11,2018-11-17,Wisconsin,Away,Purdue,W (47-44),16,24,66.7,206,2,51,385,7.5,4,75,591,7.9,7,16,1,24,13,171,1,0,1
2018,20181124WisMin,12,2018-11-24,Wisconsin,Home,Minnesota,L (15-37),22,33,66.7,189,2,31,170,5.5,0,64,359,5.6,12,9,0,21,6,54,1,3,4
2018,2018915WofWyo,1,2018-09-15,Wofford,Away,Wyoming,L (14-17),9,15,60.0,73,0,49,221,4.5,2,64,294,4.6,4,8,2,14,3,16,1,2,3
2018,2018825WyoNew,1,2018-08-25,Wyoming,Away,New Mexico State,W (29-7),13,22,59.1,137,0,56,313,5.6,3,78,450,5.8,7,13,2,22,4,60,0,0,0
2018,201891WyoWas,2,2018-09-01,Wyoming,Home,Washington State,L (19-41),8,20,40.0,67,0,39,139,3.6,2,59,206,3.5,3,11,1,15,13,109,0,1,1
2018,201898WyoMis,3,2018-09-08,Wyoming,Away,Missouri,L (13-40),13,28,46.4,160,0,30,88,2.9,1,58,248,4.3,7,5,3,15,3,17,1,0,1
2018,2018915WyoWof,4,2018-09-15,Wyoming,Home,Wofford,W (17-14),25,42,59.5,224,2,27,89,3.3,0,69,313,4.5,13,5,1,19,5,40,0,1,1
2018,2018929WyoBoi,5,2018-09-29,Wyoming,Home,Boise State,L (14-34),15,26,57.7,214,1,24,81,3.4,1,50,295,5.9,7,3,1,11,6,59,1,0,1
2018,2018106WyoHaw,6,2018-10-06,Wyoming,Away,Hawaii,L (13-17),9,18,50.0,87,0,34,157,4.6,0,52,244,4.7,4,8,1,13,6,45,0,0,0
2018,20181013WyoFre,7,2018-10-13,Wyoming,Away,Fresno State,L (3-27),12,32,37.5,117,0,30,104,3.5,0,62,221,3.6,6,6,2,14,5,22,0,1,1
2018,20181020WyoUta,8,2018-10-20,Wyoming,Home,Utah State,L (16-24),10,24,41.7,100,0,50,231,4.6,1,74,331,4.5,3,10,2,15,10,80,1,1,2
2018,20181026WyoCol,9,2018-10-26,Wyoming,Away,Colorado State,W (34-21),7,10,70.0,116,2,55,297,5.4,2,65,413,6.4,5,14,1,20,6,57,0,0,0
2018,2018113WyoSan,10,2018-11-03,Wyoming,Home,San Jose State,W (24-9),4,8,50.0,51,1,64,424,6.6,2,72,475,6.6,4,18,0,22,4,25,2,0,2
2018,20181117WyoAir,11,2018-11-17,Wyoming,Home,Air Force,W (35-27),15,29,51.7,262,2,29,111,3.8,3,58,373,6.4,9,7,2,18,5,35,1,0,1
2018,20181124WyoNew,12,2018-11-24,Wyoming,Away,New Mexico,W (31-3),4,17,23.5,41,0,55,366,6.7,4,72,407,5.7,4,16,0,20,5,47,1,0,1
