,Season,Game,Date,Team,Loc,Opp,Result,Pass_cmp,Pass_att,Pass_pct,Pass_yds,Pass_TD,Rush_att,Rush_yds,Rush_avg,Rush_TD,TO_plays,TO_yds,TO_avg,FD_pass,FD_rush,FD_pen,FD_tot,Pen_num,Pen_yds,Turn_fum,Turn_int,Turn_tot
0,2018,1,2018-09-01,Air Force,,Stony Brook,W (38-0),2,8,25.0,29,0,77,333,4.3,4,85,362,4.3,2,19,2,23,3,30,2,0,2
1,2018,2,2018-09-08,Air Force,@,Florida Atlantic,L (27-33),8,13,61.5,164,1,56,209,3.7,2,69,373,5.4,5,11,3,19,5,50,0,1,1
2,2018,3,2018-09-22,Air Force,@,Utah State,L (32-42),11,21,52.4,148,0,86,323,3.8,3,107,471,4.4,5,21,1,27,7,65,1,0,1
3,2018,4,2018-09-29,Air Force,,Nevada,L (25-28),8,19,42.1,96,1,51,154,3.0,1,70,250,3.6,5,10,1,16,5,40,2,0,2
4,2018,5,2018-10-06,Air Force,,Navy,W (35-7),6,10,60.0,142,1,55,257,4.7,4,65,399,6.1,6,10,1,17,3,32,0,0,0
5,2018,6,2018-10-12,Air Force,@,San Diego State,L (17-21),8,17,47.1,62,0,51,214,4.2,2,68,276,4.1,4,9,1,14,5,56,0,1,1
6,2018,7,2018-10-19,Air Force,@,Nevada-Las Vegas,W (41-35),9,11,81.8,217,1,52,355,6.8,4,63,572,9.1,7,17,2,26,9,76,2,0,2
7,2018,8,2018-10-27,Air Force,,Boise State,L (38-48),11,16,68.8,242,3,51,201,3.9,2,67,443,6.6,9,13,1,23,4,25,0,0,0
8,2018,9,2018-11-03,Air Force,@,Army,L (14-17),12,22,54.5,197,0,35,125,3.6,2,57,322,5.6,8,7,2,17,5,55,0,1,1
9,2018,10,2018-11-10,Air Force,,New Mexico,W (42-24),5,6,83.3,145,2,67,478,7.1,4,73,623,8.5,4,23,0,27,2,11,3,0,3
10,2018,11,2018-11-17,Air Force,@,Wyoming,L (27-35),5,9,55.6,53,0,65,362,5.6,3,74,415,5.6,3,22,0,25,5,66,0,2,2
11,2018,12,2018-11-22,Air Force,,Colorado State,W (27-19),8,16,50.0,81,1,67,393,5.9,2,83,474,5.7,4,23,3,30,1,15,0,0,0
12,2018,,12 Games,Air Force,,,,93,168,55.4,1576,10,713,3404,4.8,33,881,4980,5.7,62,185,17,264,54,521,10,5,15
13,2018,1,2018-09-08,Akron,,Morgan State,W (41-7),18,31,58.1,237,3,39,200,5.1,2,70,437,6.2,9,13,4,26,6,73,1,2,3
14,2018,2,2018-09-15,Akron,@,Northwestern,W (39-34),17,28,60.7,277,2,36,90,2.5,0,64,367,5.7,7,6,2,15,15,140,0,0,0
15,2018,3,2018-09-22,Akron,@,Iowa State,L (13-26),12,28,42.9,153,1,31,91,2.9,0,59,244,4.1,8,4,3,15,6,45,0,1,1
16,2018,4,2018-10-06,Akron,,Miami (OH),L (17-41),19,35,54.3,203,1,28,56,2.0,0,63,259,4.1,9,5,2,16,8,86,2,3,5
17,2018,5,2018-10-13,Akron,@,Buffalo,L (6-24),12,29,41.4,115,0,32,120,3.8,0,61,235,3.9,5,7,1,13,5,46,0,1,1
18,2018,6,2018-10-20,Akron,@,Kent State,W (24-23),19,35,54.3,219,1,39,143,3.7,2,74,362,4.9,13,5,1,19,7,65,0,1,1
19,2018,7,2018-10-27,Akron,,Central Michigan,W (17-10),10,27,37.0,149,1,37,154,4.2,1,64,303,4.7,6,8,2,16,4,37,4,0,4
20,2018,8,2018-11-01,Akron,,Northern Illinois,L (26-36),21,38,55.3,326,3,28,35,1.3,0,66,361,5.5,14,1,4,19,7,50,0,2,2
21,2018,9,2018-11-10,Akron,@,Eastern Michigan,L (7-27),4,15,26.7,29,0,30,72,2.4,0,45,101,2.2,1,4,1,6,2,25,1,3,4
22,2018,10,2018-11-17,Akron,,Bowling Green State,L (6-21),12,28,42.9,148,0,28,79,2.8,0,56,227,4.1,7,6,2,15,8,61,0,0,0
23,2018,11,2018-11-23,Akron,@,Ohio,L (28-49),24,41,58.5,356,4,21,32,1.5,0,62,388,6.3,16,3,4,23,9,81,0,1,1
24,2018,,11 Games,Akron,,,,168,335,50.1,2212,16,349,1072,3.1,5,684,3284,4.8,95,62,26,183,77,709,8,14,22
25,2018,1,2018-09-01,Alabama,N,Louisville,W (51-14),17,26,65.4,297,2,42,222,5.3,3,68,519,7.6,12,8,1,21,10,111,1,0,1
26,2018,2,2018-09-08,Alabama,,Arkansas State,W (57-7),20,29,69.0,321,6,44,278,6.3,1,73,599,8.2,11,13,2,26,4,35,1,0,1
27,2018,3,2018-09-15,Alabama,@,Mississippi,W (62-7),19,28,67.9,306,4,44,210,4.8,3,72,516,7.2,14,10,3,27,8,60,1,1,2
28,2018,4,2018-09-22,Alabama,,Texas A&M,W (45-23),25,33,75.8,415,4,28,109,3.9,2,61,524,8.6,16,6,2,24,9,82,0,0,0
29,2018,5,2018-09-29,Alabama,,Louisiana,W (56-14),13,16,81.3,340,4,46,268,5.8,3,62,608,9.8,11,14,1,26,3,15,0,0,0
30,2018,6,2018-10-06,Alabama,@,Arkansas,W (65-31),14,18,77.8,393,4,41,246,6.0,4,59,639,10.8,13,11,0,24,5,31,0,0,0
31,2018,7,2018-10-13,Alabama,,Missouri,W (39-10),19,30,63.3,380,3,45,184,4.1,1,75,564,7.5,12,11,2,25,5,60,1,0,1
32,2018,8,2018-10-20,Alabama,@,Tennessee,W (58-21),21,32,65.6,327,4,42,218,5.2,4,74,545,7.4,16,12,2,30,5,36,0,1,1
33,2018,9,2018-11-03,Alabama,@,Louisiana State,W (29-0),25,42,59.5,295,2,37,281,7.6,2,79,576,7.3,15,14,0,29,6,60,0,1,1
34,2018,10,2018-11-10,Alabama,,Mississippi State,W (24-0),17,27,63.0,163,1,45,142,3.2,2,72,305,4.2,9,12,2,23,0,0,1,1,2
35,2018,11,2018-11-17,Alabama,,Citadel,W (50-17),21,26,80.8,371,4,23,190,8.3,2,49,561,11.4,15,5,1,21,6,68,2,0,2
36,2018,12,2018-11-24,Alabama,,Auburn,W (52-21),26,33,78.8,377,6,26,123,4.7,1,59,500,8.5,14,6,3,23,8,82,0,0,0
37,2018,,12 Games,Alabama,,,,237,340,69.7,3985,44,463,2471,5.3,28,803,6456,8.0,158,122,19,299,69,640,7,4,11
38,2018,1,2018-09-01,Alcorn State,@,Georgia Tech,L (0-41),15,23,65.2,69,0,28,77,2.8,0,51,146,2.9,3,5,1,9,3,20,1,1,2
39,2018,2,2018-11-03,Alcorn State,@,New Mexico State,L (42-52),26,37,70.3,316,4,54,338,6.3,2,91,654,7.2,13,20,0,33,5,49,1,0,1
40,2018,,2 Games,Alcorn State,,,,41,60,68.3,385,4,82,415,5.1,2,142,800,5.6,16,25,1,42,8,69,2,1,3
41,2018,1,2018-09-01,Appalachian State,@,Penn State,L (38-45),26,39,66.7,292,2,37,159,4.3,2,76,451,5.9,13,8,1,22,9,100,0,1,1
42,2018,2,2018-09-08,Appalachian State,@,UNC Charlotte,W (45-9),15,15,100.0,295,3,35,139,4.0,1,50,434,8.7,9,7,2,18,5,55,2,0,2
43,2018,3,2018-09-22,Appalachian State,,Gardner-Webb,W (72-7),20,27,74.1,260,2,48,432,9.0,6,75,692,9.2,13,18,0,31,8,85,0,0,0
44,2018,4,2018-09-29,Appalachian State,,South Alabama,W (52-7),10,20,50.0,169,3,46,348,7.6,4,66,517,7.8,8,15,5,28,4,45,0,2,2
45,2018,5,2018-10-09,Appalachian State,@,Arkansas State,W (35-9),12,27,44.4,144,2,38,246,6.5,3,65,390,6.0,4,8,3,15,4,50,0,0,0
46,2018,6,2018-10-20,Appalachian State,,Louisiana,W (27-17),10,20,50.0,106,1,48,266,5.5,2,68,372,5.5,8,10,3,21,5,42,0,1,1
47,2018,7,2018-10-25,Appalachian State,@,Georgia Southern,L (14-34),12,27,44.4,139,1,36,149,4.1,1,63,288,4.6,6,8,0,14,11,91,1,4,5
48,2018,8,2018-11-03,Appalachian State,@,Coastal Carolina,W (23-7),9,19,47.4,127,1,56,278,5.0,2,75,405,5.4,6,14,1,21,6,40,0,2,2
49,2018,9,2018-11-10,Appalachian State,@,Texas State,W (38-7),25,36,69.4,247,2,34,221,6.5,3,70,468,6.7,11,8,0,19,5,50,0,0,0
50,2018,10,2018-11-17,Appalachian State,,Georgia State,W (45-17),22,26,84.6,296,3,39,228,5.8,2,65,524,8.1,13,10,2,25,0,0,0,0,0
51,2018,11,2018-11-24,Appalachian State,,Troy,W (21-10),12,24,50.0,113,2,43,204,4.7,1,67,317,4.7,6,8,1,15,13,104,1,0,1
52,2018,,11 Games,Appalachian State,,,,173,280,61.8,2188,22,460,2670,5.8,27,740,4858,6.6,97,114,18,229,70,662,4,10,14
53,2018,1,2018-09-01,Arizona,,Brigham Young,L (23-28),17,34,50.0,197,1,35,129,3.7,2,69,326,4.7,11,7,4,22,4,26,0,0,0
54,2018,2,2018-09-08,Arizona,@,Houston,L (18-45),28,50,56.0,381,0,50,150,3.0,2,100,531,5.3,19,9,3,31,8,85,0,2,2
55,2018,3,2018-09-15,Arizona,,Southern Utah,W (62-31),15,22,68.2,358,5,38,268,7.1,2,60,626,10.4,11,12,3,26,10,98,1,0,1
56,2018,4,2018-09-22,Arizona,@,Oregon State,W (35-14),9,17,52.9,152,2,51,442,8.7,3,68,594,8.7,8,21,0,29,7,55,1,0,1
57,2018,5,2018-09-29,Arizona,,Southern California,L (20-24),16,33,48.5,232,2,37,98,2.6,1,70,330,4.7,10,4,6,20,8,80,0,1,1
58,2018,6,2018-10-06,Arizona,,California,W (24-17),15,25,60.0,141,1,34,124,3.6,0,59,265,4.5,5,7,1,13,10,72,1,1,2
59,2018,7,2018-10-12,Arizona,@,Utah,L (10-42),24,46,52.2,246,1,31,72,2.3,0,77,318,4.1,10,4,5,19,5,56,0,0,0
60,2018,8,2018-10-20,Arizona,@,UCLA,L (30-31),15,34,44.1,231,2,38,289,7.6,1,72,520,7.2,11,7,4,22,6,64,1,2,3
61,2018,9,2018-10-27,Arizona,,Oregon,W (44-15),19,33,57.6,189,3,51,276,5.4,2,84,465,5.5,10,13,4,27,11,106,0,1,1
62,2018,10,2018-11-02,Arizona,,Colorado,W (42-34),17,22,77.3,350,5,47,216,4.6,0,69,566,8.2,12,12,3,27,12,129,1,1,2
63,2018,11,2018-11-17,Arizona,@,Washington State,L (28-69),20,34,58.8,304,4,37,127,3.4,0,71,431,6.1,12,7,2,21,7,75,3,1,4
64,2018,12,2018-11-24,Arizona,,Arizona State,L (40-41),21,39,53.8,282,3,44,238,5.4,1,83,520,6.3,11,12,3,26,7,62,1,0,1
65,2018,,12 Games,Arizona,,,,216,389,55.5,3063,29,493,2429,4.9,14,882,5492,6.2,130,115,38,283,95,908,9,9,18
66,2018,1,2018-09-01,Arizona State,,Texas-San Antonio,W (49-7),16,24,66.7,237,4,35,267,7.6,2,59,504,8.5,9,12,0,21,11,95,0,0,0
67,2018,2,2018-09-08,Arizona State,,Michigan State,W (16-13),30,48,62.5,380,1,29,44,1.5,0,77,424,5.5,18,6,3,27,4,40,0,1,1
68,2018,3,2018-09-15,Arizona State,@,San Diego State,L (21-28),31,46,67.4,341,2,24,36,1.5,1,70,377,5.4,16,3,2,21,7,39,0,0,0
69,2018,4,2018-09-22,Arizona State,@,Washington,L (20-27),17,27,63.0,104,0,40,164,4.1,2,67,268,4.0,5,9,2,16,7,72,1,0,1
70,2018,5,2018-09-29,Arizona State,,Oregon State,W (52-24),14,25,56.0,162,3,48,396,8.3,4,73,558,7.6,6,20,2,28,1,5,0,0,0
71,2018,6,2018-10-06,Arizona State,@,Colorado,L (21-28),12,18,66.7,222,1,39,145,3.7,2,57,367,6.4,7,8,3,18,5,35,0,0,0
72,2018,7,2018-10-18,Arizona State,,Stanford,L (13-20),26,45,57.8,353,0,23,84,3.7,1,68,437,6.4,16,4,0,20,7,86,1,2,3
73,2018,8,2018-10-27,Arizona State,@,Southern California,W (38-35),14,24,58.3,166,1,44,283,6.4,3,68,449,6.6,7,12,1,20,5,48,1,0,1
74,2018,9,2018-11-03,Arizona State,,Utah,W (38-20),19,24,79.2,285,3,50,251,5.0,2,74,536,7.2,11,12,2,25,6,60,0,1,1
75,2018,10,2018-11-10,Arizona State,,UCLA,W (31-28),16,22,72.7,199,1,57,283,5.0,3,79,482,6.1,11,16,2,29,6,75,0,1,1
76,2018,11,2018-11-17,Arizona State,@,Oregon,L (29-31),15,32,46.9,182,2,41,142,3.5,1,73,324,4.4,8,6,2,16,8,50,1,0,1
77,2018,12,2018-11-24,Arizona State,@,Arizona,W (41-40),18,31,58.1,265,1,30,137,4.6,4,61,402,6.6,10,8,2,20,9,74,0,0,0
78,2018,,12 Games,Arizona State,,,,228,366,62.3,2896,19,460,2232,4.9,25,826,5128,6.2,124,116,21,261,76,679,4,5,9
79,2018,1,2018-09-01,Arkansas,,Eastern Illinois,W (55-20),21,29,72.4,353,4,37,80,2.2,2,66,433,6.6,13,5,0,18,4,40,0,0,0
80,2018,2,2018-09-08,Arkansas,@,Colorado State,L (27-34),11,22,50.0,138,2,53,299,5.6,1,75,437,5.8,5,16,3,24,6,60,0,2,2
81,2018,3,2018-09-15,Arkansas,,North Texas,L (17-44),20,45,44.4,210,0,32,126,3.9,2,77,336,4.4,12,4,4,20,10,70,0,6,6
82,2018,4,2018-09-22,Arkansas,@,Auburn,L (3-34),13,32,40.6,141,0,38,149,3.9,0,70,290,4.1,5,6,2,13,8,57,1,1,2
83,2018,5,2018-09-29,Arkansas,N,Texas A&M,L (17-24),14,27,51.9,193,1,26,55,2.1,1,53,248,4.7,8,3,0,11,6,61,0,1,1
84,2018,6,2018-10-06,Arkansas,,Alabama,L (31-65),26,40,65.0,233,3,31,172,5.5,1,71,405,5.7,12,7,3,22,2,20,2,1,3
85,2018,7,2018-10-13,Arkansas,,Mississippi,L (33-37),15,22,68.2,177,2,48,299,6.2,1,70,476,6.8,7,17,3,27,5,65,0,1,1
86,2018,8,2018-10-20,Arkansas,,Tulsa,W (23-0),11,19,57.9,131,1,53,196,3.7,1,72,327,4.5,6,12,2,20,3,40,1,1,2
87,2018,9,2018-10-27,Arkansas,,Vanderbilt,L (31-45),23,36,63.9,240,2,29,207,7.1,2,65,447,6.9,12,8,1,21,6,46,0,2,2
88,2018,10,2018-11-10,Arkansas,,Louisiana State,L (17-24),19,39,48.7,200,2,19,16,0.8,0,58,216,3.7,9,2,3,14,6,60,1,1,2
89,2018,11,2018-11-17,Arkansas,@,Mississippi State,L (6-52),19,34,55.9,150,0,35,69,2.0,0,69,219,3.2,6,10,1,17,9,85,2,1,3
90,2018,12,2018-11-23,Arkansas,@,Missouri,L (0-38),10,25,40.0,135,0,39,52,1.3,0,64,187,2.9,6,5,1,12,4,18,1,1,2
91,2018,,12 Games,Arkansas,,,,202,370,54.6,2301,17,440,1720,3.9,11,810,4021,5.0,101,95,23,219,69,622,8,18,26
92,2018,1,2018-09-01,Arkansas State,,Southeast Missouri State,W (48-21),28,40,70.0,497,7,39,188,4.8,0,79,685,8.7,18,10,2,30,12,119,1,2,3
93,2018,2,2018-09-08,Arkansas State,@,Alabama,L (7-57),22,51,43.1,218,1,31,173,5.6,0,82,391,4.8,12,6,1,19,10,84,0,1,1
94,2018,3,2018-09-15,Arkansas State,@,Tulsa,W (29-20),20,33,60.6,191,0,47,218,4.6,2,80,409,5.1,9,14,1,24,11,101,1,0,1
95,2018,4,2018-09-22,Arkansas State,,Nevada-Las Vegas,W (27-20),19,27,70.4,199,3,36,197,5.5,1,63,396,6.3,9,8,0,17,11,87,1,0,1
96,2018,5,2018-09-29,Arkansas State,@,Georgia Southern,L (21-28),38,51,74.5,376,1,36,117,3.3,1,87,493,5.7,18,10,0,28,5,39,1,0,1
97,2018,6,2018-10-09,Arkansas State,,Appalachian State,L (9-35),27,45,60.0,219,0,37,117,3.2,0,82,336,4.1,10,6,2,18,7,65,0,3,3
98,2018,7,2018-10-18,Arkansas State,,Georgia State,W (51-35),17,28,60.7,257,3,37,273,7.4,3,65,530,8.2,10,11,2,23,11,109,0,0,0
99,2018,8,2018-10-27,Arkansas State,@,Louisiana,L (43-47),17,31,54.8,270,1,45,208,4.6,5,76,478,6.3,10,14,3,27,4,65,0,1,1
100,2018,9,2018-11-03,Arkansas State,,South Alabama,W (38-14),27,40,67.5,354,3,37,155,4.2,2,77,509,6.6,15,8,3,26,3,15,0,0,0
101,2018,10,2018-11-10,Arkansas State,@,Coastal Carolina,W (44-16),23,29,79.3,281,4,29,173,6.0,2,58,454,7.8,11,9,3,23,10,71,1,0,1
102,2018,11,2018-11-17,Arkansas State,,Louisiana-Monroe,W (31-17),21,27,77.8,246,3,39,158,4.1,0,66,404,6.1,11,7,2,20,7,68,0,0,0
103,2018,12,2018-11-24,Arkansas State,@,Texas State,W (33-7),18,24,75.0,276,2,46,217,4.7,1,70,493,7.0,10,10,0,20,4,37,1,0,1
104,2018,,12 Games,Arkansas State,,,,277,426,65.0,3384,28,459,2194,4.8,17,885,5578,6.3,143,113,19,275,95,860,6,7,13
105,2018,1,2018-08-31,Army,@,Duke,L (14-34),10,21,47.6,197,1,47,168,3.6,1,68,365,5.4,7,11,0,18,7,69,2,0,2
106,2018,2,2018-09-08,Army,,Liberty,W (38-14),2,8,25.0,61,1,74,449,6.1,4,82,510,6.2,2,24,2,28,7,100,0,0,0
107,2018,3,2018-09-15,Army,,Hawaii,W (28-21),6,10,60.0,162,0,66,303,4.6,4,76,465,6.1,6,12,0,18,5,70,0,0,0
108,2018,4,2018-09-22,Army,@,Oklahoma,L (21-28),3,9,33.3,40,0,78,339,4.3,3,87,379,4.4,3,22,1,26,6,50,0,2,2
109,2018,5,2018-09-29,Army,@,Buffalo,W (42-13),4,5,80.0,91,1,64,281,4.4,4,69,372,5.4,3,19,3,25,7,73,0,1,1
110,2018,6,2018-10-13,Army,N,San Jose State,W (52-3),2,5,40.0,54,1,65,341,5.2,5,70,395,5.6,2,19,2,23,3,15,0,0,0
111,2018,7,2018-10-20,Army,,Miami (OH),W (31-30),0,2,0.0,0,0,74,347,4.7,4,76,347,4.6,0,19,1,20,1,5,0,0,0
112,2018,8,2018-10-27,Army,@,Eastern Michigan,W (37-22),7,8,87.5,126,2,73,289,4.0,2,81,415,5.1,4,18,5,27,3,25,0,0,0
113,2018,9,2018-11-03,Army,,Air Force,W (17-14),3,5,60.0,44,0,59,242,4.1,2,64,286,4.5,0,15,1,16,5,69,0,0,0
114,2018,10,2018-11-10,Army,,Lafayette,W (31-13),5,6,83.3,95,0,57,313,5.5,4,63,408,6.5,3,20,0,23,6,40,1,0,1
115,2018,11,2018-11-17,Army,,Colgate,W (28-14),2,6,33.3,25,0,59,261,4.4,4,65,286,4.4,2,18,1,21,3,25,1,0,1
116,2018,,11 Games,Army,,,,44,85,51.8,895,6,716,3333,4.7,37,801,4228,5.3,32,197,16,245,53,541,4,3,7
117,2018,1,2018-09-01,Auburn,N,Washington,W (21-16),26,36,72.2,273,1,45,147,3.3,1,81,420,5.2,17,8,2,27,12,111,0,0,0
118,2018,2,2018-09-08,Auburn,,Alabama State,W (63-9),8,14,57.1,138,1,59,429,7.3,6,73,567,7.8,4,22,2,28,4,30,4,0,4
119,2018,3,2018-09-15,Auburn,,Louisiana State,L (21-22),16,28,57.1,198,1,38,130,3.4,2,66,328,5.0,10,5,4,19,9,111,0,2,2
120,2018,4,2018-09-22,Auburn,,Arkansas,W (34-3),15,22,68.2,134,0,36,91,2.5,3,58,225,3.9,6,6,1,13,7,40,0,0,0
121,2018,5,2018-09-29,Auburn,,Southern Mississippi,W (24-13),19,33,57.6,245,2,36,96,2.7,1,69,341,4.9,8,7,2,17,9,78,1,0,1
122,2018,6,2018-10-06,Auburn,@,Mississippi State,L (9-23),19,38,50.0,214,0,21,90,4.3,0,59,304,5.2,9,5,1,15,2,10,2,0,2
123,2018,7,2018-10-13,Auburn,,Tennessee,L (24-30),28,45,62.2,322,2,34,126,3.7,1,79,448,5.7,13,8,1,22,5,38,1,2,3
124,2018,8,2018-10-20,Auburn,@,Mississippi,W (31-16),13,22,59.1,215,1,46,269,5.8,3,68,484,7.1,5,15,0,20,8,80,0,0,0
125,2018,9,2018-11-03,Auburn,,Texas A&M,W (28-24),19,30,63.3,259,3,21,19,0.9,1,51,278,5.5,11,2,0,13,6,39,0,0,0
126,2018,10,2018-11-10,Auburn,@,Georgia,L (10-27),25,37,67.6,172,1,20,102,5.1,0,57,274,4.8,10,6,3,19,6,52,0,0,0
127,2018,11,2018-11-17,Auburn,,Liberty,W (53-0),14,21,66.7,191,2,61,340,5.6,3,82,531,6.5,8,22,0,29,3,25,0,0,0
128,2018,12,2018-11-24,Auburn,@,Alabama,L (21-52),15,32,46.9,153,2,43,130,3.0,1,75,283,3.8,5,10,4,19,9,88,0,1,1
129,2018,,12 Games,Auburn,,,,217,358,60.6,2514,16,460,1969,4.3,22,818,4483,5.5,106,116,20,241,80,702,8,5,13
130,2018,1,2018-08-30,Ball State,,Central Connecticut State,W (42-6),28,36,77.8,336,3,47,318,6.8,3,83,654,7.9,10,19,2,31,6,70,1,0,1
131,2018,2,2018-09-08,Ball State,@,Notre Dame,L (16-24),23,50,46.0,180,1,47,169,3.6,0,97,349,3.6,13,11,0,24,3,10,0,2,2
132,2018,3,2018-09-15,Ball State,@,Indiana,L (10-38),14,28,50.0,143,0,39,204,5.2,1,67,347,5.2,7,11,0,18,8,75,0,1,1
133,2018,4,2018-09-22,Ball State,,Western Kentucky,L (20-28),27,45,60.0,285,1,29,120,4.1,1,74,405,5.5,14,8,2,24,10,120,0,0,0
134,2018,5,2018-09-29,Ball State,,Kent State,W (52-24),32,52,61.5,446,4,42,160,3.8,3,94,606,6.4,19,7,6,32,11,91,1,1,2
135,2018,6,2018-10-06,Ball State,,Northern Illinois,L (16-24),32,56,57.1,260,0,40,131,3.3,1,96,391,4.1,17,6,3,26,2,16,1,0,1
136,2018,7,2018-10-13,Ball State,@,Central Michigan,W (24-23),20,27,74.1,202,1,51,157,3.1,2,78,359,4.6,10,11,5,26,8,80,1,0,1
137,2018,8,2018-10-20,Ball State,,Eastern Michigan,L (20-42),21,39,53.8,157,1,32,227,7.1,2,71,384,5.4,9,8,4,21,9,108,1,1,2
138,2018,9,2018-10-25,Ball State,@,Ohio,L (14-52),16,32,50.0,162,1,23,80,3.5,1,55,242,4.4,5,6,0,11,6,54,2,1,3
139,2018,10,2018-10-31,Ball State,@,Toledo,L (13-45),30,48,62.5,343,1,35,94,2.7,1,83,437,5.3,14,11,1,26,10,100,3,2,5
140,2018,11,2018-11-13,Ball State,,Western Michigan,W (42-41),22,27,81.5,282,3,26,71,2.7,3,53,353,6.7,14,7,1,22,6,49,0,2,2
141,2018,12,2018-11-20,Ball State,@,Miami (OH),L (21-42),23,36,63.9,239,1,34,143,4.2,2,70,382,5.5,15,6,1,22,3,30,0,2,2
142,2018,,12 Games,Ball State,,,,288,476,60.5,3035,17,445,1874,4.2,20,921,4909,5.3,147,111,25,283,82,803,10,12,22
143,2018,1,2018-09-01,Baylor,,Abilene Christian,W (55-27),18,28,64.3,311,2,36,295,8.2,5,64,606,9.5,12,14,0,26,5,53,0,1,1
144,2018,2,2018-09-08,Baylor,@,Texas-San Antonio,W (37-20),27,41,65.9,403,3,31,91,2.9,1,72,494,6.9,16,7,3,26,7,70,1,0,1
145,2018,3,2018-09-15,Baylor,,Duke,L (27-40),24,42,57.1,270,1,32,130,4.1,2,74,400,5.4,12,9,0,21,6,62,1,1,2
146,2018,4,2018-09-22,Baylor,,Kansas,W (26-7),20,29,69.0,257,3,39,190,4.9,0,68,447,6.6,10,10,2,22,13,141,0,0,0
147,2018,5,2018-09-29,Baylor,@,Oklahoma,L (33-66),40,63,63.5,416,2,38,77,2.0,2,101,493,4.9,18,11,4,33,9,75,1,0,1
148,2018,6,2018-10-06,Baylor,,Kansas State,W (37-34),30,45,66.7,296,1,48,261,5.4,3,93,557,6.0,19,17,2,38,2,10,0,2,2
149,2018,7,2018-10-13,Baylor,@,Texas,L (17-23),20,39,51.3,240,1,34,88,2.6,1,73,328,4.5,10,8,1,19,10,142,0,1,1
150,2018,8,2018-10-25,Baylor,@,West Virginia,L (14-58),17,29,58.6,205,0,36,82,2.3,2,65,287,4.4,9,7,1,17,8,75,1,3,4
151,2018,9,2018-11-03,Baylor,,Oklahoma State,W (35-31),14,26,53.8,158,2,39,244,6.3,2,65,402,6.2,6,12,8,26,6,69,0,1,1
152,2018,10,2018-11-10,Baylor,@,Iowa State,L (14-28),29,48,60.4,359,2,32,146,4.6,0,80,505,6.3,15,9,1,25,7,70,0,0,0
153,2018,11,2018-11-17,Baylor,,Texas Christian,L (9-16),14,29,48.3,163,0,40,140,3.5,1,69,303,4.4,7,10,3,20,9,66,2,1,3
154,2018,12,2018-11-24,Baylor,@,Texas Tech,W (35-24),22,31,71.0,308,3,51,170,3.3,2,82,478,5.8,11,13,4,28,12,80,0,2,2
155,2018,,12 Games,Baylor,,,,275,450,61.1,3386,20,456,1914,4.2,21,906,5300,5.8,145,127,29,301,94,913,6,12,18
156,2018,1,2018-09-01,Boise State,@,Troy,W (56-20),20,28,71.4,305,4,29,111,3.8,2,57,416,7.3,10,6,0,16,4,27,1,0,1
157,2018,2,2018-09-08,Boise State,,Connecticut,W (62-7),25,33,75.8,418,4,45,400,8.9,4,78,818,10.5,18,19,1,38,7,71,0,0,0
158,2018,3,2018-09-15,Boise State,@,Oklahoma State,L (21-44),39,56,69.6,380,3,31,34,1.1,0,87,414,4.8,21,2,0,23,5,40,1,0,1
159,2018,4,2018-09-29,Boise State,@,Wyoming,W (34-14),29,43,67.4,345,2,46,161,3.5,2,89,506,5.7,14,11,4,29,9,71,0,0,0
160,2018,5,2018-10-06,Boise State,,San Diego State,L (13-19),22,44,50.0,178,0,36,51,1.4,2,80,229,2.9,8,7,1,16,6,52,0,3,3
161,2018,6,2018-10-13,Boise State,@,Nevada,W (31-27),28,38,73.7,299,2,40,207,5.2,1,78,506,6.5,14,9,1,24,9,108,1,3,4
162,2018,7,2018-10-19,Boise State,,Colorado State,W (56-28),23,27,85.2,322,4,37,150,4.1,2,64,472,7.4,16,8,2,26,5,40,0,0,0
163,2018,8,2018-10-27,Boise State,@,Air Force,W (48-38),22,36,61.1,409,5,33,121,3.7,1,69,530,7.7,16,9,1,26,1,15,0,0,0
164,2018,9,2018-11-03,Boise State,,Brigham Young,W (21-16),23,35,65.7,214,1,37,113,3.1,2,72,327,4.5,10,10,0,20,7,81,1,1,2
165,2018,10,2018-11-09,Boise State,,Fresno State,W (24-17),24,30,80.0,269,1,44,179,4.1,2,74,448,6.1,11,12,1,24,4,45,0,1,1
166,2018,11,2018-11-16,Boise State,@,New Mexico,W (45-14),17,27,63.0,222,3,41,227,5.5,2,68,449,6.6,14,14,2,30,5,30,0,0,0
167,2018,12,2018-11-24,Boise State,,Utah State,W (33-24),23,32,71.9,310,1,45,199,4.4,3,77,509,6.6,11,7,2,20,7,69,0,0,0
168,2018,,12 Games,Boise State,,,,295,429,68.8,3671,30,464,1953,4.2,23,893,5624,6.3,163,114,15,292,69,649,4,8,12
169,2018,1,2018-09-01,Boston College,,Massachusetts,W (55-21),21,27,77.8,326,4,59,273,4.6,3,86,599,7.0,14,16,1,31,7,38,0,0,0
170,2018,2,2018-09-08,Boston College,,Holy Cross,W (62-14),16,20,80.0,245,4,52,365,7.0,4,72,610,8.5,8,14,0,22,5,40,1,0,1
171,2018,3,2018-09-13,Boston College,@,Wake Forest,W (41-34),16,25,64.0,304,5,44,220,5.0,1,69,524,7.6,9,9,1,19,4,35,1,0,1
172,2018,4,2018-09-22,Boston College,@,Purdue,L (13-30),15,29,51.7,144,1,34,85,2.5,1,63,229,3.6,7,7,0,14,7,60,0,4,4
173,2018,5,2018-09-29,Boston College,,Temple,W (45-35),16,34,47.1,148,3,66,275,4.2,3,100,423,4.2,9,13,6,28,10,79,2,0,2
174,2018,6,2018-10-06,Boston College,@,North Carolina State,L (23-28),14,25,56.0,198,1,25,120,4.8,1,50,318,6.4,6,6,0,12,6,37,1,0,1
175,2018,7,2018-10-13,Boston College,,Louisville,W (38-20),16,22,72.7,179,1,61,251,4.1,3,83,430,5.2,6,14,0,20,7,60,2,0,2
176,2018,8,2018-10-26,Boston College,,Miami (FL),W (27-14),17,30,56.7,210,1,53,223,4.2,2,83,433,5.2,10,11,1,22,8,70,0,1,1
177,2018,9,2018-11-03,Boston College,@,Virginia Tech,W (31-21),15,26,57.7,177,1,49,219,4.5,3,75,396,5.3,8,10,1,19,4,39,1,0,1
178,2018,10,2018-11-10,Boston College,,Clemson,L (7-27),14,24,58.3,104,0,33,9,0.3,0,57,113,2.0,6,2,0,8,6,42,0,0,0
179,2018,11,2018-11-17,Boston College,@,Florida State,L (21-22),18,38,47.4,297,1,49,125,2.6,2,87,422,4.9,13,7,0,20,5,40,0,2,2
180,2018,12,2018-11-24,Boston College,,Syracuse,L (21-42),17,37,45.9,251,3,32,105,3.3,0,69,356,5.2,11,5,2,18,6,50,2,2,4
181,2018,,12 Games,Boston College,,,,195,337,57.9,2583,25,557,2270,4.1,23,894,4853,5.4,107,114,12,233,75,590,10,9,19
182,2018,1,2018-09-01,Bowling Green State,@,Oregon,L (24-58),22,38,57.9,253,3,49,155,3.2,0,87,408,4.7,14,8,0,22,5,50,1,2,3
183,2018,2,2018-09-08,Bowling Green State,,Maryland,L (14-45),17,27,63.0,143,2,28,15,0.5,0,55,158,2.9,6,4,3,13,10,66,0,1,1
184,2018,3,2018-09-15,Bowling Green State,,Eastern Kentucky,W (42-35),28,40,70.0,258,3,40,130,3.3,2,80,388,4.9,15,7,4,26,8,69,0,1,1
185,2018,4,2018-09-22,Bowling Green State,,Miami (OH),L (23-38),33,50,66.0,300,3,34,85,2.5,0,84,385,4.6,15,10,4,29,7,57,1,0,1
186,2018,5,2018-09-29,Bowling Green State,@,Georgia Tech,L (17-63),29,49,59.2,330,1,38,63,1.7,1,87,393,4.5,17,7,1,25,5,26,1,2,3
187,2018,6,2018-10-06,Bowling Green State,@,Toledo,L (36-52),18,34,52.9,289,3,29,192,6.6,2,63,481,7.6,10,7,3,20,14,129,1,0,1
188,2018,7,2018-10-13,Bowling Green State,,Western Michigan,L (35-42),21,35,60.0,379,3,21,132,6.3,2,56,511,9.1,13,3,3,19,9,85,2,2,4
189,2018,8,2018-10-20,Bowling Green State,@,Ohio,L (14-49),19,24,79.2,214,2,26,100,3.8,0,50,314,6.3,9,4,0,13,7,78,1,1,2
190,2018,9,2018-10-30,Bowling Green State,,Kent State,L (28-35),21,38,55.3,231,3,39,86,2.2,0,77,317,4.1,11,5,2,18,11,85,0,1,1
191,2018,10,2018-11-10,Bowling Green State,@,Central Michigan,W (24-13),14,24,58.3,142,1,51,178,3.5,1,75,320,4.3,9,8,0,17,5,31,0,1,1
192,2018,11,2018-11-17,Bowling Green State,@,Akron,W (21-6),19,27,70.4,178,2,41,221,5.4,1,68,399,5.9,7,12,3,22,8,72,1,1,2
193,2018,12,2018-11-23,Bowling Green State,,Buffalo,L (14-44),9,18,50.0,147,2,18,60,3.3,0,36,207,5.8,3,3,0,6,4,40,1,1,2
194,2018,,12 Games,Bowling Green State,,,,250,404,61.9,2864,28,414,1417,3.4,9,818,4281,5.2,129,78,23,230,93,788,9,13,22
195,2018,1,2018-09-01,Brigham Young,@,Arizona,W (28-23),18,28,64.3,209,1,43,183,4.3,3,71,392,5.5,12,11,0,23,10,94,0,0,0
196,2018,2,2018-09-08,Brigham Young,,California,L (18-21),22,41,53.7,196,1,33,91,2.8,0,74,287,3.9,9,8,0,17,7,65,0,2,2
197,2018,3,2018-09-15,Brigham Young,@,Wisconsin,W (24-21),13,23,56.5,120,1,28,191,6.8,2,51,311,6.1,5,8,1,14,4,36,0,0,0
198,2018,4,2018-09-22,Brigham Young,,McNeese State,W (30-3),16,27,59.3,130,1,42,161,3.8,2,69,291,4.2,7,9,2,18,5,56,1,0,1
199,2018,5,2018-09-29,Brigham Young,@,Washington,L (7-35),18,21,85.7,160,0,28,34,1.2,1,49,194,4.0,6,1,0,7,8,50,1,0,1
200,2018,6,2018-10-05,Brigham Young,,Utah State,L (20-45),30,49,61.2,322,3,16,39,2.4,0,65,361,5.6,14,2,7,23,6,50,2,1,3
201,2018,7,2018-10-13,Brigham Young,,Hawaii,W (49-23),16,24,66.7,194,3,47,280,6.0,4,71,474,6.7,11,14,1,26,6,55,0,1,1
202,2018,8,2018-10-27,Brigham Young,,Northern Illinois,L (6-7),18,30,60.0,208,0,37,93,2.5,0,67,301,4.5,9,5,3,17,7,52,0,1,1
203,2018,9,2018-11-03,Brigham Young,@,Boise State,L (16-21),19,29,65.5,292,0,38,96,2.5,1,67,388,5.8,12,7,2,21,8,58,3,0,3
204,2018,10,2018-11-10,Brigham Young,@,Massachusetts,W (35-16),14,23,60.9,167,2,38,225,5.9,3,61,392,6.4,7,12,0,19,2,20,1,0,1
205,2018,11,2018-11-17,Brigham Young,,New Mexico State,W (45-10),13,29,44.8,193,0,51,317,6.2,6,80,510,6.4,9,15,1,25,2,20,1,1,2
206,2018,12,2018-11-24,Brigham Young,@,Utah,L (27-35),20,29,69.0,204,2,47,153,3.3,2,76,357,4.7,8,9,0,17,3,22,0,1,1
207,2018,,12 Games,Brigham Young,,,,217,353,61.5,2395,14,448,1863,4.2,24,801,4258,5.3,109,101,17,227,68,578,9,7,16
208,2018,1,2018-09-01,Buffalo,,Delaware State,W (48-10),19,29,65.5,200,6,37,154,4.2,1,66,354,5.4,9,9,3,21,5,42,0,0,0
209,2018,2,2018-09-08,Buffalo,@,Temple,W (36-29),26,45,57.8,275,3,41,152,3.7,2,86,427,5.0,17,7,3,27,4,29,0,1,1
210,2018,3,2018-09-15,Buffalo,,Eastern Michigan,W (35-28),21,26,80.8,325,3,41,164,4.0,2,67,489,7.3,10,6,2,18,7,47,1,0,1
211,2018,4,2018-09-22,Buffalo,@,Rutgers,W (42-13),14,28,50.0,263,3,36,182,5.1,3,64,445,7.0,10,5,4,19,3,25,0,2,2
212,2018,5,2018-09-29,Buffalo,,Army,L (13-42),10,24,41.7,152,1,31,103,3.3,1,55,255,4.6,5,5,4,14,7,78,0,0,0
213,2018,6,2018-10-06,Buffalo,@,Central Michigan,W (34-24),10,20,50.0,127,1,48,295,6.1,3,68,422,6.2,8,12,1,21,4,38,0,1,1
214,2018,7,2018-10-13,Buffalo,,Akron,W (24-6),16,30,53.3,212,1,46,223,4.8,2,76,435,5.7,9,10,1,20,5,45,0,1,1
215,2018,8,2018-10-20,Buffalo,@,Toledo,W (31-17),25,46,54.3,326,2,50,137,2.7,2,96,463,4.8,14,10,8,32,5,44,0,3,3
216,2018,9,2018-10-30,Buffalo,,Miami (OH),W (51-42),20,35,57.1,358,3,37,149,4.0,4,72,507,7.0,11,10,5,26,11,100,0,0,0
217,2018,10,2018-11-06,Buffalo,,Kent State,W (48-14),9,21,42.9,120,1,57,358,6.3,6,78,478,6.1,6,15,1,22,3,20,1,0,1
218,2018,11,2018-11-14,Buffalo,@,Ohio,L (17-52),10,23,43.5,120,0,22,157,7.1,2,45,277,6.2,4,7,2,13,3,20,2,3,5
219,2018,12,2018-11-23,Buffalo,@,Bowling Green State,W (44-14),12,22,54.5,151,1,60,336,5.6,4,82,487,5.9,4,24,2,30,4,25,0,1,1
220,2018,,12 Games,Buffalo,,,,192,349,55.0,2629,25,506,2410,4.8,32,855,5039,5.9,107,120,36,263,61,513,4,12,16
221,2018,1,2018-09-01,California,,North Carolina,W (24-17),16,32,50.0,119,1,49,160,3.3,1,81,279,3.4,6,9,4,19,5,35,0,0,0
222,2018,2,2018-09-08,California,@,Brigham Young,W (21-18),23,35,65.7,214,2,38,172,4.5,1,73,386,5.3,10,10,2,22,9,65,2,1,3
223,2018,3,2018-09-15,California,,Idaho State,W (45-23),24,32,75.0,269,4,43,213,5.0,1,75,482,6.4,12,11,1,24,11,111,1,1,2
224,2018,4,2018-09-29,California,,Oregon,L (24-42),16,31,51.6,186,1,41,241,5.9,2,72,427,5.9,7,15,3,25,4,30,1,4,5
225,2018,5,2018-10-06,California,@,Arizona,L (17-24),32,43,74.4,315,0,34,161,4.7,2,77,476,6.2,15,7,3,25,13,115,1,3,4
226,2018,6,2018-10-13,California,,UCLA,L (7-37),23,42,54.8,179,0,33,131,4.0,1,75,310,4.1,9,10,1,20,3,36,3,2,5
227,2018,7,2018-10-20,California,@,Oregon State,W (49-7),17,26,65.4,234,3,43,305,7.1,3,69,539,7.8,9,17,1,27,4,50,1,0,1
228,2018,8,2018-10-27,California,,Washington,W (12-10),17,24,70.8,151,0,36,91,2.5,0,60,242,4.0,8,6,0,14,4,24,0,0,0
229,2018,9,2018-11-03,California,@,Washington State,L (13-19),18,33,54.5,179,1,36,112,3.1,0,69,291,4.2,8,6,6,20,2,25,0,2,2
230,2018,10,2018-11-10,California,@,Southern California,W (15-14),14,26,53.8,93,1,32,114,3.6,1,58,207,3.6,6,3,2,11,4,35,1,0,1
231,2018,11,2018-11-24,California,,Colorado,W (33-21),14,26,53.8,116,2,35,101,2.9,0,61,217,3.6,6,3,3,12,9,75,0,0,0
232,2018,,11 Games,California,,,,214,350,61.1,2055,15,420,1801,4.3,12,770,3856,5.0,96,97,26,219,68,601,10,13,23
233,2018,1,2018-09-01,Central Michigan,@,Kentucky,L (20-35),17,27,63.0,137,0,39,118,3.0,1,66,255,3.9,3,7,1,11,12,106,0,0,0
234,2018,2,2018-09-08,Central Michigan,,Kansas,L (7-31),18,32,56.3,177,1,28,103,3.7,0,60,280,4.7,7,5,0,12,6,52,2,4,6
235,2018,3,2018-09-15,Central Michigan,@,Northern Illinois,L (16-24),18,33,54.5,158,1,46,164,3.6,1,79,322,4.1,11,10,0,21,4,31,1,1,2
236,2018,4,2018-09-22,Central Michigan,,Maine,W (17-5),7,16,43.8,82,1,41,95,2.3,1,57,177,3.1,2,5,5,12,9,83,1,1,2
237,2018,5,2018-09-29,Central Michigan,@,Michigan State,L (20-31),20,35,57.1,182,2,22,63,2.9,0,57,245,4.3,8,2,3,13,7,64,0,2,2
238,2018,6,2018-10-06,Central Michigan,,Buffalo,L (24-34),14,33,42.4,172,2,35,168,4.8,1,68,340,5.0,9,8,2,19,10,60,0,4,4
239,2018,7,2018-10-13,Central Michigan,,Ball State,L (23-24),11,23,47.8,127,1,50,261,5.2,1,73,388,5.3,5,15,3,23,11,115,0,0,0
240,2018,8,2018-10-20,Central Michigan,,Western Michigan,L (10-35),11,28,39.3,122,0,44,147,3.3,1,72,269,3.7,5,9,1,15,7,59,1,2,3
241,2018,9,2018-10-27,Central Michigan,@,Akron,L (10-17),19,39,48.7,169,0,49,131,2.7,1,88,300,3.4,9,9,0,18,7,75,1,0,1
242,2018,10,2018-11-03,Central Michigan,@,Eastern Michigan,L (7-17),12,32,37.5,61,0,32,77,2.4,0,64,138,2.2,4,4,2,10,7,61,2,2,4
243,2018,11,2018-11-10,Central Michigan,,Bowling Green State,L (13-24),11,21,52.4,94,1,29,72,2.5,1,50,166,3.3,6,4,1,11,2,13,1,1,2
244,2018,12,2018-11-23,Central Michigan,@,Toledo,L (13-51),18,43,41.9,133,1,32,48,1.5,0,75,181,2.4,8,6,2,16,16,132,0,1,1
245,2018,,12 Games,Central Michigan,,,,176,362,48.6,1614,10,447,1447,3.2,8,809,3061,3.8,77,84,20,181,98,851,9,18,27
246,2018,1,2018-09-01,Charlotte,,Fordham,W (34-10),13,20,65.0,267,1,47,221,4.7,2,67,488,7.3,8,11,1,20,4,45,1,0,1
247,2018,2,2018-09-08,Charlotte,,Appalachian State,L (9-45),12,25,48.0,108,0,43,95,2.2,0,68,203,3.0,4,8,3,15,9,80,1,1,2
248,2018,3,2018-09-13,Charlotte,,Old Dominion,W (28-25),23,34,67.6,202,2,46,171,3.7,1,80,373,4.7,11,14,2,27,3,22,1,0,1
249,2018,4,2018-09-22,Charlotte,@,Massachusetts,L (31-49),23,36,63.9,283,3,41,81,2.0,1,77,364,4.7,12,7,3,22,4,32,1,0,1
250,2018,5,2018-09-29,Charlotte,@,Alabama-Birmingham,L (7-28),17,25,68.0,194,0,34,69,2.0,1,59,263,4.5,9,4,3,16,7,76,1,1,2
251,2018,6,2018-10-13,Charlotte,,Western Kentucky,W (40-14),17,26,65.4,237,1,50,211,4.2,4,76,448,5.9,12,13,3,28,4,30,1,0,1
252,2018,7,2018-10-20,Charlotte,@,Middle Tennessee State,L (13-21),20,40,50.0,209,1,39,150,3.8,1,79,359,4.5,8,10,1,19,5,40,0,2,2
253,2018,8,2018-10-27,Charlotte,,Southern Mississippi,W (20-17),8,14,57.1,78,0,41,146,3.6,1,55,224,4.1,5,7,1,13,5,50,0,1,1
254,2018,9,2018-11-03,Charlotte,@,Tennessee,L (3-14),13,25,52.0,152,0,37,92,2.5,0,62,244,3.9,7,4,2,13,8,55,0,1,1
255,2018,10,2018-11-10,Charlotte,@,Marshall,L (13-30),10,20,50.0,72,0,41,113,2.8,1,61,185,3.0,3,10,0,13,3,15,0,0,0
256,2018,11,2018-11-17,Charlotte,,Florida International,L (35-42),16,22,72.7,253,1,57,281,4.9,4,79,534,6.8,9,16,3,28,7,65,1,1,2
257,2018,12,2018-11-24,Charlotte,@,Florida Atlantic,W (27-24),10,16,62.5,91,1,49,290,5.9,2,65,381,5.9,7,13,0,20,5,55,0,1,1
258,2018,,12 Games,Charlotte,,,,182,303,60.1,2146,10,525,1920,3.7,18,828,4066,4.9,95,117,22,234,64,565,7,8,15
259,2018,1,2018-11-17,Chattanooga,@,South Carolina,L (9-49),18,37,48.6,256,1,24,78,3.3,0,61,334,5.5,9,4,4,17,6,49,1,1,2
260,2018,1,2018-09-01,Cincinnati,@,UCLA,W (26-17),14,26,53.8,110,0,51,194,3.8,3,77,304,3.9,7,11,0,18,7,45,1,0,1
261,2018,2,2018-09-08,Cincinnati,@,Miami (OH),W (21-0),6,11,54.5,45,1,51,188,3.7,2,62,233,3.8,3,9,1,13,8,86,0,0,0
262,2018,3,2018-09-15,Cincinnati,,Alabama A&M,W (63-7),21,26,80.8,332,3,55,409,7.4,5,81,741,9.1,12,26,0,38,7,75,0,1,1
263,2018,4,2018-09-22,Cincinnati,,Ohio,W (34-30),19,31,61.3,274,2,34,150,4.4,3,65,424,6.5,12,10,2,24,14,150,0,1,1
264,2018,5,2018-09-29,Cincinnati,@,Connecticut,W (49-7),23,29,79.3,339,2,53,320,6.0,5,82,659,8.0,18,13,0,31,11,113,1,0,1
265,2018,6,2018-10-06,Cincinnati,,Tulane,W (37-21),15,25,60.0,174,2,48,272,5.7,3,73,446,6.1,8,10,4,22,7,65,2,1,3
266,2018,7,2018-10-20,Cincinnati,@,Temple,L (17-24),14,34,41.2,111,0,47,200,4.3,2,81,311,3.8,8,11,1,20,7,65,2,1,3
267,2018,8,2018-10-27,Cincinnati,@,Southern Methodist,W (26-20),33,50,66.0,352,2,39,125,3.2,0,89,477,5.4,15,9,1,25,6,51,1,2,3
268,2018,9,2018-11-03,Cincinnati,,Navy,W (42-0),14,20,70.0,189,2,41,262,6.4,4,61,451,7.4,8,14,0,22,4,30,0,0,0
269,2018,10,2018-11-10,Cincinnati,,South Florida,W (35-23),17,24,70.8,194,2,52,238,4.6,3,76,432,5.7,8,14,2,24,5,22,2,0,2
270,2018,11,2018-11-17,Cincinnati,@,Central Florida,L (13-38),11,26,42.3,127,0,55,252,4.6,1,81,379,4.7,6,13,1,20,9,70,3,0,3
271,2018,12,2018-11-23,Cincinnati,,East Carolina,W (56-6),25,40,62.5,394,5,38,247,6.5,2,78,641,8.2,16,8,1,25,9,90,1,0,1
272,2018,,12 Games,Cincinnati,,,,212,342,62.0,2641,21,564,2857,5.1,33,906,5498,6.1,121,148,13,282,94,862,13,6,19
273,2018,1,2018-11-17,Citadel,@,Alabama,L (17-50),0,2,0.0,0,0,60,275,4.6,2,62,275,4.4,0,11,2,13,6,50,1,0,1
274,2018,1,2018-09-01,Clemson,,Furman,W (48-7),22,35,62.9,277,4,34,266,7.8,2,69,543,7.9,15,8,0,23,0,0,0,0,0
275,2018,2,2018-09-08,Clemson,@,Texas A&M,W (28-26),17,27,63.0,298,2,32,115,3.6,2,59,413,7.0,7,6,1,14,4,49,0,0,0
276,2018,3,2018-09-15,Clemson,,Georgia Southern,W (38-7),21,31,67.7,286,1,46,309,6.7,4,77,595,7.7,14,13,0,27,7,65,1,2,3
277,2018,4,2018-09-22,Clemson,@,Georgia Tech,W (49-21),19,30,63.3,232,4,36,248,6.9,2,66,480,7.3,10,14,1,25,6,68,0,2,2
278,2018,5,2018-09-29,Clemson,,Syracuse,W (27-23),17,29,58.6,176,0,53,293,5.5,3,82,469,5.7,8,19,1,28,3,16,2,1,3
279,2018,6,2018-10-06,Clemson,@,Wake Forest,W (63-3),25,30,83.3,227,3,40,471,11.8,6,70,698,10.0,8,12,2,22,3,28,1,0,1
280,2018,7,2018-10-20,Clemson,,North Carolina State,W (41-7),32,48,66.7,380,1,32,91,2.8,4,80,471,5.9,19,4,1,24,8,67,1,0,1
281,2018,8,2018-10-27,Clemson,@,Florida State,W (59-10),24,44,54.5,404,5,33,120,3.6,3,77,524,6.8,16,6,3,25,5,50,0,1,1
282,2018,9,2018-11-03,Clemson,,Louisville,W (77-16),14,20,70.0,169,5,37,492,13.3,5,57,661,11.6,8,17,2,28,3,15,1,1,2
283,2018,10,2018-11-10,Clemson,@,Boston College,W (27-7),29,41,70.7,295,1,30,129,4.3,1,71,424,6.0,13,5,1,19,2,15,1,1,2
284,2018,11,2018-11-17,Clemson,,Duke,W (35-6),21,39,53.8,251,2,36,208,5.8,3,75,459,6.1,12,12,1,25,7,54,0,0,0
285,2018,12,2018-11-24,Clemson,,South Carolina,W (56-35),27,37,73.0,393,1,55,351,6.4,7,92,744,8.1,19,17,2,38,8,79,1,0,1
286,2018,,12 Games,Clemson,,,,268,411,65.2,3388,29,464,3093,6.7,42,875,6481,7.4,149,133,15,298,56,506,8,8,16
287,2018,1,2018-09-01,Coastal Carolina,@,South Carolina,L (15-49),13,18,72.2,112,1,38,131,3.4,0,56,243,4.3,5,10,5,20,4,36,1,0,1
288,2018,2,2018-09-08,Coastal Carolina,,Alabama-Birmingham,W (47-24),11,18,61.1,167,2,43,296,6.9,5,61,463,7.6,7,13,5,25,5,55,0,0,0
289,2018,3,2018-09-12,Coastal Carolina,@,Campbell,W (58-21),13,17,76.5,241,4,44,333,7.6,4,61,574,9.4,9,18,5,32,2,20,0,1,1
290,2018,4,2018-09-22,Coastal Carolina,@,Louisiana,W (30-28),12,17,70.6,186,2,56,311,5.6,2,73,497,6.8,9,14,2,25,7,70,1,0,1
291,2018,5,2018-09-29,Coastal Carolina,@,Troy,L (21-45),18,22,81.8,172,1,54,145,2.7,2,76,317,4.2,9,11,1,21,4,43,1,1,2
292,2018,6,2018-10-13,Coastal Carolina,,Louisiana-Monroe,L (20-45),12,23,52.2,167,0,52,272,5.2,2,75,439,5.9,6,13,1,20,8,71,2,1,3
293,2018,7,2018-10-20,Coastal Carolina,@,Massachusetts,W (24-13),9,18,50.0,219,2,52,279,5.4,1,70,498,7.1,7,14,1,22,3,20,1,1,2
294,2018,8,2018-10-27,Coastal Carolina,@,Georgia State,W (37-34),13,18,72.2,225,1,48,251,5.2,3,66,476,7.2,10,9,2,21,2,25,1,0,1
295,2018,9,2018-11-03,Coastal Carolina,,Appalachian State,L (7-23),14,26,53.8,106,0,26,72,2.8,0,52,178,3.4,6,5,0,11,4,27,0,1,1
296,2018,10,2018-11-10,Coastal Carolina,,Arkansas State,L (16-44),16,31,51.6,165,2,37,128,3.5,0,68,293,4.3,9,8,1,18,9,86,1,1,2
297,2018,11,2018-11-17,Coastal Carolina,,Georgia Southern,L (17-41),12,24,50.0,115,2,34,74,2.2,0,58,189,3.3,7,4,0,11,0,0,1,0,1
298,2018,12,2018-11-23,Coastal Carolina,@,South Alabama,L (28-31),21,33,63.6,293,2,30,92,3.1,2,63,385,6.1,12,8,2,22,4,40,2,1,3
299,2018,,12 Games,Coastal Carolina,,,,164,265,61.9,2168,19,514,2384,4.6,21,779,4552,5.8,96,127,25,248,52,493,11,7,18
300,2018,1,2018-11-17,Colgate,@,Army,L (14-28),11,16,68.8,63,0,28,188,6.7,1,44,251,5.7,3,9,1,13,7,55,1,0,1
301,2018,1,2018-08-31,Colorado,N,Colorado State,W (45-13),22,25,88.0,338,4,40,258,6.5,2,65,596,9.2,11,12,0,23,6,44,1,1,2
302,2018,2,2018-09-08,Colorado,@,Nebraska,W (33-28),33,50,66.0,351,3,35,44,1.3,1,85,395,4.6,16,7,3,26,8,46,0,0,0
303,2018,3,2018-09-15,Colorado,,New Hampshire,W (45-14),17,24,70.8,180,1,51,311,6.1,4,75,491,6.5,9,12,0,21,6,60,0,2,2
304,2018,4,2018-09-28,Colorado,,UCLA,W (38-16),23,27,85.2,268,1,48,209,4.4,4,75,477,6.4,12,11,3,26,6,60,0,0,0
305,2018,5,2018-10-06,Colorado,,Arizona State,W (28-21),24,33,72.7,328,2,45,166,3.7,2,78,494,6.3,12,12,1,25,6,60,0,0,0
306,2018,6,2018-10-13,Colorado,@,Southern California,L (20-31),26,47,55.3,170,0,37,95,2.6,3,84,265,3.2,7,6,4,17,8,81,0,1,1
307,2018,7,2018-10-20,Colorado,@,Washington,L (13-27),17,28,60.7,144,1,35,119,3.4,0,63,263,4.2,8,6,1,15,4,48,0,1,1
308,2018,8,2018-10-27,Colorado,,Oregon State,L (34-41),24,39,61.5,319,2,36,217,6.0,1,75,536,7.1,13,8,2,23,7,70,0,0,0
309,2018,9,2018-11-02,Colorado,@,Arizona,L (34-42),27,43,62.8,343,3,32,40,1.3,1,75,383,5.1,18,3,6,27,5,52,1,1,2
310,2018,10,2018-11-10,Colorado,,Washington State,L (7-31),21,38,55.3,222,0,16,75,4.7,1,54,297,5.5,10,2,0,12,4,51,2,1,3
311,2018,11,2018-11-17,Colorado,,Utah,L (7-30),21,33,63.6,162,0,34,34,1.0,1,67,196,2.9,8,3,3,14,4,38,1,2,3
312,2018,12,2018-11-24,Colorado,@,California,L (21-33),16,33,48.5,170,2,41,154,3.8,1,74,324,4.4,9,9,1,19,7,54,2,3,5
313,2018,,12 Games,Colorado,,,,271,420,64.5,2995,19,450,1722,3.8,21,870,4717,5.4,133,91,24,248,71,664,7,12,19
314,2018,1,2018-08-25,Colorado State,,Hawaii,L (34-43),34,50,68.0,537,5,25,116,4.6,0,75,653,8.7,22,5,2,29,12,120,0,1,1
315,2018,2,2018-08-31,Colorado State,N,Colorado,L (13-45),19,37,51.4,181,1,39,103,2.6,0,76,284,3.7,10,8,2,20,5,35,0,1,1
316,2018,3,2018-09-08,Colorado State,,Arkansas,W (34-27),32,50,64.0,389,2,23,40,1.7,1,73,429,5.9,14,5,2,21,6,54,1,1,2
317,2018,4,2018-09-15,Colorado State,@,Florida,L (10-48),23,41,56.1,240,1,41,73,1.8,0,82,313,3.8,11,8,3,22,6,33,3,0,3
318,2018,5,2018-09-22,Colorado State,,Illinois State,L (19-35),24,44,54.5,257,3,31,134,4.3,0,75,391,5.2,12,10,3,25,9,79,0,2,2
319,2018,6,2018-10-06,Colorado State,@,San Jose State,W (42-30),15,29,51.7,172,4,45,219,4.9,1,74,391,5.3,8,11,2,21,8,61,0,2,2
320,2018,7,2018-10-13,Colorado State,,New Mexico,W (20-18),24,42,57.1,311,1,41,112,2.7,1,83,423,5.1,12,10,2,24,10,65,0,0,0
321,2018,8,2018-10-19,Colorado State,@,Boise State,L (28-56),31,44,70.5,373,3,25,116,4.6,1,69,489,7.1,16,9,2,27,7,60,1,2,3
322,2018,9,2018-10-26,Colorado State,,Wyoming,L (21-34),34,54,63.0,333,0,20,20,1.0,3,74,353,4.8,19,3,1,23,3,26,1,2,3
323,2018,10,2018-11-10,Colorado State,@,Nevada,L (10-49),23,40,57.5,186,1,33,74,2.2,0,73,260,3.6,9,3,1,13,9,73,0,1,1
324,2018,11,2018-11-17,Colorado State,,Utah State,L (24-29),25,38,65.8,307,2,44,199,4.5,1,82,506,6.2,17,8,4,29,11,108,0,2,2
325,2018,12,2018-11-22,Colorado State,@,Air Force,L (19-27),19,32,59.4,373,3,24,64,2.7,0,56,437,7.8,15,4,1,20,8,75,0,2,2
326,2018,,12 Games,Colorado State,,,,303,501,60.5,3659,26,391,1270,3.2,8,892,4929,5.5,165,84,25,274,94,789,6,16,22
327,2018,1,2018-08-30,Connecticut,,Central Florida,L (17-56),27,41,65.9,266,1,46,220,4.8,1,87,486,5.6,9,16,2,27,7,93,2,1,3
328,2018,2,2018-09-08,Connecticut,@,Boise State,L (7-62),11,21,52.4,71,1,25,122,4.9,0,46,193,4.2,3,6,0,9,7,44,0,1,1
329,2018,3,2018-09-15,Connecticut,,Rhode Island,W (56-49),20,27,74.1,308,4,54,265,4.9,4,81,573,7.1,16,11,5,32,4,35,2,1,3
330,2018,4,2018-09-22,Connecticut,@,Syracuse,L (21-51),19,29,65.5,217,2,39,178,4.6,1,68,395,5.8,7,7,2,16,5,42,2,1,3
331,2018,5,2018-09-29,Connecticut,,Cincinnati,L (7-49),14,35,40.0,181,1,29,77,2.7,0,64,258,4.0,7,5,7,19,2,15,0,1,1
332,2018,6,2018-10-06,Connecticut,@,Memphis,L (14-55),24,43,55.8,215,1,30,112,3.7,1,73,327,4.5,14,4,1,19,3,25,1,3,4
333,2018,7,2018-10-20,Connecticut,@,South Florida,L (30-38),10,21,47.6,133,0,51,322,6.3,4,72,455,6.3,5,17,2,24,4,25,0,1,1
334,2018,8,2018-10-27,Connecticut,,Massachusetts,L (17-22),4,6,66.7,15,0,44,250,5.7,2,50,265,5.3,0,11,0,11,2,25,0,1,1
335,2018,9,2018-11-03,Connecticut,@,Tulsa,L (19-49),14,28,50.0,232,2,50,255,5.1,0,78,487,6.2,8,13,2,23,5,45,2,1,3
336,2018,10,2018-11-10,Connecticut,,Southern Methodist,L (50-62),25,40,62.5,215,4,49,365,7.4,3,89,580,6.5,12,17,5,34,9,77,0,1,1
337,2018,11,2018-11-17,Connecticut,@,East Carolina,L (21-55),17,33,51.5,183,3,29,91,3.1,0,62,274,4.4,11,4,1,16,5,30,1,2,3
338,2018,12,2018-11-24,Connecticut,,Temple,L (7-57),14,26,53.8,100,1,53,138,2.6,0,79,238,3.0,6,12,2,20,1,15,1,3,4
339,2018,,12 Games,Connecticut,,,,199,350,56.9,2136,20,499,2395,4.8,16,849,4531,5.3,98,123,29,250,54,471,11,17,28
340,2018,1,2018-08-31,Duke,,Army,W (34-14),13,17,76.5,197,1,35,184,5.3,3,52,381,7.3,8,9,2,19,4,30,1,0,1
341,2018,2,2018-09-08,Duke,@,Northwestern,W (21-7),18,24,75.0,204,3,39,97,2.5,0,63,301,4.8,8,6,1,15,4,42,0,0,0
342,2018,3,2018-09-15,Duke,@,Baylor,W (40-27),12,30,40.0,174,3,44,225,5.1,1,74,399,5.4,7,12,1,20,0,0,0,0,0
343,2018,4,2018-09-22,Duke,,North Carolina Central,W (55-13),20,39,51.3,256,4,59,372,6.3,4,98,628,6.4,11,19,2,32,8,75,1,0,1
344,2018,5,2018-09-29,Duke,,Virginia Tech,L (14-31),25,39,64.1,256,1,36,71,2.0,1,75,327,4.4,12,6,0,18,3,15,0,1,1
345,2018,6,2018-10-13,Duke,@,Georgia Tech,W (28-14),17,27,63.0,206,3,33,98,3.0,1,60,304,5.1,9,10,0,19,3,15,2,1,3
346,2018,7,2018-10-20,Duke,,Virginia,L (14-28),23,42,54.8,262,2,27,58,2.1,0,69,320,4.6,13,5,1,19,6,67,0,2,2
347,2018,8,2018-10-27,Duke,@,Pittsburgh,L (45-54),27,43,62.8,396,4,34,223,6.6,2,77,619,8.0,19,8,1,28,4,36,1,0,1
348,2018,9,2018-11-03,Duke,@,Miami (FL),W (20-12),19,37,51.4,144,1,30,146,4.9,1,67,290,4.3,6,5,2,13,3,25,0,1,1
349,2018,10,2018-11-10,Duke,,North Carolina,W (42-35),31,54,57.4,361,3,35,268,7.7,3,89,629,7.1,15,10,4,29,6,40,2,1,3
350,2018,11,2018-11-17,Duke,@,Clemson,L (6-35),24,44,54.5,158,0,35,104,3.0,0,79,262,3.3,5,10,2,17,6,52,0,0,0
351,2018,12,2018-11-24,Duke,,Wake Forest,L (7-59),17,36,47.2,145,1,34,106,3.1,0,70,251,3.6,9,6,1,16,3,25,3,1,4
352,2018,,12 Games,Duke,,,,246,432,56.9,2759,26,441,1952,4.4,16,873,4711,5.4,122,106,17,245,50,422,10,7,17
353,2018,1,2018-08-25,Duquesne,@,Massachusetts,L (15-63),16,30,53.3,123,1,36,130,3.6,1,66,253,3.8,6,5,2,13,3,22,1,3,4
354,2018,2,2018-09-22,Duquesne,@,Hawaii,L (21-42),14,26,53.8,142,3,27,24,0.9,0,53,166,3.1,7,1,3,11,8,83,0,1,1
355,2018,,2 Games,Duquesne,,,,30,56,53.6,265,4,63,154,2.4,1,119,419,3.5,13,6,5,24,11,105,1,4,5
356,2018,1,2018-09-02,East Carolina,,North Carolina A&T,L (23-28),38,66,57.6,314,2,29,68,2.3,0,95,382,4.0,16,6,6,28,5,45,1,2,3
357,2018,2,2018-09-08,East Carolina,,North Carolina,W (41-19),19,33,57.6,290,1,49,220,4.5,4,82,510,6.2,15,9,2,26,4,40,0,0,0
358,2018,3,2018-09-22,East Carolina,@,South Florida,L (13-20),22,50,44.0,256,0,46,156,3.4,1,96,412,4.3,11,10,3,24,2,10,0,1,1
359,2018,4,2018-09-29,East Carolina,,Old Dominion,W (37-35),25,45,55.6,313,3,38,179,4.7,2,83,492,5.9,17,6,2,25,8,86,0,2,2
360,2018,5,2018-10-06,East Carolina,@,Temple,L (6-49),18,39,46.2,120,0,28,76,2.7,0,67,196,2.9,4,5,3,12,2,25,0,0,0
361,2018,6,2018-10-13,East Carolina,,Houston,L (20-42),38,63,60.3,374,1,31,41,1.3,1,94,415,4.4,20,4,3,27,8,69,1,3,4
362,2018,7,2018-10-20,East Carolina,,Central Florida,L (10-37),29,56,51.8,406,1,38,90,2.4,0,94,496,5.3,18,9,2,29,8,60,4,1,5
363,2018,8,2018-11-03,East Carolina,,Memphis,L (41-59),34,62,54.8,449,3,29,107,3.7,2,91,556,6.1,18,8,3,29,4,45,1,0,1
364,2018,9,2018-11-10,East Carolina,@,Tulane,L (18-24),21,68,30.9,360,2,26,90,3.5,0,94,450,4.8,13,6,4,23,7,69,0,1,1
365,2018,10,2018-11-17,East Carolina,,Connecticut,W (55-21),22,33,66.7,242,4,54,415,7.7,3,87,657,7.6,9,23,2,34,5,48,0,0,0
366,2018,11,2018-11-23,East Carolina,@,Cincinnati,L (6-56),10,28,35.7,220,1,33,83,2.5,0,61,303,5.0,7,3,2,12,3,30,2,3,5
367,2018,,11 Games,East Carolina,,,,276,543,50.8,3344,18,401,1525,3.8,13,944,4869,5.2,148,89,32,269,56,527,9,13,22
368,2018,1,2018-09-08,East Tennessee State,@,Tennessee,L (3-59),12,29,41.4,69,0,29,125,4.3,0,58,194,3.3,4,5,0,9,6,39,1,2,3
369,2018,1,2018-08-31,Eastern Michigan,,Monmouth,W (51-17),22,27,81.5,302,5,39,171,4.4,2,66,473,7.2,15,9,3,27,7,65,0,0,0
370,2018,2,2018-09-08,Eastern Michigan,@,Purdue,W (20-19),22,34,64.7,347,1,31,69,2.2,1,65,416,6.4,13,3,3,19,10,71,0,1,1
371,2018,3,2018-09-15,Eastern Michigan,@,Buffalo,L (28-35),25,38,65.8,348,2,43,142,3.3,2,81,490,6.0,12,8,2,22,11,98,1,0,1
372,2018,4,2018-09-22,Eastern Michigan,@,San Diego State,L (20-23),17,27,63.0,236,1,39,119,3.1,1,66,355,5.4,7,6,1,14,6,45,1,1,2
373,2018,5,2018-09-29,Eastern Michigan,,Northern Illinois,L (23-26),17,41,41.5,180,1,33,62,1.9,1,74,242,3.3,9,5,2,16,11,85,1,0,1
374,2018,6,2018-10-06,Eastern Michigan,@,Western Michigan,L (24-27),18,31,58.1,206,2,48,178,3.7,1,79,384,4.9,11,10,2,23,4,31,1,0,1
375,2018,7,2018-10-13,Eastern Michigan,,Toledo,W (28-26),17,23,73.9,183,0,38,229,6.0,4,61,412,6.8,8,10,0,18,11,138,0,0,0
376,2018,8,2018-10-20,Eastern Michigan,@,Ball State,W (42-20),22,28,78.6,257,3,49,163,3.3,3,77,420,5.5,11,10,2,23,5,65,1,0,1
377,2018,9,2018-10-27,Eastern Michigan,,Army,L (22-37),19,29,65.5,201,2,11,34,3.1,1,40,235,5.9,7,1,2,10,8,75,1,0,1
378,2018,10,2018-11-03,Eastern Michigan,,Central Michigan,W (17-7),21,33,63.6,212,1,43,137,3.2,1,76,349,4.6,10,7,1,18,8,81,2,1,3
379,2018,11,2018-11-10,Eastern Michigan,,Akron,W (27-7),16,24,66.7,132,0,50,261,5.2,2,74,393,5.3,7,12,1,20,7,65,1,0,1
380,2018,12,2018-11-23,Eastern Michigan,@,Kent State,W (28-20),13,26,50.0,139,0,44,237,5.4,4,70,376,5.4,5,8,1,14,3,45,1,1,2
381,2018,,12 Games,Eastern Michigan,,,,229,361,63.4,2743,18,468,1802,3.9,23,829,4545,5.5,115,89,20,224,91,864,10,4,14
382,2018,1,2018-09-01,Florida,,Charleston Southern,W (53-6),19,27,70.4,241,5,39,203,5.2,1,66,444,6.7,12,12,1,25,3,20,0,0,0
383,2018,2,2018-09-08,Florida,,Kentucky,L (16-27),17,38,44.7,232,2,29,128,4.4,0,67,360,5.4,14,5,5,24,6,55,1,1,2
384,2018,3,2018-09-15,Florida,,Colorado State,W (48-10),8,15,53.3,119,2,29,222,7.7,2,44,341,7.8,3,10,1,14,8,75,0,1,1
385,2018,4,2018-09-22,Florida,@,Tennessee,W (47-21),10,19,52.6,186,3,34,201,5.9,3,53,387,7.3,6,7,1,14,10,79,1,0,1
386,2018,5,2018-09-29,Florida,@,Mississippi State,W (13-6),23,32,71.9,239,1,34,118,3.5,0,66,357,5.4,13,7,0,20,11,90,0,1,1
387,2018,6,2018-10-06,Florida,,Louisiana State,W (27-19),13,28,46.4,176,1,43,215,5.0,2,71,391,5.5,6,11,2,19,11,115,0,1,1
388,2018,7,2018-10-13,Florida,@,Vanderbilt,W (37-27),19,29,65.5,284,2,63,292,4.6,2,92,576,6.3,13,18,0,31,7,89,2,1,3
389,2018,8,2018-10-27,Florida,N,Georgia,L (17-36),13,21,61.9,105,1,37,170,4.6,1,58,275,4.7,5,9,2,16,7,27,2,1,3
390,2018,9,2018-11-03,Florida,,Missouri,L (17-38),19,40,47.5,210,1,28,113,4.0,1,68,323,4.8,8,7,2,17,8,66,0,0,0
391,2018,10,2018-11-10,Florida,,South Carolina,W (35-31),15,21,71.4,161,1,62,367,5.9,4,83,528,6.4,11,22,0,33,7,55,1,0,1
392,2018,11,2018-11-17,Florida,,Idaho,W (63-10),31,43,72.1,399,5,35,204,5.8,2,78,603,7.7,16,15,1,32,5,55,1,0,1
393,2018,12,2018-11-24,Florida,@,Florida State,W (41-14),16,27,59.3,254,3,52,282,5.4,2,79,536,6.8,11,11,2,24,7,49,0,0,0
394,2018,,12 Games,Florida,,,,203,340,59.7,2606,27,485,2515,5.2,20,825,5121,6.2,118,134,17,269,90,775,8,6,14
395,2018,1,2018-09-08,Florida A&M,@,Troy,L (7-59),17,31,54.8,219,0,32,68,2.1,1,63,287,4.6,6,6,1,13,8,65,2,2,4
396,2018,1,2018-09-01,Florida Atlantic,@,Oklahoma,L (14-63),18,32,56.3,192,0,42,132,3.1,2,74,324,4.4,11,7,2,20,6,48,0,1,1
397,2018,2,2018-09-08,Florida Atlantic,,Air Force,W (33-27),33,40,82.5,471,3,29,54,1.9,1,69,525,7.6,21,3,1,25,8,87,1,0,1
398,2018,3,2018-09-15,Florida Atlantic,,Bethune-Cookman,W (49-28),19,30,63.3,183,1,61,376,6.2,6,91,559,6.1,7,20,0,27,6,69,0,2,2
399,2018,4,2018-09-21,Florida Atlantic,@,Central Florida,L (36-56),14,27,51.9,127,1,50,320,6.4,4,77,447,5.8,5,18,2,25,7,73,0,3,3
400,2018,5,2018-09-29,Florida Atlantic,@,Middle Tennessee State,L (24-25),17,28,60.7,154,0,55,272,4.9,3,83,426,5.1,8,12,2,22,8,54,1,1,2
401,2018,6,2018-10-06,Florida Atlantic,,Old Dominion,W (52-33),21,32,65.6,339,2,40,266,6.7,5,72,605,8.4,15,13,0,28,8,84,0,0,0
402,2018,7,2018-10-20,Florida Atlantic,@,Marshall,L (7-31),20,42,47.6,240,1,37,119,3.2,0,79,359,4.5,9,6,1,16,8,69,1,4,5
403,2018,8,2018-10-26,Florida Atlantic,,Louisiana Tech,L (13-21),17,29,58.6,121,0,38,227,6.0,1,67,348,5.2,6,14,3,23,11,77,1,1,2
404,2018,9,2018-11-03,Florida Atlantic,@,Florida International,W (49-14),10,16,62.5,157,2,60,439,7.3,5,76,596,7.8,5,23,3,30,5,55,0,0,0
405,2018,10,2018-11-10,Florida Atlantic,,Western Kentucky,W (34-15),20,25,80.0,261,0,58,315,5.4,4,83,576,6.9,10,18,0,28,6,70,1,1,2
406,2018,11,2018-11-15,Florida Atlantic,@,North Texas,L (38-41),21,35,60.0,294,2,47,195,4.1,3,82,489,6.0,9,10,1,20,5,58,0,2,2
407,2018,12,2018-11-24,Florida Atlantic,,UNC Charlotte,L (24-27),16,28,57.1,305,2,49,187,3.8,1,77,492,6.4,9,12,2,23,2,41,1,0,1
408,2018,,12 Games,Florida Atlantic,,,,226,364,62.1,2844,14,566,2902,5.1,35,930,5746,6.2,115,156,17,287,80,785,6,15,21
409,2018,1,2018-09-01,Florida International,,Indiana,L (28-38),17,28,60.7,157,1,39,170,4.4,3,67,327,4.9,8,9,5,22,7,70,2,1,3
410,2018,2,2018-09-08,Florida International,@,Old Dominion,W (28-20),19,31,61.3,300,3,51,189,3.7,1,82,489,6.0,14,10,1,25,5,35,0,1,1
411,2018,3,2018-09-15,Florida International,,Massachusetts,W (63-24),16,23,69.6,207,2,53,329,6.2,5,76,536,7.1,8,22,2,32,2,30,1,1,2
412,2018,4,2018-09-22,Florida International,@,Miami (FL),L (17-31),13,28,46.4,170,2,24,17,0.7,0,52,187,3.6,5,1,1,7,3,23,0,1,1
413,2018,5,2018-09-29,Florida International,,Arkansas-Pine Bluff,W (55-9),13,19,68.4,393,4,28,222,7.9,3,47,615,13.1,11,7,0,18,5,52,0,0,0
414,2018,6,2018-10-13,Florida International,,Middle Tennessee State,W (24-21),27,36,75.0,311,2,34,70,2.1,0,70,381,5.4,11,6,4,21,7,49,0,0,0
415,2018,7,2018-10-20,Florida International,,Rice,W (36-17),20,29,69.0,229,2,38,217,5.7,2,67,446,6.7,15,8,0,23,3,15,0,0,0
416,2018,8,2018-10-27,Florida International,@,Western Kentucky,W (38-17),19,28,67.9,171,3,38,197,5.2,2,66,368,5.6,6,8,3,17,6,65,0,0,0
417,2018,9,2018-11-03,Florida International,,Florida Atlantic,L (14-49),19,34,55.9,234,2,33,96,2.9,0,67,330,4.9,13,5,1,19,2,21,1,2,3
418,2018,10,2018-11-10,Florida International,@,Texas-San Antonio,W (45-7),20,30,66.7,304,3,40,151,3.8,2,70,455,6.5,12,9,0,21,8,95,0,0,0
419,2018,11,2018-11-17,Florida International,@,UNC Charlotte,W (42-35),25,32,78.1,294,2,23,196,8.5,2,55,490,8.9,15,5,1,21,6,47,0,0,0
420,2018,12,2018-11-24,Florida International,,Marshall,L (25-28),25,38,65.8,201,0,37,190,5.1,3,75,391,5.2,12,8,5,25,3,17,0,2,2
421,2018,,12 Games,Florida International,,,,233,356,65.4,2971,26,438,2044,4.7,23,794,5015,6.3,130,98,23,251,57,519,4,8,12
422,2018,1,2018-09-03,Florida State,,Virginia Tech,L (3-24),22,35,62.9,233,0,28,94,3.4,0,63,327,5.2,8,3,1,12,7,36,2,3,5
423,2018,2,2018-09-08,Florida State,,Samford,W (36-26),31,46,67.4,320,3,35,134,3.8,1,81,454,5.6,16,6,3,25,9,69,1,0,1
424,2018,3,2018-09-15,Florida State,@,Syracuse,L (7-30),18,37,48.6,178,0,23,62,2.7,1,60,240,4.0,7,3,1,11,11,90,0,1,1
425,2018,4,2018-09-22,Florida State,,Northern Illinois,W (37-19),23,32,71.9,352,2,57,121,2.1,2,89,473,5.3,13,10,0,23,9,60,3,1,4
426,2018,5,2018-09-29,Florida State,@,Louisville,W (28-24),16,27,59.3,294,4,31,76,2.5,0,58,370,6.4,10,5,1,16,7,55,1,0,1
427,2018,6,2018-10-06,Florida State,@,Miami (FL),L (27-28),16,32,50.0,130,2,33,70,2.1,0,65,200,3.1,9,5,0,14,7,80,1,1,2
428,2018,7,2018-10-20,Florida State,,Wake Forest,W (38-17),28,41,68.3,341,2,28,130,4.6,3,69,471,6.8,13,4,2,19,6,55,1,0,1
429,2018,8,2018-10-27,Florida State,,Clemson,L (10-59),20,40,50.0,268,1,35,-21,-0.6,0,75,247,3.3,11,1,2,14,16,134,1,1,2
430,2018,9,2018-11-03,Florida State,@,North Carolina State,L (28-47),29,48,60.4,421,4,20,24,1.2,0,68,445,6.5,13,3,1,17,16,121,1,1,2
431,2018,10,2018-11-10,Florida State,@,Notre Dame,L (13-42),23,48,47.9,216,0,30,106,3.5,2,78,322,4.1,11,6,3,20,5,35,1,1,2
432,2018,11,2018-11-17,Florida State,,Boston College,W (22-21),19,39,48.7,322,1,36,156,4.3,1,75,478,6.4,11,7,1,19,7,56,0,2,2
433,2018,12,2018-11-24,Florida State,,Florida,L (14-41),14,30,46.7,154,1,35,139,4.0,1,65,293,4.5,6,7,2,15,10,60,1,2,3
434,2018,,12 Games,Florida State,,,,259,455,56.9,3229,20,391,1091,2.8,11,846,4320,5.1,128,60,17,205,110,851,13,13,26
435,2018,1,2018-09-01,Fordham,@,UNC Charlotte,L (10-34),22,47,46.8,296,1,16,-9,-0.6,0,63,287,4.6,11,0,1,12,6,30,0,1,1
436,2018,1,2018-09-01,Fresno State,,Idaho,W (79-13),21,29,72.4,247,1,42,241,5.7,7,71,488,6.9,11,13,0,24,3,27,0,0,0
437,2018,2,2018-09-08,Fresno State,@,Minnesota,L (14-21),24,34,70.6,212,2,24,87,3.6,0,58,299,5.2,9,3,1,13,4,40,0,2,2
438,2018,3,2018-09-15,Fresno State,@,UCLA,W (38-14),22,33,66.7,270,1,49,156,3.2,4,82,426,5.2,12,8,4,24,8,53,2,0,2
439,2018,4,2018-09-29,Fresno State,,Toledo,W (49-27),24,32,75.0,368,4,38,186,4.9,2,70,554,7.9,16,7,1,24,3,45,0,1,1
440,2018,5,2018-10-06,Fresno State,@,Nevada,W (21-3),20,28,71.4,241,2,24,30,1.3,1,52,271,5.2,9,3,0,12,4,30,1,0,1
441,2018,6,2018-10-13,Fresno State,,Wyoming,W (27-3),22,32,68.8,287,2,33,104,3.2,2,65,391,6.0,11,6,0,17,5,45,0,0,0
442,2018,7,2018-10-20,Fresno State,@,New Mexico,W (38-7),20,30,66.7,280,3,43,153,3.6,2,73,433,5.9,16,9,4,29,6,35,0,0,0
443,2018,8,2018-10-27,Fresno State,,Hawaii,W (50-20),26,38,68.4,348,4,33,214,6.5,1,71,562,7.9,14,10,0,24,8,69,0,0,0
444,2018,9,2018-11-03,Fresno State,@,Nevada-Las Vegas,W (48-3),26,35,74.3,274,2,34,192,5.6,4,69,466,6.8,16,8,1,25,5,40,0,1,1
445,2018,10,2018-11-09,Fresno State,@,Boise State,L (17-24),24,35,68.6,283,1,28,107,3.8,1,63,390,6.2,14,6,2,22,9,61,0,0,0
446,2018,11,2018-11-17,Fresno State,,San Diego State,W (23-14),17,24,70.8,267,1,43,123,2.9,2,67,390,5.8,6,9,2,17,3,40,0,0,0
447,2018,12,2018-11-24,Fresno State,,San Jose State,W (31-13),20,29,69.0,317,2,36,198,5.5,1,65,515,7.9,10,8,1,19,5,58,2,0,2
448,2018,,12 Games,Fresno State,,,,266,379,70.2,3394,25,427,1791,4.2,27,806,5185,6.4,144,90,16,250,63,543,5,4,9
449,2018,1,2018-09-01,Furman,@,Clemson,L (7-48),4,9,44.4,46,1,52,201,3.9,0,61,247,4.0,3,7,3,13,3,22,2,0,2
450,2018,1,2018-09-01,Georgia,,Austin Peay,W (45-0),21,27,77.8,224,3,33,284,8.6,3,60,508,8.5,13,8,0,21,3,40,1,0,1
451,2018,2,2018-09-08,Georgia,@,South Carolina,W (41-17),16,19,84.2,202,1,52,271,5.2,3,71,473,6.7,12,15,3,30,4,47,0,1,1
452,2018,3,2018-09-15,Georgia,,Middle Tennessee State,W (49-7),17,21,81.0,223,4,35,261,7.5,2,56,484,8.6,10,11,2,23,7,54,0,0,0
453,2018,4,2018-09-22,Georgia,@,Missouri,W (43-29),13,23,56.5,260,3,40,185,4.6,0,63,445,7.1,8,10,0,18,7,66,0,1,1
454,2018,5,2018-09-29,Georgia,,Tennessee,W (38-12),17,24,70.8,190,0,50,251,5.0,5,74,441,6.0,10,16,0,26,6,40,0,0,0
455,2018,6,2018-10-06,Georgia,,Vanderbilt,W (41-13),21,31,67.7,341,3,34,219,6.4,2,65,560,8.6,12,14,2,28,13,115,0,0,0
456,2018,7,2018-10-13,Georgia,@,Louisiana State,L (16-36),16,34,47.1,209,1,30,113,3.8,1,64,322,5.0,10,7,1,18,4,20,2,2,4
457,2018,8,2018-10-27,Georgia,N,Florida,W (36-17),17,24,70.8,240,3,41,189,4.6,1,65,429,6.6,10,8,2,20,4,53,0,0,0
458,2018,9,2018-11-03,Georgia,@,Kentucky,W (34-17),14,20,70.0,113,1,50,331,6.6,3,70,444,6.3,6,16,3,25,4,45,2,0,2
459,2018,10,2018-11-10,Georgia,,Auburn,W (27-10),15,23,65.2,213,2,44,309,7.0,1,67,522,7.8,8,13,3,24,12,85,0,1,1
460,2018,11,2018-11-17,Georgia,,Massachusetts,W (66-27),14,17,82.4,275,3,45,426,9.5,6,62,701,11.3,8,20,2,30,2,20,1,0,1
461,2018,12,2018-11-24,Georgia,,Georgia Tech,W (45-21),15,19,78.9,162,4,41,286,7.0,2,60,448,7.5,8,17,0,25,2,10,1,0,1
462,2018,,12 Games,Georgia,,,,196,282,69.5,2652,28,495,3125,6.3,29,777,5777,7.4,115,155,18,288,68,595,7,5,12
463,2018,1,2018-09-01,Georgia Southern,,South Carolina State,W (37-6),5,7,71.4,29,0,53,319,6.0,5,60,348,5.8,1,17,1,19,2,10,0,0,0
464,2018,2,2018-09-08,Georgia Southern,,Massachusetts,W (34-13),6,9,66.7,154,2,55,341,6.2,2,64,495,7.7,5,18,1,24,3,35,1,0,1
465,2018,3,2018-09-15,Georgia Southern,@,Clemson,L (7-38),3,9,33.3,60,0,43,80,1.9,1,52,140,2.7,3,3,1,7,4,20,1,0,1
466,2018,4,2018-09-29,Georgia Southern,,Arkansas State,W (28-21),1,3,33.3,61,1,49,348,7.1,3,52,409,7.9,1,14,0,15,8,70,0,0,0
467,2018,5,2018-10-06,Georgia Southern,,South Alabama,W (48-13),5,8,62.5,99,1,43,295,6.9,4,51,394,7.7,3,13,2,18,9,83,0,0,0
468,2018,6,2018-10-11,Georgia Southern,@,Texas State,W (15-13),7,12,58.3,51,0,52,164,3.2,1,64,215,3.4,3,8,1,12,5,49,1,0,1
469,2018,7,2018-10-20,Georgia Southern,@,New Mexico State,W (48-31),4,4,100.0,77,0,61,389,6.4,6,65,466,7.2,3,23,1,27,4,36,0,0,0
470,2018,8,2018-10-25,Georgia Southern,,Appalachian State,W (34-14),1,3,33.3,57,1,49,278,5.7,3,52,335,6.4,1,11,2,14,2,11,0,0,0
471,2018,9,2018-11-03,Georgia Southern,@,Louisiana-Monroe,L (25-44),8,15,53.3,78,1,46,138,3.0,0,61,216,3.5,5,10,3,17,6,52,1,0,1
472,2018,10,2018-11-10,Georgia Southern,,Troy,L (21-35),14,23,60.9,190,2,34,101,3.0,1,57,291,5.1,6,6,1,13,4,47,0,0,0
473,2018,11,2018-11-17,Georgia Southern,@,Coastal Carolina,W (41-17),4,6,66.7,33,0,54,409,7.6,5,60,442,7.4,2,17,0,19,2,17,1,0,1
474,2018,12,2018-11-24,Georgia Southern,@,Georgia State,W (35-14),8,11,72.7,105,2,40,278,7.0,2,51,383,7.5,3,13,0,16,8,70,0,0,0
475,2018,,12 Games,Georgia Southern,,,,66,110,60.0,994,10,579,3140,5.4,33,689,4134,6.0,36,153,13,201,57,500,5,0,5
476,2018,1,2018-08-30,Georgia State,,,W (24-20),20,28,71.4,187,3,37,130,3.5,0,65,317,4.9,12,6,3,21,3,33,1,0,1
477,2018,2,2018-09-08,Georgia State,@,North Carolina State,L (7-41),19,34,55.9,242,0,31,107,3.5,1,65,349,5.4,9,7,2,18,5,48,1,0,1
478,2018,3,2018-09-14,Georgia State,@,Memphis,L (22-59),19,34,55.9,139,0,43,173,4.0,2,77,312,4.1,10,9,3,22,2,16,0,1,1
479,2018,4,2018-09-22,Georgia State,,Western Michigan,L (15-34),19,29,65.5,285,0,30,58,1.9,2,59,343,5.8,12,6,0,18,2,25,2,1,3
480,2018,5,2018-09-29,Georgia State,,Louisiana-Monroe,W (46-14),15,18,83.3,179,1,56,308,5.5,4,74,487,6.6,7,12,1,20,7,70,1,0,1
481,2018,6,2018-10-04,Georgia State,@,Troy,L (20-37),20,36,55.6,272,1,35,116,3.3,1,71,388,5.5,11,9,3,23,0,0,2,0,2
482,2018,7,2018-10-18,Georgia State,@,Arkansas State,L (35-51),20,33,60.6,299,4,43,123,2.9,1,76,422,5.6,9,11,4,24,8,80,2,0,2
483,2018,8,2018-10-27,Georgia State,,Coastal Carolina,L (34-37),14,25,56.0,231,1,34,290,8.5,4,59,521,8.8,10,11,2,23,6,74,1,0,1
484,2018,9,2018-11-03,Georgia State,,Texas State,L (31-40),21,40,52.5,224,1,43,221,5.1,3,83,445,5.4,13,11,1,25,2,13,2,0,2
485,2018,10,2018-11-10,Georgia State,@,Louisiana,L (22-36),10,21,47.6,121,1,43,252,5.9,2,64,373,5.8,5,14,0,19,4,35,0,1,1
486,2018,11,2018-11-17,Georgia State,@,Appalachian State,L (17-45),10,21,47.6,132,1,34,197,5.8,1,55,329,6.0,5,10,0,15,6,61,0,2,2
487,2018,12,2018-11-24,Georgia State,,Georgia Southern,L (14-35),20,33,60.6,170,2,31,100,3.2,0,64,270,4.2,7,8,2,17,3,24,0,1,1
488,2018,,12 Games,Georgia State,,,,207,352,58.8,2481,15,460,2075,4.5,21,812,4556,5.6,110,114,21,245,48,479,12,6,18
489,2018,1,2018-09-01,Georgia Tech,,Alcorn State,W (41-0),9,18,50.0,104,1,54,439,8.1,4,72,543,7.5,4,20,1,25,3,30,2,1,3
490,2018,2,2018-09-08,Georgia Tech,@,South Florida,L (38-49),9,18,50.0,183,1,57,419,7.4,4,75,602,8.0,6,19,2,27,8,80,1,2,3
491,2018,3,2018-09-15,Georgia Tech,@,Pittsburgh,L (19-24),6,15,40.0,66,0,56,320,5.7,3,71,386,5.4,4,16,2,22,5,35,1,1,2
492,2018,4,2018-09-22,Georgia Tech,,Clemson,L (21-49),3,8,37.5,57,1,56,146,2.6,2,64,203,3.2,2,10,3,15,4,30,1,0,1
493,2018,5,2018-09-29,Georgia Tech,,Bowling Green State,W (63-17),5,7,71.4,160,0,49,372,7.6,7,56,532,9.5,5,16,2,23,3,54,0,0,0
494,2018,6,2018-10-05,Georgia Tech,@,Louisville,W (66-31),1,2,50.0,12,0,65,542,8.3,8,67,554,8.3,1,27,0,28,4,50,0,0,0
495,2018,7,2018-10-13,Georgia Tech,,Duke,L (14-28),7,17,41.2,125,1,61,229,3.8,1,78,354,4.5,5,14,1,20,3,18,3,0,3
496,2018,8,2018-10-25,Georgia Tech,@,Virginia Tech,W (49-28),0,1,0.0,0,0,78,465,6.0,7,79,465,5.9,0,31,4,35,6,50,0,0,0
497,2018,9,2018-11-03,Georgia Tech,@,North Carolina,W (38-28),2,2,100.0,104,1,74,461,6.2,4,76,565,7.4,2,24,1,27,3,20,3,0,3
498,2018,10,2018-11-10,Georgia Tech,,Miami (FL),W (27-21),3,4,75.0,73,1,53,231,4.4,2,57,304,5.3,3,12,0,15,3,35,1,0,1
499,2018,11,2018-11-17,Georgia Tech,,Virginia,W (30-27),1,8,12.5,37,0,52,268,5.2,1,60,305,5.1,1,11,1,13,3,25,0,0,0
500,2018,12,2018-11-24,Georgia Tech,@,Georgia,L (21-45),5,14,35.7,91,1,46,128,2.8,1,60,219,3.7,4,8,0,12,2,20,0,0,0
501,2018,,12 Games,Georgia Tech,,,,51,114,44.7,1012,7,701,4020,5.7,44,815,5032,6.2,37,208,17,262,47,447,12,4,16
502,2018,1,2018-09-01,Grambling State,@,Louisiana,L (17-49),16,29,55.2,159,0,36,147,4.1,2,65,306,4.7,9,5,1,15,9,86,0,0,0
503,2018,1,2018-08-25,Hawaii,@,Colorado State,W (43-34),26,37,70.3,418,3,36,199,5.5,2,73,617,8.5,19,9,2,30,10,65,1,0,1
504,2018,2,2018-09-01,Hawaii,,Navy,W (59-41),31,42,73.8,436,6,26,90,3.5,1,68,526,7.7,17,6,2,25,1,5,1,0,1
505,2018,3,2018-09-08,Hawaii,,Rice,W (43-29),22,33,66.7,319,4,29,162,5.6,2,62,481,7.8,16,6,1,23,6,60,0,0,0
506,2018,4,2018-09-15,Hawaii,@,Army,L (21-28),20,32,62.5,321,2,13,41,3.2,1,45,362,8.0,11,3,1,15,5,30,0,0,0
507,2018,5,2018-09-22,Hawaii,,Duquesne,W (42-21),24,40,60.0,273,5,37,245,6.6,1,77,518,6.7,13,14,7,34,8,95,1,1,2
508,2018,6,2018-09-29,Hawaii,@,San Jose State,W (44-41),34,57,59.6,341,4,42,134,3.2,1,99,475,4.8,16,11,1,28,6,65,1,1,2
509,2018,7,2018-10-06,Hawaii,,Wyoming,W (17-13),19,29,65.5,148,2,37,156,4.2,0,66,304,4.6,6,13,0,19,2,25,1,1,2
510,2018,8,2018-10-13,Hawaii,@,Brigham Young,L (23-49),22,38,57.9,248,2,28,63,2.3,1,66,311,4.7,13,4,1,18,4,25,1,1,2
511,2018,9,2018-10-20,Hawaii,,Nevada,L (22-40),19,38,50.0,259,3,35,112,3.2,0,73,371,5.1,10,5,1,16,7,73,0,0,0
512,2018,10,2018-10-27,Hawaii,@,Fresno State,L (20-50),20,35,57.1,286,2,26,88,3.4,0,61,374,6.1,12,6,1,19,3,14,1,1,2
513,2018,11,2018-11-03,Hawaii,,Utah State,L (17-56),19,48,39.6,347,2,20,43,2.2,0,68,390,5.7,13,1,4,18,10,75,0,2,2
514,2018,12,2018-11-17,Hawaii,,Nevada-Las Vegas,W (35-28),18,36,50.0,328,3,31,83,2.7,1,67,411,6.1,11,6,1,18,3,15,0,2,2
515,2018,13,2018-11-24,Hawaii,@,San Diego State,W (31-30),29,46,63.0,452,3,24,64,2.7,1,70,516,7.4,17,4,1,22,6,50,2,0,2
516,2018,,13 Games,Hawaii,,,,303,511,59.3,4176,41,384,1480,3.9,11,895,5656,6.3,174,88,23,285,71,597,9,9,18
517,2018,1,2018-09-08,Holy Cross,@,Boston College,L (14-62),12,22,54.5,66,0,43,197,4.6,0,65,263,4.0,2,9,2,13,8,51,0,2,2
518,2018,1,2018-09-01,Houston,@,Rice,W (45-27),18,25,72.0,320,3,37,251,6.8,3,62,571,9.2,11,10,2,23,5,38,2,0,2
519,2018,2,2018-09-08,Houston,,Arizona,W (45-18),19,40,47.5,254,4,40,297,7.4,2,80,551,6.9,11,14,3,28,7,56,0,0,0
520,2018,3,2018-09-15,Houston,@,Texas Tech,L (49-63),31,52,59.6,462,5,40,173,4.3,2,92,635,6.9,18,8,2,28,9,68,0,0,0
521,2018,4,2018-09-22,Houston,,Texas Southern,W (70-14),33,49,67.3,386,5,41,285,7.0,5,90,671,7.5,18,17,1,36,2,10,0,1,1
522,2018,5,2018-10-04,Houston,,Tulsa,W (41-26),19,27,70.4,165,3,39,314,8.1,2,66,479,7.3,8,11,2,21,8,55,1,2,3
523,2018,6,2018-10-13,Houston,@,East Carolina,W (42-20),16,28,57.1,249,3,43,157,3.7,2,71,406,5.7,8,8,2,18,12,115,0,0,0
524,2018,7,2018-10-20,Houston,@,Navy,W (49-36),25,39,64.1,413,3,25,157,6.3,3,64,570,8.9,18,11,0,29,3,20,1,1,2
525,2018,8,2018-10-27,Houston,,South Florida,W (57-36),28,40,70.0,419,5,49,263,5.4,3,89,682,7.7,16,16,3,35,5,50,0,2,2
526,2018,9,2018-11-03,Houston,@,Southern Methodist,L (31-45),11,22,50.0,175,2,47,190,4.0,1,69,365,5.3,6,9,0,15,6,50,2,0,2
527,2018,10,2018-11-10,Houston,,Temple,L (49-59),28,47,59.6,322,5,44,205,4.7,2,91,527,5.8,14,11,6,31,12,90,2,1,3
528,2018,11,2018-11-15,Houston,,Tulane,W (48-17),17,30,56.7,190,3,48,298,6.2,3,78,488,6.3,9,13,2,24,6,54,0,1,1
529,2018,12,2018-11-23,Houston,@,Memphis,L (31-52),18,43,41.9,256,3,41,138,3.4,0,84,394,4.7,12,9,2,23,7,44,0,1,1
530,2018,,12 Games,Houston,,,,263,442,59.5,3611,44,494,2728,5.5,28,936,6339,6.8,149,137,25,311,82,650,8,9,17
531,2018,1,2018-09-01,Idaho,@,Fresno State,L (13-79),14,33,42.4,205,1,32,102,3.2,1,65,307,4.7,9,6,0,15,4,20,2,5,7
532,2018,2,2018-11-17,Idaho,@,Florida,L (10-63),13,35,37.1,73,1,33,154,4.7,0,68,227,3.3,4,11,2,17,6,48,0,2,2
533,2018,,2 Games,Idaho,,,,27,68,39.7,278,2,65,256,3.9,1,133,534,4.0,13,17,2,32,10,68,2,7,9
534,2018,1,2018-09-15,Idaho State,@,California,L (23-45),15,23,65.2,179,1,45,140,3.1,2,68,319,4.7,3,8,6,17,3,27,0,1,1
535,2018,2,2018-10-20,Idaho State,@,Liberty,L (41-48),20,44,45.5,397,4,42,234,5.6,1,86,631,7.3,18,9,1,28,4,24,1,2,3
536,2018,,2 Games,Idaho State,,,,35,67,52.2,576,5,87,374,4.3,3,154,950,6.2,21,17,7,45,7,51,1,3,4
537,2018,1,2018-09-01,Illinois,,Kent State,W (31-24),13,23,56.5,190,0,47,284,6.0,4,70,474,6.8,10,12,0,22,3,25,1,0,1
538,2018,2,2018-09-08,Illinois,,Western Illinois,W (34-14),14,23,60.9,138,2,47,238,5.1,1,70,376,5.4,8,9,3,20,14,145,0,0,0
539,2018,3,2018-09-15,Illinois,N,South Florida,L (19-25),20,31,64.5,168,0,48,212,4.4,1,79,380,4.8,8,10,3,21,6,65,1,0,1
540,2018,4,2018-09-21,Illinois,,Penn State,L (24-63),18,31,58.1,166,2,45,245,5.4,1,76,411,5.4,11,12,3,26,7,81,0,2,2
541,2018,5,2018-10-06,Illinois,@,Rutgers,W (38-17),10,19,52.6,89,1,43,330,7.7,4,62,419,6.8,4,11,2,17,7,80,0,0,0
542,2018,6,2018-10-13,Illinois,,Purdue,L (7-46),15,29,51.7,181,0,31,69,2.2,1,60,250,4.2,7,7,0,14,7,57,0,1,1
543,2018,7,2018-10-20,Illinois,@,Wisconsin,L (20-49),9,21,42.9,90,0,36,210,5.8,2,57,300,5.3,2,9,2,13,3,25,2,3,5
544,2018,8,2018-10-27,Illinois,@,Maryland,L (33-63),14,32,43.8,261,2,35,232,6.6,1,67,493,7.4,8,11,1,20,2,25,0,1,1
545,2018,9,2018-11-03,Illinois,,Minnesota,W (55-31),18,25,72.0,216,2,35,430,12.3,5,60,646,10.8,9,11,0,20,7,70,2,1,3
546,2018,10,2018-11-10,Illinois,@,Nebraska,L (35-54),11,25,44.0,126,0,48,384,8.0,5,73,510,7.0,7,16,2,25,7,66,3,2,5
547,2018,11,2018-11-17,Illinois,,Iowa,L (0-63),12,30,40.0,82,0,43,149,3.5,0,73,231,3.2,3,8,0,11,6,68,1,3,4
548,2018,12,2018-11-24,Illinois,@,Northwestern,L (16-24),23,39,59.0,281,1,32,154,4.8,0,71,435,6.1,14,9,1,24,7,66,0,1,1
549,2018,,12 Games,Illinois,,,,177,328,54.0,1988,10,490,2937,6.0,25,818,4925,6.0,91,125,17,233,76,773,10,14,24
550,2018,1,2018-09-22,Illinois State,@,Colorado State,W (35-19),14,29,48.3,271,2,42,267,6.4,3,71,538,7.6,10,11,1,22,9,81,0,0,0
551,2018,1,2018-09-01,Indiana,@,Florida International,W (38-28),28,37,75.7,252,4,45,213,4.7,0,82,465,5.7,14,12,5,31,8,90,0,1,1
552,2018,2,2018-09-08,Indiana,,Virginia,W (20-16),16,22,72.7,150,2,44,237,5.4,1,66,387,5.9,7,12,2,21,6,42,0,1,1
553,2018,3,2018-09-15,Indiana,,Ball State,W (38-10),24,32,75.0,202,0,44,255,5.8,4,76,457,6.0,9,13,4,26,5,45,1,0,1
554,2018,4,2018-09-22,Indiana,,Michigan State,L (21-35),32,46,69.6,272,2,32,29,0.9,0,78,301,3.9,15,1,2,18,6,85,0,2,2
555,2018,5,2018-09-29,Indiana,@,Rutgers,W (24-17),27,40,67.5,288,1,42,163,3.9,2,82,451,5.5,14,8,2,24,5,60,1,1,2
556,2018,6,2018-10-06,Indiana,@,Ohio State,L (26-49),26,49,53.1,322,3,21,84,4.0,0,70,406,5.8,14,4,4,22,3,35,2,0,2
557,2018,7,2018-10-13,Indiana,,Iowa,L (16-42),31,42,73.8,263,1,25,67,2.7,1,67,330,4.9,10,8,4,22,10,99,0,2,2
558,2018,8,2018-10-20,Indiana,,Penn State,L (28-33),35,55,63.6,330,1,45,224,5.0,3,100,554,5.5,17,13,2,32,7,55,2,1,3
559,2018,9,2018-10-26,Indiana,@,Minnesota,L (31-38),29,44,65.9,232,2,30,153,5.1,1,74,385,5.2,11,9,0,20,5,37,1,2,3
560,2018,10,2018-11-10,Indiana,,Maryland,W (34-32),16,28,57.1,243,2,30,131,4.4,2,58,374,6.4,8,7,3,18,3,39,0,1,1
561,2018,11,2018-11-17,Indiana,@,Michigan,L (20-31),16,35,45.7,195,1,40,190,4.8,1,75,385,5.1,8,10,3,21,7,62,1,1,2
562,2018,12,2018-11-24,Indiana,,Purdue,L (21-28),36,51,70.6,345,1,30,142,4.7,2,81,487,6.0,16,9,2,27,6,80,0,1,1
563,2018,,12 Games,Indiana,,,,316,481,65.7,3094,20,428,1888,4.4,17,909,4982,5.5,143,106,33,282,71,729,8,13,21
564,2018,1,2018-09-08,Indiana State,@,Louisville,L (7-31),3,12,25.0,37,0,50,174,3.5,1,62,211,3.4,2,8,2,12,6,45,0,0,0
565,2018,1,2018-09-01,Iowa,,Northern Illinois,W (33-7),13,25,52.0,143,1,48,209,4.4,3,73,352,4.8,6,8,4,18,8,66,0,1,1
566,2018,2,2018-09-08,Iowa,,Iowa State,W (13-3),16,28,57.1,166,0,36,105,2.9,1,64,271,4.2,7,6,1,14,6,55,0,0,0
567,2018,3,2018-09-15,Iowa,,Northern Iowa,W (38-14),25,31,80.6,338,2,50,207,4.1,3,81,545,6.7,15,12,0,27,10,88,0,2,2
568,2018,4,2018-09-22,Iowa,,Wisconsin,L (17-28),14,23,60.9,256,2,31,148,4.8,0,54,404,7.5,11,5,3,19,1,5,2,1,3
569,2018,5,2018-10-06,Iowa,@,Minnesota,W (48-31),23,39,59.0,314,4,40,106,2.7,2,79,420,5.3,13,5,0,18,5,45,1,1,2
570,2018,6,2018-10-13,Iowa,@,Indiana,W (42-16),21,33,63.6,320,6,32,159,5.0,0,65,479,7.4,12,7,7,26,11,110,0,1,1
571,2018,7,2018-10-20,Iowa,,Maryland,W (23-0),11,24,45.8,86,1,52,224,4.3,0,76,310,4.1,7,14,1,22,0,0,0,1,1
572,2018,8,2018-10-27,Iowa,@,Penn State,L (24-30),19,50,38.0,215,1,38,135,3.6,0,88,350,4.0,13,8,2,23,6,25,0,2,2
573,2018,9,2018-11-03,Iowa,@,Purdue,L (36-38),21,32,65.6,275,1,37,118,3.2,4,69,393,5.7,15,5,2,22,8,75,1,0,1
574,2018,10,2018-11-10,Iowa,,Northwestern,L (10-14),27,41,65.9,269,1,22,64,2.9,0,63,333,5.3,12,3,1,16,3,35,2,0,2
575,2018,11,2018-11-17,Iowa,@,Illinois,W (63-0),14,23,60.9,197,3,37,203,5.5,4,60,400,6.7,9,11,0,20,2,28,0,1,1
576,2018,12,2018-11-23,Iowa,,Nebraska,W (31-28),17,28,60.7,153,2,45,266,5.9,2,73,419,5.7,11,14,0,25,2,20,0,0,0
577,2018,,12 Games,Iowa,,,,221,377,58.6,2732,24,468,1944,4.2,19,845,4676,5.5,131,98,21,250,62,552,6,10,16
578,2018,1,2018-09-08,Iowa State,@,Iowa,L (3-13),19,31,61.3,169,0,25,19,0.8,0,56,188,3.4,6,4,1,11,7,65,1,0,1
579,2018,2,2018-09-15,Iowa State,,Oklahoma,L (27-37),25,36,69.4,360,2,29,87,3.0,1,65,447,6.9,12,6,2,20,4,35,0,1,1
580,2018,3,2018-09-22,Iowa State,,Akron,W (26-13),26,34,76.5,233,1,35,132,3.8,1,69,365,5.3,12,8,1,21,5,50,2,0,2
581,2018,4,2018-09-29,Iowa State,@,Texas Christian,L (14-17),14,28,50.0,79,1,28,119,4.3,1,56,198,3.5,6,6,3,15,1,15,1,0,1
582,2018,5,2018-10-06,Iowa State,@,Oklahoma State,W (48-42),19,25,76.0,325,4,38,140,3.7,2,63,465,7.4,11,7,3,21,5,36,1,1,2
583,2018,6,2018-10-13,Iowa State,,West Virginia,W (30-14),18,25,72.0,254,3,47,244,5.2,1,72,498,6.9,11,10,4,25,10,95,0,1,1
584,2018,7,2018-10-27,Iowa State,,Texas Tech,W (40-31),13,27,48.1,250,2,51,172,3.4,2,78,422,5.4,9,10,5,24,4,25,1,0,1
585,2018,8,2018-11-03,Iowa State,@,Kansas,W (27-3),17,24,70.8,273,3,38,121,3.2,0,62,394,6.4,10,9,1,20,2,12,0,0,0
586,2018,9,2018-11-10,Iowa State,,Baylor,W (28-14),18,23,78.3,230,1,30,127,4.2,2,53,357,6.7,12,8,1,21,4,30,0,0,0
587,2018,10,2018-11-17,Iowa State,@,Texas,L (10-24),13,29,44.8,148,0,30,62,2.1,1,59,210,3.6,5,7,0,12,3,20,1,1,2
588,2018,11,2018-11-24,Iowa State,,Kansas State,W (42-38),20,27,74.1,337,2,32,156,4.9,3,59,493,8.4,11,9,2,22,5,56,1,2,3
589,2018,,11 Games,Iowa State,,,,202,309,65.4,2658,19,383,1379,3.6,14,692,4037,5.8,105,84,23,212,50,439,8,6,14
590,2018,1,2018-09-01,Jackson State,@,Southern Mississippi,L (7-55),19,37,51.4,98,1,22,101,4.6,0,59,199,3.4,6,3,1,10,5,35,2,2,4
591,2018,1,2018-09-01,Kansas,,Nicholls State,L (23-26),21,38,55.3,199,2,32,56,1.8,0,70,255,3.6,8,5,1,14,7,54,1,0,1
592,2018,2,2018-09-08,Kansas,@,Central Michigan,W (31-7),18,27,66.7,145,1,45,216,4.8,2,72,361,5.0,8,10,2,20,7,55,0,0,0
593,2018,3,2018-09-15,Kansas,,Rutgers,W (55-14),15,25,60.0,144,1,48,400,8.3,4,73,544,7.5,9,12,1,22,7,67,0,0,0
594,2018,4,2018-09-22,Kansas,@,Baylor,L (7-26),16,27,59.3,149,1,28,122,4.4,0,55,271,4.9,5,5,4,14,7,55,0,0,0
595,2018,5,2018-09-29,Kansas,,Oklahoma State,L (28-48),24,32,75.0,247,3,32,121,3.8,1,64,368,5.8,11,5,2,18,4,43,1,0,1
596,2018,6,2018-10-06,Kansas,@,West Virginia,L (22-38),21,34,61.8,206,2,26,80,3.1,1,60,286,4.8,9,5,2,16,6,45,1,2,3
597,2018,7,2018-10-20,Kansas,@,Texas Tech,L (16-48),18,41,43.9,221,2,29,98,3.4,0,70,319,4.6,9,6,1,16,6,62,1,1,2
598,2018,8,2018-10-27,Kansas,,Texas Christian,W (27-26),19,29,65.5,249,2,38,58,1.5,1,67,307,4.6,12,4,1,17,8,59,0,0,0
599,2018,9,2018-11-03,Kansas,,Iowa State,L (3-27),19,43,44.2,185,0,40,147,3.7,0,83,332,4.0,11,8,1,20,3,25,1,0,1
600,2018,10,2018-11-10,Kansas,@,Kansas State,L (17-21),21,34,61.8,232,2,35,115,3.3,0,69,347,5.0,13,4,2,19,8,53,2,0,2
601,2018,11,2018-11-17,Kansas,@,Oklahoma,L (40-55),20,28,71.4,176,1,36,348,9.7,4,64,524,8.2,8,17,0,25,6,53,0,0,0
602,2018,12,2018-11-23,Kansas,,Texas,L (17-24),18,35,51.4,159,1,33,137,4.2,1,68,296,4.4,8,5,1,14,9,98,0,1,1
603,2018,,12 Games,Kansas,,,,230,393,58.5,2312,18,422,1898,4.5,14,815,4210,5.2,111,86,18,215,78,669,7,4,11
604,2018,1,2018-09-01,Kansas State,,South Dakota,W (27-24),13,28,46.4,152,1,47,256,5.4,0,75,408,5.4,8,10,1,19,13,129,2,2,4
605,2018,2,2018-09-08,Kansas State,,Mississippi State,L (10-31),9,21,42.9,100,1,35,113,3.2,0,56,213,3.8,5,7,3,15,2,15,0,1,1
606,2018,3,2018-09-15,Kansas State,,Texas-San Antonio,W (41-17),14,19,73.7,285,3,44,164,3.7,2,63,449,7.1,11,8,1,20,4,41,2,0,2
607,2018,4,2018-09-22,Kansas State,@,West Virginia,L (6-35),18,29,62.1,227,0,36,91,2.5,0,65,318,4.9,9,7,1,17,8,69,1,0,1
608,2018,5,2018-09-29,Kansas State,,Texas,L (14-19),11,25,44.0,110,0,39,107,2.7,2,64,217,3.4,6,7,4,17,0,0,0,0,0
609,2018,6,2018-10-06,Kansas State,@,Baylor,L (34-37),15,26,57.7,149,1,35,319,9.1,4,61,468,7.7,5,15,0,20,6,55,1,2,3
610,2018,7,2018-10-13,Kansas State,,Oklahoma State,W (31-12),11,22,50.0,130,0,55,291,5.3,4,77,421,5.5,7,13,3,23,4,40,0,0,0
611,2018,8,2018-10-27,Kansas State,@,Oklahoma,L (14-51),13,21,61.9,108,0,32,137,4.3,2,53,245,4.6,5,6,2,13,4,50,1,0,1
612,2018,9,2018-11-03,Kansas State,@,Texas Christian,L (13-14),16,28,57.1,162,1,47,139,3.0,1,75,301,4.0,8,11,2,21,2,3,2,1,3
613,2018,10,2018-11-10,Kansas State,,Kansas,W (21-17),11,18,61.1,126,0,40,175,4.4,3,58,301,5.2,7,8,2,17,7,55,0,0,0
614,2018,11,2018-11-17,Kansas State,,Texas Tech,W (21-6),17,26,65.4,213,1,50,154,3.1,0,76,367,4.8,11,9,2,22,2,20,0,1,1
615,2018,12,2018-11-24,Kansas State,@,Iowa State,L (38-42),18,27,66.7,183,3,47,245,5.2,2,74,428,5.8,5,15,1,21,7,61,1,0,1
616,2018,,12 Games,Kansas State,,,,166,290,57.2,1945,11,507,2191,4.3,20,797,4136,5.2,87,116,22,225,59,538,10,7,17
617,2018,1,2018-09-01,Kent State,@,Illinois,L (24-31),28,41,68.3,270,2,42,184,4.4,1,83,454,5.5,12,12,0,24,5,38,0,2,2
618,2018,2,2018-09-08,Kent State,,Howard,W (54-14),13,29,44.8,156,1,52,355,6.8,6,81,511,6.3,8,16,2,26,15,150,3,1,4
619,2018,3,2018-09-15,Kent State,@,Penn State,L (10-63),21,40,52.5,180,1,37,41,1.1,0,77,221,2.9,8,7,3,18,10,83,0,0,0
620,2018,4,2018-09-22,Kent State,@,Mississippi,L (17-38),25,43,58.1,242,1,41,148,3.6,1,84,390,4.6,9,11,3,23,7,55,1,1,2
621,2018,5,2018-09-29,Kent State,@,Ball State,L (24-52),30,44,68.2,314,1,41,147,3.6,2,85,461,5.4,16,6,2,24,17,142,2,1,3
622,2018,6,2018-10-06,Kent State,,Ohio,L (26-27),27,35,77.1,271,2,36,201,5.6,0,71,472,6.6,12,10,3,25,11,100,1,2,3
623,2018,7,2018-10-13,Kent State,@,Miami (OH),L (6-31),15,29,51.7,149,0,31,125,4.0,1,60,274,4.6,7,6,1,14,10,70,0,1,1
624,2018,8,2018-10-20,Kent State,,Akron,L (23-24),17,31,54.8,198,1,43,173,4.0,2,74,371,5.0,8,8,2,18,6,46,0,0,0
625,2018,9,2018-10-30,Kent State,@,Bowling Green State,W (35-28),14,24,58.3,157,2,50,225,4.5,3,74,382,5.2,6,13,2,21,11,86,1,0,1
626,2018,10,2018-11-06,Kent State,@,Buffalo,L (14-48),14,28,50.0,83,1,40,100,2.5,1,68,183,2.7,5,7,0,12,4,35,0,0,0
627,2018,11,2018-11-15,Kent State,,Toledo,L (34-56),24,41,58.5,314,2,35,183,5.2,2,76,497,6.5,11,6,6,23,8,69,0,1,1
628,2018,12,2018-11-23,Kent State,,Eastern Michigan,L (20-28),19,35,54.3,209,0,45,179,4.0,1,80,388,4.9,6,11,4,21,4,45,2,1,3
629,2018,,12 Games,Kent State,,,,247,420,58.8,2543,14,493,2061,4.2,20,913,4604,5.0,108,113,28,249,108,919,10,10,20
630,2018,1,2018-09-01,Kentucky,,Central Michigan,W (35-20),15,27,55.6,128,1,43,299,7.0,4,70,427,6.1,8,15,4,27,3,40,2,2,4
631,2018,2,2018-09-08,Kentucky,@,Florida,W (27-16),11,16,68.8,151,2,41,303,7.4,1,57,454,8.0,5,15,0,20,12,114,1,1,2
632,2018,3,2018-09-15,Kentucky,,Murray State,W (48-10),24,31,77.4,283,2,43,245,5.7,4,74,528,7.1,13,14,1,28,7,67,0,0,0
633,2018,4,2018-09-22,Kentucky,,Mississippi State,W (28-7),8,14,57.1,71,0,47,229,4.9,4,61,300,4.9,3,11,4,18,5,42,0,1,1
634,2018,5,2018-09-29,Kentucky,,South Carolina,W (24-10),13,20,65.0,132,0,44,221,5.0,3,64,353,5.5,7,12,1,20,11,115,0,1,1
635,2018,6,2018-10-06,Kentucky,@,Texas A&M,L (14-20),13,20,65.0,108,1,30,70,2.3,0,50,178,3.6,3,5,0,8,8,52,0,0,0
636,2018,7,2018-10-20,Kentucky,,Vanderbilt,W (14-7),3,9,33.3,18,1,53,280,5.3,1,62,298,4.8,2,15,0,17,4,35,2,0,2
637,2018,8,2018-10-27,Kentucky,@,Missouri,W (15-14),25,39,64.1,294,1,35,91,2.6,0,74,385,5.2,13,5,3,21,5,31,0,1,1
638,2018,9,2018-11-03,Kentucky,,Georgia,L (17-34),23,29,79.3,226,1,35,84,2.4,1,64,310,4.8,11,8,2,21,6,64,2,0,2
639,2018,10,2018-11-10,Kentucky,@,Tennessee,L (7-24),23,38,60.5,185,1,34,85,2.5,0,72,270,3.8,10,8,1,19,3,20,1,2,3
640,2018,11,2018-11-17,Kentucky,,Middle Tennessee State,W (34-23),10,14,71.4,121,1,40,203,5.1,2,54,324,6.0,5,10,0,15,6,51,0,0,0
641,2018,12,2018-11-24,Kentucky,@,Louisville,W (56-10),17,24,70.8,261,3,42,336,8.0,5,66,597,9.0,11,13,5,29,6,63,0,2,2
642,2018,,12 Games,Kentucky,,,,185,281,65.8,1978,14,487,2446,5.0,25,768,4424,5.8,91,131,21,243,76,694,8,10,18
643,2018,1,2018-11-10,Lafayette,@,Army,L (13-31),9,16,56.3,76,1,24,83,3.5,0,40,159,4.0,4,5,0,9,1,5,0,0,0
644,2018,1,2018-09-08,Lamar,@,Texas Tech,L (0-77),10,32,31.3,80,0,42,102,2.4,0,74,182,2.5,3,8,2,13,4,15,1,3,4
645,2018,1,2018-09-15,Lehigh,@,Navy,L (21-51),22,40,55.0,174,1,25,162,6.5,2,65,336,5.2,9,6,1,16,3,25,2,3,5
646,2018,1,2018-09-01,Liberty,,Old Dominion,W (52-10),26,37,70.3,353,4,38,238,6.3,3,75,591,7.9,14,9,6,29,6,58,1,0,1
647,2018,2,2018-09-08,Liberty,@,Army,L (14-38),19,37,51.4,307,2,23,110,4.8,0,60,417,7.0,14,5,2,21,6,27,2,1,3
648,2018,3,2018-09-22,Liberty,,North Texas,L (7-47),16,40,40.0,222,1,42,122,2.9,0,82,344,4.2,11,9,3,23,5,45,0,1,1
649,2018,4,2018-09-29,Liberty,@,New Mexico,W (52-43),27,47,57.4,472,3,43,96,2.2,4,90,568,6.3,15,5,3,23,3,30,0,1,1
650,2018,5,2018-10-06,Liberty,@,New Mexico State,L (41-49),31,54,57.4,365,2,42,153,3.6,4,96,518,5.4,19,9,2,30,4,40,1,1,2
651,2018,6,2018-10-13,Liberty,,Troy,W (22-16),17,32,53.1,238,2,45,103,2.3,1,77,341,4.4,13,4,0,17,3,45,0,1,1
652,2018,7,2018-10-20,Liberty,,Idaho State,W (48-41),32,48,66.7,362,2,41,190,4.6,5,89,552,6.2,18,9,2,29,6,55,0,2,2
653,2018,8,2018-11-03,Liberty,@,Massachusetts,L (59-62),16,35,45.7,272,2,51,216,4.2,5,86,488,5.7,13,16,2,31,7,45,0,4,4
654,2018,9,2018-11-10,Liberty,@,Virginia,L (24-45),15,27,55.6,149,0,44,205,4.7,3,71,354,5.0,10,10,0,20,3,30,0,3,3
655,2018,10,2018-11-17,Liberty,@,Auburn,L (0-53),9,28,32.1,79,0,28,55,2.0,0,56,134,2.4,6,1,1,7,1,5,2,2,4
656,2018,11,2018-11-24,Liberty,,New Mexico State,W (28-21),18,31,58.1,154,2,47,141,3.0,0,78,295,3.8,9,7,1,17,6,63,0,2,2
657,2018,,11 Games,Liberty,,,,226,416,54.3,2973,20,444,1629,3.7,25,860,4602,5.4,142,84,22,247,50,443,6,18,24
658,2018,1,2018-09-01,Louisiana,,Grambling State,W (49-17),23,30,76.7,241,4,43,315,7.3,3,73,556,7.6,12,12,3,27,6,40,0,1,1
659,2018,2,2018-09-15,Louisiana,@,Mississippi State,L (10-56),23,34,67.6,245,1,26,65,2.5,0,60,310,5.2,10,3,0,13,4,25,0,1,1
660,2018,3,2018-09-22,Louisiana,,Coastal Carolina,L (28-30),10,18,55.6,143,1,31,238,7.7,3,49,381,7.8,6,9,2,17,6,64,0,0,0
661,2018,4,2018-09-29,Louisiana,@,Alabama,L (14-56),11,20,55.0,88,1,38,200,5.3,1,58,288,5.0,4,11,0,15,4,30,0,2,2
662,2018,5,2018-10-06,Louisiana,@,Texas State,W (42-27),14,23,60.9,230,2,49,327,6.7,4,72,557,7.7,9,13,1,23,3,30,0,1,1
663,2018,6,2018-10-13,Louisiana,,New Mexico State,W (66-38),22,29,75.9,415,6,56,344,6.1,3,85,759,8.9,18,17,2,37,7,72,1,0,1
664,2018,7,2018-10-20,Louisiana,@,Appalachian State,L (17-27),17,27,63.0,188,1,41,140,3.4,1,68,328,4.8,8,8,0,16,6,52,1,0,1
665,2018,8,2018-10-27,Louisiana,,Arkansas State,W (47-43),19,28,67.9,319,2,39,228,5.8,4,67,547,8.2,10,10,2,22,6,51,0,2,2
666,2018,9,2018-11-03,Louisiana,@,Troy,L (16-26),14,29,48.3,170,0,36,100,2.8,2,65,270,4.2,7,9,2,18,5,39,1,2,3
667,2018,10,2018-11-10,Louisiana,,Georgia State,W (36-22),16,23,69.6,170,1,37,356,9.6,4,60,526,8.8,9,11,2,22,1,8,0,0,0
668,2018,11,2018-11-17,Louisiana,,South Alabama,W (48-38),13,19,68.4,197,3,33,210,6.4,3,52,407,7.8,8,9,0,17,6,66,0,1,1
669,2018,12,2018-11-24,Louisiana,@,Louisiana-Monroe,W (31-28),17,21,81.0,213,4,49,240,4.9,0,70,453,6.5,6,13,3,22,9,78,0,1,1
670,2018,,12 Games,Louisiana,,,,199,301,66.1,2619,26,478,2763,5.8,28,779,5382,6.9,107,125,17,249,63,555,3,11,14
671,2018,1,2018-09-01,Louisiana Tech,@,South Alabama,W (30-26),19,29,65.5,209,2,48,231,4.8,2,77,440,5.7,8,11,3,22,6,55,0,3,3
672,2018,2,2018-09-08,Louisiana Tech,,Southern,W (54-17),27,42,64.3,427,3,33,186,5.6,4,75,613,8.2,18,11,3,32,4,34,1,0,1
673,2018,3,2018-09-22,Louisiana Tech,@,Louisiana State,L (21-38),27,50,54.0,330,3,26,87,3.3,0,76,417,5.5,14,5,2,21,6,48,1,1,2
674,2018,4,2018-09-29,Louisiana Tech,@,North Texas,W (29-27),20,39,51.3,230,2,32,129,4.0,0,71,359,5.1,10,6,3,19,1,10,0,0,0
675,2018,5,2018-10-06,Louisiana Tech,,Alabama-Birmingham,L (7-28),9,23,39.1,107,0,41,151,3.7,1,64,258,4.0,5,9,1,15,2,17,2,1,3
676,2018,6,2018-10-13,Louisiana Tech,@,Texas-San Antonio,W (31-3),25,37,67.6,309,1,38,75,2.0,3,75,384,5.1,14,6,1,21,4,40,1,1,2
677,2018,7,2018-10-20,Louisiana Tech,,Texas-El Paso,W (31-24),17,29,58.6,156,1,31,169,5.5,2,60,325,5.4,8,8,3,19,6,55,0,0,0
678,2018,8,2018-10-26,Louisiana Tech,@,Florida Atlantic,W (21-13),17,35,48.6,217,1,40,113,2.8,2,75,330,4.4,11,7,3,21,4,44,0,0,0
679,2018,9,2018-11-03,Louisiana Tech,@,Mississippi State,L (3-45),14,31,45.2,98,0,32,140,4.4,0,63,238,3.8,5,10,0,15,5,35,0,1,1
680,2018,10,2018-11-10,Louisiana Tech,,Rice,W (28-13),21,34,61.8,314,1,33,110,3.3,3,67,424,6.3,10,10,0,20,5,37,1,2,3
681,2018,11,2018-11-17,Louisiana Tech,@,Southern Mississippi,L (20-21),27,43,62.8,243,1,23,68,3.0,1,66,311,4.7,13,4,3,20,3,45,0,0,0
682,2018,12,2018-11-24,Louisiana Tech,,Western Kentucky,L (15-30),28,52,53.8,319,0,23,61,2.7,1,75,380,5.1,16,5,3,24,5,67,0,1,1
683,2018,,12 Games,Louisiana Tech,,,,251,444,56.5,2959,15,400,1520,3.8,19,844,4479,5.3,132,92,25,249,51,487,6,10,16
684,2018,1,2018-08-30,Louisiana-Monroe,,Southeastern Louisiana,W (34-31),35,53,66.0,346,2,43,208,4.8,2,96,554,5.8,15,14,2,31,10,75,1,1,2
685,2018,2,2018-09-08,Louisiana-Monroe,@,Southern Mississippi,W (21-20),15,28,53.6,195,2,30,159,5.3,0,58,354,6.1,7,6,0,13,8,55,1,1,2
686,2018,3,2018-09-15,Louisiana-Monroe,@,Texas A&M,L (10-48),15,28,53.6,225,1,29,103,3.6,0,57,328,5.8,7,6,1,14,4,38,0,1,1
687,2018,4,2018-09-22,Louisiana-Monroe,,Troy,L (27-35),29,48,60.4,290,2,36,200,5.6,2,84,490,5.8,15,11,1,27,10,94,0,1,1
688,2018,5,2018-09-29,Louisiana-Monroe,@,Georgia State,L (14-46),20,34,58.8,137,0,20,125,6.3,2,54,262,4.9,6,5,2,13,3,11,2,2,4
689,2018,6,2018-10-06,Louisiana-Monroe,@,Mississippi,L (21-70),23,38,60.5,297,1,38,130,3.4,1,76,427,5.6,13,10,2,25,2,15,2,0,2
690,2018,7,2018-10-13,Louisiana-Monroe,@,Coastal Carolina,W (45-20),16,22,72.7,224,1,34,242,7.1,5,56,466,8.3,8,11,1,20,2,30,1,0,1
691,2018,8,2018-10-20,Louisiana-Monroe,,Texas State,W (20-14),13,29,44.8,124,1,43,229,5.3,1,72,353,4.9,8,12,3,23,7,67,2,0,2
692,2018,9,2018-11-03,Louisiana-Monroe,,Georgia Southern,W (44-25),13,22,59.1,337,2,42,236,5.6,4,64,573,9.0,9,10,2,21,8,75,0,2,2
693,2018,10,2018-11-10,Louisiana-Monroe,@,South Alabama,W (38-10),28,33,84.8,376,2,38,175,4.6,3,71,551,7.8,16,8,2,26,1,15,1,0,1
694,2018,11,2018-11-17,Louisiana-Monroe,@,Arkansas State,L (17-31),17,28,60.7,218,1,26,58,2.2,1,54,276,5.1,10,4,2,16,5,63,0,3,3
695,2018,12,2018-11-24,Louisiana-Monroe,,Louisiana,L (28-31),15,24,62.5,201,2,35,143,4.1,1,59,344,5.8,8,9,0,17,4,50,1,1,2
696,2018,,12 Games,Louisiana-Monroe,,,,239,387,61.8,2970,17,414,2008,4.9,22,801,4978,6.2,122,106,18,246,64,588,11,12,23
697,2018,1,2018-09-01,Louisville,N,Alabama,L (14-51),20,39,51.3,252,2,25,27,1.1,0,64,279,4.4,13,1,5,19,11,93,0,2,2
698,2018,2,2018-09-08,Louisville,,Indiana State,W (31-7),14,22,63.6,164,1,38,199,5.2,2,60,363,6.1,6,12,1,19,7,75,1,1,2
699,2018,3,2018-09-15,Louisville,,Western Kentucky,W (20-17),10,21,47.6,88,0,38,204,5.4,2,59,292,4.9,4,11,2,17,5,40,0,1,1
700,2018,4,2018-09-22,Louisville,@,Virginia,L (3-27),16,28,57.1,148,0,29,66,2.3,0,57,214,3.8,11,3,0,14,6,52,1,2,3
701,2018,5,2018-09-29,Louisville,,Florida State,L (24-28),24,45,53.3,306,2,38,115,3.0,1,83,421,5.1,11,11,2,24,8,75,1,2,3
702,2018,6,2018-10-05,Louisville,,Georgia Tech,L (31-66),27,44,61.4,370,3,23,113,4.9,1,67,483,7.2,14,7,2,23,4,35,2,1,3
703,2018,7,2018-10-13,Louisville,@,Boston College,L (20-38),17,35,48.6,170,0,32,47,1.5,3,67,217,3.2,10,4,1,15,4,33,0,1,1
704,2018,8,2018-10-27,Louisville,,Wake Forest,L (35-56),30,54,55.6,358,1,36,174,4.8,4,90,532,5.9,19,11,1,31,5,31,1,0,1
705,2018,9,2018-11-03,Louisville,@,Clemson,L (16-77),17,34,50.0,231,0,36,81,2.3,1,70,312,4.5,8,8,0,16,10,100,1,2,3
706,2018,10,2018-11-09,Louisville,@,Syracuse,L (23-54),14,31,45.2,210,1,39,203,5.2,2,70,413,5.9,7,9,2,18,17,125,2,2,4
707,2018,11,2018-11-17,Louisville,,North Carolina State,L (10-52),13,25,52.0,157,0,38,254,6.7,1,63,411,6.5,8,11,0,19,12,68,1,1,2
708,2018,12,2018-11-24,Louisville,,Kentucky,L (10-56),8,16,50.0,79,0,30,226,7.5,1,46,305,6.6,3,7,0,10,12,134,0,0,0
709,2018,,12 Games,Louisville,,,,210,394,53.3,2533,10,402,1709,4.3,18,796,4242,5.3,114,95,16,225,101,861,10,15,25
710,2018,1,2018-09-02,LSU,N,Miami (FL),W (33-17),11,24,45.8,140,0,37,156,4.2,2,61,296,4.9,5,8,4,17,6,62,0,0,0
711,2018,2,2018-09-08,LSU,,Southeastern Louisiana,W (31-0),10,20,50.0,151,2,35,184,5.3,2,55,335,6.1,5,10,0,15,7,84,0,0,0
712,2018,3,2018-09-15,LSU,@,Auburn,W (22-21),15,35,42.9,249,1,42,121,2.9,1,77,370,4.8,11,4,6,21,9,91,0,0,0
713,2018,4,2018-09-22,LSU,,Louisiana Tech,W (38-21),16,28,57.1,191,0,48,218,4.5,5,76,409,5.4,8,16,1,25,4,45,1,0,1
714,2018,5,2018-09-29,LSU,,Mississippi,W (45-16),18,25,72.0,292,3,50,281,5.6,3,75,573,7.6,10,16,7,33,5,40,2,0,2
715,2018,6,2018-10-06,LSU,@,Florida,L (19-27),19,34,55.9,192,0,41,180,4.4,2,75,372,5.0,8,9,3,20,8,75,1,2,3
716,2018,7,2018-10-13,LSU,,Georgia,W (36-16),15,30,50.0,200,0,51,275,5.4,3,81,475,5.9,9,10,1,20,2,19,0,0,0
717,2018,8,2018-10-20,LSU,,Mississippi State,W (19-3),16,28,57.1,129,0,44,110,2.5,1,72,239,3.3,6,9,2,17,5,53,0,1,1
718,2018,9,2018-11-03,LSU,,Alabama,L (0-29),18,35,51.4,184,0,25,12,0.5,0,60,196,3.3,8,3,2,13,3,15,0,1,1
719,2018,10,2018-11-10,LSU,@,Arkansas,W (24-17),15,21,71.4,195,1,48,164,3.4,2,69,359,5.2,9,9,2,20,7,69,1,0,1
720,2018,11,2018-11-17,LSU,,Rice,W (42-10),24,34,70.6,372,2,35,180,5.1,4,69,552,8.0,20,10,1,31,3,26,1,0,1
721,2018,12,2018-11-24,LSU,@,Texas A&M,L (72-74),26,39,66.7,281,4,51,215,4.2,4,90,496,5.5,17,13,1,31,10,70,1,0,1
722,2018,,12 Games,LSU,,,,203,353,57.5,2576,13,507,2096,4.1,29,860,4672,5.4,116,117,30,263,69,649,7,4,11
723,2018,1,2018-09-08,Maine,@,Western Kentucky,W (31-28),12,29,41.4,182,3,41,142,3.5,0,70,324,4.6,7,6,1,14,6,40,0,1,1
724,2018,2,2018-09-22,Maine,@,Central Michigan,L (5-17),19,36,52.8,183,0,37,82,2.2,0,73,265,3.6,9,6,3,18,11,113,0,2,2
725,2018,,2 Games,Maine,,,,31,65,47.7,365,3,78,224,2.9,0,143,589,4.1,16,12,4,32,17,153,0,3,3
726,2018,1,2018-09-01,Marshall,@,Miami (OH),W (35-28),24,37,64.9,272,2,38,171,4.5,3,75,443,5.9,11,11,2,24,7,62,0,0,0
727,2018,2,2018-09-08,Marshall,,Eastern Kentucky,W (32-16),23,39,59.0,278,3,28,89,3.2,1,67,367,5.5,10,6,1,17,8,70,3,1,4
728,2018,3,2018-09-22,Marshall,,North Carolina State,L (20-37),22,43,51.2,270,1,22,54,2.5,0,65,324,5.0,11,3,1,15,4,20,1,2,3
729,2018,4,2018-09-29,Marshall,@,Western Kentucky,W (20-17),18,39,46.2,288,2,33,113,3.4,0,72,401,5.6,11,6,0,17,6,70,1,3,4
730,2018,5,2018-10-05,Marshall,,Middle Tennessee State,L (24-34),17,35,48.6,173,2,53,209,3.9,1,88,382,4.3,9,14,5,28,6,59,2,1,3
731,2018,6,2018-10-13,Marshall,@,Old Dominion,W (42-20),18,29,62.1,182,1,45,319,7.1,5,74,501,6.8,9,13,2,24,8,101,0,1,1
732,2018,7,2018-10-20,Marshall,,Florida Atlantic,W (31-7),13,24,54.2,102,2,48,233,4.9,2,72,335,4.7,4,14,0,18,5,55,0,0,0
733,2018,8,2018-11-03,Marshall,@,Southern Mississippi,L (24-26),17,38,44.7,218,1,22,31,1.4,1,60,249,4.2,9,4,2,15,7,79,3,2,5
734,2018,9,2018-11-10,Marshall,,UNC Charlotte,W (30-13),15,26,57.7,178,1,38,147,3.9,2,64,325,5.1,8,8,0,16,3,20,1,0,1
735,2018,10,2018-11-17,Marshall,,Texas-San Antonio,W (23-0),19,36,52.8,387,2,37,118,3.2,0,73,505,6.9,14,6,2,22,6,49,0,0,0
736,2018,11,2018-11-24,Marshall,@,Florida International,W (28-25),18,27,66.7,176,2,30,158,5.3,0,57,334,5.9,10,10,1,21,6,60,0,2,2
737,2018,,11 Games,Marshall,,,,204,373,54.7,2524,19,394,1642,4.2,15,767,4166,5.4,106,95,16,217,66,645,11,12,23
738,2018,1,2018-09-01,Maryland,N,Texas,W (34-29),21,34,61.8,264,2,46,143,3.1,2,80,407,5.1,8,8,5,21,8,70,0,0,0
739,2018,2,2018-09-08,Maryland,@,Bowling Green State,W (45-14),8,16,50.0,121,1,53,444,8.4,5,69,565,8.2,4,19,1,24,14,139,1,0,1
740,2018,3,2018-09-15,Maryland,,Temple,L (14-35),8,21,38.1,63,0,31,132,4.3,0,52,195,3.8,2,7,2,11,5,35,0,2,2
741,2018,4,2018-09-22,Maryland,,Minnesota,W (42-13),10,14,71.4,117,1,37,315,8.5,4,51,432,8.5,2,12,1,15,10,118,0,0,0
742,2018,5,2018-10-06,Maryland,@,Michigan,L (21-42),7,13,53.8,73,0,37,147,4.0,2,50,220,4.4,5,5,1,11,12,107,0,1,1
743,2018,6,2018-10-13,Maryland,,Rutgers,W (34-7),9,20,45.0,85,3,40,290,7.3,1,60,375,6.3,4,12,0,16,9,85,1,0,1
744,2018,7,2018-10-20,Maryland,@,Iowa,L (0-23),6,16,37.5,47,0,23,68,3.0,0,39,115,2.9,3,4,0,7,6,46,1,1,2
745,2018,8,2018-10-27,Maryland,,Illinois,W (63-33),13,21,61.9,281,3,48,431,9.0,5,69,712,10.3,10,19,1,30,7,85,0,0,0
746,2018,9,2018-11-03,Maryland,,Michigan State,L (3-24),8,24,33.3,74,0,29,26,0.9,0,53,100,1.9,4,3,2,9,3,25,2,0,2
747,2018,10,2018-11-10,Maryland,@,Indiana,L (32-34),14,25,56.0,189,1,59,353,6.0,2,84,542,6.5,8,18,1,27,10,93,3,1,4
748,2018,11,2018-11-17,Maryland,,Ohio State,L (51-52),7,14,50.0,196,1,47,340,7.2,4,61,536,8.8,5,12,2,19,9,88,1,0,1
749,2018,12,2018-11-24,Maryland,@,Penn State,L (3-38),14,23,60.9,185,0,36,74,2.1,0,59,259,4.4,7,5,1,13,7,65,0,0,0
750,2018,,12 Games,Maryland,,,,125,241,51.9,1695,12,486,2763,5.7,25,727,4458,6.1,62,124,17,203,100,956,9,5,14
751,2018,1,2018-08-25,Massachusetts,,Duquesne,W (63-15),19,28,67.9,290,4,38,284,7.5,4,66,574,8.7,12,11,1,24,4,30,1,0,1
752,2018,2,2018-09-01,Massachusetts,@,Boston College,L (21-55),21,34,61.8,249,1,34,66,1.9,2,68,315,4.6,12,5,1,18,2,8,1,2,3
753,2018,3,2018-09-08,Massachusetts,@,Georgia Southern,L (13-34),23,36,63.9,216,0,24,108,4.5,1,60,324,5.4,12,6,1,19,8,55,1,1,2
754,2018,4,2018-09-15,Massachusetts,@,Florida International,L (24-63),15,32,46.9,224,1,34,199,5.9,2,66,423,6.4,11,11,2,24,5,40,1,2,3
755,2018,5,2018-09-22,Massachusetts,,UNC Charlotte,W (49-31),12,19,63.2,189,2,35,142,4.1,4,54,331,6.1,9,5,2,16,6,59,1,0,1
756,2018,6,2018-09-29,Massachusetts,@,Ohio,L (42-58),30,43,69.8,410,5,22,41,1.9,0,65,451,6.9,19,3,1,23,8,77,0,1,1
757,2018,7,2018-10-06,Massachusetts,,South Florida,L (42-58),33,52,63.5,401,5,34,85,2.5,1,86,486,5.7,19,6,4,29,8,80,4,1,5
758,2018,8,2018-10-20,Massachusetts,,Coastal Carolina,L (13-24),25,43,58.1,390,1,22,63,2.9,0,65,453,7.0,18,4,0,22,8,70,2,0,2
759,2018,9,2018-10-27,Massachusetts,@,Connecticut,W (22-17),8,15,53.3,197,2,53,247,4.7,1,68,444,6.5,7,12,1,20,2,15,1,1,2
760,2018,10,2018-11-03,Massachusetts,,Liberty,W (62-59),29,44,65.9,540,4,54,237,4.4,4,98,777,7.9,17,15,2,34,9,79,2,1,3
761,2018,11,2018-11-10,Massachusetts,,Brigham Young,L (16-35),23,33,69.7,183,0,36,102,2.8,2,69,285,4.1,9,5,1,15,1,10,0,0,0
762,2018,12,2018-11-17,Massachusetts,@,Georgia,L (27-66),24,32,75.0,287,2,22,103,4.7,1,54,390,7.2,10,5,1,16,7,59,0,1,1
763,2018,,12 Games,Massachusetts,,,,262,411,63.7,3576,27,408,1677,4.1,22,819,5253,6.4,155,88,17,260,68,582,14,10,24
764,2018,1,2018-09-22,McNeese State,@,Brigham Young,L (3-30),18,26,69.2,134,0,28,73,2.6,0,54,207,3.8,4,4,2,10,10,70,2,2,4
765,2018,1,2018-09-01,Memphis,,Mercer,W (66-14),28,39,71.8,428,5,47,324,6.9,3,86,752,8.7,19,11,2,32,7,57,1,0,1
766,2018,2,2018-09-08,Memphis,@,Navy,L (21-22),15,25,60.0,145,0,24,233,9.7,3,49,378,7.7,8,6,0,14,4,20,3,1,4
767,2018,3,2018-09-14,Memphis,,Georgia State,W (59-22),19,27,70.4,269,5,35,410,11.7,3,62,679,11.0,14,13,0,27,10,79,0,1,1
768,2018,4,2018-09-22,Memphis,,South Alabama,W (52-35),22,30,73.3,292,2,46,271,5.9,5,76,563,7.4,14,14,3,31,5,50,0,0,0
769,2018,5,2018-09-28,Memphis,@,Tulane,L (24-40),14,30,46.7,246,2,21,31,1.5,1,51,277,5.4,8,2,3,13,4,20,0,0,0
770,2018,6,2018-10-06,Memphis,,Connecticut,W (55-14),17,19,89.5,256,2,40,378,9.5,6,59,634,10.7,9,16,1,26,9,90,0,0,0
771,2018,7,2018-10-13,Memphis,,Central Florida,L (30-31),17,29,58.6,209,0,52,281,5.4,3,81,490,6.0,10,14,3,27,7,43,2,0,2
772,2018,8,2018-10-20,Memphis,@,Missouri,L (33-65),15,38,39.5,208,2,43,200,4.7,2,81,408,5.0,12,9,4,25,8,65,0,2,2
773,2018,9,2018-11-03,Memphis,@,East Carolina,W (59-41),21,30,70.0,362,3,52,277,5.3,5,82,639,7.8,11,14,1,26,9,56,0,0,0
774,2018,10,2018-11-10,Memphis,,Tulsa,W (47-21),16,23,69.6,202,2,55,297,5.4,3,78,499,6.4,10,14,2,26,8,79,1,0,1
775,2018,11,2018-11-16,Memphis,@,Southern Methodist,W (28-18),18,31,58.1,226,2,43,208,4.8,2,74,434,5.9,12,7,2,21,12,143,0,2,2
776,2018,12,2018-11-23,Memphis,,Houston,W (52-31),21,33,63.6,209,1,59,401,6.8,6,92,610,6.6,10,19,2,31,5,32,0,2,2
777,2018,,12 Games,Memphis,,,,223,354,63.0,3052,26,517,3311,6.4,42,871,6363,7.3,137,139,23,299,88,734,7,8,15
778,2018,1,2018-09-01,Mercer,@,Memphis,L (14-66),14,27,51.9,114,2,24,60,2.5,0,51,174,3.4,6,2,0,8,7,60,0,2,2
779,2018,1,2018-09-02,Miami (FL),N,Louisiana State,L (17-33),15,35,42.9,259,1,34,83,2.4,1,69,342,5.0,9,6,3,18,11,85,0,2,2
780,2018,2,2018-09-08,Miami (FL),,Savannah State,W (77-0),19,31,61.3,255,5,37,239,6.5,5,68,494,7.3,8,11,1,20,1,15,1,1,2
781,2018,3,2018-09-15,Miami (FL),@,Toledo,W (49-24),13,23,56.5,205,2,53,268,5.1,5,76,473,6.2,7,16,1,24,0,0,0,0,0
782,2018,4,2018-09-22,Miami (FL),,Florida International,W (31-17),20,29,69.0,240,3,49,248,5.1,1,78,488,6.3,11,15,1,27,6,60,1,1,2
783,2018,5,2018-09-27,Miami (FL),,North Carolina,W (47-10),8,12,66.7,125,1,34,229,6.7,2,46,354,7.7,4,10,0,14,7,65,1,1,2
784,2018,6,2018-10-06,Miami (FL),,Florida State,W (28-27),13,32,40.6,204,4,46,102,2.2,0,78,306,3.9,8,9,3,20,6,50,1,0,1
785,2018,7,2018-10-13,Miami (FL),@,Virginia,L (13-16),15,29,51.7,190,0,29,149,5.1,1,58,339,5.8,9,6,1,16,8,71,0,3,3
786,2018,8,2018-10-26,Miami (FL),@,Boston College,L (14-27),19,39,48.7,150,1,36,155,4.3,1,75,305,4.1,8,10,1,19,6,28,0,2,2
787,2018,9,2018-11-03,Miami (FL),,Duke,L (12-20),13,28,46.4,111,0,44,300,6.8,2,72,411,5.7,5,10,1,16,6,73,2,0,2
788,2018,10,2018-11-10,Miami (FL),@,Georgia Tech,L (21-27),14,23,60.9,165,0,30,134,4.5,3,53,299,5.6,6,7,0,13,7,49,3,0,3
789,2018,11,2018-11-17,Miami (FL),@,Virginia Tech,W (38-14),21,34,61.8,171,2,32,168,5.3,2,66,339,5.1,7,8,2,17,11,71,0,0,0
790,2018,12,2018-11-24,Miami (FL),,Pittsburgh,W (24-3),6,24,25.0,52,0,32,293,9.2,2,56,345,6.2,4,6,2,12,3,30,2,0,2
791,2018,,12 Games,Miami (FL),,,,176,339,51.9,2127,19,456,2368,5.2,25,795,4495,5.7,86,114,16,216,72,597,11,10,21
792,2018,1,2018-09-01,Miami (OH),,Marshall,L (28-35),25,46,54.3,357,3,27,87,3.2,1,73,444,6.1,16,5,2,23,8,71,0,0,0
793,2018,2,2018-09-08,Miami (OH),,Cincinnati,L (0-21),22,41,53.7,139,0,19,59,3.1,0,60,198,3.3,9,1,1,11,4,45,0,1,1
794,2018,3,2018-09-15,Miami (OH),@,Minnesota,L (3-26),11,23,47.8,108,0,31,91,2.9,0,54,199,3.7,5,3,2,10,6,55,2,1,3
795,2018,4,2018-09-22,Miami (OH),@,Bowling Green State,W (38-23),10,15,66.7,119,2,52,289,5.6,3,67,408,6.1,6,10,1,17,8,85,0,0,0
796,2018,5,2018-09-29,Miami (OH),,Western Michigan,L (39-40),22,32,68.8,294,3,27,55,2.0,1,59,349,5.9,11,6,3,20,8,45,0,0,0
797,2018,6,2018-10-06,Miami (OH),@,Akron,W (41-17),24,33,72.7,214,1,38,208,5.5,3,71,422,5.9,10,9,0,19,6,60,1,1,2
798,2018,7,2018-10-13,Miami (OH),,Kent State,W (31-6),16,25,64.0,209,1,51,295,5.8,3,76,504,6.6,9,13,3,25,6,40,1,0,1
799,2018,8,2018-10-20,Miami (OH),@,Army,L (30-31),30,53,56.6,329,4,27,77,2.9,0,80,406,5.1,17,6,0,23,8,56,0,0,0
800,2018,9,2018-10-30,Miami (OH),@,Buffalo,L (42-51),20,35,57.1,313,1,41,140,3.4,5,76,453,6.0,12,9,2,23,13,139,1,0,1
801,2018,10,2018-11-07,Miami (OH),,Ohio,W (30-28),20,32,62.5,199,1,34,160,4.7,3,66,359,5.4,11,8,0,19,6,45,0,0,0
802,2018,11,2018-11-14,Miami (OH),@,Northern Illinois,W (13-7),15,24,62.5,107,0,41,94,2.3,0,65,201,3.1,9,4,3,16,2,15,0,0,0
803,2018,12,2018-11-20,Miami (OH),,Ball State,W (42-21),11,17,64.7,159,1,53,364,6.9,5,70,523,7.5,8,12,2,22,3,40,0,1,1
804,2018,,12 Games,Miami (OH),,,,226,376,60.1,2547,17,441,1919,4.4,24,817,4466,5.5,123,86,19,228,78,696,5,4,9
805,2018,1,2018-09-01,Michigan,@,Notre Dame,L (17-24),24,36,66.7,249,0,33,58,1.8,1,69,307,4.4,14,4,2,20,7,52,1,1,2
806,2018,2,2018-09-08,Michigan,,Western Michigan,W (49-3),13,18,72.2,143,4,35,308,8.8,3,53,451,8.5,7,12,1,20,7,55,0,0,0
807,2018,3,2018-09-15,Michigan,,Southern Methodist,W (45-20),14,18,77.8,237,3,41,197,4.8,2,59,434,7.4,8,10,3,21,13,137,0,1,1
808,2018,4,2018-09-22,Michigan,,Nebraska,W (56-10),18,31,58.1,206,2,45,285,6.3,4,76,491,6.5,9,12,1,22,8,77,0,1,1
809,2018,5,2018-09-29,Michigan,@,Northwestern,W (20-17),15,24,62.5,196,0,42,180,4.3,2,66,376,5.7,7,10,1,18,11,100,0,0,0
810,2018,6,2018-10-06,Michigan,,Maryland,W (42-21),20,28,71.4,294,3,40,171,4.3,1,68,465,6.8,11,11,2,24,6,52,0,1,1
811,2018,7,2018-10-13,Michigan,,Wisconsin,W (38-13),14,21,66.7,124,0,48,320,6.7,3,69,444,6.4,5,14,2,21,1,15,0,0,0
812,2018,8,2018-10-20,Michigan,@,Michigan State,W (21-7),14,25,56.0,212,2,53,183,3.5,1,78,395,5.1,8,11,0,19,9,99,2,0,2
813,2018,9,2018-11-03,Michigan,,Penn State,W (42-7),11,17,64.7,144,2,52,259,5.0,3,69,403,5.8,6,14,0,20,9,80,0,0,0
814,2018,10,2018-11-10,Michigan,@,Rutgers,W (42-7),18,27,66.7,260,3,40,193,4.8,3,67,453,6.8,14,10,0,24,2,20,0,0,0
815,2018,11,2018-11-17,Michigan,,Indiana,W (31-20),16,28,57.1,250,1,50,257,5.1,1,78,507,6.5,10,13,2,25,4,45,0,1,1
816,2018,12,2018-11-24,Michigan,@,Ohio State,L (39-62),23,38,60.5,240,3,40,161,4.0,2,78,401,5.1,12,10,6,28,7,72,0,2,2
817,2018,,12 Games,Michigan,,,,200,311,64.3,2555,23,519,2572,5.0,26,830,5127,6.2,111,131,20,262,84,804,3,7,10
818,2018,1,2018-08-31,Michigan State,,Utah State,W (38-31),23,33,69.7,287,2,42,165,3.9,2,75,452,6.0,11,9,3,23,9,62,1,1,2
819,2018,2,2018-09-08,Michigan State,@,Arizona State,L (13-16),27,39,69.2,314,1,27,63,2.3,0,66,377,5.7,17,5,1,23,9,82,0,1,1
820,2018,3,2018-09-22,Michigan State,@,Indiana,W (35-21),15,26,57.7,219,2,40,131,3.3,2,66,350,5.3,11,6,2,19,8,72,2,2,4
821,2018,4,2018-09-29,Michigan State,,Central Michigan,W (31-20),16,25,64.0,185,0,47,160,3.4,4,72,345,4.8,9,11,3,23,5,55,0,1,1
822,2018,5,2018-10-06,Michigan State,,Northwestern,L (19-29),31,51,60.8,329,1,24,96,4.0,1,75,425,5.7,17,4,1,22,5,49,0,1,1
823,2018,6,2018-10-13,Michigan State,@,Penn State,W (21-17),25,53,47.2,295,2,36,123,3.4,1,89,418,4.7,17,5,3,25,3,20,0,1,1
824,2018,7,2018-10-20,Michigan State,,Michigan,L (7-21),7,28,25.0,79,1,23,15,0.7,0,51,94,1.8,4,2,5,11,4,40,1,0,1
825,2018,8,2018-10-27,Michigan State,,Purdue,W (23-13),26,46,56.5,318,2,40,108,2.7,0,86,426,5.0,18,8,0,26,6,61,1,0,1
826,2018,9,2018-11-03,Michigan State,@,Maryland,W (24-3),11,22,50.0,87,0,46,269,5.8,3,68,356,5.2,5,13,1,19,4,33,0,2,2
827,2018,10,2018-11-10,Michigan State,,Ohio State,L (6-26),18,48,37.5,220,0,18,54,3.0,0,66,274,4.2,9,3,0,12,7,46,2,1,3
828,2018,11,2018-11-17,Michigan State,@,Nebraska,L (6-9),15,41,36.6,146,0,38,143,3.8,0,79,289,3.7,7,8,3,18,7,87,1,1,2
829,2018,12,2018-11-24,Michigan State,,Rutgers,W (14-10),19,44,43.2,173,1,36,141,3.9,1,80,314,3.9,12,8,3,23,6,69,0,2,2
830,2018,,12 Games,Michigan State,,,,233,456,51.1,2652,12,417,1468,3.5,14,873,4120,4.7,137,82,25,244,73,676,8,13,21
831,2018,1,2018-09-01,Middle Tennessee State,@,Vanderbilt,L (7-35),24,36,66.7,178,1,36,116,3.2,0,72,294,4.1,8,10,3,21,6,40,1,1,2
832,2018,2,2018-09-08,Middle Tennessee State,,Tennessee-Martin,W (61-37),23,32,71.9,396,5,32,79,2.5,2,64,475,7.4,14,5,1,20,6,68,1,0,1
833,2018,3,2018-09-15,Middle Tennessee State,@,Georgia,L (7-49),20,30,66.7,130,1,38,158,4.2,0,68,288,4.2,4,10,0,14,3,35,1,1,2
834,2018,4,2018-09-29,Middle Tennessee State,,Florida Atlantic,W (25-24),27,40,67.5,259,1,36,137,3.8,2,76,396,5.2,14,8,0,22,3,29,1,1,2
835,2018,5,2018-10-05,Middle Tennessee State,@,Marshall,W (34-24),25,40,62.5,317,2,35,103,2.9,2,75,420,5.6,13,8,4,25,11,127,1,0,1
836,2018,6,2018-10-13,Middle Tennessee State,@,Florida International,L (21-24),15,27,55.6,142,0,40,187,4.7,3,67,329,4.9,8,11,2,21,5,52,0,1,1
837,2018,7,2018-10-20,Middle Tennessee State,,UNC Charlotte,W (21-13),14,20,70.0,111,3,32,33,1.0,0,52,144,2.8,6,3,0,9,2,20,1,1,2
838,2018,8,2018-10-27,Middle Tennessee State,@,Old Dominion,W (51-17),25,33,75.8,280,2,38,208,5.5,3,71,488,6.9,12,9,5,26,5,38,0,1,1
839,2018,9,2018-11-02,Middle Tennessee State,,Western Kentucky,W (29-10),24,42,57.1,228,2,43,256,6.0,0,85,484,5.7,12,13,2,27,3,34,0,0,0
840,2018,10,2018-11-10,Middle Tennessee State,@,Texas-El Paso,W (48-32),31,40,77.5,352,4,36,139,3.9,2,76,491,6.5,13,8,0,21,6,63,2,0,2
841,2018,11,2018-11-17,Middle Tennessee State,@,Kentucky,L (23-34),30,33,90.9,293,3,38,99,2.6,0,71,392,5.5,14,8,2,24,6,57,1,1,2
842,2018,12,2018-11-24,Middle Tennessee State,,Alabama-Birmingham,W (27-3),22,29,75.9,261,2,35,133,3.8,1,64,394,6.2,10,7,2,19,4,45,0,0,0
843,2018,,12 Games,Middle Tennessee State,,,,280,402,69.7,2947,26,439,1648,3.8,15,841,4595,5.5,128,100,21,249,60,608,9,7,16
844,2018,1,2018-08-30,Minnesota,,New Mexico State,W (48-10),17,34,50.0,227,2,46,300,6.5,3,80,527,6.6,9,14,0,23,9,92,1,0,1
845,2018,2,2018-09-08,Minnesota,,Fresno State,W (21-14),16,26,61.5,175,0,45,132,2.9,2,71,307,4.3,12,7,1,20,3,30,1,0,1
846,2018,3,2018-09-15,Minnesota,,Miami (OH),W (26-3),14,26,53.8,177,3,44,118,2.7,0,70,295,4.2,8,12,2,22,5,52,1,1,2
847,2018,4,2018-09-22,Minnesota,@,Maryland,L (13-42),14,32,43.8,169,1,40,94,2.4,0,72,263,3.7,9,8,6,23,1,15,1,2,3
848,2018,5,2018-10-06,Minnesota,,Iowa,L (31-48),18,36,50.0,234,3,31,86,2.8,1,67,320,4.8,9,8,3,20,2,10,0,4,4
849,2018,6,2018-10-13,Minnesota,@,Ohio State,L (14-30),13,23,56.5,218,0,33,178,5.4,2,56,396,7.1,10,7,2,19,4,60,1,2,3
850,2018,7,2018-10-20,Minnesota,@,Nebraska,L (28-53),20,36,55.6,349,1,36,125,3.5,3,72,474,6.6,16,5,1,22,8,80,0,1,1
851,2018,8,2018-10-26,Minnesota,,Indiana,W (38-31),17,24,70.8,302,3,40,180,4.5,2,64,482,7.5,12,8,2,22,3,20,3,1,4
852,2018,9,2018-11-03,Minnesota,@,Illinois,L (31-55),15,28,53.6,260,2,42,178,4.2,2,70,438,6.3,7,10,3,20,2,15,2,0,2
853,2018,10,2018-11-10,Minnesota,,Purdue,W (41-10),11,20,55.0,150,2,41,265,6.5,2,61,415,6.8,6,11,5,22,5,50,0,1,1
854,2018,11,2018-11-17,Minnesota,,Northwestern,L (14-24),19,32,59.4,197,1,35,109,3.1,1,67,306,4.6,9,7,2,18,3,34,1,2,3
855,2018,12,2018-11-24,Minnesota,@,Wisconsin,W (37-15),9,16,56.3,124,0,44,205,4.7,3,60,329,5.5,7,11,1,19,2,20,0,0,0
856,2018,,12 Games,Minnesota,,,,183,333,55.0,2582,18,477,1970,4.1,21,810,4552,5.6,114,108,28,250,47,478,11,14,25
857,2018,1,2018-09-01,Mississippi State,,Stephen F. Austin,W (63-6),15,34,44.1,398,5,37,220,5.9,4,71,618,8.7,12,12,1,25,7,80,0,0,0
858,2018,2,2018-09-08,Mississippi State,@,Kansas State,W (31-10),11,27,40.7,154,2,39,384,9.8,2,66,538,8.2,6,18,0,24,11,84,0,1,1
859,2018,3,2018-09-15,Mississippi State,,Louisiana,W (56-10),16,24,66.7,276,2,47,331,7.0,6,71,607,8.5,11,18,0,29,3,15,0,1,1
860,2018,4,2018-09-22,Mississippi State,@,Kentucky,L (7-28),16,32,50.0,145,0,28,56,2.0,1,60,201,3.4,6,5,0,11,16,139,0,1,1
861,2018,5,2018-09-29,Mississippi State,,Florida,L (6-13),11,26,42.3,98,0,32,104,3.3,0,58,202,3.5,6,7,2,15,2,15,0,0,0
862,2018,6,2018-10-06,Mississippi State,,Auburn,W (23-9),9,17,52.9,69,0,57,349,6.1,2,74,418,5.6,3,18,1,22,1,15,0,1,1
863,2018,7,2018-10-20,Mississippi State,@,Louisiana State,L (3-19),8,24,33.3,59,0,37,201,5.4,0,61,260,4.3,3,9,3,15,5,45,0,4,4
864,2018,8,2018-10-27,Mississippi State,,Texas A&M,W (28-13),14,22,63.6,241,2,31,143,4.6,2,53,384,7.2,7,7,1,15,10,95,0,0,0
865,2018,9,2018-11-03,Mississippi State,,Louisiana Tech,W (45-3),17,29,58.6,243,4,36,289,8.0,2,65,532,8.2,11,13,2,26,3,25,0,0,0
866,2018,10,2018-11-10,Mississippi State,@,Alabama,L (0-24),11,20,55.0,125,0,30,44,1.5,0,50,169,3.4,3,3,0,6,7,50,1,0,1
867,2018,11,2018-11-17,Mississippi State,,Arkansas,W (52-6),12,18,66.7,188,5,47,287,6.1,2,65,475,7.3,9,16,4,29,7,60,1,0,1
868,2018,12,2018-11-22,Mississippi State,@,Mississippi,W (35-3),11,18,61.1,111,1,51,309,6.1,4,69,420,6.1,6,16,1,23,3,35,0,0,0
869,2018,,12 Games,Mississippi State,,,,151,291,51.9,2107,21,472,2717,5.8,25,763,4824,6.3,83,142,15,240,75,658,2,8,10
870,2018,1,2018-09-01,Missouri,,Tennessee-Martin,W (51-14),23,34,67.6,394,4,44,164,3.7,2,78,558,7.2,13,8,5,26,4,45,0,0,0
871,2018,2,2018-09-08,Missouri,,Wyoming,W (40-13),33,45,73.3,398,4,46,203,4.4,1,91,601,6.6,23,10,0,33,8,79,1,0,1
872,2018,3,2018-09-15,Missouri,@,Purdue,W (40-37),26,43,60.5,375,3,46,233,5.1,1,89,608,6.8,14,14,3,31,4,27,0,1,1
873,2018,4,2018-09-22,Missouri,,Georgia,L (29-43),23,48,47.9,221,0,37,172,4.6,4,85,393,4.6,15,9,2,26,5,30,2,1,3
874,2018,5,2018-10-06,Missouri,@,South Carolina,L (35-37),17,36,47.2,204,0,46,286,6.2,3,82,490,6.0,9,10,4,23,10,83,0,2,2
875,2018,6,2018-10-13,Missouri,@,Alabama,L (10-39),13,26,50.0,142,1,35,70,2.0,0,61,212,3.5,6,5,2,13,5,53,1,2,3
876,2018,7,2018-10-20,Missouri,,Memphis,W (65-33),24,32,75.0,373,4,40,273,6.8,4,72,646,9.0,13,14,3,30,12,122,0,0,0
877,2018,8,2018-10-27,Missouri,,Kentucky,L (14-15),15,27,55.6,165,0,35,84,2.4,2,62,249,4.0,7,3,3,13,8,69,0,0,0
878,2018,9,2018-11-03,Missouri,@,Florida,W (38-17),24,32,75.0,250,3,42,221,5.3,2,74,471,6.4,12,10,0,22,11,84,0,0,0
879,2018,10,2018-11-10,Missouri,,Vanderbilt,W (33-28),22,33,66.7,253,2,49,253,5.2,2,82,506,6.2,12,17,1,30,2,15,0,2,2
880,2018,11,2018-11-17,Missouri,@,Tennessee,W (50-17),21,30,70.0,257,2,49,227,4.6,3,79,484,6.1,14,12,3,29,10,79,1,0,1
881,2018,12,2018-11-23,Missouri,,Arkansas,W (38-0),17,27,63.0,227,2,42,181,4.3,2,69,408,5.9,8,8,1,17,5,49,1,0,1
882,2018,,12 Games,Missouri,,,,258,413,62.5,3259,25,511,2367,4.6,26,924,5626,6.1,146,120,27,293,84,735,6,8,14
883,2018,1,2018-09-01,Navy,@,Hawaii,L (41-59),6,13,46.2,85,1,49,326,6.7,5,62,411,6.6,6,13,0,19,2,18,0,0,0
884,2018,2,2018-09-08,Navy,,Memphis,W (22-21),4,6,66.7,52,0,73,264,3.6,3,79,316,4.0,3,16,1,20,1,10,1,0,1
885,2018,3,2018-09-15,Navy,,Lehigh,W (51-21),6,14,42.9,145,0,62,484,7.8,6,76,629,8.3,4,21,1,26,8,63,1,1,2
886,2018,4,2018-09-22,Navy,@,Southern Methodist,L (30-31),1,4,25.0,25,1,78,349,4.5,3,82,374,4.6,1,22,0,23,2,25,3,0,3
887,2018,5,2018-10-06,Navy,@,Air Force,L (7-35),3,12,25.0,49,0,41,129,3.1,1,53,178,3.4,2,7,0,9,4,40,0,0,0
888,2018,6,2018-10-13,Navy,,Temple,L (17-24),3,11,27.3,14,0,53,270,5.1,2,64,284,4.4,1,14,3,18,6,40,1,0,1
889,2018,7,2018-10-20,Navy,,Houston,L (36-49),10,16,62.5,178,1,68,344,5.1,4,84,522,6.2,6,19,1,26,3,32,0,1,1
890,2018,8,2018-10-27,Navy,N,Notre Dame,L (22-44),4,12,33.3,52,0,48,292,6.1,3,60,344,5.7,2,11,1,14,4,16,1,1,2
891,2018,9,2018-11-03,Navy,@,Cincinnati,L (0-42),3,4,75.0,47,0,52,124,2.4,0,56,171,3.1,2,9,2,13,3,31,1,0,1
892,2018,10,2018-11-10,Navy,@,Central Florida,L (24-35),0,2,0.0,0,0,62,375,6.0,3,64,375,5.9,0,19,1,20,4,30,1,0,1
893,2018,11,2018-11-17,Navy,,Tulsa,W (37-29),1,2,50.0,15,0,61,395,6.5,5,63,410,6.5,1,18,2,21,4,45,1,0,1
894,2018,12,2018-11-24,Navy,@,Tulane,L (28-29),8,16,50.0,204,2,45,117,2.6,1,61,321,5.3,6,7,0,13,2,10,0,0,0
895,2018,,12 Games,Navy,,,,49,112,43.8,866,5,692,3469,5.0,36,804,4335,5.4,34,176,12,222,43,360,10,3,13
896,2018,1,2018-09-08,Nebraska,,Colorado,L (28-33),19,29,65.5,236,1,54,329,6.1,3,83,565,6.8,9,13,3,25,11,95,2,1,3
897,2018,2,2018-09-15,Nebraska,,Troy,L (19-24),19,27,70.4,177,2,48,187,3.9,0,75,364,4.9,7,12,3,22,10,77,1,2,3
898,2018,3,2018-09-22,Nebraska,@,Michigan,L (10-56),13,24,54.2,93,0,30,39,1.3,1,54,132,2.4,4,5,3,12,10,79,1,1,2
899,2018,4,2018-09-29,Nebraska,,Purdue,L (28-42),25,42,59.5,323,2,39,259,6.6,2,81,582,7.2,16,14,1,31,11,136,0,1,1
900,2018,5,2018-10-06,Nebraska,@,Wisconsin,L (24-41),26,44,59.1,407,2,24,111,4.6,1,68,518,7.6,17,7,2,26,10,100,1,0,1
901,2018,6,2018-10-13,Nebraska,@,Northwestern,L (31-34),25,35,71.4,251,1,47,231,4.9,3,82,482,5.9,9,15,0,24,9,89,1,2,3
902,2018,7,2018-10-20,Nebraska,,Minnesota,W (53-28),25,30,83.3,276,3,43,383,8.9,4,73,659,9.0,9,18,1,28,6,43,1,0,1
903,2018,8,2018-10-27,Nebraska,,Bethune-Cookman,W (45-9),17,31,54.8,242,2,33,226,6.8,3,64,468,7.3,11,12,0,23,5,35,0,2,2
904,2018,9,2018-11-03,Nebraska,@,Ohio State,L (31-36),22,33,66.7,266,1,49,184,3.8,3,82,450,5.5,14,11,2,27,5,44,1,0,1
905,2018,10,2018-11-10,Nebraska,,Illinois,W (54-35),24,34,70.6,290,3,34,316,9.3,4,68,606,8.9,12,9,1,22,7,72,1,1,2
906,2018,11,2018-11-17,Nebraska,,Michigan State,W (9-6),16,37,43.2,145,0,30,103,3.4,0,67,248,3.7,8,5,1,14,5,45,2,0,2
907,2018,12,2018-11-23,Nebraska,@,Iowa,L (28-31),26,38,68.4,260,2,33,140,4.2,1,71,400,5.6,14,9,1,24,3,35,0,1,1
908,2018,,12 Games,Nebraska,,,,257,404,63.6,2966,19,464,2508,5.4,25,868,5474,6.3,130,130,18,278,92,850,11,11,22
909,2018,1,2018-08-31,Nevada,,Portland State,W (72-19),18,28,64.3,420,4,35,216,6.2,4,63,636,10.1,12,12,1,25,9,106,0,1,1
910,2018,2,2018-09-08,Nevada,@,Vanderbilt,L (10-41),22,39,56.4,216,1,25,34,1.4,0,64,250,3.9,8,6,0,14,6,67,2,2,4
911,2018,3,2018-09-15,Nevada,,Oregon State,W (37-35),18,37,48.6,201,2,30,156,5.2,2,67,357,5.3,10,6,1,17,5,60,0,1,1
912,2018,4,2018-09-22,Nevada,@,Toledo,L (44-63),29,50,58.0,320,1,35,262,7.5,5,85,582,6.8,14,11,2,27,10,70,1,1,2
913,2018,5,2018-09-29,Nevada,@,Air Force,W (28-25),24,33,72.7,259,4,34,177,5.2,0,67,436,6.5,12,7,0,19,13,103,1,1,2
914,2018,6,2018-10-06,Nevada,,Fresno State,L (3-21),22,43,51.2,195,0,43,132,3.1,0,86,327,3.8,13,7,1,21,1,5,0,3,3
915,2018,7,2018-10-13,Nevada,,Boise State,L (27-31),24,42,57.1,304,2,24,82,3.4,1,66,386,5.8,11,7,5,23,4,20,2,1,3
916,2018,8,2018-10-20,Nevada,@,Hawaii,W (40-22),23,31,74.2,261,1,36,220,6.1,4,67,481,7.2,11,12,2,25,5,55,3,0,3
917,2018,9,2018-10-27,Nevada,,San Diego State,W (28-24),23,43,53.5,235,2,23,62,2.7,1,66,297,4.5,10,3,1,14,5,75,0,0,0
918,2018,10,2018-11-10,Nevada,,Colorado State,W (49-10),28,36,77.8,404,4,35,235,6.7,3,71,639,9.0,20,8,1,29,6,61,1,1,2
919,2018,11,2018-11-17,Nevada,@,San Jose State,W (21-12),19,32,59.4,314,1,47,149,3.2,2,79,463,5.9,13,10,1,24,3,15,1,1,2
920,2018,12,2018-11-24,Nevada,@,Nevada-Las Vegas,L (29-34),27,45,60.0,295,2,27,169,6.3,1,72,464,6.4,13,6,0,19,4,50,0,3,3
921,2018,,12 Games,Nevada,,,,277,459,60.3,3424,24,394,1894,4.8,23,853,5318,6.2,147,95,15,257,71,687,11,15,26
922,2018,1,2018-09-01,Nevada-Las Vegas,@,Southern California,L (21-43),12,27,44.4,97,2,43,308,7.2,1,70,405,5.8,4,13,0,17,4,35,1,0,1
923,2018,2,2018-09-08,Nevada-Las Vegas,,Texas-El Paso,W (52-24),6,14,42.9,119,3,56,414,7.4,4,70,533,7.6,5,21,3,29,3,29,0,0,0
924,2018,3,2018-09-15,Nevada-Las Vegas,,Prairie View A&M,W (46-17),11,21,52.4,130,1,64,318,5.0,5,85,448,5.3,8,18,2,28,4,29,2,1,3
925,2018,4,2018-09-22,Nevada-Las Vegas,@,Arkansas State,L (20-27),5,21,23.8,23,0,49,310,6.3,3,70,333,4.8,2,11,2,15,6,40,1,3,4
926,2018,5,2018-10-06,Nevada-Las Vegas,,New Mexico,L (14-50),15,35,42.9,123,2,27,43,1.6,0,62,166,2.7,8,3,2,13,3,25,1,1,2
927,2018,6,2018-10-13,Nevada-Las Vegas,@,Utah State,L (28-59),18,36,50.0,250,3,48,154,3.2,1,84,404,4.8,10,8,3,21,9,70,0,1,1
928,2018,7,2018-10-19,Nevada-Las Vegas,,Air Force,L (35-41),26,38,68.4,261,3,33,139,4.2,2,71,400,5.6,12,6,5,23,6,40,0,1,1
929,2018,8,2018-10-27,Nevada-Las Vegas,@,San Jose State,L (37-50),28,50,56.0,387,4,37,167,4.5,1,87,554,6.4,14,9,2,25,4,35,0,3,3
930,2018,9,2018-11-03,Nevada-Las Vegas,,Fresno State,L (3-48),15,35,42.9,105,0,41,197,4.8,0,76,302,4.0,6,12,0,18,8,57,0,1,1
931,2018,10,2018-11-10,Nevada-Las Vegas,@,San Diego State,W (27-24),16,24,66.7,237,1,43,199,4.6,2,67,436,6.5,9,9,1,19,5,51,1,1,2
932,2018,11,2018-11-17,Nevada-Las Vegas,@,Hawaii,L (28-35),10,24,41.7,87,2,53,221,4.2,2,77,308,4.0,4,12,0,16,8,97,0,0,0
933,2018,12,2018-11-24,Nevada-Las Vegas,,Nevada,W (34-29),15,23,65.2,183,3,50,226,4.5,2,73,409,5.6,7,13,2,22,5,40,1,0,1
934,2018,,12 Games,Nevada-Las Vegas,,,,177,348,50.9,2002,24,544,2696,5.0,23,892,4698,5.3,89,135,22,246,65,548,7,12,19
935,2018,1,2018-09-15,New Hampshire,@,Colorado,L (14-45),16,39,41.0,228,1,31,42,1.4,0,70,270,3.9,6,7,2,15,6,35,2,1,3
936,2018,1,2018-09-01,New Mexico,,Incarnate Word,W (62-30),15,25,60.0,361,5,66,319,4.8,4,91,680,7.5,10,19,3,32,7,48,1,1,2
937,2018,2,2018-09-08,New Mexico,@,Wisconsin,L (14-45),14,24,58.3,134,2,30,77,2.6,0,54,211,3.9,8,5,1,14,1,10,1,2,3
938,2018,3,2018-09-15,New Mexico,@,New Mexico State,W (42-25),12,19,63.2,127,0,62,198,3.2,5,81,325,4.0,6,14,2,22,15,133,1,1,2
939,2018,4,2018-09-29,New Mexico,,Liberty,L (43-52),21,41,51.2,369,4,37,211,5.7,2,78,580,7.4,13,10,1,24,6,57,0,4,4
940,2018,5,2018-10-06,New Mexico,@,Nevada-Las Vegas,W (50-14),13,21,61.9,250,4,60,252,4.2,3,81,502,6.2,9,14,2,25,3,40,1,0,1
941,2018,6,2018-10-13,New Mexico,@,Colorado State,L (18-20),12,20,60.0,165,2,35,134,3.8,0,55,299,5.4,7,7,1,15,5,45,1,0,1
942,2018,7,2018-10-20,New Mexico,,Fresno State,L (7-38),15,32,46.9,132,1,33,148,4.5,0,65,280,4.3,8,9,2,19,8,110,0,1,1
943,2018,8,2018-10-27,New Mexico,@,Utah State,L (19-61),18,37,48.6,220,1,30,71,2.4,0,67,291,4.3,10,3,0,13,3,35,1,4,5
944,2018,9,2018-11-03,New Mexico,,San Diego State,L (23-31),9,20,45.0,41,2,37,101,2.7,0,57,142,2.5,3,7,1,11,2,30,0,1,1
945,2018,10,2018-11-10,New Mexico,@,Air Force,L (24-42),13,18,72.2,186,0,36,119,3.3,2,54,305,5.6,5,9,0,14,0,0,1,1,2
946,2018,11,2018-11-16,New Mexico,,Boise State,L (14-45),8,14,57.1,103,0,45,159,3.5,1,59,262,4.4,5,10,0,15,4,41,2,1,3
947,2018,12,2018-11-24,New Mexico,,Wyoming,L (3-31),3,17,17.6,34,0,34,49,1.4,0,51,83,1.6,1,3,2,6,2,20,0,1,1
948,2018,,12 Games,New Mexico,,,,153,288,53.1,2122,21,505,1838,3.6,17,793,3960,5.0,85,110,15,210,56,569,9,17,26
949,2018,1,2018-08-25,New Mexico State,,Wyoming,L (7-29),18,33,54.5,144,1,16,-9,-0.6,0,49,135,2.8,5,2,0,7,12,57,0,0,0
950,2018,2,2018-08-30,New Mexico State,@,Minnesota,L (10-48),29,58,50.0,233,1,20,38,1.9,0,78,271,3.5,10,4,5,19,5,50,0,1,1
951,2018,3,2018-09-08,New Mexico State,@,Utah State,L (13-60),20,37,54.1,171,1,45,109,2.4,0,82,280,3.4,8,11,1,20,6,66,2,3,5
952,2018,4,2018-09-15,New Mexico State,,New Mexico,L (25-42),22,40,55.0,249,1,36,119,3.3,1,76,368,4.8,10,6,6,22,15,114,0,5,5
953,2018,5,2018-09-22,New Mexico State,@,Texas-El Paso,W (27-20),9,18,50.0,156,1,34,155,4.6,0,52,311,6.0,5,6,4,15,8,65,1,0,1
954,2018,6,2018-10-06,New Mexico State,,Liberty,W (49-41),34,51,66.7,402,4,28,173,6.2,3,79,575,7.3,18,6,1,25,8,77,0,0,0
955,2018,7,2018-10-13,New Mexico State,@,Louisiana,L (38-66),25,44,56.8,284,1,25,122,4.9,3,69,406,5.9,15,7,4,26,2,30,1,1,2
956,2018,8,2018-10-20,New Mexico State,,Georgia Southern,L (31-48),25,38,65.8,295,0,35,148,4.2,4,73,443,6.1,12,10,4,26,5,38,2,1,3
957,2018,9,2018-10-27,New Mexico State,@,Texas State,L (20-27),29,59,49.2,275,0,33,153,4.6,1,92,428,4.7,14,5,3,22,6,63,0,2,2
958,2018,10,2018-11-03,New Mexico State,,Alcorn State,W (52-42),32,44,72.7,396,4,29,133,4.6,2,73,529,7.2,14,10,0,24,2,15,1,0,1
959,2018,11,2018-11-17,New Mexico State,@,Brigham Young,L (10-45),25,61,41.0,264,1,26,48,1.8,0,87,312,3.6,12,7,1,20,5,39,1,2,3
960,2018,12,2018-11-24,New Mexico State,@,Liberty,L (21-28),29,54,53.7,313,1,27,83,3.1,0,81,396,4.9,16,4,0,20,2,20,1,1,2
961,2018,,12 Games,New Mexico State,,,,297,537,55.3,3182,16,354,1272,3.6,14,891,4454,5.0,139,78,29,246,76,634,9,16,25
962,2018,1,2018-09-01,North Carolina,@,California,L (17-24),15,35,42.9,137,1,38,164,4.3,1,73,301,4.1,5,10,1,16,13,124,0,4,4
963,2018,2,2018-09-08,North Carolina,@,East Carolina,L (19-41),25,44,56.8,234,0,25,161,6.4,1,69,395,5.7,9,8,2,19,7,65,0,0,0
964,2018,3,2018-09-22,North Carolina,,Pittsburgh,W (38-35),22,31,71.0,313,2,40,173,4.3,3,71,486,6.8,13,9,1,23,5,45,1,0,1
965,2018,4,2018-09-27,North Carolina,@,Miami (FL),L (10-47),20,35,57.1,114,0,40,215,5.4,1,75,329,4.4,8,14,2,24,4,40,3,3,6
966,2018,5,2018-10-13,North Carolina,,Virginia Tech,L (19-22),22,35,62.9,287,1,38,235,6.2,0,73,522,7.2,12,6,3,21,7,35,2,0,2
967,2018,6,2018-10-20,North Carolina,@,Syracuse,L (37-40),34,54,63.0,321,2,41,179,4.4,1,95,500,5.3,14,10,0,24,5,34,1,1,2
968,2018,7,2018-10-27,North Carolina,@,Virginia,L (21-31),22,38,57.9,271,2,22,66,3.0,1,60,337,5.6,11,3,0,14,4,19,1,0,1
969,2018,8,2018-11-03,North Carolina,,Georgia Tech,L (28-38),18,31,58.1,208,1,36,166,4.6,1,67,374,5.6,10,9,0,19,1,10,0,3,3
970,2018,9,2018-11-10,North Carolina,@,Duke,L (35-42),27,43,62.8,221,1,37,315,8.5,4,80,536,6.7,11,14,0,25,10,115,0,0,0
971,2018,10,2018-11-17,North Carolina,,Western Carolina,W (49-26),20,28,71.4,358,3,50,296,5.9,4,78,654,8.4,14,14,2,30,7,85,1,2,3
972,2018,11,2018-11-24,North Carolina,,North Carolina State,L (28-34),19,40,47.5,276,1,35,153,4.4,2,75,429,5.7,10,8,1,19,3,40,0,1,1
973,2018,,11 Games,North Carolina,,,,244,414,58.9,2740,14,402,2123,5.3,19,816,4863,6.0,117,105,12,234,66,612,9,14,23
974,2018,1,2018-09-01,North Carolina State,,James Madison,W (24-13),29,43,67.4,309,2,29,83,2.9,1,72,392,5.4,18,6,1,25,5,50,1,0,1
975,2018,2,2018-09-08,North Carolina State,,Georgia State,W (41-7),32,39,82.1,426,2,31,117,3.8,3,70,543,7.8,19,3,2,24,6,52,0,1,1
976,2018,3,2018-09-22,North Carolina State,@,Marshall,W (37-20),23,40,57.5,377,1,36,125,3.5,2,76,502,6.6,17,6,1,24,4,25,1,0,1
977,2018,4,2018-09-29,North Carolina State,,Virginia,W (35-21),22,32,68.8,257,3,39,176,4.5,1,71,433,6.1,12,10,3,25,7,80,0,0,0
978,2018,5,2018-10-06,North Carolina State,,Boston College,W (28-23),25,34,73.5,308,2,53,225,4.2,2,87,533,6.1,17,14,3,34,1,5,2,2,4
979,2018,6,2018-10-20,North Carolina State,@,Clemson,L (7-41),22,35,62.9,193,0,32,104,3.3,1,67,297,4.4,5,7,4,16,6,49,1,2,3
980,2018,7,2018-10-27,North Carolina State,@,Syracuse,L (41-51),26,44,59.1,473,3,29,68,2.3,2,73,541,7.4,13,6,2,21,9,95,0,1,1
981,2018,8,2018-11-03,North Carolina State,,Florida State,W (47-28),21,28,75.0,240,3,49,177,3.6,2,77,417,5.4,10,10,5,25,4,50,0,0,0
982,2018,9,2018-11-08,North Carolina State,,Wake Forest,L (23-27),35,53,66.0,374,1,27,47,1.7,1,80,421,5.3,18,3,2,23,6,55,0,1,1
983,2018,10,2018-11-17,North Carolina State,@,Louisville,W (52-10),31,42,73.8,354,4,36,164,4.6,3,78,518,6.6,19,9,1,29,2,25,0,0,0
984,2018,11,2018-11-24,North Carolina State,@,North Carolina,W (34-28),16,29,55.2,200,0,48,206,4.3,5,77,406,5.3,10,9,3,22,3,35,0,1,1
985,2018,,11 Games,North Carolina State,,,,282,419,67.3,3511,21,409,1492,3.6,23,828,5003,6.0,158,83,27,268,53,521,5,8,13
986,2018,1,2018-09-01,North Texas,,Southern Methodist,W (46-23),41,51,80.4,461,3,43,68,1.6,0,94,529,5.6,27,5,2,34,5,40,0,0,0
987,2018,2,2018-09-08,North Texas,,Incarnate Word,W (58-16),32,49,65.3,454,4,42,153,3.6,3,91,607,6.7,19,9,4,32,5,61,0,1,1
988,2018,3,2018-09-15,North Texas,@,Arkansas,W (44-17),24,46,52.2,281,1,29,95,3.3,2,75,376,5.0,11,3,4,18,9,102,1,0,1
989,2018,4,2018-09-22,North Texas,@,Liberty,W (47-7),16,27,59.3,185,2,47,346,7.4,5,74,531,7.2,10,15,0,25,4,45,0,0,0
990,2018,5,2018-09-29,North Texas,,Louisiana Tech,L (27-29),22,35,62.9,296,3,37,131,3.5,1,72,427,5.9,13,9,1,23,4,55,2,0,2
991,2018,6,2018-10-06,North Texas,@,Texas-El Paso,W (27-24),23,34,67.6,294,2,35,134,3.8,1,69,428,6.2,12,8,1,21,3,40,0,0,0
992,2018,7,2018-10-13,North Texas,,Southern Mississippi,W (30-7),24,38,63.2,292,1,33,165,5.0,3,71,457,6.4,13,10,1,24,5,55,1,0,1
993,2018,8,2018-10-20,North Texas,@,Alabama-Birmingham,L (21-29),29,40,72.5,336,3,23,64,2.8,0,63,400,6.3,16,3,5,24,4,50,1,0,1
994,2018,9,2018-10-27,North Texas,,Rice,W (41-17),18,35,51.4,333,2,24,164,6.8,3,59,497,8.4,13,9,5,27,2,16,2,0,2
995,2018,10,2018-11-10,North Texas,@,Old Dominion,L (31-34),26,44,59.1,240,2,38,155,4.1,2,82,395,4.8,12,9,2,23,4,60,1,1,2
996,2018,11,2018-11-15,North Texas,,Florida Atlantic,W (41-38),23,35,65.7,303,2,37,208,5.6,3,72,511,7.1,14,8,3,25,4,40,0,2,2
997,2018,12,2018-11-24,North Texas,@,Texas-San Antonio,W (24-21),26,36,72.2,320,2,33,196,5.9,1,69,516,7.5,16,9,1,26,6,60,0,1,1
998,2018,,12 Games,North Texas,,,,304,470,64.7,3795,27,421,1879,4.5,24,891,5674,6.4,176,97,29,302,55,624,8,5,13
999,2018,1,2018-09-01,Northern Arizona,@,Texas-El Paso,W (30-10),19,26,73.1,211,2,35,109,3.1,2,61,320,5.2,9,4,1,14,7,70,0,1,1
1000,2018,1,2018-09-01,Northern Illinois,@,Iowa,L (7-33),15,26,57.7,110,1,36,101,2.8,0,62,211,3.4,6,8,1,15,7,65,1,1,2
1001,2018,2,2018-09-08,Northern Illinois,,Utah,L (6-17),18,33,54.5,111,0,43,117,2.7,0,76,228,3.0,6,8,1,15,4,43,1,1,2
1002,2018,3,2018-09-15,Northern Illinois,,Central Michigan,W (24-16),12,20,60.0,104,3,48,180,3.8,0,68,284,4.2,5,8,2,15,4,44,0,1,1
1003,2018,4,2018-09-22,Northern Illinois,@,Florida State,L (19-37),20,41,48.8,215,2,20,6,0.3,1,61,221,3.6,9,3,1,13,3,15,0,0,0
1004,2018,5,2018-09-29,Northern Illinois,@,Eastern Michigan,W (26-23),20,35,57.1,121,1,62,235,3.8,2,97,356,3.7,5,17,2,24,8,68,1,2,3
1005,2018,6,2018-10-06,Northern Illinois,@,Ball State,W (24-16),18,29,62.1,143,1,43,227,5.3,2,72,370,5.1,10,13,0,23,6,38,0,1,1
1006,2018,7,2018-10-13,Northern Illinois,,Ohio,W (24-21),17,33,51.5,145,0,46,255,5.5,3,79,400,5.1,10,13,2,25,12,109,0,0,0
1007,2018,8,2018-10-27,Northern Illinois,@,Brigham Young,W (7-6),10,21,47.6,115,0,36,89,2.5,1,57,204,3.6,5,4,2,11,10,80,0,0,0
1008,2018,9,2018-11-01,Northern Illinois,@,Akron,W (36-26),21,28,75.0,188,1,61,296,4.9,2,89,484,5.4,12,20,2,34,7,85,1,0,1
1009,2018,10,2018-11-07,Northern Illinois,,Toledo,W (38-15),13,19,68.4,131,1,44,296,6.7,3,63,427,6.8,7,13,0,20,5,58,1,1,2
1010,2018,11,2018-11-14,Northern Illinois,,Miami (OH),L (7-13),15,33,45.5,157,0,37,212,5.7,1,70,369,5.3,6,8,1,15,9,90,1,1,2
1011,2018,12,2018-11-20,Northern Illinois,@,Western Michigan,L (21-28),14,21,66.7,156,1,43,106,2.5,1,64,262,4.1,8,8,0,16,5,45,1,2,3
1012,2018,,12 Games,Northern Illinois,,,,193,339,56.9,1696,11,519,2120,4.1,16,858,3816,4.4,89,123,14,226,80,740,7,10,17
1013,2018,1,2018-08-30,Northwestern,@,Purdue,W (31-27),23,37,62.2,235,0,42,166,4.0,4,79,401,5.1,11,7,4,22,6,56,0,0,0
1014,2018,2,2018-09-08,Northwestern,,Duke,L (7-21),31,56,55.4,282,0,32,99,3.1,1,88,381,4.3,16,5,3,24,2,20,0,2,2
1015,2018,3,2018-09-15,Northwestern,,Akron,L (34-39),37,58,63.8,405,3,36,86,2.4,2,94,491,5.2,19,7,4,30,3,35,1,2,3
1016,2018,4,2018-09-29,Northwestern,,Michigan,L (17-20),16,29,55.2,174,0,34,28,0.8,2,63,202,3.2,7,5,3,15,2,25,0,0,0
1017,2018,5,2018-10-06,Northwestern,@,Michigan State,W (29-19),31,47,66.0,373,3,20,8,0.4,1,67,381,5.7,14,3,2,19,3,35,0,2,2
1018,2018,6,2018-10-13,Northwestern,,Nebraska,W (34-31),41,64,64.1,455,3,23,32,1.4,0,87,487,5.6,21,4,5,30,1,5,0,2,2
1019,2018,7,2018-10-20,Northwestern,@,Rutgers,W (18-15),17,34,50.0,150,0,47,128,2.7,2,81,278,3.4,8,8,4,20,6,49,1,0,1
1020,2018,8,2018-10-27,Northwestern,,Wisconsin,W (31-17),17,30,56.7,167,1,49,182,3.7,3,79,349,4.4,8,9,2,19,3,20,0,3,3
1021,2018,9,2018-11-03,Northwestern,,Notre Dame,L (21-31),16,29,55.2,141,1,40,108,2.7,2,69,249,3.6,10,5,1,16,0,0,0,0,0
1022,2018,10,2018-11-10,Northwestern,@,Iowa,W (14-10),15,30,50.0,122,1,46,184,4.0,1,76,306,4.0,6,12,1,19,5,40,0,2,2
1023,2018,11,2018-11-17,Northwestern,@,Minnesota,W (24-14),15,21,71.4,230,0,39,95,2.4,3,60,325,5.4,11,4,1,16,2,20,0,0,0
1024,2018,12,2018-11-24,Northwestern,,Illinois,W (24-16),12,18,66.7,110,2,44,265,6.0,1,62,375,6.0,6,12,1,19,1,15,0,0,0
1025,2018,,12 Games,Northwestern,,,,271,453,59.8,2844,14,452,1381,3.1,22,905,4225,4.7,137,81,31,249,34,320,2,13,15
1026,2018,1,2018-08-30,Northwestern State,@,Texas A&M,L (7-59),18,35,51.4,230,1,13,21,1.6,0,48,251,5.2,5,2,6,13,11,93,0,0,0
1027,2018,1,2018-09-01,Notre Dame,,Michigan,W (24-17),12,22,54.5,170,1,47,132,2.8,2,69,302,4.4,7,10,4,21,4,40,0,1,1
1028,2018,2,2018-09-08,Notre Dame,,Ball State,W (24-16),17,31,54.8,297,0,39,121,3.1,3,70,418,6.0,13,7,0,20,2,20,0,3,3
1029,2018,3,2018-09-15,Notre Dame,,Vanderbilt,W (22-17),16,26,61.5,135,1,48,245,5.1,1,74,380,5.1,7,14,3,24,6,63,0,0,0
1030,2018,4,2018-09-22,Notre Dame,@,Wake Forest,W (56-27),25,36,69.4,325,2,40,241,6.0,6,76,566,7.4,11,15,2,28,4,37,1,0,1
1031,2018,5,2018-09-29,Notre Dame,,Stanford,W (38-17),24,33,72.7,278,4,55,272,4.9,1,88,550,6.3,16,12,1,29,6,67,0,0,0
1032,2018,6,2018-10-06,Notre Dame,@,Virginia Tech,W (45-23),25,35,71.4,271,2,32,167,5.2,3,67,438,6.5,12,6,1,19,5,19,0,1,1
1033,2018,7,2018-10-13,Notre Dame,,Pittsburgh,W (19-14),26,32,81.3,264,2,38,80,2.1,0,70,344,4.9,12,8,3,23,4,35,0,2,2
1034,2018,8,2018-10-27,Notre Dame,N,Navy,W (44-22),27,33,81.8,330,2,43,254,5.9,4,76,584,7.7,14,13,1,28,3,40,1,1,2
1035,2018,9,2018-11-03,Notre Dame,@,Northwestern,W (31-21),22,34,64.7,343,2,40,121,3.0,2,74,464,6.3,18,7,0,25,8,58,1,0,1
1036,2018,10,2018-11-10,Notre Dame,,Florida State,W (42-13),12,25,48.0,130,3,50,365,7.3,2,75,495,6.6,8,15,1,24,8,74,0,2,2
1037,2018,11,2018-11-17,Notre Dame,N,Syracuse,W (36-3),23,38,60.5,292,2,36,171,4.8,2,74,463,6.3,14,7,2,23,7,55,0,1,1
1038,2018,12,2018-11-24,Notre Dame,@,Southern California,W (24-17),22,39,56.4,352,2,31,121,3.9,1,70,473,6.8,16,6,1,23,3,38,0,1,1
1039,2018,,12 Games,Notre Dame,,,,251,384,65.4,3187,23,499,2290,4.6,27,883,5477,6.2,148,120,19,287,60,546,3,12,15
1040,2018,1,2018-09-01,Ohio,,Howard,W (38-32),19,33,57.6,277,2,39,148,3.8,2,72,425,5.9,11,10,1,22,5,50,0,0,0
1041,2018,2,2018-09-15,Ohio,N,Virginia,L (31-45),16,31,51.6,246,2,30,118,3.9,2,61,364,6.0,9,4,0,13,5,35,2,0,2
1042,2018,3,2018-09-22,Ohio,@,Cincinnati,L (30-34),12,27,44.4,178,1,45,234,5.2,2,72,412,5.7,7,10,8,25,8,85,1,1,2
1043,2018,4,2018-09-29,Ohio,,Massachusetts,W (58-42),23,32,71.9,270,3,44,394,9.0,4,76,664,8.7,15,16,3,34,4,45,0,1,1
1044,2018,5,2018-10-06,Ohio,@,Kent State,W (27-26),18,20,90.0,284,1,38,130,3.4,3,58,414,7.1,13,8,4,25,6,61,3,1,4
1045,2018,6,2018-10-13,Ohio,@,Northern Illinois,L (21-24),15,23,65.2,275,2,32,46,1.4,1,55,321,5.8,9,3,7,19,6,59,2,1,3
1046,2018,7,2018-10-20,Ohio,,Bowling Green State,W (49-14),9,13,69.2,205,4,50,392,7.8,3,63,597,9.5,8,24,0,32,4,29,1,0,1
1047,2018,8,2018-10-25,Ohio,,Ball State,W (52-14),12,22,54.5,143,1,57,411,7.2,6,79,554,7.0,7,21,2,30,3,20,0,1,1
1048,2018,9,2018-11-01,Ohio,@,Western Michigan,W (59-14),13,19,68.4,164,3,41,256,6.2,4,60,420,7.0,10,13,1,24,8,75,0,0,0
1049,2018,10,2018-11-07,Ohio,@,Miami (OH),L (28-30),16,28,57.1,163,2,32,201,6.3,1,60,364,6.1,8,7,1,16,3,43,1,0,1
1050,2018,11,2018-11-14,Ohio,,Buffalo,W (52-17),17,27,63.0,209,3,56,437,7.8,4,83,646,7.8,8,23,1,32,4,55,0,1,1
1051,2018,12,2018-11-23,Ohio,,Akron,W (49-28),5,14,35.7,87,0,51,381,7.5,6,65,468,7.2,4,20,1,25,8,95,0,1,1
1052,2018,,12 Games,Ohio,,,,175,289,60.6,2501,24,515,3148,6.1,38,804,5649,7.0,109,159,29,297,64,652,10,7,17
1053,2018,1,2018-09-01,Ohio State,,Oregon State,W (77-31),25,34,73.5,346,5,52,377,7.3,5,86,723,8.4,14,18,3,35,6,50,1,1,2
1054,2018,2,2018-09-08,Ohio State,,Rutgers,W (52-3),30,33,90.9,354,5,40,225,5.6,2,73,579,7.9,15,12,5,32,11,120,0,0,0
1055,2018,3,2018-09-15,Ohio State,N,Texas Christian,W (40-28),24,38,63.2,344,2,42,182,4.3,1,80,526,6.6,14,13,2,29,5,39,0,0,0
1056,2018,4,2018-09-22,Ohio State,,Tulane,W (49-6),31,38,81.6,419,5,38,151,4.0,2,76,570,7.5,22,8,2,32,10,89,0,0,0
1057,2018,5,2018-09-29,Ohio State,@,Penn State,W (27-26),22,39,56.4,270,3,37,119,3.2,1,76,389,5.1,11,8,2,21,10,105,0,1,1
1058,2018,6,2018-10-06,Ohio State,,Indiana,W (49-26),33,44,75.0,455,6,48,154,3.2,1,92,609,6.6,19,13,1,33,9,82,1,2,3
1059,2018,7,2018-10-13,Ohio State,,Minnesota,W (30-14),33,44,75.0,412,3,32,92,2.9,0,76,504,6.6,20,6,3,29,5,36,0,0,0
1060,2018,8,2018-10-20,Ohio State,@,Purdue,L (20-49),49,73,67.1,470,2,25,76,3.0,0,98,546,5.6,24,4,3,31,10,86,0,1,1
1061,2018,9,2018-11-03,Ohio State,,Nebraska,W (36-31),18,32,56.3,252,2,40,229,5.7,3,72,481,6.7,10,11,2,23,6,46,2,1,3
1062,2018,10,2018-11-10,Ohio State,@,Michigan State,W (26-6),24,39,61.5,227,1,45,120,2.7,1,84,347,4.1,12,8,1,21,4,30,1,0,1
1063,2018,11,2018-11-17,Ohio State,@,Maryland,W (52-51),28,38,73.7,405,3,56,283,5.1,4,94,688,7.3,17,12,7,36,10,79,2,1,3
1064,2018,12,2018-11-24,Ohio State,,Michigan,W (62-39),19,30,63.3,318,5,37,249,6.7,2,67,567,8.5,14,10,4,28,12,150,1,0,1
1065,2018,,12 Games,Ohio State,,,,336,482,69.7,4272,42,492,2257,4.6,22,974,6529,6.7,192,123,35,350,98,912,8,7,15
1066,2018,1,2018-09-01,Oklahoma,,Florida Atlantic,W (63-14),19,23,82.6,334,3,39,316,8.1,5,62,650,10.5,13,12,1,26,6,70,0,0,0
1067,2018,2,2018-09-08,Oklahoma,,UCLA,W (49-21),19,35,54.3,306,3,35,179,5.1,4,70,485,6.9,14,9,4,27,6,40,0,1,1
1068,2018,3,2018-09-15,Oklahoma,@,Iowa State,W (37-27),21,29,72.4,348,3,39,171,4.4,1,68,519,7.6,13,10,1,24,5,60,1,0,1
1069,2018,4,2018-09-22,Oklahoma,,Army,W (28-21),11,15,73.3,165,3,25,190,7.6,1,40,355,8.9,8,10,1,19,4,20,0,1,1
1070,2018,5,2018-09-29,Oklahoma,,Baylor,W (66-33),17,23,73.9,432,6,31,175,5.6,3,54,607,11.2,12,8,2,22,7,80,0,0,0
1071,2018,6,2018-10-06,Oklahoma,N,Texas,L (45-48),20,27,74.1,310,4,31,222,7.2,2,58,532,9.2,12,9,0,21,7,73,2,1,3
1072,2018,7,2018-10-20,Oklahoma,@,Texas Christian,W (52-27),19,25,76.0,213,4,47,323,6.9,3,72,536,7.4,11,15,0,26,8,60,0,0,0
1073,2018,8,2018-10-27,Oklahoma,,Kansas State,W (51-14),22,29,75.9,380,3,39,322,8.3,3,68,702,10.3,15,15,2,32,5,69,0,0,0
1074,2018,9,2018-11-03,Oklahoma,@,Texas Tech,W (51-46),20,35,57.1,360,3,44,323,7.3,4,79,683,8.6,15,16,1,32,10,113,0,2,2
1075,2018,10,2018-11-10,Oklahoma,,Oklahoma State,W (48-47),21,30,70.0,349,1,47,353,7.5,5,77,702,9.1,15,14,0,29,8,70,0,0,0
1076,2018,11,2018-11-17,Oklahoma,,Kansas,W (55-40),21,32,65.6,272,2,38,296,7.8,5,70,568,8.1,15,14,2,31,2,25,1,1,2
1077,2018,12,2018-11-23,Oklahoma,@,West Virginia,W (59-56),20,27,74.1,364,3,35,308,8.8,2,62,672,10.8,14,11,0,25,6,60,1,1,2
1078,2018,,12 Games,Oklahoma,,,,230,330,69.7,3833,38,450,3178,7.1,38,780,7011,9.0,157,143,14,314,74,740,5,7,12
1079,2018,1,2018-08-30,Oklahoma State,,Missouri State,W (58-17),25,37,67.6,296,5,55,436,7.9,3,92,732,8.0,15,15,3,33,7,55,1,1,2
1080,2018,2,2018-09-08,Oklahoma State,,South Alabama,W (55-13),26,42,61.9,453,2,44,164,3.7,4,86,617,7.2,21,7,4,32,9,112,1,2,3
1081,2018,3,2018-09-15,Oklahoma State,,Boise State,W (44-21),16,27,59.3,246,1,38,176,4.6,3,65,422,6.5,9,10,0,19,4,25,0,0,0
1082,2018,4,2018-09-22,Oklahoma State,,Texas Tech,L (17-41),18,38,47.4,258,1,24,128,5.3,1,62,386,6.2,12,6,0,18,8,73,1,1,2
1083,2018,5,2018-09-29,Oklahoma State,@,Kansas,W (48-28),15,20,75.0,312,4,46,256,5.6,2,66,568,8.6,10,14,1,25,8,92,0,1,1
1084,2018,6,2018-10-06,Oklahoma State,,Iowa State,L (42-48),19,33,57.6,289,4,43,126,2.9,2,76,415,5.5,13,8,1,22,9,87,1,1,2
1085,2018,7,2018-10-13,Oklahoma State,@,Kansas State,L (12-31),17,35,48.6,184,0,28,127,4.5,1,63,311,4.9,8,6,1,15,7,70,0,2,2
1086,2018,8,2018-10-27,Oklahoma State,,Texas,W (38-35),23,34,67.6,321,3,51,181,3.5,2,85,502,5.9,14,10,3,27,4,52,0,0,0
1087,2018,9,2018-11-03,Oklahoma State,@,Baylor,L (31-35),25,42,59.5,301,1,47,212,4.5,3,89,513,5.8,16,13,3,32,12,133,1,0,1
1088,2018,10,2018-11-10,Oklahoma State,@,Oklahoma,L (47-48),34,53,64.2,501,3,33,139,4.2,4,86,640,7.4,27,9,3,39,5,31,1,0,1
1089,2018,11,2018-11-17,Oklahoma State,,West Virginia,W (45-41),30,46,65.2,338,5,43,266,6.2,1,89,604,6.8,15,19,1,35,3,35,2,2,4
1090,2018,12,2018-11-24,Oklahoma State,@,Texas Christian,L (24-31),17,40,42.5,181,0,32,99,3.1,3,72,280,3.9,9,5,1,15,6,76,1,1,2
1091,2018,,12 Games,Oklahoma State,,,,265,447,59.3,3680,29,484,2310,4.8,29,931,5990,6.4,169,122,21,312,82,841,9,11,20
1092,2018,1,2018-09-01,Old Dominion,@,Liberty,L (10-52),18,34,52.9,172,0,39,129,3.3,1,73,301,4.1,9,6,3,18,8,75,2,0,2
1093,2018,2,2018-09-08,Old Dominion,,Florida International,L (20-28),19,37,51.4,303,2,27,93,3.4,0,64,396,6.2,11,4,1,16,3,35,0,0,0
1094,2018,3,2018-09-13,Old Dominion,@,UNC Charlotte,L (25-28),16,28,57.1,215,1,28,123,4.4,3,56,338,6.0,9,5,2,16,3,28,0,2,2
1095,2018,4,2018-09-22,Old Dominion,,Virginia Tech,W (49-35),30,50,60.0,495,4,34,137,4.0,3,84,632,7.5,19,7,4,30,2,10,0,0,0
1096,2018,5,2018-09-29,Old Dominion,@,East Carolina,L (35-37),21,36,58.3,250,2,35,21,0.6,2,71,271,3.8,10,3,5,18,5,50,0,1,1
1097,2018,6,2018-10-06,Old Dominion,@,Florida Atlantic,L (33-52),39,51,76.5,390,2,36,118,3.3,3,87,508,5.8,22,8,4,34,3,25,0,2,2
1098,2018,7,2018-10-13,Old Dominion,,Marshall,L (20-42),31,54,57.4,296,2,31,106,3.4,0,85,402,4.7,15,6,4,25,7,70,1,1,2
1099,2018,8,2018-10-20,Old Dominion,@,Western Kentucky,W (37-34),21,33,63.6,327,1,42,181,4.3,3,75,508,6.8,12,13,5,30,9,95,2,0,2
1100,2018,9,2018-10-27,Old Dominion,,Middle Tennessee State,L (17-51),26,35,74.3,333,2,35,187,5.3,0,70,520,7.4,11,9,1,21,9,101,2,3,5
1101,2018,10,2018-11-10,Old Dominion,,North Texas,W (34-31),21,43,48.8,301,2,34,58,1.7,2,77,359,4.7,12,4,3,19,5,45,0,1,1
1102,2018,11,2018-11-17,Old Dominion,,Virginia Military Institute,W (77-14),18,25,72.0,170,2,58,339,5.8,7,83,509,6.1,10,20,2,32,4,27,0,0,0
1103,2018,12,2018-11-24,Old Dominion,@,Rice,L (13-27),33,54,61.1,312,1,26,77,3.0,0,80,389,4.9,16,4,1,21,4,34,1,2,3
1104,2018,,12 Games,Old Dominion,,,,293,480,61.0,3564,21,425,1569,3.7,24,905,5133,5.7,156,89,35,280,62,595,8,12,20
1105,2018,1,2018-09-01,Ole Miss,N,Texas Tech,W (47-27),22,32,68.8,336,2,28,210,7.5,2,60,546,9.1,12,7,3,22,7,49,1,0,1
1106,2018,2,2018-09-08,Ole Miss,,Southern Illinois,W (76-41),24,35,68.6,479,5,32,167,5.2,4,67,646,9.6,17,8,1,26,9,75,0,0,0
1107,2018,3,2018-09-15,Ole Miss,,Alabama,L (7-62),7,22,31.8,133,1,37,115,3.1,0,59,248,4.2,3,5,1,9,8,67,1,2,3
1108,2018,4,2018-09-22,Ole Miss,,Kent State,W (38-17),28,38,73.7,442,2,37,209,5.6,3,75,651,8.7,16,9,1,26,8,90,0,1,1
1109,2018,5,2018-09-29,Ole Miss,@,Louisiana State,L (16-45),19,38,50.0,178,0,31,150,4.8,1,69,328,4.8,8,9,1,18,17,167,0,1,1
1110,2018,6,2018-10-06,Ole Miss,,Louisiana-Monroe,W (70-21),31,34,91.2,517,5,38,309,8.1,5,72,826,11.5,22,12,1,35,7,73,0,0,0
1111,2018,7,2018-10-13,Ole Miss,@,Arkansas,W (37-33),26,35,74.3,387,2,38,224,5.9,3,73,611,8.4,15,15,2,32,4,50,0,1,1
1112,2018,8,2018-10-20,Ole Miss,,Auburn,L (16-31),27,47,57.4,324,1,39,123,3.2,0,86,447,5.2,14,11,2,27,6,35,0,0,0
1113,2018,9,2018-11-03,Ole Miss,,South Carolina,L (44-48),31,48,64.6,379,0,50,237,4.7,5,98,616,6.3,18,14,2,34,4,35,1,0,1
1114,2018,10,2018-11-10,Ole Miss,@,Texas A&M,L (24-38),22,35,62.9,373,1,30,67,2.2,1,65,440,6.8,13,4,2,19,5,48,1,0,1
1115,2018,11,2018-11-17,Ole Miss,@,Vanderbilt,L (29-36),32,52,61.5,457,2,30,121,4.0,0,82,578,7.0,18,7,3,28,10,89,0,2,2
1116,2018,12,2018-11-22,Ole Miss,,Mississippi State,L (3-35),13,25,52.0,152,0,28,47,1.7,0,53,199,3.8,7,4,2,13,3,24,1,2,3
1117,2018,,12 Games,Ole Miss,,,,282,441,63.9,4157,21,418,1979,4.7,24,859,6136,7.1,163,105,21,289,88,802,5,9,14
1118,2018,1,2018-09-01,Oregon,,Bowling Green State,W (58-24),11,26,42.3,292,5,42,212,5.0,2,68,504,7.4,8,11,4,23,3,35,1,2,3
1119,2018,2,2018-09-08,Oregon,,Portland State,W (62-14),23,29,79.3,266,4,47,296,6.3,5,76,562,7.4,14,17,1,32,5,55,0,0,0
1120,2018,3,2018-09-15,Oregon,,San Jose State,W (35-22),16,36,44.4,309,3,49,134,2.7,2,85,443,5.2,12,7,1,20,6,59,0,2,2
1121,2018,4,2018-09-22,Oregon,,Stanford,L (31-38),26,33,78.8,346,1,49,178,3.6,3,82,524,6.4,15,10,2,27,4,32,1,1,2
1122,2018,5,2018-09-29,Oregon,@,California,W (42-24),16,22,72.7,225,2,42,260,6.2,2,64,485,7.6,9,11,1,21,7,72,1,0,1
1123,2018,6,2018-10-13,Oregon,,Washington,W (30-27),18,32,56.3,202,2,49,177,3.6,2,81,379,4.7,11,11,2,24,7,70,1,0,1
1124,2018,7,2018-10-20,Oregon,@,Washington State,L (20-34),25,44,56.8,270,1,23,65,2.8,1,67,335,5.0,13,5,3,21,6,44,0,0,0
1125,2018,8,2018-10-27,Oregon,@,Arizona,L (15-44),24,48,50.0,186,2,23,84,3.7,0,71,270,3.8,12,4,2,18,6,53,2,1,3
1126,2018,9,2018-11-03,Oregon,,UCLA,W (42-21),19,33,57.6,292,2,42,200,4.8,3,75,492,6.6,11,8,1,20,1,15,0,0,0
1127,2018,10,2018-11-10,Oregon,@,Utah,L (25-32),20,33,60.6,288,3,32,117,3.7,0,65,405,6.2,11,5,1,17,7,63,1,0,1
1128,2018,11,2018-11-17,Oregon,,Arizona State,W (31-29),19,34,55.9,262,2,39,199,5.1,2,73,461,6.3,10,10,1,21,6,55,2,2,4
1129,2018,12,2018-11-23,Oregon,@,Oregon State,W (55-15),10,14,71.4,118,1,62,392,6.3,6,76,510,6.7,6,19,1,26,0,0,0,0,0
1130,2018,,12 Games,Oregon,,,,227,384,59.1,3056,28,499,2314,4.6,28,883,5370,6.1,132,118,20,270,58,553,9,8,17
1131,2018,1,2018-09-01,Oregon State,@,Ohio State,L (31-77),14,24,58.3,196,2,39,196,5.0,2,63,392,6.2,7,6,2,15,5,49,2,0,2
1132,2018,2,2018-09-08,Oregon State,,Southern Utah,W (48-25),19,31,61.3,289,1,45,360,8.0,5,76,649,8.5,13,14,0,27,5,70,1,0,1
1133,2018,3,2018-09-15,Oregon State,@,Nevada,L (35-37),35,56,62.5,459,2,40,81,2.0,3,96,540,5.6,17,9,2,28,7,60,1,2,3
1134,2018,4,2018-09-22,Oregon State,,Arizona,L (14-35),18,26,69.2,141,2,44,97,2.2,0,70,238,3.4,7,9,2,18,5,50,0,0,0
1135,2018,5,2018-09-29,Oregon State,@,Arizona State,L (24-52),14,24,58.3,145,1,53,261,4.9,2,77,406,5.3,7,17,0,24,5,50,1,0,1
1136,2018,6,2018-10-06,Oregon State,,Washington State,L (37-56),18,26,69.2,221,0,50,276,5.5,5,76,497,6.5,10,11,1,22,11,104,1,0,1
1137,2018,7,2018-10-20,Oregon State,,California,L (7-49),17,33,51.5,146,0,41,95,2.3,1,74,241,3.3,7,8,3,18,5,43,0,2,2
1138,2018,8,2018-10-27,Oregon State,@,Colorado,W (41-34),34,54,63.0,345,3,45,114,2.5,2,99,459,4.6,20,5,3,28,7,62,0,1,1
1139,2018,9,2018-11-03,Oregon State,,Southern California,L (21-38),31,46,67.4,301,1,32,31,1.0,2,78,332,4.3,17,5,2,24,4,28,0,0,0
1140,2018,10,2018-11-10,Oregon State,@,Stanford,L (17-48),17,35,48.6,236,2,33,168,5.1,0,68,404,5.9,8,9,1,18,6,34,0,1,1
1141,2018,11,2018-11-17,Oregon State,@,Washington,L (23-42),21,36,58.3,229,1,35,134,3.8,1,71,363,5.1,12,8,0,20,3,25,2,0,2
1142,2018,12,2018-11-23,Oregon State,,Oregon,L (15-55),21,39,53.8,282,2,28,54,1.9,0,67,336,5.0,13,5,3,21,0,0,1,3,4
1143,2018,,12 Games,Oregon State,,,,259,430,60.2,2990,17,485,1867,3.8,23,915,4857,5.3,138,106,19,263,63,575,9,9,18
1144,2018,1,2018-09-01,Penn State,,Appalachian State,W (45-38),21,36,58.3,230,1,43,204,4.7,5,79,434,5.5,11,10,3,24,2,10,0,0,0
1145,2018,2,2018-09-08,Penn State,@,Pittsburgh,W (51-6),15,31,48.4,179,3,33,211,6.4,3,64,390,6.1,8,10,5,23,4,45,2,0,2
1146,2018,3,2018-09-15,Penn State,,Kent State,W (63-10),14,25,56.0,346,3,45,297,6.6,6,70,643,9.2,9,14,3,26,9,85,0,1,1
1147,2018,4,2018-09-21,Penn State,@,Illinois,W (63-24),13,20,65.0,204,3,51,387,7.6,6,71,591,8.3,7,20,4,31,8,72,1,1,2
1148,2018,5,2018-09-29,Penn State,,Ohio State,L (26-27),16,32,50.0,286,2,44,206,4.7,1,76,492,6.5,9,9,4,22,7,64,1,0,1
1149,2018,6,2018-10-13,Penn State,,Michigan State,L (17-21),19,32,59.4,192,1,32,205,6.4,1,64,397,6.2,9,5,0,14,6,41,1,0,1
1150,2018,7,2018-10-20,Penn State,@,Indiana,W (33-28),20,37,54.1,243,1,36,174,4.8,3,73,417,5.7,12,8,0,20,3,40,1,1,2
1151,2018,8,2018-10-27,Penn State,,Iowa,W (30-24),13,29,44.8,194,1,35,118,3.4,2,64,312,4.9,10,6,0,16,6,47,1,1,2
1152,2018,9,2018-11-03,Penn State,@,Michigan,L (7-42),8,17,47.1,118,0,30,68,2.3,1,47,186,4.0,5,5,1,11,4,35,1,2,3
1153,2018,10,2018-11-10,Penn State,,Wisconsin,W (22-10),19,25,76.0,160,1,47,183,3.9,1,72,343,4.8,8,13,2,23,3,22,2,0,2
1154,2018,11,2018-11-17,Penn State,@,Rutgers,W (20-7),17,37,45.9,183,2,39,139,3.6,0,76,322,4.2,8,9,2,19,3,43,1,1,2
1155,2018,12,2018-11-24,Penn State,,Maryland,W (38-3),14,24,58.3,255,1,44,310,7.0,4,68,565,8.3,11,13,4,28,3,23,1,0,1
1156,2018,,12 Games,Penn State,,,,189,345,54.8,2590,19,479,2502,5.2,33,824,5092,6.2,107,122,28,257,58,527,12,7,19
1157,2018,1,2018-09-01,Pitt,,Albany,W (33-7),17,23,73.9,169,2,37,238,6.4,2,60,407,6.8,7,14,0,21,6,55,1,1,2
1158,2018,2,2018-09-08,Pitt,,Penn State,L (6-51),9,18,50.0,55,0,52,245,4.7,1,70,300,4.3,1,13,1,15,14,116,2,1,3
1159,2018,3,2018-09-15,Pitt,,Georgia Tech,W (24-19),16,23,69.6,197,0,31,138,4.5,3,54,335,6.2,8,6,2,16,4,38,0,1,1
1160,2018,4,2018-09-22,Pitt,@,North Carolina,L (35-38),19,33,57.6,174,2,36,228,6.3,3,69,402,5.8,8,12,0,20,5,45,1,0,1
1161,2018,5,2018-09-29,Pitt,@,Central Florida,L (14-45),16,26,61.5,163,1,33,109,3.3,0,59,272,4.6,6,8,2,16,11,125,0,1,1
1162,2018,6,2018-10-06,Pitt,,Syracuse,W (44-37),11,20,55.0,137,1,47,265,5.6,3,67,402,6.0,4,13,1,18,3,25,2,1,3
1163,2018,7,2018-10-13,Pitt,@,Notre Dame,L (14-19),19,30,63.3,126,0,30,116,3.9,1,60,242,4.0,6,6,2,14,8,80,0,0,0
1164,2018,8,2018-10-27,Pitt,,Duke,W (54-45),8,19,42.1,150,2,52,484,9.3,4,71,634,8.9,6,22,1,29,4,50,0,0,0
1165,2018,9,2018-11-02,Pitt,@,Virginia,W (23-13),7,14,50.0,61,0,42,254,6.0,3,56,315,5.6,1,12,3,15,7,72,0,0,0
1166,2018,10,2018-11-10,Pitt,,Virginia Tech,W (52-22),7,11,63.6,162,1,36,492,13.7,6,47,654,13.9,4,13,0,17,5,65,1,0,1
1167,2018,11,2018-11-17,Pitt,@,Wake Forest,W (34-13),23,30,76.7,316,3,47,154,3.3,2,77,470,6.1,10,9,1,20,10,78,0,0,0
1168,2018,12,2018-11-24,Pitt,@,Miami (FL),L (3-24),15,24,62.5,131,0,38,69,1.8,0,62,200,3.2,5,4,2,11,10,100,1,0,1
1169,2018,,12 Games,Pitt,,,,167,271,61.6,1841,12,481,2792,5.8,28,752,4633,6.2,66,132,15,212,87,849,8,5,13
1170,2018,1,2018-08-25,Prairie View A&M,@,Rice,L (28-31),16,29,55.2,244,3,27,140,5.2,1,56,384,6.9,10,6,2,18,6,60,1,0,1
1171,2018,2,2018-09-15,Prairie View A&M,@,Nevada-Las Vegas,L (17-46),11,38,28.9,238,2,32,99,3.1,0,70,337,4.8,9,6,0,15,7,75,3,0,3
1172,2018,,2 Games,Prairie View A&M,,,,27,67,40.3,482,5,59,239,4.1,1,126,721,5.7,19,12,2,33,13,135,4,0,4
1173,2018,1,2018-08-30,Purdue,,Northwestern,L (27-31),30,46,65.2,270,1,25,202,8.1,2,71,472,6.6,13,8,2,23,9,95,0,3,3
1174,2018,2,2018-09-08,Purdue,,Eastern Michigan,L (19-20),14,24,58.3,135,1,42,341,8.1,1,66,476,7.2,6,13,0,19,7,85,2,0,2
1175,2018,3,2018-09-15,Purdue,,Missouri,L (37-40),39,55,70.9,572,3,16,42,2.6,1,71,614,8.6,21,2,0,23,7,65,0,1,1
1176,2018,4,2018-09-22,Purdue,,Boston College,W (30-13),21,28,75.0,296,3,41,76,1.9,1,69,372,5.4,10,6,1,17,2,25,2,0,2
1177,2018,5,2018-09-29,Purdue,@,Nebraska,W (42-28),25,42,59.5,328,1,37,188,5.1,4,79,516,6.5,11,10,6,27,10,75,0,0,0
1178,2018,6,2018-10-13,Purdue,@,Illinois,W (46-7),26,37,70.3,384,4,44,227,5.2,2,81,611,7.5,14,11,4,29,5,45,0,1,1
1179,2018,7,2018-10-20,Purdue,,Ohio State,W (49-20),25,43,58.1,378,3,29,161,5.6,3,72,539,7.5,12,9,3,24,7,95,0,0,0
1180,2018,8,2018-10-27,Purdue,@,Michigan State,L (13-23),29,49,59.2,277,0,13,62,4.8,1,62,339,5.5,13,2,1,16,4,30,0,3,3
1181,2018,9,2018-11-03,Purdue,,Iowa,W (38-36),23,32,71.9,333,4,31,101,3.3,1,63,434,6.9,9,10,2,21,6,60,0,2,2
1182,2018,10,2018-11-10,Purdue,@,Minnesota,L (10-41),21,32,65.6,145,1,30,88,2.9,0,62,233,3.8,7,6,1,14,7,81,1,0,1
1183,2018,11,2018-11-17,Purdue,,Wisconsin,L (44-47),31,48,64.6,386,4,31,76,2.5,1,79,462,5.8,16,6,6,28,5,48,1,0,1
1184,2018,12,2018-11-24,Purdue,@,Indiana,W (28-21),27,35,77.1,310,3,32,132,4.1,1,67,442,6.6,14,9,3,26,6,73,0,1,1
1185,2018,,12 Games,Purdue,,,,311,471,66.0,3814,28,371,1696,4.6,18,842,5510,6.5,146,92,29,267,75,777,6,11,17
1186,2018,1,2018-08-25,Rice,,Prairie View A&M,W (31-28),12,24,50.0,87,0,50,310,6.2,3,74,397,5.4,4,16,2,22,7,54,0,0,0
1187,2018,2,2018-09-01,Rice,,Houston,L (27-45),24,41,58.5,292,3,43,147,3.4,0,84,439,5.2,14,5,3,22,6,57,0,1,1
1188,2018,3,2018-09-08,Rice,@,Hawaii,L (29-43),20,33,60.6,299,2,39,147,3.8,1,72,446,6.2,11,8,2,21,5,54,1,1,2
1189,2018,4,2018-09-22,Rice,@,Southern Mississippi,L (22-40),13,26,50.0,125,2,29,137,4.7,1,55,262,4.8,7,5,0,12,3,30,0,2,2
1190,2018,5,2018-09-29,Rice,@,Wake Forest,L (24-56),17,32,53.1,103,2,44,267,6.1,1,76,370,4.9,9,9,1,19,6,55,1,2,3
1191,2018,6,2018-10-06,Rice,,Texas-San Antonio,L (3-20),16,30,53.3,175,0,37,47,1.3,0,67,222,3.3,8,2,1,11,4,20,2,2,4
1192,2018,7,2018-10-13,Rice,,Alabama-Birmingham,L (0-42),13,28,46.4,136,0,37,50,1.4,0,65,186,2.9,7,1,1,9,5,42,1,0,1
1193,2018,8,2018-10-20,Rice,@,Florida International,L (17-36),12,21,57.1,115,0,29,125,4.3,2,50,240,4.8,6,10,0,16,0,0,0,3,3
1194,2018,9,2018-10-27,Rice,@,North Texas,L (17-41),21,37,56.8,204,1,37,95,2.6,1,74,299,4.0,12,6,0,18,8,99,1,0,1
1195,2018,10,2018-11-03,Rice,,Texas-El Paso,L (26-34),17,32,53.1,313,2,28,70,2.5,1,60,383,6.4,10,4,2,16,7,45,1,2,3
1196,2018,11,2018-11-10,Rice,@,Louisiana Tech,L (13-28),19,35,54.3,226,1,29,100,3.4,0,64,326,5.1,8,7,0,15,1,3,0,3,3
1197,2018,12,2018-11-17,Rice,@,Louisiana State,L (10-42),7,15,46.7,101,0,43,97,2.3,1,58,198,3.4,6,8,1,15,3,22,0,0,0
1198,2018,13,2018-11-24,Rice,,Old Dominion,W (27-13),6,14,42.9,96,0,45,275,6.1,4,59,371,6.3,4,10,0,14,3,32,0,0,0
1199,2018,,13 Games,Rice,,,,197,368,53.5,2272,13,490,1867,3.8,15,858,4139,4.8,106,91,13,210,58,513,7,16,23
1200,2018,1,2018-09-01,Richmond,@,Virginia,L (13-42),12,29,41.4,191,0,19,34,1.8,0,48,225,4.7,8,1,0,9,5,69,0,2,2
1201,2018,1,2018-09-01,Rutgers,,Texas State,W (35-7),20,29,69.0,205,1,46,218,4.7,3,75,423,5.6,11,10,2,23,7,50,1,3,4
1202,2018,2,2018-09-08,Rutgers,@,Ohio State,L (3-52),11,30,36.7,65,0,31,69,2.2,0,61,134,2.2,4,4,4,12,7,72,0,2,2
1203,2018,3,2018-09-15,Rutgers,@,Kansas,L (14-55),14,31,45.2,124,0,33,150,4.5,1,64,274,4.3,6,7,1,14,5,60,3,3,6
1204,2018,4,2018-09-22,Rutgers,,Buffalo,L (13-42),18,37,48.6,168,0,38,116,3.1,1,75,284,3.8,7,6,1,14,9,97,0,0,0
1205,2018,5,2018-09-29,Rutgers,,Indiana,L (17-24),19,36,52.8,193,1,23,98,4.3,1,59,291,4.9,10,6,3,19,6,63,0,1,1
1206,2018,6,2018-10-06,Rutgers,,Illinois,L (17-38),29,46,63.0,267,1,30,119,4.0,1,76,386,5.1,14,8,3,25,10,105,0,3,3
1207,2018,7,2018-10-13,Rutgers,@,Maryland,L (7-34),2,17,11.8,8,0,45,171,3.8,1,62,179,2.9,0,11,3,14,4,23,0,5,5
1208,2018,8,2018-10-20,Rutgers,,Northwestern,L (15-18),15,31,48.4,81,0,26,107,4.1,1,57,188,3.3,2,7,1,10,7,60,0,0,0
1209,2018,9,2018-11-03,Rutgers,@,Wisconsin,L (17-31),20,39,51.3,261,1,26,72,2.8,1,65,333,5.1,10,2,1,13,4,50,0,0,0
1210,2018,10,2018-11-10,Rutgers,,Michigan,L (7-42),9,20,45.0,59,0,33,193,5.8,1,53,252,4.8,3,7,1,11,3,30,1,1,2
1211,2018,11,2018-11-17,Rutgers,,Penn State,L (7-20),5,16,31.3,46,0,55,188,3.4,1,71,234,3.3,1,13,3,17,5,62,1,2,3
1212,2018,12,2018-11-24,Rutgers,@,Michigan State,L (10-14),9,18,50.0,109,1,34,110,3.2,0,52,219,4.2,4,5,1,10,8,76,1,2,3
1213,2018,,12 Games,Rutgers,,,,171,350,48.9,1586,5,420,1611,3.8,12,770,3197,4.2,72,86,24,182,75,748,7,22,29
1214,2018,1,2018-09-08,Samford,@,Florida State,L (26-36),39,60,65.0,475,2,19,50,2.6,1,79,525,6.6,18,2,3,23,5,51,1,4,5
1215,2018,1,2018-08-31,San Diego State,@,Stanford,L (10-31),10,15,66.7,113,0,37,150,4.1,1,52,263,5.1,5,6,0,11,11,125,1,0,1
1216,2018,2,2018-09-08,San Diego State,,Sacramento State,W (28-14),17,28,60.7,271,0,45,158,3.5,3,73,429,5.9,15,8,2,25,8,53,0,2,2
1217,2018,3,2018-09-15,San Diego State,,Arizona State,W (28-21),12,24,50.0,129,1,58,311,5.4,2,82,440,5.4,7,18,2,27,9,85,1,0,1
1218,2018,4,2018-09-22,San Diego State,,Eastern Michigan,W (23-20),12,22,54.5,176,2,37,174,4.7,0,59,350,5.9,8,6,1,15,5,56,0,1,1
1219,2018,5,2018-10-06,San Diego State,@,Boise State,W (19-13),8,15,53.3,113,0,44,154,3.5,2,59,267,4.5,4,4,1,9,8,55,2,0,2
1220,2018,6,2018-10-12,San Diego State,,Air Force,W (21-17),9,25,36.0,213,1,34,84,2.5,1,59,297,5.0,8,5,0,13,8,55,0,1,1
1221,2018,7,2018-10-20,San Diego State,,San Jose State,W (16-13),7,11,63.6,86,0,47,207,4.4,1,58,293,5.1,4,10,2,16,8,67,1,0,1
1222,2018,8,2018-10-27,San Diego State,@,Nevada,L (24-28),20,41,48.8,283,3,36,173,4.8,0,77,456,5.9,14,7,3,24,8,68,2,0,2
1223,2018,9,2018-11-03,San Diego State,@,New Mexico,W (31-23),17,25,68.0,240,1,40,161,4.0,3,65,401,6.2,10,6,1,17,9,80,3,0,3
1224,2018,10,2018-11-10,San Diego State,,Nevada-Las Vegas,L (24-27),22,36,61.1,279,2,34,89,2.6,1,70,368,5.3,10,10,1,21,4,45,0,2,2
1225,2018,11,2018-11-17,San Diego State,@,Fresno State,L (14-23),8,21,38.1,218,2,27,64,2.4,0,48,282,5.9,5,2,1,8,6,41,0,0,0
1226,2018,12,2018-11-24,San Diego State,,Hawaii,L (30-31),12,23,52.2,178,2,44,224,5.1,2,67,402,6.0,7,13,1,21,5,38,0,0,0
1227,2018,,12 Games,San Diego State,,,,154,286,53.8,2299,14,483,1949,4.0,16,769,4248,5.5,97,95,15,207,89,768,10,6,16
1228,2018,1,2018-08-30,San Jose State,,California-Davis,L (38-44),28,52,53.8,365,3,38,141,3.7,2,90,506,5.6,17,8,2,27,12,125,1,2,3
1229,2018,2,2018-09-08,San Jose State,@,Washington State,L (0-31),14,28,50.0,100,0,23,9,0.4,0,51,109,2.1,5,2,1,8,9,56,0,1,1
1230,2018,3,2018-09-15,San Jose State,@,Oregon,L (22-35),20,41,48.8,267,1,28,29,1.0,1,69,296,4.3,12,1,3,16,3,25,0,2,2
1231,2018,4,2018-09-29,San Jose State,,Hawaii,L (41-44),28,49,57.1,451,3,37,39,1.1,2,86,490,5.7,17,5,2,24,10,75,0,0,0
1232,2018,5,2018-10-06,San Jose State,,Colorado State,L (30-42),18,43,41.9,237,3,34,48,1.4,1,77,285,3.7,8,6,2,16,6,45,0,2,2
1233,2018,6,2018-10-13,San Jose State,N,Army,L (3-52),13,18,72.2,135,0,30,36,1.2,0,48,171,3.6,7,3,0,10,7,55,4,0,4
1234,2018,7,2018-10-20,San Jose State,@,San Diego State,L (13-16),27,37,73.0,233,0,34,62,1.8,1,71,295,4.2,13,3,2,18,6,52,0,1,1
1235,2018,8,2018-10-27,San Jose State,,Nevada-Las Vegas,W (50-37),26,37,70.3,349,4,40,157,3.9,1,77,506,6.6,18,7,0,25,4,36,0,1,1
1236,2018,9,2018-11-03,San Jose State,@,Wyoming,L (9-24),19,32,59.4,173,1,24,71,3.0,0,56,244,4.4,9,5,1,15,6,45,0,0,0
1237,2018,10,2018-11-10,San Jose State,@,Utah State,L (24-62),22,42,52.4,344,2,20,56,2.8,0,62,400,6.5,12,1,1,14,9,80,1,2,3
1238,2018,11,2018-11-17,San Jose State,,Nevada,L (12-21),18,27,66.7,170,2,26,30,1.2,0,53,200,3.8,10,1,0,11,5,21,0,1,1
1239,2018,12,2018-11-24,San Jose State,@,Fresno State,L (13-31),25,43,58.1,307,2,22,60,2.7,0,65,367,5.6,12,2,2,16,5,40,0,1,1
1240,2018,,12 Games,San Jose State,,,,258,449,57.5,3131,21,356,738,2.1,8,805,3869,4.8,140,44,16,200,82,655,6,13,19
1241,2018,1,2018-09-01,SMU,@,North Texas,L (23-46),12,24,50.0,252,2,19,4,0.2,1,43,256,6.0,7,2,0,9,4,40,0,1,1
1242,2018,2,2018-09-07,SMU,,Texas Christian,L (12-42),18,39,46.2,111,0,33,131,4.0,1,72,242,3.4,3,9,1,13,8,68,1,0,1
1243,2018,3,2018-09-15,SMU,@,Michigan,L (20-45),19,34,55.9,209,3,31,110,3.5,0,65,319,4.9,10,5,7,22,6,60,0,1,1
1244,2018,4,2018-09-22,SMU,,Navy,W (31-30),24,32,75.0,166,3,37,158,4.3,0,69,324,4.7,10,7,0,17,3,16,1,0,1
1245,2018,5,2018-09-29,SMU,,,W (63-27),24,37,64.9,409,4,50,244,4.9,5,87,653,7.5,13,15,2,30,7,71,1,1,2
1246,2018,6,2018-10-06,SMU,@,Central Florida,L (20-48),24,42,57.1,237,2,39,83,2.1,0,81,320,4.0,12,5,4,21,2,15,1,0,1
1247,2018,7,2018-10-20,SMU,@,Tulane,W (27-23),21,40,52.5,291,3,32,36,1.1,1,72,327,4.5,12,3,2,17,7,43,0,1,1
1248,2018,8,2018-10-27,SMU,,Cincinnati,L (20-26),22,43,51.2,328,2,24,23,1.0,0,67,351,5.2,11,0,2,13,7,72,0,1,1
1249,2018,9,2018-11-03,SMU,,Houston,W (45-31),28,44,63.6,318,4,40,196,4.9,2,84,514,6.1,16,9,0,25,2,19,0,0,0
1250,2018,10,2018-11-10,SMU,@,Connecticut,W (62-50),20,30,66.7,279,2,38,316,8.3,6,68,595,8.8,12,9,3,24,6,83,0,0,0
1251,2018,11,2018-11-16,SMU,,Memphis,L (18-28),30,57,52.6,341,2,26,25,1.0,0,83,366,4.4,13,5,7,25,5,33,2,1,3
1252,2018,12,2018-11-24,SMU,@,Tulsa,L (24-27),26,46,56.5,319,1,31,61,2.0,1,77,380,4.9,16,6,2,24,6,30,0,2,2
1253,2018,,12 Games,SMU,,,,268,468,57.3,3260,28,400,1387,3.5,17,868,4647,5.4,135,75,30,240,63,550,6,8,14
1254,2018,1,2018-09-01,South Alabama,,Louisiana Tech,L (26-30),11,23,47.8,91,1,43,217,5.0,3,66,308,4.7,4,10,1,15,7,82,2,2,4
1255,2018,2,2018-09-08,South Alabama,@,Oklahoma State,L (13-55),17,34,50.0,136,1,37,78,2.1,1,71,214,3.0,5,5,5,15,12,85,0,1,1
1256,2018,3,2018-09-15,South Alabama,,Texas State,W (41-31),24,33,72.7,266,2,27,116,4.3,2,60,382,6.4,7,4,2,13,15,143,3,0,3
1257,2018,4,2018-09-22,South Alabama,@,Memphis,L (35-52),24,32,75.0,360,3,36,107,3.0,2,68,467,6.9,11,7,1,19,8,83,2,0,2
1258,2018,5,2018-09-29,South Alabama,@,Appalachian State,L (7-52),20,33,60.6,225,0,35,83,2.4,1,68,308,4.5,10,4,2,16,9,91,0,1,1
1259,2018,6,2018-10-06,South Alabama,@,Georgia Southern,L (13-48),19,31,61.3,197,0,39,129,3.3,1,70,326,4.7,7,7,3,17,10,90,2,2,4
1260,2018,7,2018-10-13,South Alabama,,Alabama State,W (45-7),13,17,76.5,211,2,44,185,4.2,3,61,396,6.5,7,13,1,21,7,75,0,0,0
1261,2018,8,2018-10-23,South Alabama,,Troy,L (17-38),18,30,60.0,275,2,45,110,2.4,0,75,385,5.1,14,8,1,23,7,91,0,3,3
1262,2018,9,2018-11-03,South Alabama,@,Arkansas State,L (14-38),12,22,54.5,93,2,46,156,3.4,0,68,249,3.7,8,7,1,16,6,64,0,0,0
1263,2018,10,2018-11-10,South Alabama,,Louisiana-Monroe,L (10-38),14,23,60.9,129,1,31,89,2.9,0,54,218,4.0,5,5,1,11,5,36,0,0,0
1264,2018,11,2018-11-17,South Alabama,@,Louisiana,L (38-48),18,28,64.3,254,2,57,223,3.9,3,85,477,5.6,10,13,4,27,9,61,2,1,3
1265,2018,12,2018-11-23,South Alabama,,Coastal Carolina,W (31-28),10,13,76.9,202,3,51,331,6.5,1,64,533,8.3,6,13,1,20,12,101,1,0,1
1266,2018,,12 Games,South Alabama,,,,200,319,62.7,2439,19,491,1824,3.7,17,810,4263,5.3,94,96,23,213,107,1002,12,10,22
1267,2018,1,2018-09-01,South Carolina,,Coastal Carolina,W (49-15),25,35,71.4,294,5,37,267,7.2,2,72,561,7.8,15,16,1,32,9,99,0,0,0
1268,2018,2,2018-09-08,South Carolina,,Georgia,L (17-41),31,48,64.6,282,2,20,54,2.7,0,68,336,4.9,16,1,2,19,3,40,0,2,2
1269,2018,3,2018-09-22,South Carolina,@,Vanderbilt,W (37-14),19,28,67.9,261,1,48,273,5.7,3,76,534,7.0,14,12,2,28,8,54,2,1,3
1270,2018,4,2018-09-29,South Carolina,@,Kentucky,L (10-24),17,34,50.0,193,1,35,133,3.8,0,69,326,4.7,8,11,1,20,11,94,1,3,4
1271,2018,5,2018-10-06,South Carolina,,Missouri,W (37-35),20,35,57.1,249,3,47,128,2.7,0,82,377,4.6,13,4,1,18,9,83,1,0,1
1272,2018,6,2018-10-13,South Carolina,,Texas A&M,L (23-26),17,35,48.6,223,3,18,76,4.2,0,53,299,5.6,8,6,5,19,4,39,1,1,2
1273,2018,7,2018-10-27,South Carolina,,Tennessee,W (27-24),11,16,68.8,152,1,40,224,5.6,2,56,376,6.7,6,12,1,19,2,9,0,1,1
1274,2018,8,2018-11-03,South Carolina,@,Mississippi,W (48-44),22,32,68.8,363,2,36,145,4.0,3,68,508,7.5,12,6,0,18,5,51,0,0,0
1275,2018,9,2018-11-10,South Carolina,@,Florida,L (31-35),18,28,64.3,239,2,36,147,4.1,2,64,386,6.0,10,7,1,18,7,41,0,1,1
1276,2018,10,2018-11-17,South Carolina,,Chattanooga,W (49-9),29,36,80.6,364,4,42,238,5.7,3,78,602,7.7,13,17,3,33,6,48,0,0,0
1277,2018,11,2018-11-24,South Carolina,@,Clemson,L (35-56),32,50,64.0,510,5,25,90,3.6,0,75,600,8.0,23,4,2,29,7,48,0,1,1
1278,2018,,11 Games,South Carolina,,,,241,377,63.9,3130,29,384,1775,4.6,15,761,4905,6.4,138,96,19,253,71,606,5,10,15
1279,2018,1,2018-09-01,South Florida,,Elon,W (34-14),29,46,63.0,367,3,38,148,3.9,1,84,515,6.1,17,10,0,27,7,55,0,0,0
1280,2018,2,2018-09-08,South Florida,,Georgia Tech,W (49-38),21,31,67.7,202,2,44,224,5.1,3,75,426,5.7,13,13,3,29,5,36,0,1,1
1281,2018,3,2018-09-15,South Florida,N,Illinois,W (25-19),23,40,57.5,411,2,44,215,4.9,1,84,626,7.5,19,11,1,31,14,124,0,2,2
1282,2018,4,2018-09-22,South Florida,,East Carolina,W (20-13),12,20,60.0,181,1,32,115,3.6,2,52,296,5.7,5,4,0,9,3,33,1,0,1
1283,2018,5,2018-10-06,South Florida,@,Massachusetts,W (58-42),17,24,70.8,209,1,41,365,8.9,5,65,574,8.8,8,9,1,18,11,100,1,1,2
1284,2018,6,2018-10-12,South Florida,@,Tulsa,W (25-24),17,40,42.5,237,0,47,250,5.3,3,87,487,5.6,11,12,3,26,8,70,0,1,1
1285,2018,7,2018-10-20,South Florida,,Connecticut,W (38-30),20,28,71.4,265,1,37,346,9.4,4,65,611,9.4,8,16,0,24,9,90,1,2,3
1286,2018,8,2018-10-27,South Florida,@,Houston,L (36-57),26,39,66.7,263,1,42,204,4.9,3,81,467,5.8,14,13,2,29,8,85,1,1,2
1287,2018,9,2018-11-03,South Florida,,Tulane,L (15-41),29,49,59.2,322,0,33,102,3.1,2,82,424,5.2,17,8,2,27,10,91,2,1,3
1288,2018,10,2018-11-10,South Florida,@,Cincinnati,L (23-35),14,32,43.8,232,3,29,81,2.8,0,61,313,5.1,8,4,0,12,8,80,0,0,0
1289,2018,11,2018-11-17,South Florida,@,Temple,L (17-27),14,23,60.9,82,0,48,184,3.8,2,71,266,3.7,3,10,2,15,7,55,3,2,5
1290,2018,12,2018-11-23,South Florida,,Central Florida,L (10-38),15,29,51.7,113,1,46,221,4.8,0,75,334,4.5,5,11,1,17,4,34,0,1,1
1291,2018,,12 Games,South Florida,,,,237,401,59.1,2884,15,481,2455,5.1,26,882,5339,6.1,128,121,15,264,94,853,9,12,21
1292,2018,1,2018-09-01,Southern,@,Texas Christian,L (7-55),5,18,27.8,101,1,34,84,2.5,0,52,185,3.6,2,5,2,9,5,40,1,2,3
1293,2018,2,2018-09-08,Southern,@,Louisiana Tech,L (17-54),18,25,72.0,216,1,40,70,1.8,1,65,286,4.4,9,7,1,17,6,68,1,0,1
1294,2018,,2 Games,Southern,,,,23,43,53.5,317,2,74,154,2.1,1,117,471,4.0,11,12,3,26,11,108,2,2,4
1295,2018,1,2018-09-08,Southern Illinois,@,Mississippi,L (41-76),30,48,62.5,388,4,45,241,5.4,1,93,629,6.8,15,11,3,29,8,48,1,2,3
1296,2018,1,2018-09-01,Southern Mississippi,,Jackson State,W (55-7),25,33,75.8,255,4,45,202,4.5,1,78,457,5.9,15,13,1,29,4,35,1,2,3
1297,2018,2,2018-09-08,Southern Mississippi,,Louisiana-Monroe,L (20-21),31,46,67.4,378,2,34,58,1.7,0,80,436,5.5,18,4,1,23,4,45,2,2,4
1298,2018,3,2018-09-22,Southern Mississippi,,Rice,W (40-22),25,34,73.5,428,4,31,138,4.5,1,65,566,8.7,16,9,0,25,5,39,0,1,1
1299,2018,4,2018-09-29,Southern Mississippi,@,Auburn,L (13-24),30,44,68.2,215,1,21,45,2.1,0,65,260,4.0,11,2,2,15,7,46,1,2,3
1300,2018,5,2018-10-13,Southern Mississippi,@,North Texas,L (7-30),30,44,68.2,317,1,28,50,1.8,0,72,367,5.1,14,4,2,20,3,32,1,1,2
1301,2018,6,2018-10-20,Southern Mississippi,,Texas-San Antonio,W (27-17),28,33,84.8,269,1,46,218,4.7,2,79,487,6.2,14,10,0,24,7,60,2,1,3
1302,2018,7,2018-10-27,Southern Mississippi,@,UNC Charlotte,L (17-20),27,39,69.2,297,2,34,129,3.8,0,73,426,5.8,14,8,3,25,6,43,0,3,3
1303,2018,8,2018-11-03,Southern Mississippi,,Marshall,W (26-24),16,25,64.0,134,1,45,88,2.0,1,70,222,3.2,4,4,5,13,10,90,2,0,2
1304,2018,9,2018-11-10,Southern Mississippi,@,Alabama-Birmingham,L (23-26),16,39,41.0,160,1,34,5,0.1,1,73,165,2.3,6,5,4,15,8,58,0,1,1
1305,2018,10,2018-11-17,Southern Mississippi,,Louisiana Tech,W (21-20),26,31,83.9,226,1,33,54,1.6,2,64,280,4.4,14,3,2,19,4,38,1,0,1
1306,2018,11,2018-11-24,Southern Mississippi,@,Texas-El Paso,W (39-7),15,21,71.4,126,1,48,252,5.3,3,69,378,5.5,6,15,0,21,2,15,0,0,0
1307,2018,,11 Games,Southern Mississippi,,,,269,389,69.2,2805,19,399,1239,3.1,11,788,4044,5.1,132,77,20,229,60,501,10,13,23
1308,2018,1,2018-08-31,Stanford,,San Diego State,W (31-10),21,31,67.7,332,4,28,50,1.8,0,59,382,6.5,11,3,5,19,3,20,0,1,1
1309,2018,2,2018-09-08,Stanford,,Southern California,W (17-3),16,27,59.3,183,1,29,159,5.5,1,56,342,6.1,9,4,0,13,7,50,0,0,0
1310,2018,3,2018-09-15,Stanford,,California-Davis,W (30-10),17,33,51.5,214,2,33,137,4.2,1,66,351,5.3,10,6,1,17,10,64,0,2,2
1311,2018,4,2018-09-22,Stanford,@,Oregon,W (38-31),19,26,73.1,327,3,24,71,3.0,1,50,398,8.0,13,3,1,17,5,23,0,0,0
1312,2018,5,2018-09-29,Stanford,@,Notre Dame,L (17-38),15,27,55.6,174,1,24,55,2.3,1,51,229,4.5,7,1,2,10,7,50,0,1,1
1313,2018,6,2018-10-06,Stanford,,Utah,L (21-40),26,42,61.9,381,1,28,42,1.5,2,70,423,6.0,18,4,4,26,2,20,2,2,4
1314,2018,7,2018-10-18,Stanford,@,Arizona State,W (20-13),22,29,75.9,231,1,43,127,3.0,1,72,358,5.0,10,8,6,24,5,60,0,0,0
1315,2018,8,2018-10-27,Stanford,,Washington State,L (38-41),34,43,79.1,323,4,23,120,5.2,1,66,443,6.7,16,6,5,27,3,18,1,0,1
1316,2018,9,2018-11-03,Stanford,@,Washington,L (23-27),29,44,65.9,347,2,23,77,3.3,1,67,424,6.3,15,3,4,22,4,28,0,3,3
1317,2018,10,2018-11-10,Stanford,,Oregon State,W (48-17),25,38,65.8,352,4,30,244,8.1,3,68,596,8.8,11,11,2,24,8,70,0,1,1
1318,2018,11,2018-11-24,Stanford,@,UCLA,W (49-42),23,37,62.2,344,5,30,126,4.2,1,67,470,7.0,16,5,3,24,7,64,0,1,1
1319,2018,,11 Games,Stanford,,,,247,377,65.5,3208,28,315,1208,3.8,13,692,4416,6.4,136,54,33,223,61,467,3,11,14
1320,2018,1,2018-08-31,Syracuse,@,Western Michigan,W (55-42),11,28,39.3,226,2,62,334,5.4,5,90,560,6.2,7,17,2,26,5,45,1,0,1
1321,2018,2,2018-09-08,Syracuse,,Wagner,W (62-10),24,37,64.9,241,5,43,215,5.0,2,80,456,5.7,13,13,0,26,5,50,0,1,1
1322,2018,3,2018-09-15,Syracuse,,Florida State,W (30-7),18,31,58.1,219,1,57,222,3.9,2,88,441,5.0,10,11,4,25,8,33,0,0,0
1323,2018,4,2018-09-22,Syracuse,,Connecticut,W (51-21),22,32,68.8,295,2,46,341,7.4,3,78,636,8.2,11,15,0,26,11,100,1,0,1
1324,2018,5,2018-09-29,Syracuse,@,Clemson,L (23-27),26,41,63.4,250,0,26,61,2.3,2,67,311,4.6,8,4,0,12,5,31,0,1,1
1325,2018,6,2018-10-06,Syracuse,@,Pittsburgh,L (37-44),18,38,47.4,195,1,40,189,4.7,3,78,384,4.9,9,10,1,20,5,24,1,2,3
1326,2018,7,2018-10-20,Syracuse,,North Carolina,W (40-37),28,52,53.8,406,3,33,140,4.2,2,85,546,6.4,15,8,2,25,6,53,1,1,2
1327,2018,8,2018-10-27,Syracuse,,North Carolina State,W (51-41),30,42,71.4,480,3,37,81,2.2,3,79,561,7.1,19,5,6,30,9,65,0,0,0
1328,2018,9,2018-11-03,Syracuse,@,Wake Forest,W (41-24),23,35,65.7,157,0,60,264,4.4,5,95,421,4.4,7,15,3,25,9,77,0,0,0
1329,2018,10,2018-11-09,Syracuse,,Louisville,W (54-23),14,27,51.9,192,1,54,344,6.4,5,81,536,6.6,6,13,4,23,7,65,2,1,3
1330,2018,11,2018-11-17,Syracuse,N,Notre Dame,L (3-36),15,35,42.9,115,0,38,119,3.1,0,73,234,3.2,6,9,1,16,3,45,0,3,3
1331,2018,12,2018-11-24,Syracuse,@,Boston College,W (42-21),21,35,60.0,362,3,54,202,3.7,3,89,564,6.3,13,11,4,28,10,90,0,1,1
1332,2018,,12 Games,Syracuse,,,,250,433,57.7,3138,21,550,2512,4.6,35,983,5650,5.7,124,131,27,282,83,678,6,10,16
1333,2018,1,2018-09-01,Temple,,Villanova,L (17-19),19,33,57.6,205,1,22,46,2.1,0,55,251,4.6,10,5,1,16,6,56,0,2,2
1334,2018,2,2018-09-08,Temple,,Buffalo,L (29-36),17,38,44.7,240,3,29,115,4.0,0,67,355,5.3,10,6,0,16,6,65,1,2,3
1335,2018,3,2018-09-15,Temple,@,Maryland,W (35-14),16,28,57.1,264,2,52,165,3.2,2,80,429,5.4,11,9,1,21,4,50,0,1,1
1336,2018,4,2018-09-20,Temple,,Tulsa,W (31-17),8,21,38.1,109,0,36,191,5.3,2,57,300,5.3,4,11,1,16,6,47,0,2,2
1337,2018,5,2018-09-29,Temple,@,Boston College,L (35-45),21,47,44.7,261,0,34,191,5.6,4,81,452,5.6,15,7,2,24,11,95,1,2,3
1338,2018,6,2018-10-06,Temple,,East Carolina,W (49-6),25,30,83.3,297,4,48,173,3.6,2,78,470,6.0,14,11,1,26,6,66,0,1,1
1339,2018,7,2018-10-13,Temple,@,Navy,W (24-17),23,32,71.9,300,1,34,109,3.2,2,66,409,6.2,11,8,2,21,7,63,1,1,2
1340,2018,8,2018-10-20,Temple,,Cincinnati,W (24-17),20,42,47.6,237,3,30,80,2.7,0,72,317,4.4,11,3,2,16,6,60,0,3,3
1341,2018,9,2018-11-01,Temple,@,Central Florida,L (40-52),31,52,59.6,444,4,46,226,4.9,1,98,670,6.8,21,12,2,35,14,149,0,2,2
1342,2018,10,2018-11-10,Temple,@,Houston,W (59-49),15,23,65.2,225,0,55,317,5.8,8,78,542,6.9,11,15,2,28,15,114,1,0,1
1343,2018,11,2018-11-17,Temple,,South Florida,W (27-17),20,35,57.1,264,0,39,74,1.9,1,74,338,4.6,15,2,1,18,7,61,1,1,2
1344,2018,12,2018-11-24,Temple,@,Connecticut,W (57-7),12,15,80.0,223,1,34,312,9.2,4,49,535,10.9,6,12,0,18,4,50,0,1,1
1345,2018,,12 Games,Temple,,,,227,396,57.3,3069,19,459,1999,4.4,26,855,5068,5.9,139,101,15,255,92,876,5,18,23
1346,2018,1,2018-09-01,Tennessee,N,West Virginia,L (14-40),19,25,76.0,172,1,38,129,3.4,1,63,301,4.8,9,9,1,19,6,48,0,0,0
1347,2018,2,2018-09-08,Tennessee,,East Tennessee State,W (59-3),11,16,68.8,224,1,44,190,4.3,5,60,414,6.9,8,10,1,19,3,19,0,0,0
1348,2018,3,2018-09-15,Tennessee,,Texas-El Paso,W (24-0),13,19,68.4,167,1,50,345,6.9,2,69,512,7.4,9,14,1,24,8,65,2,0,2
1349,2018,4,2018-09-22,Tennessee,,Florida,L (21-47),10,25,40.0,208,0,52,161,3.1,2,77,369,4.8,6,6,6,18,6,58,4,2,6
1350,2018,5,2018-09-29,Tennessee,@,Georgia,L (12-38),13,21,61.9,143,2,25,66,2.6,0,46,209,4.5,5,4,2,11,5,25,1,0,1
1351,2018,6,2018-10-13,Tennessee,@,Auburn,W (30-24),21,32,65.6,328,2,35,70,2.0,0,67,398,5.9,12,4,0,16,5,40,0,0,0
1352,2018,7,2018-10-20,Tennessee,,Alabama,L (21-58),14,25,56.0,227,2,30,31,1.0,0,55,258,4.7,9,2,2,13,9,59,1,0,1
1353,2018,8,2018-10-27,Tennessee,@,South Carolina,L (24-27),27,39,69.2,207,2,34,144,4.2,1,73,351,4.8,12,10,1,23,9,75,0,0,0
1354,2018,9,2018-11-03,Tennessee,,UNC Charlotte,W (14-3),16,21,76.2,172,1,26,20,0.8,0,47,192,4.1,7,2,1,10,4,55,0,0,0
1355,2018,10,2018-11-10,Tennessee,,Kentucky,W (24-7),12,20,60.0,197,2,38,219,5.8,1,58,416,7.2,7,8,1,16,4,30,2,0,2
1356,2018,11,2018-11-17,Tennessee,,Missouri,L (17-50),7,21,33.3,173,0,28,82,2.9,2,49,255,5.2,5,3,3,11,6,59,1,2,3
1357,2018,12,2018-11-24,Tennessee,@,Vanderbilt,L (13-38),13,33,39.4,139,1,14,103,7.4,1,47,242,5.1,7,3,2,12,3,25,0,1,1
1358,2018,,12 Games,Tennessee,,,,176,297,59.3,2357,15,414,1560,3.8,15,711,3917,5.5,96,75,21,192,68,558,11,5,16
1359,2018,1,2018-09-29,Tennessee State,@,Vanderbilt,L (27-31),22,31,71.0,269,3,35,104,3.0,1,66,373,5.7,13,7,0,20,8,44,0,0,0
1360,2018,1,2018-09-01,Texas,N,Maryland,L (29-34),21,39,53.8,263,2,36,142,3.9,2,75,405,5.4,10,9,1,20,10,102,1,2,3
1361,2018,2,2018-09-08,Texas,,Tulsa,W (28-21),21,27,77.8,237,2,47,241,5.1,2,74,478,6.5,9,12,3,24,8,65,1,0,1
1362,2018,3,2018-09-15,Texas,,Southern California,W (37-14),16,34,47.1,234,2,48,160,3.3,1,82,394,4.8,11,10,4,25,7,86,1,0,1
1363,2018,4,2018-09-22,Texas,,Texas Christian,W (31-16),22,32,68.8,255,2,45,112,2.5,2,77,367,4.8,14,6,0,20,4,25,0,0,0
1364,2018,5,2018-09-29,Texas,@,Kansas State,W (19-14),30,38,78.9,228,1,27,115,4.3,0,65,343,5.3,14,8,0,22,10,104,0,0,0
1365,2018,6,2018-10-06,Texas,N,Oklahoma,W (48-45),26,37,70.3,324,3,38,177,4.7,3,75,501,6.7,15,9,3,27,6,43,0,0,0
1366,2018,7,2018-10-13,Texas,,Baylor,W (23-17),24,39,61.5,219,1,41,170,4.1,1,80,389,4.9,13,9,3,25,8,56,0,1,1
1367,2018,8,2018-10-27,Texas,@,Oklahoma State,L (35-38),22,42,52.4,283,2,30,119,4.0,3,72,402,5.6,13,8,3,24,11,86,0,0,0
1368,2018,9,2018-11-03,Texas,,West Virginia,L (41-42),25,36,69.4,354,3,39,166,4.3,2,75,520,6.9,15,11,2,28,7,64,1,0,1
1369,2018,10,2018-11-10,Texas,@,Texas Tech,W (41-34),22,34,64.7,312,4,48,157,3.3,1,82,469,5.7,15,10,3,28,6,59,0,0,0
1370,2018,11,2018-11-17,Texas,,Iowa State,W (24-10),22,25,88.0,226,2,46,179,3.9,1,71,405,5.7,10,10,0,20,3,25,1,0,1
1371,2018,12,2018-11-23,Texas,@,Kansas,W (24-17),16,28,57.1,154,2,38,149,3.9,1,66,303,4.6,7,10,2,19,4,35,0,2,2
1372,2018,,12 Games,Texas,,,,267,411,65.0,3089,26,483,1887,3.9,19,894,4976,5.6,146,112,24,282,84,750,5,5,10
1373,2018,1,2018-08-30,Texas A&M,,Northwestern State,W (59-7),23,35,65.7,255,3,61,503,8.2,5,96,758,7.9,14,24,2,40,8,95,1,0,1
1374,2018,2,2018-09-08,Texas A&M,,Clemson,L (26-28),23,40,57.5,430,3,32,71,2.2,0,72,501,7.0,18,4,3,25,5,32,2,0,2
1375,2018,3,2018-09-15,Texas A&M,,Louisiana-Monroe,W (48-10),19,27,70.4,249,1,45,281,6.2,4,72,530,7.4,12,18,2,32,5,55,0,0,0
1376,2018,4,2018-09-22,Texas A&M,@,Alabama,L (23-45),23,44,52.3,263,1,28,130,4.6,1,72,393,5.5,15,5,2,22,4,50,0,2,2
1377,2018,5,2018-09-29,Texas A&M,N,Arkansas,W (24-17),17,26,65.4,201,0,46,176,3.8,2,72,377,5.2,10,11,3,24,7,44,0,2,2
1378,2018,6,2018-10-06,Texas A&M,,Kentucky,W (20-14),18,30,60.0,226,2,45,164,3.6,1,75,390,5.2,9,10,2,21,6,25,1,1,2
1379,2018,7,2018-10-13,Texas A&M,@,South Carolina,W (26-23),25,37,67.6,353,1,40,105,2.6,1,77,458,5.9,15,9,1,25,12,117,0,0,0
1380,2018,8,2018-10-27,Texas A&M,@,Mississippi State,L (13-28),23,46,50.0,232,1,22,61,2.8,0,68,293,4.3,10,4,5,19,7,40,0,1,1
1381,2018,9,2018-11-03,Texas A&M,@,Auburn,L (24-28),16,32,50.0,220,1,47,201,4.3,2,79,421,5.3,11,13,4,28,7,31,1,1,2
1382,2018,10,2018-11-10,Texas A&M,,Mississippi,W (38-24),19,28,67.9,236,3,46,268,5.8,2,74,504,6.8,13,12,2,27,7,59,1,1,2
1383,2018,11,2018-11-17,Texas A&M,,Alabama-Birmingham,W (41-20),11,20,55.0,192,2,34,252,7.4,2,54,444,8.2,9,11,2,22,1,15,1,0,1
1384,2018,12,2018-11-24,Texas A&M,,Louisiana State,W (74-72),23,51,45.1,287,6,56,234,4.2,3,107,521,4.9,14,16,3,33,3,24,1,0,1
1385,2018,,12 Games,Texas A&M,,,,240,416,57.7,3144,24,502,2446,4.9,23,918,5590,6.1,150,137,31,318,72,587,8,8,16
1386,2018,1,2018-09-01,Texas Christian,,Southern,W (55-7),21,32,65.6,264,4,42,235,5.6,2,74,499,6.7,16,12,2,30,5,48,0,0,0
1387,2018,2,2018-09-07,Texas Christian,@,Southern Methodist,W (42-12),15,28,53.6,146,1,42,247,5.9,3,70,393,5.6,5,17,1,23,4,35,1,1,2
1388,2018,3,2018-09-15,Texas Christian,N,Ohio State,L (28-40),24,40,60.0,308,1,36,203,5.6,3,76,511,6.7,13,8,1,22,5,40,1,2,3
1389,2018,4,2018-09-22,Texas Christian,@,Texas,L (16-31),20,39,51.3,231,1,32,141,4.4,0,71,372,5.2,9,7,0,16,3,30,1,3,4
1390,2018,5,2018-09-29,Texas Christian,,Iowa State,W (17-14),21,29,72.4,182,1,46,117,2.5,0,75,299,4.0,10,9,0,19,5,55,2,1,3
1391,2018,6,2018-10-11,Texas Christian,,Texas Tech,L (14-17),26,45,57.8,290,2,32,121,3.8,0,77,411,5.3,12,6,2,20,8,63,1,2,3
1392,2018,7,2018-10-20,Texas Christian,,Oklahoma,L (27-52),10,25,40.0,163,2,30,112,3.7,0,55,275,5.0,6,5,1,12,2,10,0,1,1
1393,2018,8,2018-10-27,Texas Christian,@,Kansas,L (26-27),23,33,69.7,351,1,39,153,3.9,2,72,504,7.0,17,7,3,27,5,57,1,1,2
1394,2018,9,2018-11-03,Texas Christian,,Kansas State,W (14-13),17,33,51.5,218,1,26,57,2.2,1,59,275,4.7,8,5,0,13,2,15,1,0,1
1395,2018,10,2018-11-10,Texas Christian,@,West Virginia,L (10-47),22,37,59.5,229,1,24,-7,-0.3,0,61,222,3.6,9,3,0,12,2,15,2,0,2
1396,2018,11,2018-11-17,Texas Christian,@,Baylor,W (16-9),15,21,71.4,151,1,42,160,3.8,1,63,311,4.9,4,10,0,14,8,80,0,0,0
1397,2018,12,2018-11-24,Texas Christian,,Oklahoma State,W (31-24),16,25,64.0,180,2,45,243,5.4,1,70,423,6.0,8,11,3,22,4,30,1,0,1
1398,2018,,12 Games,Texas Christian,,,,230,387,59.4,2713,18,436,1782,4.1,13,823,4495,5.5,117,100,13,230,53,478,11,11,22
1399,2018,1,2018-09-08,Texas Southern,@,Texas State,L (20-36),21,40,52.5,315,3,20,36,1.8,0,60,351,5.9,9,3,2,13,4,37,1,0,1
1400,2018,2,2018-09-22,Texas Southern,@,Houston,L (14-70),19,43,44.2,278,1,27,60,2.2,1,70,338,4.8,10,6,0,16,9,63,1,0,1
1401,2018,,2 Games,Texas Southern,,,,40,83,48.2,593,4,47,96,2.0,1,130,689,5.3,19,9,2,29,13,100,2,0,2
1402,2018,1,2018-09-01,Texas State,@,Rutgers,L (7-35),9,24,37.5,100,0,30,69,2.3,0,54,169,3.1,5,4,3,12,15,119,2,1,3
1403,2018,2,2018-09-08,Texas State,,Texas Southern,W (36-20),18,29,62.1,243,1,52,304,5.8,1,81,547,6.8,8,19,1,28,8,70,1,0,1
1404,2018,3,2018-09-15,Texas State,@,South Alabama,L (31-41),17,32,53.1,214,2,52,158,3.0,2,84,372,4.4,9,8,3,20,6,50,1,2,3
1405,2018,4,2018-09-22,Texas State,@,Texas-San Antonio,L (21-25),17,28,60.7,222,2,25,26,1.0,1,53,248,4.7,9,4,2,15,5,41,1,2,3
1406,2018,5,2018-10-06,Texas State,,Louisiana,L (27-42),29,41,70.7,301,4,28,124,4.4,0,69,425,6.2,14,7,1,22,3,30,0,0,0
1407,2018,6,2018-10-11,Texas State,,Georgia Southern,L (13-15),14,27,51.9,135,1,32,107,3.3,1,59,242,4.1,7,6,2,15,3,25,1,1,2
1408,2018,7,2018-10-20,Texas State,@,Louisiana-Monroe,L (14-20),15,25,60.0,115,0,36,127,3.5,2,61,242,4.0,6,7,6,19,6,53,0,0,0
1409,2018,8,2018-10-27,Texas State,,New Mexico State,W (27-20),9,18,50.0,113,2,48,230,4.8,2,66,343,5.2,4,9,1,14,10,79,1,0,1
1410,2018,9,2018-11-03,Texas State,@,Georgia State,W (40-31),21,26,80.8,325,2,36,164,4.6,4,62,489,7.9,12,7,0,19,5,32,0,0,0
1411,2018,10,2018-11-10,Texas State,,Appalachian State,L (7-38),19,30,63.3,132,1,31,86,2.8,0,61,218,3.6,8,5,2,15,3,19,2,1,3
1412,2018,11,2018-11-17,Texas State,@,Troy,L (7-12),9,23,39.1,155,0,36,129,3.6,1,59,284,4.8,6,6,1,13,2,10,1,5,6
1413,2018,12,2018-11-24,Texas State,,Arkansas State,L (7-33),16,27,59.3,133,0,40,242,6.1,1,67,375,5.6,6,10,1,17,6,50,1,0,1
1414,2018,,12 Games,Texas State,,,,193,330,58.5,2188,15,446,1766,4.0,15,776,3954,5.1,94,92,23,209,72,578,11,12,23
1415,2018,1,2018-09-01,Texas Tech,N,Mississippi,L (27-47),33,56,58.9,322,1,39,154,3.9,2,95,476,5.0,18,10,2,31,6,80,0,0,0
1416,2018,2,2018-09-08,Texas Tech,,Lamar,W (77-0),30,35,85.7,419,3,51,264,5.2,7,86,683,7.9,20,12,0,32,14,139,0,1,1
1417,2018,3,2018-09-15,Texas Tech,,Houston,W (63-49),43,59,72.9,605,5,41,99,2.4,4,100,704,7.0,25,6,5,36,9,82,1,0,1
1418,2018,4,2018-09-22,Texas Tech,@,Oklahoma State,W (41-17),35,46,76.1,397,2,46,224,4.9,3,92,621,6.8,20,11,4,35,3,20,0,2,2
1419,2018,5,2018-09-29,Texas Tech,,West Virginia,L (34-42),25,47,53.2,295,2,42,168,4.0,2,89,463,5.2,13,13,2,28,7,60,0,3,3
1420,2018,6,2018-10-11,Texas Tech,@,Texas Christian,W (17-14),15,27,55.6,202,1,43,151,3.5,1,70,353,5.0,7,9,1,17,12,89,0,1,1
1421,2018,7,2018-10-20,Texas Tech,,Kansas,W (48-16),39,49,79.6,441,3,35,112,3.2,3,84,553,6.6,21,7,2,30,7,50,2,1,3
1422,2018,8,2018-10-27,Texas Tech,@,Iowa State,L (31-40),33,57,57.9,333,1,24,30,1.3,1,81,363,4.5,20,4,0,24,10,85,0,3,3
1423,2018,9,2018-11-03,Texas Tech,,Oklahoma,L (46-51),30,44,68.2,366,4,27,107,4.0,2,71,473,6.7,15,4,4,23,7,69,0,0,0
1424,2018,10,2018-11-10,Texas Tech,,Texas,L (34-41),38,48,79.2,454,4,33,141,4.3,0,81,595,7.3,22,9,1,32,8,89,2,1,3
1425,2018,11,2018-11-17,Texas Tech,@,Kansas State,L (6-21),19,30,63.3,150,0,26,31,1.2,0,56,181,3.2,8,3,0,11,4,37,2,1,3
1426,2018,12,2018-11-24,Texas Tech,,Baylor,L (24-35),21,37,56.8,247,2,30,100,3.3,1,67,347,5.2,11,7,2,20,8,85,0,2,2
1427,2018,,12 Games,Texas Tech,,,,361,535,67.5,4231,28,437,1581,3.6,26,972,5812,6.0,200,95,23,319,95,885,7,15,22
1428,2018,1,2018-09-01,Toledo,,Virginia Military Institute,W (66-3),22,32,68.8,390,3,45,213,4.7,5,77,603,7.8,16,14,0,30,5,50,0,0,0
1429,2018,2,2018-09-15,Toledo,,Miami (FL),L (24-49),13,23,56.5,222,2,36,112,3.1,1,59,334,5.7,9,8,0,17,5,38,0,1,1
1430,2018,3,2018-09-22,Toledo,,Nevada,W (63-44),16,25,64.0,230,5,46,230,5.0,2,71,460,6.5,11,10,2,23,6,65,1,0,1
1431,2018,4,2018-09-29,Toledo,@,Fresno State,L (27-49),16,31,51.6,238,3,40,137,3.4,0,71,375,5.3,11,7,3,21,3,25,0,1,1
1432,2018,5,2018-10-06,Toledo,,Bowling Green State,W (52-36),17,35,48.6,184,3,44,288,6.5,4,79,472,6.0,10,13,6,29,10,79,0,0,0
1433,2018,6,2018-10-13,Toledo,@,Eastern Michigan,L (26-28),12,27,44.4,147,1,52,229,4.4,2,79,376,4.8,6,14,5,25,16,130,0,1,1
1434,2018,7,2018-10-20,Toledo,,Buffalo,L (17-31),7,21,33.3,137,1,29,158,5.4,1,50,295,5.9,2,4,2,8,12,148,2,2,4
1435,2018,8,2018-10-25,Toledo,@,Western Michigan,W (51-24),18,32,56.3,247,5,35,268,7.7,1,67,515,7.7,13,10,2,25,7,56,0,0,0
1436,2018,9,2018-10-31,Toledo,,Ball State,W (45-13),25,35,71.4,327,2,38,204,5.4,3,73,531,7.3,16,8,3,27,6,45,0,5,5
1437,2018,10,2018-11-07,Toledo,@,Northern Illinois,L (15-38),26,47,55.3,264,1,42,167,4.0,1,89,431,4.8,13,8,3,24,5,30,0,0,0
1438,2018,11,2018-11-15,Toledo,@,Kent State,W (56-34),12,18,66.7,133,2,49,384,7.8,4,67,517,7.7,6,13,2,21,12,140,0,0,0
1439,2018,12,2018-11-23,Toledo,,Central Michigan,W (51-13),14,31,45.2,180,1,49,293,6.0,5,80,473,5.9,9,15,4,28,7,70,3,1,4
1440,2018,,12 Games,Toledo,,,,198,357,55.5,2699,29,505,2683,5.3,29,862,5382,6.2,122,124,32,278,94,876,6,11,17
1441,2018,1,2018-09-01,Troy,,Boise State,L (20-56),24,34,70.6,255,1,44,124,2.8,2,78,379,4.9,13,7,1,21,3,25,3,1,4
1442,2018,2,2018-09-08,Troy,,Florida A&M,W (59-7),22,38,57.9,185,5,41,292,7.1,2,79,477,6.0,10,15,1,26,5,51,0,0,0
1443,2018,3,2018-09-15,Troy,@,Nebraska,W (24-19),14,21,66.7,110,0,34,143,4.2,2,55,253,4.6,4,5,3,12,10,95,1,1,2
1444,2018,4,2018-09-22,Troy,@,Louisiana-Monroe,W (35-27),27,32,84.4,329,3,35,140,4.0,2,67,469,7.0,15,10,2,27,5,32,0,0,0
1445,2018,5,2018-09-29,Troy,,Coastal Carolina,W (45-21),14,19,73.7,185,2,31,282,9.1,3,50,467,9.3,7,9,2,18,6,45,1,1,2
1446,2018,6,2018-10-04,Troy,,Georgia State,W (37-20),19,25,76.0,217,3,37,337,9.1,2,62,554,8.9,9,9,0,18,13,95,0,1,1
1447,2018,7,2018-10-13,Troy,@,Liberty,L (16-22),16,30,53.3,160,1,39,133,3.4,0,69,293,4.2,5,10,2,17,10,65,2,1,3
1448,2018,8,2018-10-23,Troy,@,South Alabama,W (38-17),9,16,56.3,158,3,35,252,7.2,2,51,410,8.0,5,7,4,16,7,67,1,1,2
1449,2018,9,2018-11-03,Troy,,Louisiana,W (26-16),18,22,81.8,317,1,40,110,2.8,1,62,427,6.9,12,8,1,21,9,73,1,0,1
1450,2018,10,2018-11-10,Troy,@,Georgia Southern,W (35-21),23,30,76.7,314,1,42,140,3.3,3,72,454,6.3,13,9,2,24,4,45,1,0,1
1451,2018,11,2018-11-17,Troy,,Texas State,W (12-7),13,27,48.1,79,0,47,141,3.0,0,74,220,3.0,4,9,0,13,4,25,0,0,0
1452,2018,12,2018-11-24,Troy,@,Appalachian State,L (10-21),18,35,51.4,170,1,27,62,2.3,0,62,232,3.7,9,2,2,13,8,59,2,2,4
1453,2018,,12 Games,Troy,,,,217,329,66.0,2479,21,452,2156,4.8,19,781,4635,5.9,106,100,20,226,84,677,12,8,20
1454,2018,1,2018-08-30,Tulane,,Wake Forest,L (17-23),19,38,50.0,283,2,41,153,3.7,0,79,436,5.5,8,9,3,20,9,83,1,0,1
1455,2018,2,2018-09-08,Tulane,,Nicholls State,W (42-17),12,16,75.0,190,1,41,268,6.5,5,57,458,8.0,9,12,1,22,9,78,1,0,1
1456,2018,3,2018-09-15,Tulane,@,Alabama-Birmingham,L (24-31),7,26,26.9,180,2,40,175,4.4,1,66,355,5.4,6,8,3,17,2,25,2,1,3
1457,2018,4,2018-09-22,Tulane,@,Ohio State,L (6-49),10,16,62.5,156,0,41,107,2.6,1,57,263,4.6,8,5,1,14,6,55,0,0,0
1458,2018,5,2018-09-28,Tulane,,Memphis,W (40-24),13,22,59.1,178,1,56,318,5.7,4,78,496,6.4,9,13,0,22,9,95,0,0,0
1459,2018,6,2018-10-06,Tulane,@,Cincinnati,L (21-37),12,31,38.7,132,2,38,134,3.5,1,69,266,3.9,5,7,2,14,12,90,1,0,1
1460,2018,7,2018-10-20,Tulane,,Southern Methodist,L (23-27),14,22,63.6,153,0,46,168,3.7,2,68,321,4.7,7,10,1,18,10,96,2,1,3
1461,2018,8,2018-10-27,Tulane,@,Tulsa,W (24-17),10,19,52.6,92,0,55,312,5.7,3,74,404,5.5,5,9,3,17,8,70,1,0,1
1462,2018,9,2018-11-03,Tulane,@,South Florida,W (41-15),4,11,36.4,61,0,52,365,7.0,5,63,426,6.8,1,15,1,17,7,52,1,0,1
1463,2018,10,2018-11-10,Tulane,,East Carolina,W (24-18),12,28,42.9,372,3,49,163,3.3,0,77,535,6.9,10,7,0,17,8,93,1,0,1
1464,2018,11,2018-11-15,Tulane,@,Houston,L (17-48),10,24,41.7,147,0,43,212,4.9,2,67,359,5.4,6,12,0,18,5,43,1,3,4
1465,2018,12,2018-11-24,Tulane,,Navy,W (29-28),18,29,62.1,291,3,30,131,4.4,1,59,422,7.2,11,7,1,19,2,20,0,1,1
1466,2018,,12 Games,Tulane,,,,141,282,50.0,2235,14,532,2506,4.7,25,814,4741,5.8,85,114,16,215,87,800,11,6,17
1467,2018,1,2018-09-01,Tulsa,,Central Arkansas,W (38-27),15,24,62.5,196,2,63,274,4.3,3,87,470,5.4,6,18,1,25,9,92,1,0,1
1468,2018,2,2018-09-08,Tulsa,@,Texas,L (21-28),13,26,50.0,164,1,38,189,5.0,2,64,353,5.5,7,9,1,17,6,45,0,2,2
1469,2018,3,2018-09-15,Tulsa,,Arkansas State,L (20-29),19,27,70.4,172,1,42,167,4.0,1,69,339,4.9,7,10,2,19,8,64,2,1,3
1470,2018,4,2018-09-20,Tulsa,@,Temple,L (17-31),22,41,53.7,195,0,66,208,3.2,2,107,403,3.8,12,18,2,32,8,73,2,3,5
1471,2018,5,2018-10-04,Tulsa,@,Houston,L (26-41),13,31,41.9,227,1,57,199,3.5,1,88,426,4.8,8,11,0,19,9,85,2,1,3
1472,2018,6,2018-10-12,Tulsa,,South Florida,L (24-25),6,21,28.6,79,1,49,220,4.5,2,70,299,4.3,5,10,1,16,10,81,0,0,0
1473,2018,7,2018-10-20,Tulsa,@,Arkansas,L (0-23),8,25,32.0,127,0,40,133,3.3,0,65,260,4.0,5,9,1,15,4,43,1,1,2
1474,2018,8,2018-10-27,Tulsa,,Tulane,L (17-24),12,26,46.2,180,1,35,135,3.9,1,61,315,5.2,8,8,1,17,8,57,1,0,1
1475,2018,9,2018-11-03,Tulsa,,Connecticut,W (49-19),9,14,64.3,168,4,57,470,8.2,3,71,638,9.0,7,18,0,25,6,60,1,0,1
1476,2018,10,2018-11-10,Tulsa,@,Memphis,L (21-47),14,26,53.8,140,1,41,112,2.7,2,67,252,3.8,9,5,2,16,6,46,1,0,1
1477,2018,11,2018-11-17,Tulsa,@,Navy,L (29-37),19,28,67.9,206,0,44,164,3.7,4,72,370,5.1,11,10,1,22,7,75,1,1,2
1478,2018,12,2018-11-24,Tulsa,,Southern Methodist,W (27-24),21,28,75.0,271,1,46,151,3.3,2,74,422,5.7,12,7,0,19,5,40,0,1,1
1479,2018,,12 Games,Tulsa,,,,171,317,53.9,2125,13,578,2422,4.2,23,895,4547,5.1,97,133,12,242,86,761,12,10,22
1480,2018,1,2018-08-30,UAB,,Savannah State,W (52-0),23,29,79.3,263,2,53,287,5.4,4,82,550,6.7,16,16,4,36,4,55,1,1,2
1481,2018,2,2018-09-08,UAB,@,Coastal Carolina,L (24-47),12,27,44.4,149,0,41,286,7.0,3,68,435,6.4,8,16,2,26,15,143,0,1,1
1482,2018,3,2018-09-15,UAB,,Tulane,W (31-24),12,27,44.4,180,1,56,269,4.8,2,83,449,5.4,8,16,1,25,8,80,0,2,2
1483,2018,4,2018-09-29,UAB,,UNC Charlotte,W (28-7),14,18,77.8,214,1,34,116,3.4,3,52,330,6.3,8,5,1,14,5,80,0,0,0
1484,2018,5,2018-10-06,UAB,@,Louisiana Tech,W (28-7),8,24,33.3,136,1,44,229,5.2,3,68,365,5.4,6,10,0,16,5,50,0,1,1
1485,2018,6,2018-10-13,UAB,@,Rice,W (42-0),11,19,57.9,274,2,45,208,4.6,3,64,482,7.5,8,8,2,18,2,30,0,1,1
1486,2018,7,2018-10-20,UAB,,North Texas,W (29-21),14,22,63.6,189,0,48,203,4.2,3,70,392,5.6,8,11,2,21,7,90,1,0,1
1487,2018,8,2018-10-27,UAB,@,Texas-El Paso,W (19-0),13,23,56.5,92,0,47,265,5.6,2,70,357,5.1,6,15,2,23,6,65,0,1,1
1488,2018,9,2018-11-03,UAB,,Texas-San Antonio,W (52-3),10,17,58.8,249,3,53,419,7.9,4,70,668,9.5,10,19,1,30,11,122,0,1,1
1489,2018,10,2018-11-10,UAB,,Southern Mississippi,W (26-23),14,27,51.9,207,1,43,99,2.3,2,70,306,4.4,9,5,2,16,7,100,0,3,3
1490,2018,11,2018-11-17,UAB,@,Texas A&M,L (20-41),25,39,64.1,306,2,37,111,3.0,1,76,417,5.5,16,9,0,25,6,41,1,2,3
1491,2018,12,2018-11-24,UAB,@,Middle Tennessee State,L (3-27),9,24,37.5,90,0,29,-1,0.0,0,53,89,1.7,4,3,1,8,5,60,0,1,1
1492,2018,,12 Games,UAB,,,,165,296,55.7,2349,13,530,2491,4.7,30,826,4840,5.9,107,133,18,258,81,916,3,14,17
1493,2018,1,2018-08-30,UCF,@,Connecticut,W (56-17),26,34,76.5,356,5,36,296,8.2,3,70,652,9.3,15,14,3,32,3,27,0,0,0
1494,2018,2,2018-09-08,UCF,,South Carolina State,W (38-0),22,43,51.2,250,1,47,316,6.7,4,90,566,6.3,10,18,1,29,11,101,0,3,3
1495,2018,3,2018-09-21,UCF,,Florida Atlantic,W (56-36),21,32,65.6,306,3,50,239,4.8,4,82,545,6.6,14,14,4,32,4,49,0,0,0
1496,2018,4,2018-09-29,UCF,,Pittsburgh,W (45-14),18,34,52.9,328,4,45,240,5.3,2,79,568,7.2,12,13,6,31,8,71,0,0,0
1497,2018,5,2018-10-06,UCF,,Southern Methodist,W (48-20),19,37,51.4,285,2,43,256,6.0,4,80,541,6.8,12,13,0,25,7,75,0,1,1
1498,2018,6,2018-10-13,UCF,@,Memphis,W (31-30),17,29,58.6,296,1,37,165,4.5,3,66,461,7.0,11,6,1,18,12,103,1,0,1
1499,2018,7,2018-10-20,UCF,@,East Carolina,W (37-10),13,21,61.9,111,1,55,316,5.7,2,76,427,5.6,6,14,2,22,14,120,0,0,0
1500,2018,8,2018-11-01,UCF,,Temple,W (52-40),17,33,51.5,312,3,43,318,7.4,4,76,630,8.3,11,18,6,35,8,50,0,1,1
1501,2018,9,2018-11-10,UCF,,Navy,W (35-24),17,21,81.0,200,2,51,300,5.9,3,72,500,6.9,12,16,0,28,3,25,1,0,1
1502,2018,10,2018-11-17,UCF,,Cincinnati,W (38-13),13,25,52.0,268,3,36,134,3.7,2,61,402,6.6,11,7,0,18,5,45,1,0,1
1503,2018,11,2018-11-23,UCF,@,South Florida,W (38-10),10,24,41.7,167,1,58,399,6.9,4,82,566,6.9,9,17,1,27,5,34,0,1,1
1504,2018,,11 Games,UCF,,,,193,333,58.0,2879,26,501,2979,5.9,35,834,5858,7.0,123,150,24,297,80,700,3,6,9
1505,2018,1,2018-09-01,UCLA,,Cincinnati,L (17-26),23,37,62.2,162,0,31,144,4.6,2,68,306,4.5,10,4,1,15,6,26,0,1,1
1506,2018,2,2018-09-08,UCLA,@,Oklahoma,L (21-49),16,26,61.5,254,1,50,129,2.6,2,76,383,5.0,11,9,0,20,6,77,0,0,0
1507,2018,3,2018-09-15,UCLA,,Fresno State,L (14-38),10,24,41.7,151,1,31,119,3.8,1,55,270,4.9,6,5,3,14,11,96,2,2,4
1508,2018,4,2018-09-28,UCLA,@,Colorado,L (16-38),17,35,48.6,138,1,28,151,5.4,0,63,289,4.6,5,8,2,15,8,67,0,0,0
1509,2018,5,2018-10-06,UCLA,,Washington,L (24-31),27,38,71.1,272,2,27,150,5.6,1,65,422,6.5,12,8,0,20,4,45,0,1,1
1510,2018,6,2018-10-13,UCLA,@,California,W (37-7),13,15,86.7,141,0,55,207,3.8,3,70,348,5.0,6,12,2,20,4,30,0,0,0
1511,2018,7,2018-10-20,UCLA,,Arizona,W (31-30),22,35,62.9,307,3,47,153,3.3,1,82,460,5.6,14,6,3,23,12,103,1,0,1
1512,2018,8,2018-10-26,UCLA,,Utah,L (10-41),20,40,50.0,164,0,26,127,4.9,1,66,291,4.4,7,9,1,17,5,40,1,2,3
1513,2018,9,2018-11-03,UCLA,@,Oregon,L (21-42),23,49,46.9,297,2,38,199,5.2,1,87,496,5.7,14,15,0,29,11,64,2,1,3
1514,2018,10,2018-11-10,UCLA,@,Arizona State,L (28-31),26,35,74.3,335,2,29,104,3.6,1,64,439,6.9,17,4,3,24,7,58,0,1,1
1515,2018,11,2018-11-17,UCLA,,Southern California,W (34-27),13,22,59.1,166,1,51,318,6.2,3,73,484,6.6,10,12,3,25,2,15,0,1,1
1516,2018,12,2018-11-24,UCLA,,Stanford,L (42-49),29,47,61.7,466,0,37,62,1.7,4,84,528,6.3,22,6,3,31,6,63,1,1,2
1517,2018,,12 Games,UCLA,,,,239,403,59.3,2853,13,450,1863,4.1,20,853,4716,5.5,134,98,21,253,82,684,7,10,17
1518,2018,1,2018-09-01,USC,,Nevada-Las Vegas,W (43-21),22,35,62.9,282,1,38,219,5.8,3,73,501,6.9,11,10,2,23,6,58,0,0,0
1519,2018,2,2018-09-08,USC,@,Stanford,L (3-17),17,36,47.2,218,0,37,114,3.1,0,73,332,4.5,9,11,0,20,4,35,0,2,2
1520,2018,3,2018-09-15,USC,@,Texas,L (14-37),30,48,62.5,322,0,16,-5,-0.3,2,64,317,5.0,13,2,1,16,10,99,0,1,1
1521,2018,4,2018-09-21,USC,,Washington State,W (39-36),17,26,65.4,241,3,31,113,3.6,2,57,354,6.2,10,6,7,23,8,65,0,0,0
1522,2018,5,2018-09-29,USC,@,Arizona,W (24-20),16,24,66.7,197,0,47,253,5.4,3,71,450,6.3,7,9,2,18,18,169,3,0,3
1523,2018,6,2018-10-13,USC,,Colorado,W (31-20),17,34,50.0,272,3,27,62,2.3,0,61,334,5.5,8,6,2,16,13,123,1,2,3
1524,2018,7,2018-10-20,USC,@,Utah,L (28-41),12,23,52.2,132,2,31,73,2.4,1,54,205,3.8,5,3,2,10,2,20,0,2,2
1525,2018,8,2018-10-27,USC,,Arizona State,L (35-38),21,30,70.0,271,3,33,149,4.5,1,63,420,6.7,11,6,2,19,7,73,1,0,1
1526,2018,9,2018-11-03,USC,@,Oregon State,W (38-21),14,26,53.8,177,1,44,332,7.5,4,70,509,7.3,11,12,2,25,6,52,1,0,1
1527,2018,10,2018-11-10,USC,,California,L (14-15),21,34,61.8,180,2,38,97,2.6,0,72,277,3.8,11,6,1,18,5,55,1,1,2
1528,2018,11,2018-11-17,USC,@,UCLA,L (27-34),20,34,58.8,337,2,27,112,4.1,0,61,449,7.4,12,6,1,19,9,63,0,2,2
1529,2018,12,2018-11-24,USC,,Notre Dame,L (17-24),37,51,72.5,349,1,24,94,3.9,1,75,443,5.9,16,7,1,24,8,71,2,0,2
1530,2018,,12 Games,USC,,,,244,401,60.8,2978,18,393,1613,4.1,17,794,4591,5.8,124,84,23,231,96,883,9,10,19
1531,2018,1,2018-08-30,Utah,,Weber State,W (41-10),26,41,63.4,293,4,36,294,8.2,1,77,587,7.6,12,11,2,25,4,20,3,1,4
1532,2018,2,2018-09-08,Utah,@,Northern Illinois,W (17-6),20,31,64.5,286,0,39,68,1.7,1,70,354,5.1,13,4,2,19,6,60,2,0,2
1533,2018,3,2018-09-15,Utah,,Washington,L (7-21),20,39,51.3,138,0,29,123,4.2,1,68,261,3.8,6,7,0,13,6,55,2,1,3
1534,2018,4,2018-09-29,Utah,@,Washington State,L (24-28),12,21,57.1,118,0,50,204,4.1,3,71,322,4.5,4,11,5,20,9,76,0,0,0
1535,2018,5,2018-10-06,Utah,@,Stanford,W (40-21),17,21,81.0,199,1,43,222,5.2,2,64,421,6.6,8,12,2,22,7,65,0,0,0
1536,2018,6,2018-10-12,Utah,,Arizona,W (42-10),16,22,72.7,265,3,46,230,5.0,3,68,495,7.3,8,12,3,23,9,94,0,1,1
1537,2018,7,2018-10-20,Utah,,Southern California,W (41-28),22,30,73.3,341,4,51,200,3.9,1,81,541,6.7,12,15,0,27,7,69,2,0,2
1538,2018,8,2018-10-26,Utah,@,UCLA,W (41-10),14,22,63.6,145,1,50,325,6.5,4,72,470,6.5,9,17,0,26,5,45,0,1,1
1539,2018,9,2018-11-03,Utah,@,Arizona State,L (20-38),11,26,42.3,147,1,32,178,5.6,1,58,325,5.6,6,9,2,17,3,28,0,3,3
1540,2018,10,2018-11-10,Utah,,Oregon,W (32-25),18,31,58.1,262,0,46,244,5.3,2,77,506,6.6,12,10,2,24,3,25,0,0,0
1541,2018,11,2018-11-17,Utah,@,Colorado,W (30-7),11,23,47.8,221,2,47,169,3.6,1,70,390,5.6,8,11,0,19,5,64,0,0,0
1542,2018,12,2018-11-24,Utah,,Brigham Young,W (35-27),19,28,67.9,141,1,37,155,4.2,3,65,296,4.6,6,11,1,18,1,10,1,0,1
1543,2018,,12 Games,Utah,,,,206,335,61.5,2556,17,506,2412,4.8,23,841,4968,5.9,104,130,19,253,65,611,10,7,17
1544,2018,1,2018-08-31,Utah State,@,Michigan State,L (31-38),29,44,65.9,319,0,25,25,1.0,3,69,344,5.0,18,2,2,22,7,49,0,2,2
1545,2018,2,2018-09-08,Utah State,,New Mexico State,W (60-13),17,31,54.8,172,1,46,274,6.0,3,77,446,5.8,8,11,3,22,10,91,1,1,2
1546,2018,3,2018-09-13,Utah State,,Tennessee Tech,W (73-12),30,35,85.7,291,2,42,330,7.9,7,77,621,8.1,14,15,2,31,6,60,2,0,2
1547,2018,4,2018-09-22,Utah State,,Air Force,W (42-32),26,38,68.4,356,2,24,133,5.5,4,62,489,7.9,19,3,0,22,5,35,2,0,2
1548,2018,5,2018-10-05,Utah State,@,Brigham Young,W (45-20),18,28,64.3,165,4,42,223,5.3,1,70,388,5.5,8,10,1,19,12,125,0,0,0
1549,2018,6,2018-10-13,Utah State,,Nevada-Las Vegas,W (59-28),22,31,71.0,377,5,38,221,5.8,2,69,598,8.7,14,9,1,24,5,55,1,0,1
1550,2018,7,2018-10-20,Utah State,@,Wyoming,W (24-16),12,28,42.9,53,0,33,141,4.3,2,61,194,3.2,1,8,2,11,6,52,0,1,1
1551,2018,8,2018-10-27,Utah State,,New Mexico,W (61-19),30,42,71.4,516,4,49,188,3.8,2,91,704,7.7,19,11,0,30,6,43,3,0,3
1552,2018,9,2018-11-03,Utah State,@,Hawaii,W (56-17),19,24,79.2,175,1,54,426,7.9,7,78,601,7.7,11,17,1,29,12,105,1,0,1
1553,2018,10,2018-11-10,Utah State,,San Jose State,W (62-24),35,50,70.0,510,5,39,296,7.6,3,89,806,9.1,19,11,3,33,10,82,0,0,0
1554,2018,11,2018-11-17,Utah State,@,Colorado State,W (29-24),15,24,62.5,169,1,28,141,5.0,0,52,310,6.0,7,9,0,16,7,71,1,0,1
1555,2018,12,2018-11-24,Utah State,@,Boise State,L (24-33),29,47,61.7,363,3,19,62,3.3,0,66,425,6.4,12,5,1,18,8,72,1,1,2
1556,2018,,12 Games,Utah State,,,,282,422,66.8,3466,28,439,2460,5.6,34,861,5926,6.9,150,111,16,277,94,840,12,5,17
1557,2018,1,2018-09-01,UTEP,,Northern Arizona,L (10-30),15,31,48.4,127,0,36,102,2.8,1,67,229,3.4,6,6,3,15,10,76,1,2,3
1558,2018,2,2018-09-08,UTEP,@,Nevada-Las Vegas,L (24-52),11,29,37.9,123,0,37,265,7.2,3,66,388,5.9,6,13,0,19,8,67,2,1,3
1559,2018,3,2018-09-15,UTEP,@,Tennessee,L (0-24),9,23,39.1,39,0,28,95,3.4,0,51,134,2.6,2,4,1,7,6,42,0,0,0
1560,2018,4,2018-09-22,UTEP,,New Mexico State,L (20-27),10,16,62.5,194,1,64,235,3.7,1,80,429,5.4,8,14,2,24,10,73,2,1,3
1561,2018,5,2018-09-29,UTEP,@,Texas-San Antonio,L (21-30),11,19,57.9,143,1,44,154,3.5,2,63,297,4.7,6,8,1,15,5,41,1,1,2
1562,2018,6,2018-10-06,UTEP,,North Texas,L (24-27),16,33,48.5,313,2,28,104,3.7,1,61,417,6.8,10,7,2,19,4,26,0,2,2
1563,2018,7,2018-10-20,UTEP,@,Louisiana Tech,L (24-31),19,33,57.6,284,1,37,72,1.9,2,70,356,5.1,13,3,2,18,6,60,0,1,1
1564,2018,8,2018-10-27,UTEP,,Alabama-Birmingham,L (0-19),12,20,60.0,101,0,28,19,0.7,0,48,120,2.5,4,3,3,10,6,60,0,0,0
1565,2018,9,2018-11-03,UTEP,@,Rice,W (34-26),14,24,58.3,210,0,45,200,4.4,5,69,410,5.9,10,10,0,20,3,13,1,1,2
1566,2018,10,2018-11-10,UTEP,,Middle Tennessee State,L (32-48),18,39,46.2,218,2,29,115,4.0,2,68,333,4.9,9,5,2,16,1,15,1,2,3
1567,2018,11,2018-11-17,UTEP,@,Western Kentucky,L (16-40),15,34,44.1,342,2,20,50,2.5,0,54,392,7.3,9,2,0,11,3,30,0,5,5
1568,2018,12,2018-11-24,UTEP,,Southern Mississippi,L (7-39),11,23,47.8,114,1,31,73,2.4,0,54,187,3.5,7,4,1,12,2,15,1,3,4
1569,2018,,12 Games,UTEP,,,,161,324,49.7,2208,10,427,1484,3.5,17,751,3692,4.9,90,79,17,186,64,518,9,19,28
1570,2018,1,2018-09-01,UTSA,@,Arizona State,L (7-49),19,43,44.2,218,0,33,3,0.1,1,76,221,2.9,11,5,2,18,5,29,2,1,3
1571,2018,2,2018-09-08,UTSA,,Baylor,L (20-37),18,33,54.5,157,1,26,98,3.8,1,59,255,4.3,11,5,0,16,6,30,0,1,1
1572,2018,3,2018-09-15,UTSA,@,Kansas State,L (17-41),19,34,55.9,157,2,39,143,3.7,0,73,300,4.1,8,8,1,17,7,41,1,0,1
1573,2018,4,2018-09-22,UTSA,,Texas State,W (25-21),19,35,54.3,127,1,41,145,3.5,0,76,272,3.6,8,7,0,15,5,50,1,0,1
1574,2018,5,2018-09-29,UTSA,,Texas-El Paso,W (30-21),20,35,57.1,187,2,24,91,3.8,1,59,278,4.7,10,5,2,17,4,45,1,0,1
1575,2018,6,2018-10-06,UTSA,@,Rice,W (20-3),8,22,36.4,43,0,38,135,3.6,2,60,178,3.0,3,8,0,11,7,55,0,0,0
1576,2018,7,2018-10-13,UTSA,,Louisiana Tech,L (3-31),19,40,47.5,201,0,23,85,3.7,0,63,286,4.5,9,6,1,16,4,47,1,1,2
1577,2018,8,2018-10-20,UTSA,@,Southern Mississippi,L (17-27),12,28,42.9,117,1,26,57,2.2,0,54,174,3.2,5,4,0,9,2,15,0,0,0
1578,2018,9,2018-11-03,UTSA,@,Alabama-Birmingham,L (3-52),15,35,42.9,136,0,26,84,3.2,0,61,220,3.6,6,7,6,19,2,20,1,1,2
1579,2018,10,2018-11-10,UTSA,,Florida International,L (7-45),18,32,56.3,143,1,26,102,3.9,0,58,245,4.2,6,6,3,15,4,23,0,4,4
1580,2018,11,2018-11-17,UTSA,@,Marshall,L (0-23),17,34,50.0,163,0,21,-26,-1.2,0,55,137,2.5,9,0,1,10,10,73,1,1,2
1581,2018,12,2018-11-24,UTSA,,North Texas,L (21-24),20,33,60.6,269,1,30,131,4.4,2,63,400,6.3,11,9,0,20,9,71,0,1,1
1582,2018,,12 Games,UTSA,,,,204,404,50.5,1918,9,353,1048,3.0,7,757,2966,3.9,97,70,16,183,65,499,8,10,18
1583,2018,1,2018-09-01,Vanderbilt,,Middle Tennessee State,W (35-7),10,17,58.8,170,2,37,177,4.8,2,54,347,6.4,8,10,1,19,7,49,0,0,0
1584,2018,2,2018-09-08,Vanderbilt,,Nevada,W (41-10),24,34,70.6,270,2,39,198,5.1,3,73,468,6.4,13,9,3,25,6,44,2,0,2
1585,2018,3,2018-09-15,Vanderbilt,@,Notre Dame,L (17-22),26,43,60.5,326,1,27,94,3.5,1,70,420,6.0,14,5,4,23,5,60,2,1,3
1586,2018,4,2018-09-22,Vanderbilt,,South Carolina,L (14-37),19,40,47.5,192,1,33,92,2.8,1,73,284,3.9,11,9,2,22,4,21,1,1,2
1587,2018,5,2018-09-29,Vanderbilt,,Tennessee State,W (31-27),22,30,73.3,297,3,34,256,7.5,1,64,553,8.6,13,8,2,23,2,15,0,2,2
1588,2018,6,2018-10-06,Vanderbilt,@,Georgia,L (13-41),16,30,53.3,183,0,29,138,4.8,1,59,321,5.4,9,6,3,18,9,69,0,0,0
1589,2018,7,2018-10-13,Vanderbilt,,Florida,L (27-37),18,36,50.0,229,2,22,107,4.9,1,58,336,5.8,9,3,5,17,5,28,0,1,1
1590,2018,8,2018-10-20,Vanderbilt,@,Kentucky,L (7-14),15,23,65.2,216,1,31,68,2.2,0,54,284,5.3,7,4,1,12,5,25,2,0,2
1591,2018,9,2018-10-27,Vanderbilt,@,Arkansas,W (45-31),13,19,68.4,192,2,49,250,5.1,4,68,442,6.5,8,15,2,25,7,60,0,0,0
1592,2018,10,2018-11-10,Vanderbilt,@,Missouri,L (28-33),24,36,66.7,249,3,29,216,7.4,1,65,465,7.2,10,9,0,19,5,45,0,0,0
1593,2018,11,2018-11-17,Vanderbilt,,Mississippi,W (36-29),22,35,62.9,191,3,36,196,5.4,1,71,387,5.5,8,10,3,21,10,83,0,1,1
1594,2018,12,2018-11-24,Vanderbilt,,Tennessee,W (38-13),31,35,88.6,367,3,42,102,2.4,2,77,469,6.1,18,9,2,29,3,43,0,0,0
1595,2018,,12 Games,Vanderbilt,,,,240,378,63.5,2882,23,408,1894,4.6,18,786,4776,6.1,128,97,28,253,68,542,7,6,13
1596,2018,1,2018-09-01,Villanova,@,Temple,W (19-17),29,40,72.5,254,3,37,151,4.1,0,77,405,5.3,14,9,3,26,9,82,0,1,1
1597,2018,1,2018-09-01,Virginia,,Richmond,W (42-13),14,26,53.8,191,2,48,301,6.3,4,74,492,6.6,8,17,0,25,4,24,0,1,1
1598,2018,2,2018-09-08,Virginia,@,Indiana,L (16-20),12,25,48.0,106,2,39,188,4.8,0,64,294,4.6,6,7,2,15,5,56,1,0,1
1599,2018,3,2018-09-15,Virginia,N,Ohio,W (45-31),25,30,83.3,379,3,31,173,5.6,3,61,552,9.0,14,8,1,23,3,20,3,0,3
1600,2018,4,2018-09-22,Virginia,,Louisville,W (27-3),17,26,65.4,197,2,39,204,5.2,1,65,401,6.2,10,9,1,20,3,29,0,1,1
1601,2018,5,2018-09-29,Virginia,@,North Carolina State,L (21-35),20,35,57.1,258,2,29,93,3.2,1,64,351,5.5,10,7,3,20,6,62,0,2,2
1602,2018,6,2018-10-13,Virginia,,Miami (FL),W (16-13),12,21,57.1,92,0,41,139,3.4,1,62,231,3.7,3,12,3,18,6,60,0,3,3
1603,2018,7,2018-10-20,Virginia,@,Duke,W (28-14),21,34,61.8,198,1,44,178,4.0,2,78,376,4.8,12,8,1,21,6,55,0,0,0
1604,2018,8,2018-10-27,Virginia,,North Carolina,W (31-21),18,27,66.7,217,3,44,208,4.7,1,71,425,6.0,11,12,0,23,1,5,0,1,1
1605,2018,9,2018-11-02,Virginia,,Pittsburgh,L (13-23),17,24,70.8,205,1,26,44,1.7,0,50,249,5.0,6,6,1,13,10,80,1,0,1
1606,2018,10,2018-11-10,Virginia,,Liberty,W (45-24),14,22,63.6,168,2,39,221,5.7,3,61,389,6.4,8,15,1,24,1,10,0,1,1
1607,2018,11,2018-11-17,Virginia,@,Georgia Tech,L (27-30),22,28,78.6,273,2,33,130,3.9,1,61,403,6.6,14,10,0,24,4,35,1,0,1
1608,2018,12,2018-11-23,Virginia,@,Virginia Tech,L (31-34),14,29,48.3,259,3,38,164,4.3,1,67,423,6.3,9,11,2,22,7,62,3,0,3
1609,2018,,12 Games,Virginia,,,,206,327,63.0,2543,23,451,2043,4.5,18,778,4586,5.9,111,122,15,248,56,498,9,9,18
1610,2018,1,2018-09-01,Virginia Military Institute,@,Toledo,L (3-66),29,47,61.7,174,0,30,48,1.6,0,77,222,2.9,7,5,2,14,3,11,1,2,3
1611,2018,2,2018-11-17,Virginia Military Institute,@,Old Dominion,L (14-77),18,42,42.9,216,1,26,72,2.8,1,68,288,4.2,10,2,3,15,3,40,2,2,4
1612,2018,,2 Games,Virginia Military Institute,,,,47,89,52.8,390,1,56,120,2.1,1,145,510,3.5,17,7,5,29,6,51,3,4,7
1613,2018,1,2018-09-03,Virginia Tech,@,Florida State,W (24-3),16,26,61.5,207,2,37,112,3.0,0,63,319,5.1,8,7,0,15,5,55,0,0,0
1614,2018,2,2018-09-08,Virginia Tech,,William & Mary,W (62-17),16,23,69.6,281,1,46,305,6.6,7,69,586,8.5,14,16,2,32,2,20,1,0,1
1615,2018,3,2018-09-22,Virginia Tech,@,Old Dominion,L (35-49),17,34,50.0,282,3,49,318,6.5,2,83,600,7.2,11,15,0,26,7,95,0,1,1
1616,2018,4,2018-09-29,Virginia Tech,@,Duke,W (31-14),17,28,60.7,332,3,41,81,2.0,1,69,413,6.0,13,4,0,17,4,26,0,0,0
1617,2018,5,2018-10-06,Virginia Tech,,Notre Dame,L (23-45),31,52,59.6,309,2,33,132,4.0,0,85,441,5.2,18,6,1,25,6,41,1,1,2
1618,2018,6,2018-10-13,Virginia Tech,@,North Carolina,W (22-19),20,36,55.6,221,2,41,154,3.8,1,77,375,4.9,12,8,0,20,8,59,0,2,2
1619,2018,7,2018-10-25,Virginia Tech,,Georgia Tech,L (28-49),15,22,68.2,201,2,25,122,4.9,2,47,323,6.9,8,7,1,16,8,87,1,0,1
1620,2018,8,2018-11-03,Virginia Tech,,Boston College,L (21-31),25,43,58.1,281,3,36,111,3.1,0,79,392,5.0,14,8,1,23,8,59,1,1,2
1621,2018,9,2018-11-10,Virginia Tech,@,Pittsburgh,L (22-52),23,38,60.5,240,3,48,192,4.0,0,86,432,5.0,10,15,3,28,3,34,0,0,0
1622,2018,10,2018-11-17,Virginia Tech,,Miami (FL),L (14-38),18,36,50.0,216,1,33,119,3.6,1,69,335,4.9,12,8,2,22,3,35,1,2,3
1623,2018,11,2018-11-23,Virginia Tech,,Virginia,W (34-31),14,34,41.2,199,1,45,254,5.6,2,79,453,5.7,7,13,1,21,7,70,0,2,2
1624,2018,,11 Games,Virginia Tech,,,,212,372,57.0,2769,23,434,1900,4.4,16,806,4669,5.8,127,107,11,245,61,581,5,9,14
1625,2018,1,2018-08-30,Wake Forest,@,Tulane,W (23-17),31,51,60.8,378,2,43,170,4.0,1,94,548,5.8,20,10,2,32,6,70,1,2,3
1626,2018,2,2018-09-08,Wake Forest,,Towson,W (51-20),17,27,63.0,242,2,54,340,6.3,2,81,582,7.2,13,16,3,32,0,0,1,1,2
1627,2018,3,2018-09-13,Wake Forest,,Boston College,L (34-41),20,45,44.4,214,2,60,298,5.0,1,105,512,4.9,10,16,1,27,3,35,0,2,2
1628,2018,4,2018-09-22,Wake Forest,,Notre Dame,L (27-56),16,31,51.6,139,0,61,259,4.2,3,92,398,4.3,9,15,3,27,3,23,0,1,1
1629,2018,5,2018-09-29,Wake Forest,,Rice,W (56-24),17,20,85.0,243,4,41,171,4.2,2,61,414,6.8,8,9,3,20,3,25,1,1,2
1630,2018,6,2018-10-06,Wake Forest,,Clemson,L (3-63),7,27,25.9,74,0,51,175,3.4,0,78,249,3.2,4,7,0,11,5,55,0,1,1
1631,2018,7,2018-10-20,Wake Forest,@,Florida State,L (17-38),26,56,46.4,261,2,51,119,2.3,0,107,380,3.6,14,10,1,25,5,65,0,1,1
1632,2018,8,2018-10-27,Wake Forest,@,Louisville,W (56-35),16,24,66.7,223,2,48,368,7.7,5,72,591,8.2,10,18,0,28,3,35,0,0,0
1633,2018,9,2018-11-03,Wake Forest,,Syracuse,L (24-41),21,37,56.8,275,2,44,159,3.6,1,81,434,5.4,12,10,4,26,10,95,2,1,3
1634,2018,10,2018-11-08,Wake Forest,@,North Carolina State,W (27-23),22,33,66.7,297,3,38,138,3.6,0,71,435,6.1,11,10,1,22,5,50,1,0,1
1635,2018,11,2018-11-17,Wake Forest,,Pittsburgh,L (13-34),15,30,50.0,206,1,28,79,2.8,0,58,285,4.9,9,6,1,16,1,15,0,2,2
1636,2018,12,2018-11-24,Wake Forest,@,Duke,W (59-7),18,23,78.3,177,4,57,340,6.0,3,80,517,6.5,9,19,1,29,4,30,0,0,0
1637,2018,,12 Games,Wake Forest,,,,226,404,55.9,2729,24,576,2616,4.5,18,980,5345,5.5,129,146,20,295,48,498,6,12,18
1638,2018,1,2018-09-01,Washington,N,Auburn,L (16-21),18,32,56.3,296,1,33,102,3.1,0,65,398,6.1,12,8,4,24,10,95,1,1,2
1639,2018,2,2018-09-08,Washington,,North Dakota,W (45-3),31,45,68.9,437,3,34,195,5.7,2,79,632,8.0,17,8,0,25,5,45,0,2,2
1640,2018,3,2018-09-15,Washington,@,Utah,W (21-7),14,24,58.3,155,1,41,172,4.2,2,65,327,5.0,10,6,2,18,5,35,0,1,1
1641,2018,4,2018-09-22,Washington,,Arizona State,W (27-20),15,23,65.2,202,3,39,171,4.4,0,62,373,6.0,11,12,3,26,3,30,0,1,1
1642,2018,5,2018-09-29,Washington,,Brigham Young,W (35-7),23,25,92.0,277,1,37,187,5.1,4,62,464,7.5,15,10,1,26,5,40,1,0,1
1643,2018,6,2018-10-06,Washington,@,UCLA,W (31-24),18,26,69.2,265,1,55,197,3.6,3,81,462,5.7,11,13,2,26,1,10,0,1,1
1644,2018,7,2018-10-13,Washington,@,Oregon,L (27-30),15,25,60.0,243,1,45,194,4.3,2,70,437,6.2,13,7,2,22,5,38,0,1,1
1645,2018,8,2018-10-20,Washington,,Colorado,W (27-13),15,25,60.0,150,1,40,201,5.0,2,65,351,5.4,8,12,3,23,3,45,1,1,2
1646,2018,9,2018-10-27,Washington,@,California,L (10-12),12,25,48.0,159,1,33,91,2.8,0,58,250,4.3,8,4,1,13,4,18,0,2,2
1647,2018,10,2018-11-03,Washington,,Stanford,W (27-23),16,27,59.3,194,1,45,177,3.9,2,72,371,5.2,11,6,2,19,8,85,0,0,0
1648,2018,11,2018-11-17,Washington,,Oregon State,W (42-23),18,25,72.0,228,3,42,275,6.5,3,67,503,7.5,11,10,1,22,4,40,0,0,0
1649,2018,12,2018-11-23,Washington,@,Washington State,W (28-15),12,15,80.0,229,1,44,258,5.9,3,59,487,8.3,7,13,0,20,6,47,2,1,3
1650,2018,,12 Games,Washington,,,,207,317,65.3,2835,18,488,2220,4.5,23,805,5055,6.3,134,109,21,264,59,528,5,11,16
1651,2018,1,2018-09-01,Washington State,@,Wyoming,W (41-19),38,57,66.7,319,3,21,75,3.6,2,78,394,5.1,15,5,4,24,10,75,1,1,2
1652,2018,2,2018-09-08,Washington State,,San Jose State,W (31-0),35,54,64.8,420,3,31,124,4.0,1,85,544,6.4,14,7,2,27,8,60,0,3,3
1653,2018,3,2018-09-15,Washington State,,Eastern Washington,W (59-24),51,65,78.5,524,3,15,41,2.7,4,80,565,7.1,32,1,2,35,7,87,0,0,0
1654,2018,4,2018-09-21,Washington State,@,Southern California,L (36-39),37,52,71.2,344,3,24,91,3.8,2,76,435,5.7,19,4,1,24,11,118,0,0,0
1655,2018,5,2018-09-29,Washington State,,Utah,W (28-24),31,56,55.4,445,3,10,13,1.3,1,66,458,6.9,16,1,4,21,9,104,0,1,1
1656,2018,6,2018-10-06,Washington State,@,Oregon State,W (56-37),30,40,75.0,430,5,22,100,4.5,2,62,530,8.5,18,6,0,24,5,46,1,0,1
1657,2018,7,2018-10-20,Washington State,,Oregon,W (34-20),39,51,76.5,323,4,24,77,3.2,1,75,400,5.3,19,5,1,25,5,55,0,2,2
1658,2018,8,2018-10-27,Washington State,@,Stanford,W (41-38),40,50,80.0,438,3,19,59,3.1,2,69,497,7.2,19,4,1,24,9,89,0,0,0
1659,2018,9,2018-11-03,Washington State,,California,W (19-13),35,51,68.6,334,1,15,79,5.3,1,66,413,6.3,19,4,0,23,7,80,1,1,2
1660,2018,10,2018-11-10,Washington State,@,Colorado,W (31-7),37,61,60.7,346,2,33,131,4.0,2,94,477,5.1,17,7,2,26,2,10,0,0,0
1661,2018,11,2018-11-17,Washington State,,Arizona,W (69-28),44,56,78.6,482,7,23,123,5.3,2,79,605,7.7,20,6,5,31,3,35,0,0,0
1662,2018,12,2018-11-23,Washington State,,Washington,L (15-28),26,35,74.3,152,0,24,85,3.5,2,59,237,4.0,8,6,1,15,4,21,0,2,2
1663,2018,,12 Games,Washington State,,,,443,628,70.5,4557,37,261,998,3.8,22,889,5555,6.2,216,56,23,299,80,780,3,10,13
1664,2018,1,2018-09-01,West Virginia,N,Tennessee,W (40-14),25,34,73.5,429,5,27,118,4.4,0,61,547,9.0,18,6,2,26,4,35,1,0,1
1665,2018,2,2018-09-08,West Virginia,,Youngstown State,W (52-17),22,29,75.9,336,4,46,289,6.3,3,75,625,8.3,17,11,1,29,12,114,0,1,1
1666,2018,3,2018-09-22,West Virginia,,Kansas State,W (35-6),25,36,69.4,356,5,28,108,3.9,0,64,464,7.3,16,3,1,20,3,35,1,3,4
1667,2018,4,2018-09-29,West Virginia,@,Texas Tech,W (42-34),27,41,65.9,370,3,32,119,3.7,2,73,489,6.7,15,8,3,26,12,115,0,0,0
1668,2018,5,2018-10-06,West Virginia,,Kansas,W (38-22),28,41,68.3,332,4,39,177,4.5,1,80,509,6.4,14,15,0,29,7,50,1,3,4
1669,2018,6,2018-10-13,West Virginia,@,Iowa State,L (14-30),11,15,73.3,100,1,27,52,1.9,0,42,152,3.6,2,7,0,9,9,103,0,1,1
1670,2018,7,2018-10-25,West Virginia,,Baylor,W (58-14),21,31,67.7,396,4,33,172,5.2,3,64,568,8.9,13,5,4,22,6,64,0,0,0
1671,2018,8,2018-11-03,West Virginia,@,Texas,W (42-41),28,42,66.7,346,3,33,232,7.0,2,75,578,7.7,16,9,3,28,14,120,0,0,0
1672,2018,9,2018-11-10,West Virginia,,Texas Christian,W (47-10),26,41,63.4,371,3,40,164,4.1,3,81,535,6.6,15,11,0,26,2,15,1,1,2
1673,2018,10,2018-11-17,West Virginia,@,Oklahoma State,L (41-45),27,48,56.3,364,2,43,189,4.4,3,91,553,6.1,17,7,1,25,5,24,1,0,1
1674,2018,11,2018-11-23,West Virginia,,Oklahoma,L (56-59),32,49,65.3,539,4,41,165,4.0,4,90,704,7.8,20,10,3,33,5,60,2,0,2
1675,2018,,11 Games,West Virginia,,,,272,407,66.8,3939,38,389,1785,4.6,21,796,5724,7.2,163,92,18,273,79,735,7,9,16
1676,2018,1,2018-11-17,Western Carolina,@,North Carolina,L (26-49),19,36,52.8,300,0,34,133,3.9,2,70,433,6.2,12,7,5,24,7,50,2,0,2
1677,2018,1,2018-08-31,Western Kentucky,@,Wisconsin,L (3-34),17,30,56.7,181,0,34,124,3.6,0,64,305,4.8,8,6,1,15,6,65,1,1,2
1678,2018,2,2018-09-08,Western Kentucky,,Maine,L (28-31),23,41,56.1,347,3,31,42,1.4,0,72,389,5.4,6,11,0,17,4,38,2,0,2
1679,2018,3,2018-09-15,Western Kentucky,@,Louisville,L (17-20),25,38,65.8,260,1,43,168,3.9,1,81,428,5.3,14,11,1,26,8,69,0,1,1
1680,2018,4,2018-09-22,Western Kentucky,@,Ball State,W (28-20),25,35,71.4,252,2,40,192,4.8,2,75,444,5.9,12,14,3,29,11,102,0,0,0
1681,2018,5,2018-09-29,Western Kentucky,,Marshall,L (17-20),24,39,61.5,263,1,32,61,1.9,1,71,324,4.6,10,4,3,17,6,43,2,1,3
1682,2018,6,2018-10-13,Western Kentucky,@,UNC Charlotte,L (14-40),27,39,69.2,214,1,17,42,2.5,1,56,256,4.6,11,4,2,17,7,55,1,2,3
1683,2018,7,2018-10-20,Western Kentucky,,Old Dominion,L (34-37),24,32,75.0,257,2,45,207,4.6,2,77,464,6.0,14,11,4,29,10,83,0,0,0
1684,2018,8,2018-10-27,Western Kentucky,,Florida International,L (17-38),18,34,52.9,144,0,38,168,4.4,2,72,312,4.3,7,12,4,23,4,34,0,1,1
1685,2018,9,2018-11-02,Western Kentucky,@,Middle Tennessee State,L (10-29),16,47,34.0,270,1,25,109,4.4,0,72,379,5.3,10,6,1,17,7,80,1,1,2
1686,2018,10,2018-11-10,Western Kentucky,@,Florida Atlantic,L (15-34),25,42,59.5,228,1,34,123,3.6,1,76,351,4.6,15,4,2,21,2,10,0,1,1
1687,2018,11,2018-11-17,Western Kentucky,,Texas-El Paso,W (40-16),19,31,61.3,214,2,50,208,4.2,2,81,422,5.2,9,12,1,22,7,62,0,1,1
1688,2018,12,2018-11-24,Western Kentucky,@,Louisiana Tech,W (30-15),11,23,47.8,92,1,49,200,4.1,3,72,292,4.1,4,12,2,18,6,50,0,1,1
1689,2018,,12 Games,Western Kentucky,,,,254,431,58.9,2722,15,438,1644,3.8,15,869,4366,5.0,120,107,24,251,78,691,7,10,17
1690,2018,1,2018-08-31,Western Michigan,,Syracuse,L (42-55),19,36,52.8,379,3,28,242,8.6,3,64,621,9.7,14,7,3,24,6,45,0,2,2
1691,2018,2,2018-09-08,Western Michigan,@,Michigan,L (3-49),16,34,47.1,85,0,40,123,3.1,0,74,208,2.8,5,9,3,17,4,30,0,1,1
1692,2018,3,2018-09-15,Western Michigan,,Delaware State,W (68-0),23,33,69.7,286,2,41,241,5.9,4,74,527,7.1,14,13,4,31,6,65,0,0,0
1693,2018,4,2018-09-22,Western Michigan,@,Georgia State,W (34-15),20,25,80.0,234,3,45,294,6.5,1,70,528,7.5,12,12,1,25,5,50,0,0,0
1694,2018,5,2018-09-29,Western Michigan,@,Miami (OH),W (40-39),27,42,64.3,439,5,37,123,3.3,1,79,562,7.1,20,7,4,31,9,96,2,0,2
1695,2018,6,2018-10-06,Western Michigan,,Eastern Michigan,W (27-24),16,27,59.3,235,1,41,152,3.7,3,68,387,5.7,10,8,0,18,10,67,1,1,2
1696,2018,7,2018-10-13,Western Michigan,@,Bowling Green State,W (42-35),22,37,59.5,286,2,54,282,5.2,4,91,568,6.2,11,18,4,33,5,67,0,2,2
1697,2018,8,2018-10-20,Western Michigan,@,Central Michigan,W (35-10),5,9,55.6,51,0,55,305,5.5,5,64,356,5.6,2,12,2,16,5,55,0,0,0
1698,2018,9,2018-10-25,Western Michigan,,Toledo,L (24-51),25,32,78.1,307,2,34,125,3.7,1,66,432,6.5,11,4,2,17,8,76,1,0,1
1699,2018,10,2018-11-01,Western Michigan,,Ohio,L (14-59),10,19,52.6,152,1,40,118,3.0,1,59,270,4.6,4,7,2,13,6,51,4,2,6
1700,2018,11,2018-11-13,Western Michigan,@,Ball State,L (41-42),20,29,69.0,187,1,67,361,5.4,4,96,548,5.7,11,19,3,33,6,50,1,0,1
1701,2018,12,2018-11-20,Western Michigan,,Northern Illinois,W (28-21),19,35,54.3,285,0,46,94,2.0,3,81,379,4.7,14,7,1,22,2,10,1,0,1
1702,2018,,12 Games,Western Michigan,,,,222,358,62.0,2926,20,528,2460,4.7,30,886,5386,6.1,128,123,29,280,72,662,10,8,18
1703,2018,1,2018-09-08,William & Mary,@,Virginia Tech,L (17-62),18,30,60.0,232,1,29,34,1.2,1,59,266,4.5,10,1,1,12,4,22,2,0,2
1704,2018,1,2018-08-31,Wisconsin,,Western Kentucky,W (34-3),17,31,54.8,257,2,39,234,6.0,2,70,491,7.0,14,9,1,24,8,70,1,0,1
1705,2018,2,2018-09-08,Wisconsin,,New Mexico,W (45-14),9,13,69.2,151,2,59,417,7.1,4,72,568,7.9,5,24,0,29,4,39,1,1,2
1706,2018,3,2018-09-15,Wisconsin,,Brigham Young,L (21-24),18,28,64.3,190,0,43,204,4.7,3,71,394,5.5,9,13,1,23,6,33,0,1,1
1707,2018,4,2018-09-22,Wisconsin,@,Iowa,W (28-17),17,22,77.3,205,3,44,210,4.8,1,66,415,6.3,8,11,0,19,8,68,0,0,0
1708,2018,5,2018-10-06,Wisconsin,,Nebraska,W (41-24),13,24,54.2,163,1,48,370,7.7,4,72,533,7.4,9,15,2,26,5,50,1,0,1
1709,2018,6,2018-10-13,Wisconsin,@,Michigan,L (13-38),7,20,35.0,100,1,29,183,6.3,1,49,283,5.8,4,7,0,11,3,30,0,2,2
1710,2018,7,2018-10-20,Wisconsin,,Illinois,W (49-20),13,22,59.1,188,3,54,357,6.6,4,76,545,7.2,10,20,1,31,5,50,0,2,2
1711,2018,8,2018-10-27,Wisconsin,@,Northwestern,L (17-31),20,33,60.6,158,1,32,165,5.2,1,65,323,5.0,6,11,0,17,5,54,3,0,3
1712,2018,9,2018-11-03,Wisconsin,,Rutgers,W (31-17),12,23,52.2,156,1,46,317,6.9,3,69,473,6.9,9,16,1,26,4,19,0,2,2
1713,2018,10,2018-11-10,Wisconsin,@,Penn State,L (10-22),9,20,45.0,60,0,37,209,5.6,1,57,269,4.7,4,7,1,12,6,50,2,2,4
1714,2018,11,2018-11-17,Wisconsin,@,Purdue,W (47-44),16,24,66.7,206,2,51,385,7.5,4,75,591,7.9,7,16,1,24,13,171,1,0,1
1715,2018,12,2018-11-24,Wisconsin,,Minnesota,L (15-37),22,33,66.7,189,2,31,170,5.5,0,64,359,5.6,12,9,0,21,6,54,1,3,4
1716,2018,,12 Games,Wisconsin,,,,173,293,59.0,2023,18,513,3221,6.3,28,806,5244,6.5,97,158,8,263,73,688,10,13,23
1717,2018,1,2018-09-15,Wofford,@,Wyoming,L (14-17),9,15,60.0,73,0,49,221,4.5,2,64,294,4.6,4,8,2,14,3,16,1,2,3
1718,2018,1,2018-08-25,Wyoming,@,New Mexico State,W (29-7),13,22,59.1,137,0,56,313,5.6,3,78,450,5.8,7,13,2,22,4,60,0,0,0
1719,2018,2,2018-09-01,Wyoming,,Washington State,L (19-41),8,20,40.0,67,0,39,139,3.6,2,59,206,3.5,3,11,1,15,13,109,0,1,1
1720,2018,3,2018-09-08,Wyoming,@,Missouri,L (13-40),13,28,46.4,160,0,30,88,2.9,1,58,248,4.3,7,5,3,15,3,17,1,0,1
1721,2018,4,2018-09-15,Wyoming,,Wofford,W (17-14),25,42,59.5,224,2,27,89,3.3,0,69,313,4.5,13,5,1,19,5,40,0,1,1
1722,2018,5,2018-09-29,Wyoming,,Boise State,L (14-34),15,26,57.7,214,1,24,81,3.4,1,50,295,5.9,7,3,1,11,6,59,1,0,1
1723,2018,6,2018-10-06,Wyoming,@,Hawaii,L (13-17),9,18,50.0,87,0,34,157,4.6,0,52,244,4.7,4,8,1,13,6,45,0,0,0
1724,2018,7,2018-10-13,Wyoming,@,Fresno State,L (3-27),12,32,37.5,117,0,30,104,3.5,0,62,221,3.6,6,6,2,14,5,22,0,1,1
1725,2018,8,2018-10-20,Wyoming,,Utah State,L (16-24),10,24,41.7,100,0,50,231,4.6,1,74,331,4.5,3,10,2,15,10,80,1,1,2
1726,2018,9,2018-10-26,Wyoming,@,Colorado State,W (34-21),7,10,70.0,116,2,55,297,5.4,2,65,413,6.4,5,14,1,20,6,57,0,0,0
1727,2018,10,2018-11-03,Wyoming,,San Jose State,W (24-9),4,8,50.0,51,1,64,424,6.6,2,72,475,6.6,4,18,0,22,4,25,2,0,2
1728,2018,11,2018-11-17,Wyoming,,Air Force,W (35-27),15,29,51.7,262,2,29,111,3.8,3,58,373,6.4,9,7,2,18,5,35,1,0,1
1729,2018,12,2018-11-24,Wyoming,@,New Mexico,W (31-3),4,17,23.5,41,0,55,366,6.7,4,72,407,5.7,4,16,0,20,5,47,1,0,1
1730,2018,,12 Games,Wyoming,,,,135,276,48.9,1576,8,493,2400,4.9,19,769,3976,5.2,72,116,16,204,72,596,7,4,11
