,Season,Game,Date,Team,Loc,Opp,Result,Pass_cmp,Pass_att,Pass_pct,Pass_yds,Pass_TD,Rush_att,Rush_yds,Rush_avg,Rush_TD,TO_plays,TO_yds,TO_avg,FD_pass,FD_rush,FD_pen,FD_tot,Pen_num,Pen_yds,Turn_fum,Turn_int,Turn_tot
0,2014,1,2014-08-30,Air Force,,Nicholls State,W (44-16),3,6,50.0,19,0,73,539,7.4,6,79,558,7.1,1,26,0,27,9,109,0,0,0
1,2014,2,2014-09-06,Air Force,@,Wyoming,L (13-17),17,32,53.1,226,0,52,151,2.9,1,84,377,4.5,12,9,0,21,4,25,2,0,2
2,2014,3,2014-09-13,Air Force,@,Georgia State,W (48-38),12,15,80.0,224,2,65,315,4.8,4,80,539,6.7,11,18,2,31,2,20,0,0,0
3,2014,4,2014-09-27,Air Force,,Boise State,W (28-14),5,12,41.7,48,1,60,287,4.8,2,72,335,4.7,2,12,2,16,5,47,2,0,2
4,2014,5,2014-10-04,Air Force,,Navy,W (30-21),12,17,70.6,166,4,48,198,4.1,0,65,364,5.6,5,12,1,18,6,65,0,0,0
5,2014,6,2014-10-11,Air Force,@,Utah State,L (16-34),15,29,51.7,224,0,51,155,3.0,1,80,379,4.7,10,6,2,18,4,30,2,2,4
6,2014,7,2014-10-18,Air Force,,New Mexico,W (35-31),5,9,55.6,159,1,74,269,3.6,4,83,428,5.2,4,19,0,23,1,5,1,0,1
7,2014,8,2014-11-01,Air Force,@,Army,W (23-6),8,12,66.7,141,2,62,242,3.9,0,74,383,5.2,6,13,2,21,1,5,0,1,1
8,2014,9,2014-11-08,Air Force,@,Nevada-Las Vegas,W (48-21),6,7,85.7,156,1,78,386,4.9,5,85,542,6.4,4,21,1,26,2,30,1,0,1
9,2014,10,2014-11-15,Air Force,,Nevada,W (45-38),11,15,73.3,129,3,65,342,5.3,3,80,471,5.9,6,20,2,28,5,48,0,0,0
10,2014,11,2014-11-21,Air Force,@,San Diego State,L (14-30),12,27,44.4,189,1,41,140,3.4,1,68,329,4.8,5,11,0,16,3,20,3,1,4
11,2014,12,2014-11-28,Air Force,,Colorado State,W (27-24),6,15,40.0,135,0,63,242,3.8,3,78,377,4.8,5,16,1,22,1,15,1,0,1
12,2014,13,2014-12-20,Air Force,N,Western Michigan*,W (38-24),5,10,50.0,77,0,64,284,4.4,4,74,361,4.9,3,15,2,20,3,41,1,0,1
13,2014,,13 Games,Air Force,,,,117,206,56.8,1893,15,796,3550,4.5,34,1002,5443,5.4,74,198,15,287,46,460,13,4,17
14,2015,1,2015-09-05,Air Force,,Morgan State,W (63-7),4,7,57.1,119,2,63,394,6.3,5,70,513,7.3,4,22,3,29,6,57,0,0,0
15,2015,2,2015-09-12,Air Force,,San Jose State,W (37-16),3,11,27.3,24,0,69,428,6.2,5,80,452,5.7,0,0,0,23,5,48,0,1,1
16,2015,3,2015-09-19,Air Force,@,Michigan State,L (21-35),6,9,66.7,149,1,51,279,5.5,2,60,428,7.1,5,16,3,24,7,95,2,1,3
17,2015,4,2015-10-03,Air Force,@,Navy,L (11-33),5,12,41.7,73,0,56,204,3.6,1,68,277,4.1,3,12,0,15,3,25,3,1,4
18,2015,5,2015-10-10,Air Force,,Wyoming,W (31-17),5,10,50.0,80,1,58,299,5.2,3,68,379,5.6,2,14,0,16,2,30,1,1,2
19,2015,6,2015-10-17,Air Force,@,Colorado State,L (23-38),10,16,62.5,137,0,56,269,4.8,3,72,406,5.6,5,14,2,21,5,45,1,1,2
20,2015,7,2015-10-24,Air Force,,Fresno State,W (42-14),6,11,54.5,128,1,79,458,5.8,5,90,586,6.5,5,21,0,26,5,38,1,0,1
21,2015,8,2015-10-31,Air Force,@,Hawaii,W (58-7),3,9,33.3,80,0,83,496,6.0,7,92,576,6.3,3,27,2,32,3,30,0,0,0
22,2015,9,2015-11-07,Air Force,,Army,W (20-3),7,10,70.0,156,2,47,196,4.2,0,57,352,6.2,5,9,0,14,2,20,0,0,0
23,2015,10,2015-11-14,Air Force,,Utah State,W (35-28),11,17,64.7,271,1,64,309,4.8,4,81,580,7.2,10,15,2,27,4,20,0,0,0
24,2015,11,2015-11-20,Air Force,@,Boise State,W (37-30),9,16,56.3,279,2,54,328,6.1,2,70,607,8.7,8,15,0,23,4,58,1,3,4
25,2015,12,2015-11-28,Air Force,@,New Mexico,L (35-47),6,16,37.5,167,3,38,222,5.8,2,54,389,7.2,4,9,1,14,1,14,0,3,3
26,2015,13,2015-12-05,Air Force,@,San Diego State,L (24-27),5,11,45.5,35,0,46,305,6.6,3,57,340,6.0,3,11,0,14,2,9,0,0,0
27,2015,14,2015-12-29,Air Force,N,California*,L (36-55),7,15,46.7,149,2,53,285,5.4,3,68,434,6.4,7,14,2,23,4,47,2,1,3
28,2015,,14 Games,Air Force,,,,87,170,51.2,1847,15,817,4472,5.5,45,987,6319,6.4,64,199,15,301,53,536,11,12,23
29,2016,1,2016-09-03,Air Force,,Abilene Christian,W (37-21),6,11,54.5,201,3,66,407,6.2,2,77,608,7.9,5,22,2,29,7,57,2,0,2
30,2016,2,2016-09-10,Air Force,,Georgia State,W (48-14),3,9,33.3,67,0,83,464,5.6,5,92,531,5.8,2,28,0,30,2,30,0,0,0
31,2016,3,2016-09-24,Air Force,@,Utah State,W (27-20),5,13,38.5,113,1,52,213,4.1,2,65,326,5.0,3,13,1,17,8,66,0,0,0
32,2016,4,2016-10-01,Air Force,,Navy,W (28-14),8,15,53.3,257,2,53,173,3.3,1,68,430,6.3,8,10,0,18,5,70,0,1,1
33,2016,5,2016-10-08,Air Force,@,Wyoming,L (26-35),6,19,31.6,188,2,39,149,3.8,1,58,337,5.8,6,6,0,12,4,45,1,3,4
34,2016,6,2016-10-15,Air Force,N,New Mexico,L (40-45),12,24,50.0,280,2,49,251,5.1,3,73,531,7.3,11,12,1,24,4,41,0,0,0
35,2016,7,2016-10-22,Air Force,,Hawaii,L (27-34),1,10,10.0,20,0,87,389,4.5,3,97,409,4.2,1,24,2,27,4,35,2,1,3
36,2016,8,2016-10-28,Air Force,@,Fresno State,W (31-21),5,9,55.6,97,1,73,327,4.5,2,82,424,5.2,4,19,0,23,6,47,1,0,1
37,2016,9,2016-11-05,Air Force,@,Army,W (31-12),6,9,66.7,195,1,52,249,4.8,3,61,444,7.3,6,12,2,20,9,99,1,0,1
38,2016,10,2016-11-12,Air Force,,Colorado State,W (49-46),3,8,37.5,49,0,68,485,7.1,7,76,534,7.0,2,22,2,26,3,36,1,1,2
39,2016,11,2016-11-19,Air Force,@,San Jose State,W (41-38),3,7,42.9,33,1,63,458,7.3,4,70,491,7.0,1,25,1,27,7,85,1,1,2
40,2016,12,2016-11-25,Air Force,,Boise State,W (27-20),3,6,50.0,45,0,77,314,4.1,2,83,359,4.3,1,23,1,25,3,30,0,1,1
41,2016,13,2016-12-30,Air Force,N,South Alabama*,W (45-21),7,10,70.0,207,1,60,257,4.3,4,70,464,6.6,6,14,4,24,5,25,0,0,0
42,2016,,13 Games,Air Force,,,,68,150,45.3,1752,14,822,4136,5.0,39,972,5888,6.1,56,230,16,302,67,666,9,8,17
43,2017,1,2017-09-02,Air Force,,Virginia Military Institute,W (62-0),10,14,71.4,190,2,67,457,6.8,7,81,647,8.0,6,26,0,32,5,53,0,0,0
44,2017,2,2017-09-16,Air Force,@,Michigan,L (13-29),1,9,11.1,64,1,49,168,3.4,0,58,232,4.0,1,10,4,15,3,29,0,1,1
45,2017,3,2017-09-23,Air Force,,San Diego State,L (24-28),2,6,33.3,33,0,60,220,3.7,3,66,253,3.8,1,13,0,14,5,52,0,1,1
46,2017,4,2017-09-30,Air Force,@,New Mexico,L (38-56),9,18,50.0,158,3,63,238,3.8,2,81,396,4.9,8,15,3,26,2,15,2,0,2
47,2017,5,2017-10-07,Air Force,@,Navy,L (45-48),10,17,58.8,281,2,55,340,6.2,4,72,621,8.6,8,18,1,27,3,25,2,0,2
48,2017,6,2017-10-14,Air Force,,Nevada-Las Vegas,W (34-30),4,8,50.0,72,0,78,401,5.1,5,86,473,5.5,3,25,2,30,5,56,4,0,4
49,2017,7,2017-10-20,Air Force,@,Nevada,W (45-42),4,7,57.1,41,0,89,552,6.2,6,96,593,6.2,3,32,1,36,5,58,1,1,2
50,2017,8,2017-10-28,Air Force,@,Colorado State,W (45-28),2,4,50.0,64,1,74,413,5.6,4,78,477,6.1,1,26,3,30,4,28,0,1,1
51,2017,9,2017-11-04,Air Force,,Army,L (0-21),6,13,46.2,95,0,34,95,2.8,0,47,190,4.0,4,8,0,12,3,21,0,0,0
52,2017,10,2017-11-11,Air Force,,Wyoming,L (14-28),10,22,45.5,175,1,61,203,3.3,1,83,378,4.6,9,11,2,22,5,55,2,1,3
53,2017,11,2017-11-18,Air Force,@,Boise State,L (19-44),7,13,53.8,115,0,51,181,3.5,2,64,296,4.6,5,12,1,18,6,63,3,0,3
54,2017,12,2017-11-25,Air Force,,Utah State,W (38-35),4,12,33.3,33,0,82,407,5.0,4,94,440,4.7,3,23,2,28,2,10,0,1,1
55,2017,,12 Games,Air Force,,,,69,143,48.3,1321,10,763,3675,4.8,38,906,4996,5.5,52,219,19,290,48,465,14,6,20
56,2014,1,2014-08-28,Akron,,Howard,W (41-0),27,43,62.8,396,5,29,117,4.0,1,72,513,7.1,7,15,2,24,7,70,0,0,0
57,2014,2,2014-09-06,Akron,@,Penn State,L (3-21),24,46,52.2,208,0,25,69,2.8,0,71,277,3.9,12,4,1,17,7,64,0,0,0
58,2014,3,2014-09-20,Akron,,Marshall,L (17-48),25,52,48.1,251,1,23,92,4.0,1,75,343,4.6,10,8,7,25,10,94,2,2,4
59,2014,4,2014-09-27,Akron,@,Pittsburgh,W (21-10),17,35,48.6,213,1,36,169,4.7,2,71,382,5.4,11,9,0,20,10,64,0,1,1
60,2014,5,2014-10-04,Akron,,Eastern Michigan,W (31-6),33,50,66.0,355,2,31,197,6.4,2,81,552,6.8,17,10,0,27,15,124,0,0,0
61,2014,6,2014-10-11,Akron,,Miami (OH),W (29-19),20,36,55.6,167,0,37,151,4.1,3,73,318,4.4,11,8,5,24,9,128,2,0,2
62,2014,7,2014-10-18,Akron,@,Ohio,L (20-23),23,46,50.0,268,2,25,84,3.4,0,71,352,5.0,11,4,3,18,10,83,1,2,3
63,2014,8,2014-10-25,Akron,@,Ball State,L (21-35),21,39,53.8,200,1,34,125,3.7,2,73,325,4.5,9,11,0,20,7,45,1,4,5
64,2014,9,2014-11-04,Akron,,Bowling Green State,L (10-27),31,63,49.2,304,0,27,94,3.5,1,90,398,4.4,16,9,1,26,7,55,2,3,5
65,2014,10,2014-11-11,Akron,@,Buffalo,L (24-55),19,35,54.3,161,0,30,68,2.3,2,65,229,3.5,7,8,0,15,9,98,2,0,2
66,2014,11,2014-11-18,Akron,,Massachusetts,W (30-6),26,40,65.0,277,2,37,134,3.6,1,77,411,5.3,14,9,4,27,4,40,2,0,2
67,2014,12,2014-11-28,Akron,@,Kent State,L (24-27),17,42,40.5,191,0,30,188,6.3,3,72,379,5.3,7,8,2,17,6,59,0,2,2
68,2014,,12 Games,Akron,,,,283,527,53.7,2991,14,364,1488,4.1,18,891,4479,5.0,132,103,25,260,101,924,12,14,26
69,2015,1,2015-09-05,Akron,@,Oklahoma,L (3-41),6,26,23.1,88,0,44,138,3.1,0,70,226,3.2,5,4,1,10,9,62,1,0,1
70,2015,2,2015-09-12,Akron,,Pittsburgh,L (7-24),7,22,31.8,63,0,24,47,2.0,1,46,110,2.4,3,4,1,8,9,85,1,0,1
71,2015,3,2015-09-19,Akron,,Savannah State,W (52-9),18,33,54.5,335,2,47,291,6.2,5,80,626,7.8,13,15,3,31,4,51,0,2,2
72,2015,4,2015-09-26,Akron,@,Louisiana,W (35-14),13,29,44.8,238,2,42,220,5.2,3,71,458,6.5,7,11,4,22,11,92,0,1,1
73,2015,5,2015-10-03,Akron,,Ohio,L (12-14),18,38,47.4,231,0,35,88,2.5,0,73,319,4.4,13,5,2,20,10,79,0,1,1
74,2015,6,2015-10-10,Akron,@,Eastern Michigan,W (47-21),14,22,63.6,222,4,53,278,5.2,2,75,500,6.7,10,15,3,28,8,54,0,0,0
75,2015,7,2015-10-17,Akron,@,Bowling Green State,L (10-59),15,30,50.0,104,1,42,167,4.0,0,72,271,3.8,6,9,1,16,9,85,2,2,4
76,2015,8,2015-10-31,Akron,,Central Michigan,L (6-14),22,36,61.1,252,1,25,25,1.0,0,61,277,4.5,11,3,1,15,5,34,0,1,1
77,2015,9,2015-11-07,Akron,@,Massachusetts,W (17-13),15,27,55.6,174,1,41,155,3.8,1,68,329,4.8,9,8,1,18,6,65,1,2,3
78,2015,10,2015-11-14,Akron,@,Miami (OH),W (37-28),13,28,46.4,221,1,45,193,4.3,4,73,414,5.7,9,10,1,20,9,80,0,2,2
79,2015,11,2015-11-21,Akron,,Buffalo,W (42-21),17,30,56.7,258,4,45,217,4.8,2,75,475,6.3,10,13,2,25,7,73,0,0,0
80,2015,12,2015-11-27,Akron,,Kent State,W (20-0),11,19,57.9,140,1,51,229,4.5,1,70,369,5.3,11,11,4,26,7,60,1,0,1
81,2015,13,2015-12-22,Akron,N,Utah State*,W (23-21),15,30,50.0,182,1,42,100,2.4,1,72,282,3.9,9,6,2,17,5,34,0,1,1
82,2015,,13 Games,Akron,,,,184,370,49.7,2508,18,536,2148,4.0,20,906,4656,5.1,116,114,26,256,99,854,6,12,18
83,2016,1,2016-09-03,Akron,,Virginia Military Institute,W (47-24),25,38,65.8,425,6,29,151,5.2,1,67,576,8.6,16,7,1,24,13,111,1,1,2
84,2016,2,2016-09-10,Akron,@,Wisconsin,L (10-54),14,25,56.0,136,0,21,88,4.2,0,46,224,4.9,4,4,2,10,8,66,1,1,2
85,2016,3,2016-09-17,Akron,@,Marshall,W (65-38),21,32,65.6,379,4,30,145,4.8,2,62,524,8.5,15,5,6,26,13,136,1,0,1
86,2016,4,2016-09-24,Akron,,Appalachian State,L (38-45),31,43,72.1,353,3,26,133,5.1,2,69,486,7.0,18,9,3,30,9,72,0,2,2
87,2016,5,2016-10-01,Akron,@,Kent State,W (31-27),11,28,39.3,237,2,32,141,4.4,2,60,378,6.3,11,6,1,18,6,64,1,2,3
88,2016,6,2016-10-08,Akron,,Miami (OH),W (35-13),15,29,51.7,174,3,35,125,3.6,2,64,299,4.7,8,6,2,16,1,5,0,0,0
89,2016,7,2016-10-15,Akron,,Western Michigan,L (0-41),13,31,41.9,153,0,28,130,4.6,0,59,283,4.8,6,10,1,17,9,47,0,2,2
90,2016,8,2016-10-22,Akron,@,Ball State,W (35-25),28,41,68.3,352,3,30,177,5.9,2,71,529,7.5,14,9,3,26,8,51,1,0,1
91,2016,9,2016-10-27,Akron,@,Buffalo,L (20-41),18,42,42.9,178,1,42,128,3.0,0,84,306,3.6,7,9,2,18,4,40,0,1,1
92,2016,10,2016-11-02,Akron,,Toledo,L (17-48),18,36,50.0,348,2,25,96,3.8,0,61,444,7.3,12,8,1,21,5,63,0,2,2
93,2016,11,2016-11-09,Akron,,Bowling Green State,L (28-38),11,24,45.8,197,1,50,177,3.5,2,74,374,5.1,8,5,1,14,8,85,3,3,6
94,2016,12,2016-11-22,Akron,@,Ohio,L (3-9),12,27,44.4,131,0,32,95,3.0,0,59,226,3.8,7,5,2,14,7,67,0,0,0
95,2016,,12 Games,Akron,,,,217,396,54.8,3063,25,380,1586,4.2,13,776,4649,6.0,126,83,25,234,91,807,8,14,22
96,2017,1,2017-09-02,Akron,@,Penn State,L (0-52),14,29,48.3,86,0,34,73,2.1,0,63,159,2.5,7,4,1,12,9,84,0,1,1
97,2017,2,2017-09-09,Akron,,Arkansas-Pine Bluff,W (52-3),17,26,65.4,197,1,44,267,6.1,5,70,464,6.6,9,15,3,27,11,130,0,0,0
98,2017,3,2017-09-16,Akron,,Iowa State,L (14-41),27,44,61.4,293,2,24,38,1.6,0,68,331,4.9,13,4,2,19,7,79,1,2,3
99,2017,4,2017-09-23,Akron,@,Troy,L (17-22),20,40,50.0,268,1,35,99,2.8,1,75,367,4.9,12,7,4,23,12,100,1,2,3
100,2017,5,2017-09-30,Akron,@,Bowling Green State,W (34-23),14,25,56.0,183,2,40,178,4.5,2,65,361,5.6,7,10,2,19,1,5,2,1,3
101,2017,6,2017-10-07,Akron,,Ball State,W (31-3),18,31,58.1,249,2,31,134,4.3,1,62,383,6.2,13,6,0,19,2,15,0,0,0
102,2017,7,2017-10-15,Akron,@,Western Michigan,W (14-13),13,24,54.2,127,1,31,88,2.8,1,55,215,3.9,8,3,3,14,9,93,0,1,1
103,2017,8,2017-10-21,Akron,@,Toledo,L (21-48),23,40,57.5,291,3,24,42,1.8,0,64,333,5.2,16,2,5,23,0,0,1,1,2
104,2017,9,2017-10-28,Akron,,Buffalo,W (21-20),21,29,72.4,286,3,25,81,3.2,0,54,367,6.8,12,7,0,19,4,49,0,1,1
105,2017,10,2017-11-07,Akron,@,Miami (OH),L (14-24),19,38,50.0,218,1,30,55,1.8,1,68,273,4.0,10,6,2,18,5,57,0,0,0
106,2017,11,2017-11-14,Akron,,Ohio,W (37-34),22,38,57.9,322,4,32,121,3.8,1,70,443,6.3,11,7,0,18,16,167,0,0,0
107,2017,12,2017-11-21,Akron,,Kent State,W (24-14),6,20,30.0,69,1,39,122,3.1,1,59,191,3.2,4,8,3,15,5,20,0,1,1
108,2017,13,2017-12-02,Akron,N,Toledo,L (28-45),18,42,42.9,283,3,33,113,3.4,1,75,396,5.3,12,6,2,20,3,25,1,1,2
109,2017,14,2017-12-19,Akron,@,Florida Atlantic*,L (3-50),10,21,47.6,77,0,37,69,1.9,0,58,146,2.5,3,5,4,12,4,49,0,0,0
110,2017,,14 Games,Akron,,,,242,447,54.1,2949,24,459,1480,3.2,14,906,4429,4.9,137,90,31,258,88,873,6,11,17
111,2014,1,2014-08-30,Alabama,N,West Virginia,W (33-23),24,33,72.7,250,0,49,288,5.9,3,82,538,6.6,14,13,3,30,7,49,0,1,1
112,2014,2,2014-09-06,Alabama,,Florida Atlantic,W (41-0),27,38,71.1,430,3,32,190,5.9,2,70,620,8.9,17,10,0,27,6,60,1,0,1
113,2014,3,2014-09-13,Alabama,,Southern Mississippi,W (52-12),17,24,70.8,214,2,49,333,6.8,5,73,547,7.5,14,16,1,31,3,25,1,0,1
114,2014,4,2014-09-20,Alabama,,Florida,W (42-21),24,35,68.6,449,5,52,223,4.3,1,87,672,7.7,13,13,2,28,11,80,3,1,4
115,2014,5,2014-10-04,Alabama,@,Mississippi,L (17-23),19,31,61.3,228,0,44,168,3.8,1,75,396,5.3,13,7,0,20,8,52,1,1,2
116,2014,6,2014-10-11,Alabama,@,Arkansas,W (14-13),11,21,52.4,161,2,32,66,2.1,0,53,227,4.3,6,3,1,10,4,30,2,0,2
117,2014,7,2014-10-18,Alabama,,Texas A&M,W (59-0),21,35,60.0,304,4,45,298,6.6,4,80,602,7.5,15,14,1,30,0,0,0,0,0
118,2014,8,2014-10-25,Alabama,@,Tennessee,W (34-20),14,24,58.3,286,2,41,183,4.5,3,65,469,7.2,10,11,2,23,6,50,2,0,2
119,2014,9,2014-11-08,Alabama,@,Louisiana State,W (20-13),20,46,43.5,209,2,29,106,3.7,0,75,315,4.2,9,6,0,15,3,29,1,0,1
120,2014,10,2014-11-15,Alabama,,Mississippi State,W (25-20),19,31,61.3,211,1,32,124,3.9,2,63,335,5.3,9,7,1,17,7,61,0,0,0
121,2014,11,2014-11-22,Alabama,,Western Carolina,W (48-14),29,43,67.4,337,3,45,275,6.1,3,88,612,7.0,16,19,1,36,5,50,1,1,2
122,2014,12,2014-11-29,Alabama,,Auburn,W (55-44),20,27,74.1,312,4,34,227,6.7,4,61,539,8.8,13,9,2,24,3,30,0,3,3
123,2014,13,2014-12-06,Alabama,N,Missouri,W (42-13),23,27,85.2,262,2,49,242,4.9,4,76,504,6.6,13,14,1,28,2,10,0,0,0
124,2014,14,2015-01-01,Alabama,N,Ohio State*,L (35-42),22,36,61.1,237,2,34,170,5.0,3,70,407,5.8,8,12,1,21,4,36,0,3,3
125,2014,,14 Games,Alabama,,,,290,451,64.3,3890,32,567,2893,5.1,35,1018,6783,6.7,170,154,16,340,69,562,12,10,22
126,2015,1,2015-09-05,Alabama,N,Wisconsin,W (35-17),22,29,75.9,264,1,37,238,6.4,4,66,502,7.6,14,12,1,27,11,120,0,0,0
127,2015,2,2015-09-12,Alabama,,Middle Tennessee State,W (37-10),26,43,60.5,312,2,39,220,5.6,3,82,532,6.5,13,13,2,28,5,40,0,2,2
128,2015,3,2015-09-19,Alabama,,Mississippi,L (37-43),32,59,54.2,288,3,42,215,5.1,2,101,503,5.0,14,11,4,29,4,36,2,3,5
129,2015,4,2015-09-26,Alabama,,Louisiana-Monroe,W (34-0),18,32,56.3,166,3,35,137,3.9,1,67,303,4.5,8,8,1,17,7,72,0,1,1
130,2015,5,2015-10-03,Alabama,@,Georgia,W (38-10),11,16,68.8,190,1,47,189,4.0,2,63,379,6.0,6,6,3,15,7,39,2,0,2
131,2015,6,2015-10-10,Alabama,,Arkansas,W (27-14),24,33,72.7,262,2,46,134,2.9,1,79,396,5.0,8,12,2,22,6,56,0,2,2
132,2015,7,2015-10-17,Alabama,@,Texas A&M,W (41-23),19,25,76.0,138,0,45,258,5.7,2,70,396,5.7,6,11,0,17,7,60,1,0,1
133,2015,8,2015-10-24,Alabama,,Tennessee,W (19-14),21,27,77.8,247,0,42,117,2.8,2,69,364,5.3,12,10,1,23,7,64,0,1,1
134,2015,9,2015-11-07,Alabama,,Louisiana State,W (30-16),18,24,75.0,184,0,55,250,4.5,3,79,434,5.5,12,14,2,28,9,88,1,0,1
135,2015,10,2015-11-14,Alabama,@,Mississippi State,W (31-6),15,25,60.0,144,1,30,235,7.8,2,55,379,6.9,4,8,1,13,4,40,0,1,1
136,2015,11,2015-11-21,Alabama,,Charleston Southern,W (56-6),19,25,76.0,208,2,35,195,5.6,4,60,403,6.7,10,13,0,23,2,30,0,0,0
137,2015,12,2015-11-28,Alabama,@,Auburn,W (29-13),17,26,65.4,179,1,50,286,5.7,1,76,465,6.1,8,13,3,24,7,65,0,0,0
138,2015,13,2015-12-05,Alabama,N,Florida,W (29-15),18,26,69.2,204,2,58,233,4.0,1,84,437,5.2,9,14,2,25,5,35,1,0,1
139,2015,14,2015-12-31,Alabama,N,Michigan State*,W (38-0),25,31,80.6,286,2,35,154,4.4,2,66,440,6.7,12,7,2,21,6,69,0,0,0
140,2015,15,2016-01-11,Alabama,N,Clemson*,W (45-40),16,25,64.0,335,2,46,138,3.0,3,71,473,6.7,11,6,1,18,2,21,0,0,0
141,2015,,15 Games,Alabama,,,,301,446,67.5,3407,22,642,2999,4.7,33,1088,6406,5.9,147,158,25,330,89,835,7,10,17
142,2016,1,2016-09-03,Alabama,N,Southern California,W (52-6),12,18,66.7,223,3,45,242,5.4,3,63,465,7.4,6,9,0,15,4,29,1,1,2
143,2016,2,2016-09-10,Alabama,,Western Kentucky,W (38-10),25,42,59.5,351,2,39,124,3.2,2,81,475,5.9,13,9,1,23,12,84,1,0,1
144,2016,3,2016-09-17,Alabama,@,Mississippi,W (48-43),19,31,61.3,158,0,48,334,7.0,3,79,492,6.2,7,14,1,22,9,75,1,0,1
145,2016,4,2016-09-24,Alabama,,Kent State,W (48-0),22,34,64.7,217,2,46,285,6.2,3,80,502,6.3,10,16,0,26,2,20,0,0,0
146,2016,5,2016-10-01,Alabama,,Kentucky,W (34-6),25,38,65.8,315,2,37,173,4.7,1,75,488,6.5,14,11,0,25,4,20,1,0,1
147,2016,6,2016-10-08,Alabama,@,Arkansas,W (49-30),13,17,76.5,253,2,34,264,7.8,3,51,517,10.1,8,8,0,16,7,86,2,1,3
148,2016,7,2016-10-15,Alabama,@,Tennessee,W (49-10),18,28,64.3,185,1,48,409,8.5,4,76,594,7.8,8,20,0,28,5,38,1,1,2
149,2016,8,2016-10-22,Alabama,,Texas A&M,W (33-14),15,25,60.0,164,2,57,287,5.0,1,82,451,5.5,7,19,2,28,7,44,0,2,2
150,2016,9,2016-11-05,Alabama,@,Louisiana State,W (10-0),10,19,52.6,107,0,51,216,4.2,1,70,323,4.6,3,12,1,16,6,29,1,1,2
151,2016,10,2016-11-12,Alabama,,Mississippi State,W (51-3),31,41,75.6,397,5,31,218,7.0,1,72,615,8.5,17,7,2,26,3,35,1,1,2
152,2016,11,2016-11-19,Alabama,,Chattanooga,W (31-3),15,21,71.4,136,3,37,196,5.3,1,58,332,5.7,4,10,0,14,1,10,1,0,1
153,2016,12,2016-11-26,Alabama,,Auburn,W (30-12),28,37,75.7,298,2,44,203,4.6,1,81,501,6.2,13,12,1,26,4,28,0,2,2
154,2016,13,2016-12-03,Alabama,N,Florida,W (54-16),11,20,55.0,138,1,38,234,6.2,4,58,372,6.4,3,12,3,18,2,14,0,0,0
155,2016,14,2016-12-31,Alabama,N,Washington,W (24-7),7,14,50.0,57,0,50,269,5.4,2,64,326,5.1,3,13,0,16,11,66,0,0,0
156,2016,15,2017-01-09,Alabama,N,Clemson,L (31-35),14,32,43.8,155,1,34,221,6.5,3,66,376,5.7,5,10,1,16,9,82,0,0,0
157,2016,,15 Games,Alabama,,,,265,417,63.5,3154,26,639,3675,5.8,33,1056,6829,6.5,121,182,12,315,86,660,10,9,19
158,2017,1,2017-09-02,Alabama,N,Florida State,W (24-7),10,18,55.6,96,1,42,173,4.1,1,60,269,4.5,4,8,1,13,5,30,0,0,0
159,2017,2,2017-09-09,Alabama,,Fresno State,W (41-10),20,27,74.1,192,2,39,305,7.8,3,66,497,7.5,11,17,0,28,4,30,0,0,0
160,2017,3,2017-09-16,Alabama,,Colorado State,W (41-23),13,21,61.9,248,2,39,239,6.1,3,60,487,8.1,10,12,1,23,4,45,0,0,0
161,2017,4,2017-09-23,Alabama,@,Vanderbilt,W (59-0),17,27,63.0,181,2,66,496,7.5,6,93,677,7.3,12,24,2,38,6,40,0,0,0
162,2017,5,2017-09-30,Alabama,,Mississippi,W (66-3),15,24,62.5,248,3,51,365,7.2,5,75,613,8.2,11,14,1,26,7,60,0,0,0
163,2017,6,2017-10-07,Alabama,@,Texas A&M,W (27-19),13,22,59.1,123,1,44,232,5.3,2,66,355,5.4,6,8,2,16,6,50,1,0,1
164,2017,7,2017-10-14,Alabama,,Arkansas,W (41-9),13,21,61.9,188,1,43,308,7.2,4,64,496,7.8,9,14,0,23,6,66,1,1,2
165,2017,8,2017-10-21,Alabama,,Tennessee,W (45-7),22,33,66.7,332,2,53,272,5.1,4,86,604,7.0,16,16,3,35,7,56,1,1,2
166,2017,9,2017-11-04,Alabama,,Louisiana State,W (24-10),11,24,45.8,183,1,36,116,3.2,2,60,299,5.0,6,7,1,14,1,11,0,0,0
167,2017,10,2017-11-11,Alabama,@,Mississippi State,W (31-24),10,19,52.6,242,1,38,202,5.3,3,57,444,7.8,7,11,1,19,5,60,0,0,0
168,2017,11,2017-11-18,Alabama,,Mercer,W (56-0),14,18,77.8,265,6,42,265,6.3,2,60,530,8.8,10,12,0,22,1,5,2,0,2
169,2017,12,2017-11-25,Alabama,@,Auburn,L (14-26),13,23,56.5,103,1,38,211,5.6,1,61,314,5.1,4,12,2,18,9,65,1,0,1
170,2017,13,2018-01-01,Alabama,N,Clemson*,W (24-6),16,24,66.7,120,2,42,141,3.4,0,66,261,4.0,6,9,3,16,2,10,1,0,1
171,2017,14,2018-01-08,Alabama,N,Georgia*,W (26-23),17,32,53.1,187,3,39,184,4.7,0,71,371,5.2,8,10,2,20,6,41,0,1,1
172,2017,,14 Games,Alabama,,,,204,333,61.3,2708,28,612,3509,5.7,36,945,6217,6.6,120,174,19,311,69,569,7,3,10
173,2016,1,2016-10-01,Alcorn State,@,Arkansas,L (10-52),13,19,68.4,158,0,38,155,4.1,1,57,313,5.5,7,8,0,15,3,15,2,2,4
174,2017,1,2017-09-08,Alcorn State,N,Florida International,L (10-17),22,34,64.7,191,1,25,78,3.1,0,59,269,4.6,8,4,0,12,9,81,0,0,0
175,2014,1,2014-08-30,Appalachian State,@,Michigan,L (14-52),17,33,51.5,127,1,36,153,4.3,1,69,280,4.1,6,9,2,17,8,69,0,0,0
176,2014,2,2014-09-20,Appalachian State,@,Southern Mississippi,L (20-21),28,40,70.0,264,2,47,191,4.1,1,87,455,5.2,16,9,4,29,11,59,1,2,3
177,2014,3,2014-10-04,Appalachian State,,South Alabama,L (21-47),20,36,55.6,191,3,38,203,5.3,0,74,394,5.3,9,9,7,25,8,77,2,1,3
178,2014,4,2014-10-11,Appalachian State,,Liberty,L (48-55),20,31,64.5,397,3,37,231,6.2,2,68,628,9.2,11,11,1,23,7,58,2,2,4
179,2014,5,2014-10-18,Appalachian State,@,Troy,W (53-14),9,16,56.3,110,1,54,441,8.2,5,70,551,7.9,3,19,2,24,7,52,1,0,1
180,2014,6,2014-11-01,Appalachian State,,Georgia State,W (44-0),9,14,64.3,98,0,66,469,7.1,6,80,567,7.1,5,21,0,26,1,17,0,0,0
181,2014,7,2014-11-08,Appalachian State,,Louisiana-Monroe,W (31-29),25,35,71.4,276,2,36,104,2.9,2,71,380,5.4,13,6,4,23,7,50,0,1,1
182,2014,8,2014-11-15,Appalachian State,@,Arkansas State,W (37-32),14,22,63.6,255,2,63,294,4.7,3,85,549,6.5,10,16,3,29,10,87,2,0,2
183,2014,9,2014-11-22,Appalachian State,@,Louisiana,W (35-16),11,22,50.0,195,1,47,232,4.9,3,69,427,6.2,9,10,1,20,3,30,1,1,2
184,2014,10,2014-11-29,Appalachian State,,Idaho,W (45-28),13,20,65.0,223,3,43,207,4.8,3,63,430,6.8,9,10,4,23,7,70,1,1,2
185,2014,,10 Games,Appalachian State,,,,166,269,61.7,2136,18,467,2525,5.4,26,736,4661,6.3,91,120,28,239,69,569,10,8,18
186,2015,1,2015-09-05,Appalachian State,,Howard,W (49-0),21,28,75.0,287,4,56,376,6.7,3,84,663,7.9,12,18,3,33,7,60,1,0,1
187,2015,2,2015-09-12,Appalachian State,@,Clemson,L (10-41),9,28,32.1,95,1,45,203,4.5,0,73,298,4.1,3,8,1,12,12,91,1,3,4
188,2015,3,2015-09-26,Appalachian State,@,Old Dominion,W (49-0),12,17,70.6,198,4,56,303,5.4,2,73,501,6.9,6,15,3,24,7,68,1,0,1
189,2015,4,2015-10-03,Appalachian State,,Wyoming,W (31-13),3,12,25.0,65,1,34,249,7.3,2,46,314,6.8,2,10,2,14,4,30,0,1,1
190,2015,5,2015-10-10,Appalachian State,@,Georgia State,W (37-3),18,25,72.0,291,3,44,207,4.7,0,69,498,7.2,13,8,3,24,8,56,0,1,1
191,2015,6,2015-10-17,Appalachian State,@,Louisiana-Monroe,W (59-14),9,16,56.3,275,3,50,379,7.6,5,66,654,9.9,8,15,0,23,6,68,1,0,1
192,2015,7,2015-10-22,Appalachian State,,Georgia Southern,W (31-13),14,20,70.0,202,2,48,231,4.8,2,68,433,6.4,11,11,0,22,5,40,0,0,0
193,2015,8,2015-10-31,Appalachian State,,Troy,W (44-41),16,26,61.5,184,2,58,248,4.3,2,84,432,5.1,8,11,3,22,7,71,0,1,1
194,2015,9,2015-11-05,Appalachian State,,Arkansas State,L (27-40),23,36,63.9,357,4,30,108,3.6,0,66,465,7.0,14,4,0,18,6,64,2,1,3
195,2015,10,2015-11-14,Appalachian State,@,Idaho,W (47-20),10,17,58.8,110,4,56,401,7.2,2,73,511,7.0,5,23,1,29,5,36,0,0,0
196,2015,11,2015-11-28,Appalachian State,,Louisiana,W (28-7),14,21,66.7,172,1,46,230,5.0,3,67,402,6.0,9,13,3,25,5,57,2,0,2
197,2015,12,2015-12-05,Appalachian State,@,South Alabama,W (34-27),15,22,68.2,163,2,36,301,8.4,2,58,464,8.0,9,9,2,20,3,19,3,1,4
198,2015,13,2015-12-19,Appalachian State,N,Ohio*,W (31-29),13,26,50.0,124,2,49,303,6.2,2,75,427,5.7,9,12,3,24,9,80,2,1,3
199,2015,,13 Games,Appalachian State,,,,177,294,60.2,2523,33,608,3539,5.8,25,902,6062,6.7,109,157,24,290,84,740,13,9,22
200,2016,1,2016-09-01,Appalachian State,@,Tennessee,L (13-20),15,23,65.2,108,1,43,184,4.3,1,66,292,4.4,7,10,0,17,5,36,0,1,1
201,2016,2,2016-09-10,Appalachian State,,Old Dominion,W (31-7),15,22,68.2,185,0,48,230,4.8,4,70,415,5.9,7,14,1,22,7,72,0,1,1
202,2016,3,2016-09-17,Appalachian State,,Miami (FL),L (10-45),10,22,45.5,115,1,47,161,3.4,0,69,276,4.0,6,9,2,17,8,58,0,1,1
203,2016,4,2016-09-24,Appalachian State,@,Akron,W (45-38),22,31,71.0,280,3,49,307,6.3,3,80,587,7.3,16,13,1,30,7,83,1,0,1
204,2016,5,2016-10-01,Appalachian State,,Georgia State,W (17-3),13,25,52.0,143,1,48,218,4.5,1,73,361,4.9,7,12,7,26,9,101,0,1,1
205,2016,6,2016-10-12,Appalachian State,@,Louisiana,W (24-0),15,26,57.7,201,1,36,177,4.9,2,62,378,6.1,8,9,3,20,5,50,0,1,1
206,2016,7,2016-10-22,Appalachian State,,Idaho,W (37-19),20,25,80.0,246,1,35,139,4.0,2,60,385,6.4,10,9,2,21,5,39,1,0,1
207,2016,8,2016-10-27,Appalachian State,@,Georgia Southern,W (34-10),16,27,59.3,199,0,43,335,7.8,4,70,534,7.6,10,16,2,28,4,36,1,2,3
208,2016,9,2016-11-05,Appalachian State,,Texas State,W (35-10),15,22,68.2,136,4,38,303,8.0,1,60,439,7.3,5,12,1,18,9,79,0,0,0
209,2016,10,2016-11-12,Appalachian State,@,Troy,L (24-28),14,28,50.0,167,0,38,167,4.4,2,66,334,5.1,9,9,0,18,6,61,1,1,2
210,2016,11,2016-11-19,Appalachian State,,Louisiana-Monroe,W (42-17),14,22,63.6,208,2,46,431,9.4,4,68,639,9.4,10,17,0,27,6,65,0,0,0
211,2016,12,2016-11-26,Appalachian State,@,New Mexico State,W (37-7),20,28,71.4,220,1,48,384,8.0,3,76,604,7.9,10,12,0,22,6,53,1,0,1
212,2016,13,2016-12-17,Appalachian State,N,Toledo*,W (31-28),14,33,42.4,119,1,47,304,6.5,2,80,423,5.3,9,14,2,25,2,21,0,0,0
213,2016,,13 Games,Appalachian State,,,,203,334,60.8,2327,16,566,3340,5.9,29,900,5667,6.3,114,156,21,291,79,754,5,8,13
214,2017,1,2017-09-02,Appalachian State,@,Georgia,L (10-31),21,32,65.6,148,0,32,136,4.3,1,64,284,4.4,6,6,0,12,11,105,0,0,0
215,2017,2,2017-09-09,Appalachian State,,Savannah State,W (54-7),16,22,72.7,345,5,47,274,5.8,2,69,619,9.0,13,12,2,27,8,106,2,0,2
216,2017,3,2017-09-16,Appalachian State,@,Texas State,W (20-13),17,28,60.7,167,1,29,116,4.0,1,57,283,5.0,9,7,3,19,6,57,1,0,1
217,2017,4,2017-09-23,Appalachian State,,Wake Forest,L (19-20),26,52,50.0,372,2,35,122,3.5,0,87,494,5.7,16,8,3,27,7,65,0,0,0
218,2017,5,2017-10-07,Appalachian State,,New Mexico State,W (45-31),11,22,50.0,75,1,38,350,9.2,5,60,425,7.1,5,12,0,17,11,81,1,2,3
219,2017,6,2017-10-14,Appalachian State,@,Idaho,W (23-20),19,26,73.1,155,3,38,121,3.2,0,64,276,4.3,3,10,1,14,0,0,1,1,2
220,2017,7,2017-10-21,Appalachian State,,Coastal Carolina,W (37-29),23,39,59.0,427,2,35,122,3.5,3,74,549,7.4,16,8,3,27,8,72,0,0,0
221,2017,8,2017-10-28,Appalachian State,@,Massachusetts,L (27-30),14,29,48.3,133,2,47,234,5.0,1,76,367,4.8,5,9,1,15,11,104,2,1,3
222,2017,9,2017-11-04,Appalachian State,@,Louisiana-Monroe,L (45-52),20,29,69.0,339,4,36,169,4.7,2,65,508,7.8,14,9,2,25,5,40,1,0,1
223,2017,10,2017-11-09,Appalachian State,,Georgia Southern,W (27-6),7,14,50.0,161,2,47,256,5.4,1,61,417,6.8,5,11,3,19,7,61,0,0,0
224,2017,11,2017-11-25,Appalachian State,@,Georgia State,W (31-10),15,23,65.2,107,2,46,323,7.0,2,69,430,6.2,7,12,1,20,8,65,0,2,2
225,2017,12,2017-12-02,Appalachian State,,Louisiana,W (63-14),18,23,78.3,251,4,47,357,7.6,5,70,608,8.7,10,17,0,27,5,50,0,0,0
226,2017,13,2017-12-23,Appalachian State,N,Toledo*,W (34-0),8,17,47.1,131,0,53,327,6.2,4,70,458,6.5,5,16,2,23,4,25,0,0,0
227,2017,,13 Games,Appalachian State,,,,215,356,60.4,2811,28,530,2907,5.5,27,886,5718,6.5,114,137,21,272,91,831,8,6,14
228,2014,1,2014-08-29,Arizona,,Nevada-Las Vegas,W (58-13),26,46,56.5,434,4,48,353,7.4,3,94,787,8.4,17,13,2,32,7,63,0,0,0
229,2014,2,2014-09-04,Arizona,@,Texas-San Antonio,W (26-23),17,32,53.1,231,1,44,223,5.1,1,76,454,6.0,8,11,3,22,8,73,0,0,0
230,2014,3,2014-09-13,Arizona,,Nevada,W (35-28),22,26,84.6,278,3,38,229,6.0,2,64,507,7.9,13,10,3,26,7,47,0,1,1
231,2014,4,2014-09-20,Arizona,,California,W (49-45),47,74,63.5,520,5,32,107,3.3,1,106,627,5.9,24,8,4,36,6,65,0,2,2
232,2014,5,2014-10-02,Arizona,@,Oregon,W (31-24),20,31,64.5,287,1,55,208,3.8,3,86,495,5.8,13,11,5,29,9,78,1,1,2
233,2014,6,2014-10-11,Arizona,,Southern California,L (26-28),43,72,59.7,395,1,30,78,2.6,2,102,473,4.6,23,6,5,34,4,35,1,0,1
234,2014,7,2014-10-25,Arizona,@,Washington State,W (59-37),26,38,68.4,294,5,36,157,4.4,1,74,451,6.1,12,8,5,25,8,89,1,0,1
235,2014,8,2014-11-01,Arizona,@,UCLA,L (7-17),18,48,37.5,175,1,31,80,2.6,0,79,255,3.2,10,5,4,19,4,40,0,1,1
236,2014,9,2014-11-08,Arizona,,Colorado,W (38-20),21,38,55.3,211,4,47,288,6.1,0,85,499,5.9,11,11,6,28,8,75,0,0,0
237,2014,10,2014-11-15,Arizona,,Washington,W (27-26),17,40,42.5,242,0,40,133,3.3,3,80,375,4.7,10,8,4,22,2,14,1,2,3
238,2014,11,2014-11-22,Arizona,@,Utah,W (42-10),11,22,50.0,222,0,47,298,6.3,4,69,520,7.5,9,12,0,21,6,57,1,0,1
239,2014,12,2014-11-28,Arizona,,Arizona State,W (42-35),15,21,71.4,208,2,37,125,3.4,3,58,333,5.7,6,7,0,13,9,123,2,0,2
240,2014,13,2014-12-05,Arizona,N,Oregon,L (13-51),9,26,34.6,113,1,35,111,3.2,1,61,224,3.7,3,7,0,10,8,67,1,1,2
241,2014,14,2014-12-31,Arizona,N,Boise State*,L (30-38),28,50,56.0,335,1,56,157,2.8,2,106,492,4.6,17,11,1,29,6,55,0,2,2
242,2014,,14 Games,Arizona,,,,320,564,56.7,3945,29,576,2547,4.4,26,1140,6492,5.7,176,128,42,346,92,881,8,10,18
243,2015,1,2015-09-03,Arizona,,Texas-San Antonio,W (42-32),22,36,61.1,229,4,38,163,4.3,0,74,392,5.3,12,8,5,25,8,76,1,0,1
244,2015,2,2015-09-12,Arizona,@,Nevada,W (44-20),25,34,73.5,269,2,43,301,7.0,4,77,570,7.4,10,10,4,24,3,30,1,0,1
245,2015,3,2015-09-19,Arizona,,Northern Arizona,W (77-13),26,39,66.7,293,4,41,499,12.2,7,80,792,9.9,15,19,2,36,4,50,0,0,0
246,2015,4,2015-09-26,Arizona,,UCLA,L (30-56),10,28,35.7,115,2,59,353,6.0,2,87,468,5.4,5,23,4,32,5,40,2,1,3
247,2015,5,2015-10-03,Arizona,@,Stanford,L (17-55),17,33,51.5,196,1,34,118,3.5,1,67,314,4.7,9,7,0,16,7,55,0,0,0
248,2015,6,2015-10-10,Arizona,,Oregon State,W (44-7),17,30,56.7,276,0,58,368,6.3,5,88,644,7.3,10,15,2,27,7,56,0,0,0
249,2015,7,2015-10-17,Arizona,@,Colorado,W (38-31),25,40,62.5,325,2,44,291,6.6,3,84,616,7.3,14,12,0,26,3,25,2,0,2
250,2015,8,2015-10-24,Arizona,,Washington State,L (42-45),24,37,64.9,307,2,32,176,5.5,3,69,483,7.0,13,8,3,24,5,40,1,0,1
251,2015,9,2015-10-31,Arizona,@,Washington,L (3-49),25,42,59.5,203,0,44,127,2.9,0,86,330,3.8,9,10,3,22,4,22,1,3,4
252,2015,10,2015-11-07,Arizona,@,Southern California,L (30-38),31,47,66.0,352,3,32,60,1.9,0,79,412,5.2,16,5,3,24,9,80,0,1,1
253,2015,11,2015-11-14,Arizona,,Utah,W (37-30),18,32,56.3,302,3,34,158,4.6,1,66,460,7.0,11,9,4,24,8,71,0,2,2
254,2015,12,2015-11-21,Arizona,@,Arizona State,L (37-52),20,43,46.5,340,2,34,109,3.2,1,77,449,5.8,13,5,1,19,7,58,1,2,3
255,2015,13,2015-12-19,Arizona,N,New Mexico*,W (45-37),13,24,54.2,329,2,32,174,5.4,4,56,503,9.0,10,7,2,19,4,30,1,1,2
256,2015,,13 Games,Arizona,,,,273,465,58.7,3536,27,525,2897,5.5,31,990,6433,6.5,147,138,33,318,74,633,10,10,20
257,2016,1,2016-09-03,Arizona,N,Brigham Young,L (16-18),20,30,66.7,213,0,26,115,4.4,2,56,328,5.9,9,6,2,17,4,20,0,2,2
258,2016,2,2016-09-10,Arizona,,Grambling State,W (31-21),15,30,50.0,223,1,47,222,4.7,3,77,445,5.8,8,11,2,21,7,65,0,0,0
259,2016,3,2016-09-17,Arizona,,Hawaii,W (47-28),16,21,76.2,235,1,49,347,7.1,5,70,582,8.3,8,19,1,28,11,105,0,0,0
260,2016,4,2016-09-24,Arizona,,Washington,L (28-35),19,31,61.3,167,1,43,308,7.2,3,74,475,6.4,8,12,3,23,2,30,2,1,3
261,2016,5,2016-10-01,Arizona,@,UCLA,L (24-45),13,31,41.9,145,3,49,242,4.9,0,80,387,4.8,7,11,4,22,5,40,0,0,0
262,2016,6,2016-10-08,Arizona,@,Utah,L (23-36),16,29,55.2,348,2,37,127,3.4,1,66,475,7.2,11,8,2,21,7,65,0,3,3
263,2016,7,2016-10-15,Arizona,,Southern California,L (14-48),11,26,42.3,142,1,44,201,4.6,1,70,343,4.9,7,8,5,20,4,35,2,2,4
264,2016,8,2016-10-29,Arizona,,Stanford,L (10-34),5,20,25.0,116,1,44,170,3.9,0,64,286,4.5,4,9,2,15,5,55,2,1,3
265,2016,9,2016-11-05,Arizona,@,Washington State,L (7-69),11,23,47.8,128,1,30,158,5.3,0,53,286,5.4,4,7,3,14,7,85,1,2,3
266,2016,10,2016-11-12,Arizona,,Colorado,L (24-49),12,26,46.2,155,0,52,257,4.9,3,78,412,5.3,7,12,4,23,13,138,1,0,1
267,2016,11,2016-11-19,Arizona,@,Oregon State,L (17-42),16,31,51.6,188,1,40,162,4.1,1,71,350,4.9,11,10,2,23,3,29,0,1,1
268,2016,12,2016-11-25,Arizona,,Arizona State,W (56-35),3,8,37.5,77,1,48,511,10.6,7,56,588,10.5,1,16,2,19,8,101,1,0,1
269,2016,,12 Games,Arizona,,,,157,306,51.3,2137,13,509,2820,5.5,26,815,4957,6.1,85,129,32,246,76,768,9,12,21
270,2017,1,2017-09-02,Arizona,,Northern Arizona,W (62-24),7,14,50.0,89,1,47,506,10.8,7,61,595,9.8,2,17,4,23,9,81,0,0,0
271,2017,2,2017-09-09,Arizona,,Houston,L (16-19),22,37,59.5,219,0,39,152,3.9,1,76,371,4.9,10,8,3,21,4,35,1,1,2
272,2017,3,2017-09-15,Arizona,@,Texas-El Paso,W (63-16),20,23,87.0,175,3,64,328,5.1,5,87,503,5.8,11,17,1,29,3,20,1,0,1
273,2017,4,2017-09-22,Arizona,,Utah,L (24-30),24,42,57.1,248,1,42,200,4.8,2,84,448,5.3,9,10,5,24,4,60,2,3,5
274,2017,5,2017-10-07,Arizona,@,Colorado,W (45-42),12,14,85.7,154,1,40,416,10.4,5,54,570,10.6,6,15,4,25,2,10,1,0,1
275,2017,6,2017-10-14,Arizona,,UCLA,W (47-30),9,13,69.2,148,1,61,457,7.5,4,74,605,8.2,5,18,4,27,11,113,0,0,0
276,2017,7,2017-10-21,Arizona,@,California,W (45-44),10,15,66.7,166,2,46,345,7.5,4,61,511,8.4,7,15,2,24,8,88,0,1,1
277,2017,8,2017-10-28,Arizona,,Washington State,W (58-37),10,17,58.8,275,2,34,310,9.1,4,51,585,11.5,8,5,0,13,2,20,2,1,3
278,2017,9,2017-11-04,Arizona,@,Southern California,L (35-49),14,31,45.2,146,2,43,234,5.4,2,74,380,5.1,8,13,4,25,3,32,1,2,3
279,2017,10,2017-11-11,Arizona,,Oregon State,W (49-28),5,7,71.4,68,0,55,534,9.7,7,62,602,9.7,4,21,1,26,5,70,0,1,1
280,2017,11,2017-11-18,Arizona,@,Oregon,L (28-48),18,35,51.4,159,1,45,171,3.8,3,80,330,4.1,8,13,6,27,8,94,0,2,2
281,2017,12,2017-11-25,Arizona,@,Arizona State,L (30-42),15,21,71.4,194,0,51,245,4.8,4,72,439,6.1,7,13,4,23,4,45,0,1,1
282,2017,13,2017-12-27,Arizona,N,Purdue*,L (35-38),17,26,65.4,302,5,43,128,3.0,0,69,430,6.2,12,5,2,19,6,47,1,1,2
283,2017,,13 Games,Arizona,,,,183,295,62.0,2343,19,610,4026,6.6,48,905,6369,7.0,97,170,40,306,69,715,9,13,22
284,2014,1,2014-08-28,Arizona State,,Weber State,W (45-14),24,39,61.5,303,2,45,267,5.9,4,84,570,6.8,20,9,3,32,4,30,0,0,0
285,2014,2,2014-09-06,Arizona State,@,New Mexico,W (58-23),12,21,57.1,198,2,48,423,8.8,6,69,621,9.0,7,18,0,25,4,30,1,0,1
286,2014,3,2014-09-13,Arizona State,@,Colorado,W (38-24),15,25,60.0,203,3,35,223,6.4,2,60,426,7.1,8,8,2,18,8,59,0,0,0
287,2014,4,2014-09-25,Arizona State,,UCLA,L (27-62),42,69,60.9,488,3,36,138,3.8,0,105,626,6.0,26,9,3,38,6,59,2,2,4
288,2014,5,2014-10-04,Arizona State,@,Southern California,W (38-34),27,46,58.7,510,5,22,31,1.4,0,68,541,8.0,19,1,4,24,5,36,0,0,0
289,2014,6,2014-10-18,Arizona State,,Stanford,W (26-10),24,34,70.6,242,1,46,114,2.5,1,80,356,4.5,14,8,1,23,2,9,0,0,0
290,2014,7,2014-10-25,Arizona State,@,Washington,W (24-10),14,25,56.0,180,2,43,105,2.4,0,68,285,4.2,8,6,0,14,5,20,0,1,1
291,2014,8,2014-11-01,Arizona State,,Utah,W (19-16),18,33,54.5,205,1,43,239,5.6,0,76,444,5.8,9,10,1,20,6,55,0,2,2
292,2014,9,2014-11-08,Arizona State,,Notre Dame,W (55-31),17,28,60.7,224,3,45,188,4.2,2,73,412,5.6,10,10,2,22,3,19,0,1,1
293,2014,10,2014-11-15,Arizona State,@,Oregon State,L (27-35),22,44,50.0,264,2,31,103,3.3,0,75,367,4.9,11,7,2,20,5,54,0,2,2
294,2014,11,2014-11-22,Arizona State,,Washington State,W (52-31),15,25,60.0,232,4,36,98,2.7,3,61,330,5.4,8,7,1,16,5,25,0,0,0
295,2014,12,2014-11-28,Arizona State,@,Arizona,L (35-42),27,44,61.4,267,4,43,113,2.6,0,87,380,4.4,13,9,5,27,3,15,1,1,2
296,2014,13,2014-12-27,Arizona State,N,Duke*,W (36-31),24,34,70.6,240,2,35,152,4.3,2,69,392,5.7,13,8,1,22,2,10,0,0,0
297,2014,,13 Games,Arizona State,,,,281,467,60.2,3556,34,508,2194,4.3,20,975,5750,5.9,166,110,25,301,58,421,4,9,13
298,2015,1,2015-09-05,Arizona State,N,Texas A&M,L (17-38),25,41,61.0,199,1,41,92,2.2,1,82,291,3.5,7,9,3,19,6,45,2,0,2
299,2015,2,2015-09-12,Arizona State,,Cal Poly,W (35-21),23,35,65.7,283,3,45,248,5.5,2,80,531,6.6,15,12,1,28,3,45,1,1,2
300,2015,3,2015-09-18,Arizona State,,New Mexico,W (34-10),22,37,59.5,317,3,30,132,4.4,1,67,449,6.7,10,9,0,19,3,25,1,0,1
301,2015,4,2015-09-26,Arizona State,,Southern California,L (14-42),23,44,52.3,272,0,35,182,5.2,2,79,454,5.7,15,8,3,26,2,25,3,1,4
302,2015,5,2015-10-03,Arizona State,@,UCLA,W (38-23),27,44,61.4,273,2,46,192,4.2,2,90,465,5.2,14,10,1,25,4,39,0,1,1
303,2015,6,2015-10-10,Arizona State,,Colorado,W (48-23),20,31,64.5,260,5,40,231,5.8,1,71,491,6.9,10,8,3,21,3,19,0,1,1
304,2015,7,2015-10-17,Arizona State,@,Utah,L (18-34),20,42,47.6,242,0,28,15,0.5,0,70,257,3.7,10,2,0,12,6,46,1,1,2
305,2015,8,2015-10-29,Arizona State,,Oregon,L (55-61),32,53,60.4,398,5,55,344,6.3,2,108,742,6.9,19,16,2,37,9,70,0,2,2
306,2015,9,2015-11-07,Arizona State,@,Washington State,L (24-38),28,45,62.2,256,0,42,202,4.8,3,87,458,5.3,13,11,0,24,3,25,1,1,2
307,2015,10,2015-11-14,Arizona State,,Washington,W (27-17),22,34,64.7,253,1,43,144,3.3,2,77,397,5.2,12,6,1,19,3,39,0,0,0
308,2015,11,2015-11-21,Arizona State,,Arizona,W (52-37),21,32,65.6,315,2,48,250,5.2,3,80,565,7.1,11,10,3,24,5,50,1,1,2
309,2015,12,2015-11-28,Arizona State,@,California,L (46-48),27,43,62.8,395,4,52,191,3.7,0,95,586,6.2,17,10,1,28,7,45,0,0,0
310,2015,13,2016-01-02,Arizona State,N,West Virginia*,L (42-43),29,52,55.8,418,4,32,102,3.2,0,84,520,6.2,17,5,1,23,6,45,0,0,0
311,2015,,13 Games,Arizona State,,,,319,533,59.8,3881,30,537,2325,4.3,19,1070,6206,5.8,170,116,19,305,60,518,10,9,19
312,2016,1,2016-09-03,Arizona State,,Northern Arizona,W (44-13),20,27,74.1,180,0,46,276,6.0,5,73,456,6.2,8,18,1,27,5,40,1,1,2
313,2016,2,2016-09-10,Arizona State,,Texas Tech,W (68-55),28,37,75.7,351,2,53,301,5.7,7,90,652,7.2,18,11,5,34,6,60,0,0,0
314,2016,3,2016-09-16,Arizona State,@,Texas-San Antonio,W (32-28),15,31,48.4,264,2,48,205,4.3,1,79,469,5.9,11,12,2,25,3,30,2,1,3
315,2016,4,2016-09-24,Arizona State,,California,W (51-41),21,30,70.0,290,1,50,164,3.3,3,80,454,5.7,12,9,2,23,5,44,0,1,1
316,2016,5,2016-10-01,Arizona State,@,Southern California,L (20-41),19,37,51.4,228,1,33,75,2.3,1,70,303,4.3,10,4,2,16,5,75,0,1,1
317,2016,6,2016-10-08,Arizona State,,UCLA,W (23-20),20,39,51.3,196,1,34,79,2.3,1,73,275,3.8,12,3,0,15,5,64,1,2,3
318,2016,7,2016-10-15,Arizona State,@,Colorado,L (16-40),13,35,37.1,149,1,28,50,1.8,0,63,199,3.2,6,1,0,7,2,20,0,1,1
319,2016,8,2016-10-22,Arizona State,,Washington State,L (32-37),14,24,58.3,167,0,34,117,3.4,3,58,284,4.9,7,4,1,12,4,40,1,0,1
320,2016,9,2016-10-29,Arizona State,@,Oregon,L (35-54),23,40,57.5,329,2,36,139,3.9,3,76,468,6.2,14,8,0,22,6,49,0,3,3
321,2016,10,2016-11-10,Arizona State,,Utah,L (26-49),20,32,62.5,355,1,47,41,0.9,2,79,396,5.0,10,8,0,18,8,75,0,2,2
322,2016,11,2016-11-19,Arizona State,@,Washington,L (18-44),21,33,63.6,230,2,27,15,0.6,0,60,245,4.1,10,1,3,14,9,66,1,1,2
323,2016,12,2016-11-25,Arizona State,@,Arizona,L (35-56),43,60,71.7,372,3,38,120,3.2,1,98,492,5.0,16,9,6,31,8,61,1,1,2
324,2016,,12 Games,Arizona State,,,,257,425,60.5,3111,16,474,1582,3.3,27,899,4693,5.2,134,88,22,244,66,624,7,14,21
325,2017,1,2017-08-31,Arizona State,,New Mexico State,W (37-31),24,30,80.0,321,2,40,79,2.0,2,70,400,5.7,13,5,1,19,1,10,0,0,0
326,2017,2,2017-09-09,Arizona State,,San Diego State,L (20-30),20,33,60.6,298,2,31,44,1.4,1,64,342,5.3,10,3,2,15,5,50,1,0,1
327,2017,3,2017-09-16,Arizona State,@,Texas Tech,L (45-52),27,41,65.9,326,3,44,168,3.8,3,85,494,5.8,13,11,3,27,4,37,1,0,1
328,2017,4,2017-09-23,Arizona State,,Oregon,W (37-35),24,39,61.5,347,1,53,142,2.7,3,92,489,5.3,14,8,1,23,6,65,1,0,1
329,2017,5,2017-09-30,Arizona State,@,Stanford,L (24-34),16,25,64.0,195,1,46,214,4.7,2,71,409,5.8,7,12,3,22,3,25,0,2,2
330,2017,6,2017-10-14,Arizona State,,Washington,W (13-7),29,41,70.7,245,0,32,40,1.3,1,73,285,3.9,10,7,0,17,1,5,0,0,0
331,2017,7,2017-10-21,Arizona State,@,Utah,W (30-10),19,29,65.5,140,0,46,205,4.5,2,75,345,4.6,7,13,3,23,2,25,0,1,1
332,2017,8,2017-10-28,Arizona State,,Southern California,L (17-48),18,31,58.1,278,1,29,88,3.0,1,60,366,6.1,9,5,1,15,10,99,0,1,1
333,2017,9,2017-11-04,Arizona State,,Colorado,W (41-30),18,34,52.9,202,2,54,381,7.1,3,88,583,6.6,8,18,1,27,1,5,0,0,0
334,2017,10,2017-11-11,Arizona State,@,UCLA,L (37-44),21,37,56.8,290,1,61,294,4.8,2,98,584,6.0,12,17,0,29,4,41,0,1,1
335,2017,11,2017-11-18,Arizona State,@,Oregon State,W (40-24),12,19,63.2,167,2,49,286,5.8,3,68,453,6.7,6,15,3,24,7,71,1,0,1
336,2017,12,2017-11-25,Arizona State,,Arizona,W (42-30),11,17,64.7,163,3,49,227,4.6,3,66,390,5.9,7,10,1,19,5,50,1,1,2
337,2017,13,2017-12-29,Arizona State,N,North Carolina State*,L (31-52),25,40,62.5,352,3,30,117,3.9,1,70,469,6.7,15,8,1,24,1,4,1,3,4
338,2017,,13 Games,Arizona State,,,,264,416,63.5,3324,21,564,2285,4.1,27,980,5609,5.7,131,132,20,284,50,487,6,9,15
339,2014,1,2014-08-30,Arkansas,@,Auburn,L (21-45),18,31,58.1,175,2,29,153,5.3,1,60,328,5.5,9,9,2,20,4,40,0,1,1
340,2014,2,2014-09-06,Arkansas,,Nicholls State,W (73-7),8,14,57.1,189,4,40,495,12.4,6,54,684,12.7,7,19,0,26,7,69,0,1,1
341,2014,3,2014-09-13,Arkansas,@,Texas Tech,W (49-28),6,12,50.0,61,0,68,438,6.4,7,80,499,6.2,5,24,3,32,2,15,2,0,2
342,2014,4,2014-09-20,Arkansas,,Northern Illinois,W (52-14),16,23,69.6,215,2,45,212,4.7,3,68,427,6.3,11,11,2,24,4,30,0,0,0
343,2014,5,2014-09-27,Arkansas,N,Texas A&M,L (28-35),15,27,55.6,199,1,47,285,6.1,3,74,484,6.5,7,13,2,22,8,76,1,0,1
344,2014,6,2014-10-11,Arkansas,,Alabama,L (13-14),21,40,52.5,246,1,39,89,2.3,1,79,335,4.2,12,5,1,18,4,28,2,1,3
345,2014,7,2014-10-18,Arkansas,N,Georgia,L (32-45),28,45,62.2,296,3,37,126,3.4,2,82,422,5.1,13,9,7,29,7,79,2,2,4
346,2014,8,2014-10-25,Arkansas,,Alabama-Birmingham,W (45-17),16,26,61.5,211,3,46,273,5.9,3,72,484,6.7,10,14,0,24,2,9,1,0,1
347,2014,9,2014-11-01,Arkansas,@,Mississippi State,L (10-17),22,44,50.0,238,0,38,163,4.3,1,82,401,4.9,13,8,0,21,6,40,0,1,1
348,2014,10,2014-11-15,Arkansas,,Louisiana State,W (17-0),16,27,59.3,169,0,38,95,2.5,2,65,264,4.1,10,6,1,17,4,43,0,0,0
349,2014,11,2014-11-22,Arkansas,,Mississippi,W (30-0),8,17,47.1,152,1,50,159,3.2,1,67,311,4.6,7,10,0,17,6,44,1,0,1
350,2014,12,2014-11-28,Arkansas,@,Missouri,L (14-21),13,30,43.3,133,2,30,155,5.2,0,60,288,4.8,9,7,2,18,12,93,2,0,2
351,2014,13,2014-12-29,Arkansas,N,Texas*,W (31-7),12,23,52.2,160,2,50,191,3.8,1,73,351,4.8,7,11,2,20,2,15,0,0,0
352,2014,,13 Games,Arkansas,,,,199,359,55.4,2444,21,557,2834,5.1,31,916,5278,5.8,120,146,22,288,68,581,11,6,17
353,2015,1,2015-09-05,Arkansas,,Texas-El Paso,W (48-13),14,20,70.0,308,4,34,182,5.4,2,54,490,9.1,11,7,0,18,6,68,0,0,0
354,2015,2,2015-09-12,Arkansas,N,Toledo,L (12-16),32,53,60.4,412,0,31,103,3.3,1,84,515,6.1,20,9,1,30,9,85,0,1,1
355,2015,3,2015-09-19,Arkansas,,Texas Tech,L (24-35),16,21,76.2,196,2,43,228,5.3,1,64,424,6.6,10,12,1,23,5,43,1,1,2
356,2015,4,2015-09-26,Arkansas,N,Texas A&M,L (21-28),20,25,80.0,225,1,42,232,5.5,2,67,457,6.8,11,13,1,25,11,93,1,1,2
357,2015,5,2015-10-03,Arkansas,@,Tennessee,W (24-20),11,24,45.8,219,1,49,288,5.9,2,73,507,6.9,10,12,1,23,3,20,0,0,0
358,2015,6,2015-10-10,Arkansas,@,Alabama,L (14-27),15,32,46.9,176,2,25,44,1.8,0,57,220,3.9,8,1,1,10,7,44,0,1,1
359,2015,7,2015-10-24,Arkansas,,Auburn,W (54-46),20,32,62.5,244,3,49,213,4.3,4,81,457,5.6,14,14,1,29,3,25,0,1,1
360,2015,8,2015-10-31,Arkansas,,Tennessee-Martin,W (63-28),15,20,75.0,300,3,36,291,8.1,6,56,591,10.6,10,12,0,22,3,25,0,0,0
361,2015,9,2015-11-07,Arkansas,@,Mississippi,W (53-52),33,45,73.3,442,6,39,163,4.2,1,84,605,7.2,24,9,1,34,2,20,0,0,0
362,2015,10,2015-11-14,Arkansas,@,Louisiana State,W (31-14),9,16,56.3,141,1,40,299,7.5,3,56,440,7.9,7,10,0,17,2,20,1,1,2
363,2015,11,2015-11-21,Arkansas,,Mississippi State,L (50-51),30,43,69.8,406,7,29,73,2.5,0,72,479,6.7,21,2,1,24,1,9,0,0,0
364,2015,12,2015-11-27,Arkansas,,Missouri,W (28-3),11,17,64.7,102,0,52,208,4.0,4,69,310,4.5,6,12,1,19,1,5,0,1,1
365,2015,13,2016-01-02,Arkansas,N,Kansas State*,W (45-23),20,26,76.9,315,1,42,254,6.0,5,68,569,8.4,14,16,0,30,2,20,0,1,1
366,2015,,13 Games,Arkansas,,,,246,374,65.8,3486,31,511,2578,5.0,31,885,6064,6.9,166,129,9,304,55,477,3,8,11
367,2016,1,2016-09-03,Arkansas,,Louisiana Tech,W (21-20),20,29,69.0,191,2,40,106,2.7,1,69,297,4.3,12,8,1,21,4,35,0,2,2
368,2016,2,2016-09-10,Arkansas,@,Texas Christian,W (41-38),17,29,58.6,223,3,43,180,4.2,1,72,403,5.6,11,9,0,20,5,45,0,0,0
369,2016,3,2016-09-17,Arkansas,,Texas State,W (42-3),16,22,72.7,241,2,44,226,5.1,3,66,467,7.1,9,15,2,26,7,40,1,0,1
370,2016,4,2016-09-24,Arkansas,N,Texas A&M,L (24-45),28,42,66.7,371,2,40,120,3.0,1,82,491,6.0,17,4,6,27,7,62,3,0,3
371,2016,5,2016-10-01,Arkansas,,Alcorn State,W (52-10),13,18,72.2,206,3,38,353,9.3,3,56,559,10.0,8,17,0,25,4,45,1,0,1
372,2016,6,2016-10-08,Arkansas,,Alabama,L (30-49),25,48,52.1,400,3,36,73,2.0,1,84,473,5.6,13,7,5,25,6,60,2,3,5
373,2016,7,2016-10-15,Arkansas,,Mississippi,W (34-30),19,32,59.4,229,3,51,200,3.9,1,83,429,5.2,13,12,2,27,6,71,0,1,1
374,2016,8,2016-10-22,Arkansas,@,Auburn,L (3-56),18,33,54.5,190,0,31,25,0.8,0,64,215,3.4,10,4,0,14,4,29,1,1,2
375,2016,9,2016-11-05,Arkansas,,Florida,W (31-10),15,26,57.7,243,1,49,223,4.6,2,75,466,6.2,10,9,3,22,9,97,0,1,1
376,2016,10,2016-11-12,Arkansas,,Louisiana State,L (10-38),15,31,48.4,210,1,24,81,3.4,0,55,291,5.3,8,4,1,13,7,56,1,2,3
377,2016,11,2016-11-19,Arkansas,@,Mississippi State,W (58-42),19,26,73.1,304,3,40,359,9.0,5,66,663,10.0,14,13,0,27,1,10,0,0,0
378,2016,12,2016-11-25,Arkansas,@,Missouri,L (24-28),24,39,61.5,348,1,46,155,3.4,2,85,503,5.9,14,13,0,27,8,55,0,2,2
379,2016,13,2016-12-29,Arkansas,N,Virginia Tech*,L (24-35),18,31,58.1,278,2,34,36,1.1,1,65,314,4.8,11,1,2,16,12,70,1,3,4
380,2016,,13 Games,Arkansas,,,,247,406,60.8,3434,26,516,2137,4.1,21,922,5571,6.0,150,116,22,290,80,675,10,15,25
381,2017,1,2017-08-31,Arkansas,N,Florida A&M,W (49-7),16,22,72.7,179,2,45,236,5.2,4,67,415,6.2,9,16,1,26,2,20,0,1,1
382,2017,2,2017-09-09,Arkansas,,Texas Christian,L (7-28),9,23,39.1,138,1,31,129,4.2,0,54,267,4.9,6,5,2,13,5,49,1,0,1
383,2017,3,2017-09-23,Arkansas,N,Texas A&M,L (43-50),13,27,48.1,231,3,45,226,5.0,3,72,457,6.3,8,12,1,21,9,69,0,1,1
384,2017,4,2017-09-30,Arkansas,,New Mexico State,W (42-24),19,26,73.1,264,3,51,230,4.5,3,77,494,6.4,13,13,3,29,3,35,0,1,1
385,2017,5,2017-10-07,Arkansas,@,South Carolina,L (22-48),20,37,54.1,224,2,32,106,3.3,1,69,330,4.8,11,7,1,19,4,25,2,2,4
386,2017,6,2017-10-14,Arkansas,@,Alabama,L (9-41),23,43,53.5,200,1,29,27,0.9,0,72,227,3.2,9,3,3,15,5,25,0,1,1
387,2017,7,2017-10-21,Arkansas,,Auburn,L (20-52),15,26,57.7,163,0,42,171,4.1,1,68,334,4.9,7,10,2,19,7,50,3,0,3
388,2017,8,2017-10-28,Arkansas,@,Mississippi,W (38-37),19,30,63.3,189,3,53,260,4.9,1,83,449,5.4,10,15,2,27,1,10,1,1,2
389,2017,9,2017-11-04,Arkansas,,Coastal Carolina,W (39-38),16,25,64.0,264,1,35,259,7.4,4,60,523,8.7,8,13,0,21,5,52,1,0,1
390,2017,10,2017-11-11,Arkansas,@,Louisiana State,L (10-33),16,33,48.5,176,0,34,142,4.2,1,67,318,4.7,10,6,1,17,5,59,0,1,1
391,2017,11,2017-11-18,Arkansas,,Mississippi State,L (21-28),12,18,66.7,124,0,34,97,2.9,2,52,221,4.3,7,3,2,12,4,35,1,0,1
392,2017,12,2017-11-24,Arkansas,,Missouri,L (45-48),14,30,46.7,313,2,31,133,4.3,4,61,446,7.3,10,7,2,19,8,76,0,1,1
393,2017,,12 Games,Arkansas,,,,192,340,56.5,2465,18,462,2016,4.4,24,802,4481,5.6,108,110,20,238,58,505,9,9,18
394,2014,1,2014-08-30,Arkansas State,,Montana State,W (37-10),20,30,66.7,264,1,49,283,5.8,3,79,547,6.9,10,13,0,23,4,25,2,0,2
395,2014,2,2014-09-06,Arkansas State,@,Tennessee,L (19-34),22,36,61.1,190,1,42,141,3.4,2,78,331,4.2,9,8,0,17,9,75,1,0,1
396,2014,3,2014-09-13,Arkansas State,@,Miami (FL),L (20-41),23,42,54.8,236,1,47,93,2.0,2,89,329,3.7,15,6,3,24,9,84,1,1,2
397,2014,4,2014-09-20,Arkansas State,,Utah State,W (21-14),19,33,57.6,190,1,47,126,2.7,2,80,316,4.0,9,10,3,22,8,62,3,1,4
398,2014,5,2014-10-04,Arkansas State,,Louisiana-Monroe,W (28-14),21,36,58.3,284,1,51,288,5.6,3,87,572,6.6,11,15,3,29,11,110,1,2,3
399,2014,6,2014-10-11,Arkansas State,@,Georgia State,W (52-10),22,30,73.3,234,3,53,384,7.2,4,83,618,7.4,12,20,0,32,5,40,2,0,2
400,2014,7,2014-10-21,Arkansas State,@,Louisiana,L (40-55),27,39,69.2,342,3,37,253,6.8,2,76,595,7.8,12,9,1,22,7,51,0,1,1
401,2014,8,2014-11-01,Arkansas State,@,Idaho,W (44-28),21,29,72.4,244,0,48,198,4.1,5,77,442,5.7,11,8,1,20,11,99,1,0,1
402,2014,9,2014-11-08,Arkansas State,,South Alabama,W (45-10),17,34,50.0,186,2,49,214,4.4,3,83,400,4.8,8,13,1,22,8,77,0,0,0
403,2014,10,2014-11-15,Arkansas State,,Appalachian State,L (32-37),14,29,48.3,147,3,30,167,5.6,1,59,314,5.3,5,7,2,14,5,54,1,0,1
404,2014,11,2014-11-20,Arkansas State,@,Texas State,L (27-45),31,57,54.4,366,2,40,132,3.3,1,97,498,5.1,16,7,2,25,8,80,0,1,1
405,2014,12,2014-11-29,Arkansas State,,New Mexico State,W (68-35),16,22,72.7,295,2,51,469,9.2,7,73,764,10.5,10,22,2,34,14,107,0,2,2
406,2014,13,2015-01-04,Arkansas State,N,Toledo*,L (44-63),23,31,74.2,403,5,32,65,2.0,0,63,468,7.4,11,7,2,20,5,41,2,0,2
407,2014,,13 Games,Arkansas State,,,,276,448,61.6,3381,25,576,2813,4.9,35,1024,6194,6.0,139,145,20,304,104,905,14,8,22
408,2015,1,2015-09-05,Arkansas State,@,Southern California,L (6-55),17,37,45.9,193,0,50,208,4.2,1,87,401,4.6,8,11,0,19,8,88,2,2,4
409,2015,2,2015-09-12,Arkansas State,,Missouri,L (20-27),14,30,46.7,124,2,45,93,2.1,0,75,217,2.9,6,10,2,18,7,80,0,3,3
410,2015,3,2015-09-19,Arkansas State,,Missouri State,W (70-7),23,26,88.5,280,3,46,344,7.5,6,72,624,8.7,13,13,1,27,7,49,1,0,1
411,2015,4,2015-09-26,Arkansas State,@,Toledo,L (7-37),18,35,51.4,223,0,24,-14,-0.6,0,59,209,3.5,10,0,1,11,8,90,2,3,5
412,2015,5,2015-10-03,Arkansas State,,Idaho,W (49-35),16,25,64.0,188,1,53,333,6.3,6,78,521,6.7,11,16,2,29,15,169,1,1,2
413,2015,6,2015-10-13,Arkansas State,@,South Alabama,W (49-31),10,18,55.6,119,2,53,226,4.3,2,71,345,4.9,6,1,1,17,8,80,1,0,1
414,2015,7,2015-10-20,Arkansas State,,Louisiana,W (37-27),9,20,45.0,129,2,52,306,5.9,2,72,435,6.0,6,14,2,22,3,20,0,1,1
415,2015,8,2015-10-31,Arkansas State,,Georgia State,W (48-34),21,29,72.4,224,3,52,296,5.7,4,81,520,6.4,10,14,4,28,9,64,1,2,3
416,2015,9,2015-11-05,Arkansas State,@,Appalachian State,W (40-27),14,25,56.0,208,1,52,309,5.9,2,77,517,6.7,7,17,0,24,2,5,0,0,0
417,2015,10,2015-11-14,Arkansas State,@,Louisiana-Monroe,W (59-21),15,32,46.9,300,5,50,148,3.0,2,82,448,5.5,8,9,2,19,11,105,1,0,1
418,2015,11,2015-11-28,Arkansas State,@,New Mexico State,W (52-28),23,43,53.5,367,2,46,238,5.2,3,89,605,6.8,15,13,2,30,11,118,0,1,1
419,2015,12,2015-12-05,Arkansas State,,Texas State,W (55-17),12,16,75.0,192,2,46,353,7.7,5,62,545,8.8,9,13,1,23,9,67,1,0,1
420,2015,13,2015-12-19,Arkansas State,N,Louisiana Tech*,L (28-47),15,29,51.7,146,0,39,177,4.5,2,68,323,4.8,6,11,6,23,11,109,1,2,3
421,2015,,13 Games,Arkansas State,,,,207,365,56.7,2693,23,608,3017,5.0,35,973,5710,5.9,115,142,24,290,109,1044,11,15,26
422,2016,1,2016-09-02,Arkansas State,,Toledo,L (10-31),11,25,44.0,124,0,38,142,3.7,1,63,266,4.2,3,8,2,13,6,48,0,0,0
423,2016,2,2016-09-10,Arkansas State,@,Auburn,L (14-51),19,30,63.3,260,0,35,66,1.9,2,65,326,5.0,9,4,1,14,10,71,0,0,0
424,2016,3,2016-09-16,Arkansas State,@,Utah State,L (20-34),20,33,60.6,287,1,31,70,2.3,1,64,357,5.6,11,3,2,16,18,129,1,2,3
425,2016,4,2016-09-24,Arkansas State,,Central Arkansas,L (23-28),21,38,55.3,424,3,34,45,1.3,0,72,469,6.5,14,6,0,20,8,63,2,2,4
426,2016,5,2016-10-05,Arkansas State,,Georgia Southern,W (27-26),16,28,57.1,182,2,49,343,7.0,1,77,525,6.8,9,16,2,27,2,20,3,2,5
427,2016,6,2016-10-15,Arkansas State,,South Alabama,W (17-7),9,13,69.2,93,0,54,204,3.8,1,67,297,4.4,14,20,2,36,4,25,0,1,1
428,2016,7,2016-10-29,Arkansas State,,Louisiana-Monroe,W (51-10),24,41,58.5,316,5,31,118,3.8,2,72,434,6.0,16,5,3,24,7,58,0,0,0
429,2016,8,2016-11-03,Arkansas State,@,Georgia State,W (31-16),15,35,42.9,212,0,41,93,2.3,2,76,305,4.0,10,6,1,17,6,50,1,0,1
430,2016,9,2016-11-12,Arkansas State,,New Mexico State,W (41-22),22,29,75.9,293,3,38,160,4.2,2,67,453,6.8,10,8,0,18,6,51,0,1,1
431,2016,10,2016-11-17,Arkansas State,@,Troy,W (35-3),14,26,53.8,180,1,51,208,4.1,3,77,388,5.0,6,12,1,19,9,57,0,0,0
432,2016,11,2016-11-26,Arkansas State,@,Louisiana,L (19-24),35,57,61.4,393,1,33,128,3.9,1,90,521,5.8,20,8,0,28,6,58,0,1,1
433,2016,12,2016-12-03,Arkansas State,@,Texas State,W (36-14),13,21,61.9,179,2,44,178,4.0,3,65,357,5.5,7,9,2,18,10,65,0,0,0
434,2016,13,2016-12-17,Arkansas State,N,Central Florida*,W (31-13),12,26,46.2,205,3,38,29,0.8,0,64,234,3.7,5,3,0,8,15,140,1,0,1
435,2016,,13 Games,Arkansas State,,,,231,402,57.5,3148,21,517,1784,3.5,19,919,4932,5.4,134,108,16,258,107,835,8,9,17
436,2017,1,2017-09-02,Arkansas State,@,Nebraska,L (36-43),46,68,67.6,415,3,21,82,3.9,0,89,497,5.6,25,5,2,32,9,63,0,2,2
437,2017,2,2017-09-16,Arkansas State,,Arkansas-Pine Bluff,W (48-3),26,34,76.5,356,6,37,137,3.7,1,71,493,6.9,16,9,1,26,5,39,0,0,0
438,2017,3,2017-09-23,Arkansas State,@,Southern Methodist,L (21-44),23,43,53.5,284,2,29,143,4.9,1,72,427,5.9,14,6,0,20,12,93,1,1,2
439,2017,4,2017-10-04,Arkansas State,@,Georgia Southern,W (43-25),12,26,46.2,316,4,35,65,1.9,2,61,381,6.2,11,6,2,19,5,55,1,4,5
440,2017,5,2017-10-14,Arkansas State,,Coastal Carolina,W (51-17),24,37,64.9,286,5,37,189,5.1,0,74,475,6.4,16,10,2,27,6,59,0,0,0
441,2017,6,2017-10-19,Arkansas State,,Louisiana,W (47-3),24,39,61.5,309,2,42,264,6.3,3,81,573,7.1,12,14,4,30,7,60,1,0,1
442,2017,7,2017-10-28,Arkansas State,@,New Mexico State,W (37-21),25,40,62.5,297,4,40,120,3.0,1,80,417,5.2,16,6,5,27,13,126,1,1,2
443,2017,8,2017-11-11,Arkansas State,@,South Alabama,L (19-24),28,45,62.2,299,2,33,66,2.0,0,78,365,4.7,12,9,2,23,7,40,2,4,6
444,2017,9,2017-11-18,Arkansas State,,Texas State,W (30-12),20,33,60.6,229,1,61,233,3.8,3,94,462,4.9,10,14,1,25,6,39,0,0,0
445,2017,10,2017-11-25,Arkansas State,@,Louisiana-Monroe,W (67-50),26,38,68.4,520,4,44,261,5.9,4,82,781,9.5,21,8,2,31,10,108,0,1,1
446,2017,11,2017-12-02,Arkansas State,,Troy,L (25-32),31,50,62.0,437,2,44,169,3.8,1,94,606,6.4,21,9,2,32,7,65,0,3,3
447,2017,12,2017-12-16,Arkansas State,N,Middle Tennessee State*,L (30-35),32,58,55.2,358,3,39,104,2.7,1,97,462,4.8,17,9,4,30,7,81,2,1,3
448,2017,,12 Games,Arkansas State,,,,317,511,62.0,4106,38,462,1833,4.0,17,973,5939,6.1,191,105,27,322,94,828,8,17,25
449,2014,1,2014-09-06,Army,,Buffalo,W (47-39),7,7,100.0,125,0,54,341,6.3,7,61,466,7.6,4,13,0,17,12,105,2,0,2
450,2014,2,2014-09-13,Army,@,Stanford,L (0-35),3,5,60.0,9,0,56,198,3.5,0,61,207,3.4,1,10,1,12,2,20,1,1,2
451,2014,3,2014-09-20,Army,@,Wake Forest,L (21-24),3,5,60.0,18,1,59,341,5.8,2,64,359,5.6,0,16,1,17,7,57,2,0,2
452,2014,4,2014-09-27,Army,@,Yale,L (43-49),12,21,57.1,211,1,53,386,7.3,4,74,597,8.1,8,15,0,23,8,70,0,0,0
453,2014,5,2014-10-04,Army,,Ball State,W (33-24),2,5,40.0,48,0,69,425,6.2,4,74,473,6.4,1,21,2,24,1,15,1,0,1
454,2014,6,2014-10-11,Army,,Rice,L (21-41),6,14,42.9,91,1,54,250,4.6,2,68,341,5.0,2,15,2,19,2,24,2,0,2
455,2014,7,2014-10-18,Army,@,Kent State,L (17-39),5,15,33.3,35,0,56,295,5.3,2,71,330,4.6,1,17,1,19,5,38,0,1,1
456,2014,8,2014-11-01,Army,,Air Force,L (6-23),3,13,23.1,47,0,38,122,3.2,0,51,169,3.3,1,7,0,8,3,41,1,0,1
457,2014,9,2014-11-08,Army,N,Connecticut,W (35-21),2,3,66.7,38,0,59,325,5.5,4,62,363,5.9,2,20,1,23,3,13,1,0,1
458,2014,10,2014-11-15,Army,@,Western Kentucky,L (24-52),3,6,50.0,40,0,57,293,5.1,3,63,333,5.3,2,13,3,18,3,20,0,0,0
459,2014,11,2014-11-22,Army,,Fordham,W (42-31),2,4,50.0,48,0,64,382,6.0,5,68,430,6.3,1,21,0,22,1,5,0,0,0
460,2014,12,2014-12-13,Army,N,Navy,L (10-17),2,7,28.6,37,0,45,198,4.4,0,52,235,4.5,2,13,0,15,2,10,1,0,1
461,2014,,12 Games,Army,,,,50,105,47.6,747,3,664,3556,5.4,33,769,4303,5.6,25,181,11,217,49,418,11,2,13
462,2015,1,2015-09-04,Army,,Fordham,L (35-37),7,16,43.8,133,2,42,256,6.1,3,58,389,6.7,4,17,1,22,3,26,1,1,2
463,2015,2,2015-09-12,Army,@,Connecticut,L (17-22),3,8,37.5,85,1,33,180,5.5,1,41,265,6.5,1,6,2,9,6,60,0,1,1
464,2015,3,2015-09-19,Army,,Wake Forest,L (14-17),2,3,66.7,54,0,54,186,3.4,2,57,240,4.2,2,9,0,11,4,57,0,0,0
465,2015,4,2015-09-26,Army,@,Eastern Michigan,W (58-36),5,9,55.6,98,1,71,556,7.8,7,80,654,8.2,3,24,2,29,6,70,2,1,3
466,2015,5,2015-10-03,Army,@,Penn State,L (14-20),1,1,100.0,32,0,55,261,4.7,2,56,293,5.2,1,16,0,17,4,45,3,0,3
467,2015,6,2015-10-10,Army,,Duke,L (3-44),2,6,33.3,55,0,49,113,2.3,0,55,168,3.1,2,9,1,12,5,32,2,1,3
468,2015,7,2015-10-17,Army,,Bucknell,W (21-14),5,10,50.0,114,1,61,263,4.3,2,71,377,5.3,3,14,1,18,4,35,1,2,3
469,2015,8,2015-10-24,Army,@,Rice,L (31-38),2,10,20.0,18,1,56,378,6.8,3,66,396,6.0,1,14,3,18,2,24,1,0,1
470,2015,9,2015-11-07,Army,@,Air Force,L (3-20),2,8,25.0,45,0,44,124,2.8,0,52,169,3.3,2,6,1,9,4,27,0,0,0
471,2015,10,2015-11-14,Army,,Tulane,L (31-34),7,13,53.8,146,2,55,216,3.9,1,68,362,5.3,6,10,0,16,5,35,1,0,1
472,2015,11,2015-11-21,Army,,Rutgers,L (21-31),4,6,66.7,140,1,52,261,5.0,2,58,401,6.9,4,13,1,18,3,35,1,1,2
473,2015,12,2015-12-12,Army,N,Navy,L (17-21),9,18,50.0,208,1,44,137,3.1,1,62,345,5.6,7,8,1,16,2,28,1,2,3
474,2015,,12 Games,Army,,,,49,108,45.4,1128,10,616,2931,4.8,24,724,4059,5.6,36,146,13,195,48,474,13,9,22
475,2016,1,2016-09-02,Army,@,Temple,W (28-13),2,5,40.0,15,0,67,329,4.9,4,72,344,4.8,1,23,1,25,5,34,0,0,0
476,2016,2,2016-09-10,Army,,Rice,W (31-14),4,6,66.7,66,0,69,348,5.0,4,75,414,5.5,4,18,1,23,5,50,0,0,0
477,2016,3,2016-09-17,Army,@,Texas-El Paso,W (66-14),7,8,87.5,174,1,71,426,6.0,7,79,600,7.6,7,24,2,33,2,10,0,0,0
478,2016,4,2016-09-24,Army,@,Buffalo,L (20-23),4,10,40.0,48,0,67,396,5.9,2,77,444,5.8,2,19,0,21,8,83,1,1,2
479,2016,5,2016-10-08,Army,@,Duke,L (6-13),3,11,27.3,49,0,43,165,3.8,1,54,214,4.0,2,5,1,8,5,40,2,1,3
480,2016,6,2016-10-15,Army,,Lafayette,W (62-7),7,13,53.8,134,3,54,537,9.9,6,67,671,10.0,4,26,1,31,6,64,1,0,1
481,2016,7,2016-10-22,Army,,North Texas,L (18-35),7,21,33.3,94,0,67,302,4.5,2,88,396,4.5,3,19,2,24,9,79,3,4,7
482,2016,8,2016-10-29,Army,@,Wake Forest,W (21-13),6,9,66.7,145,1,64,238,3.7,2,73,383,5.2,4,17,0,21,2,20,1,1,2
483,2016,9,2016-11-05,Army,,Air Force,L (12-31),5,16,31.3,84,1,40,144,3.6,1,56,228,4.1,4,7,4,15,5,35,0,2,2
484,2016,10,2016-11-12,Army,N,Notre Dame,L (6-44),2,8,25.0,13,0,42,229,5.5,1,50,242,4.8,1,9,0,10,7,68,0,1,1
485,2016,11,2016-11-19,Army,,Morgan State,W (60-3),3,8,37.5,57,1,60,504,8.4,7,68,561,8.3,3,23,2,28,4,25,2,0,2
486,2016,12,2016-12-10,Army,N,Navy,W (21-17),2,4,50.0,35,0,70,316,4.5,3,74,351,4.7,1,22,0,23,0,0,3,1,4
487,2016,13,2016-12-27,Army,N,North Texas*,W (38-31),2,4,50.0,53,0,73,481,6.6,6,77,534,6.9,2,20,0,22,4,40,1,0,1
488,2016,,13 Games,Army,,,,54,123,43.9,967,7,787,4415,5.6,46,910,5382,5.9,38,232,14,284,62,548,14,11,25
489,2017,1,2017-09-01,Army,,Fordham,W (64-6),0,2,0.0,0,0,47,513,10.9,8,49,513,10.5,0,22,0,22,3,30,1,0,1
490,2017,2,2017-09-09,Army,,Buffalo,W (21-17),2,8,25.0,17,0,66,322,4.9,3,74,339,4.6,1,16,2,19,5,44,0,0,0
491,2017,3,2017-09-16,Army,@,Ohio State,L (7-38),2,8,25.0,19,0,58,259,4.5,1,66,278,4.2,1,14,1,16,2,22,1,0,1
492,2017,4,2017-09-23,Army,@,Tulane,L (17-21),0,5,0.0,0,0,69,371,5.4,2,74,371,5.0,0,20,2,22,5,35,1,2,3
493,2017,5,2017-09-30,Army,,Texas-El Paso,W (35-21),3,7,42.9,80,1,50,353,7.1,4,57,433,7.6,3,18,1,22,6,47,0,1,1
494,2017,6,2017-10-07,Army,@,Rice,W (49-12),1,3,33.3,9,0,65,418,6.4,6,68,427,6.3,0,20,1,21,5,35,0,1,1
495,2017,7,2017-10-14,Army,,Eastern Michigan,W (28-27),0,5,0.0,0,0,61,413,6.8,4,66,413,6.3,0,21,0,21,4,32,0,0,0
496,2017,8,2017-10-21,Army,,Temple,W (31-28),8,18,44.4,141,1,50,248,5.0,3,68,389,5.7,7,11,1,19,5,46,0,1,1
497,2017,9,2017-11-04,Army,@,Air Force,W (21-0),0,0,,0,0,59,392,6.6,3,59,392,6.6,0,20,0,20,2,10,0,0,0
498,2017,10,2017-11-11,Army,,Duke,W (21-16),1,1,100.0,42,0,57,226,4.0,2,58,268,4.6,1,14,2,17,6,49,1,0,1
499,2017,11,2017-11-18,Army,@,North Texas,L (49-52),1,3,33.3,27,0,67,534,8.0,7,70,561,8.0,1,24,0,25,6,65,1,0,1
500,2017,12,2017-12-09,Army,N,Navy,W (14-13),1,1,100.0,20,0,49,221,4.5,2,50,241,4.8,1,13,1,15,2,10,0,0,0
501,2017,13,2017-12-23,Army,N,San Diego State*,W (42-35),1,4,25.0,6,0,87,440,5.1,5,91,446,4.9,1,28,2,31,4,47,0,1,1
502,2017,,13 Games,Army,,,,20,65,30.8,361,2,785,4710,6.0,50,850,5071,6.0,16,241,13,270,55,472,5,6,11
503,2014,1,2014-08-30,Auburn,,Arkansas,W (45-21),16,22,72.7,293,2,48,302,6.3,3,70,595,8.5,11,15,1,27,7,71,1,0,1
504,2014,2,2014-09-06,Auburn,,San Jose State,W (59-13),13,23,56.5,135,1,50,358,7.2,6,73,493,6.8,6,18,2,26,5,45,2,0,2
505,2014,3,2014-09-18,Auburn,@,Kansas State,W (20-14),17,31,54.8,231,2,45,128,2.8,0,76,359,4.7,15,7,0,22,6,46,0,1,1
506,2014,4,2014-09-27,Auburn,,Louisiana Tech,W (45-17),14,22,63.6,219,4,48,254,5.3,1,70,473,6.8,9,14,0,23,5,51,0,0,0
507,2014,5,2014-10-04,Auburn,,Louisiana State,W (41-7),17,25,68.0,268,2,49,298,6.1,3,74,566,7.6,9,15,1,25,7,80,1,0,1
508,2014,6,2014-10-11,Auburn,@,Mississippi State,L (23-38),17,35,48.6,209,2,43,232,5.4,0,78,441,5.7,9,15,1,25,6,56,2,2,4
509,2014,7,2014-10-25,Auburn,,South Carolina,W (42-35),13,15,86.7,156,1,47,395,8.4,5,62,551,8.9,9,16,0,25,4,53,1,0,1
510,2014,8,2014-11-01,Auburn,@,Mississippi,W (35-31),15,22,68.2,254,2,46,248,5.4,3,68,502,7.4,10,12,0,22,13,145,0,1,1
511,2014,9,2014-11-08,Auburn,,Texas A&M,L (38-41),15,21,71.4,219,1,59,363,6.2,4,80,582,7.3,11,18,2,31,8,65,3,0,3
512,2014,10,2014-11-15,Auburn,@,Georgia,L (7-34),15,28,53.6,142,0,35,150,4.3,1,63,292,4.6,9,8,0,17,7,78,2,1,3
513,2014,11,2014-11-22,Auburn,,Samford,W (31-7),13,22,59.1,186,1,47,200,4.3,3,69,386,5.6,7,14,1,22,8,76,0,1,1
514,2014,12,2014-11-29,Auburn,@,Alabama,L (44-55),27,43,62.8,456,3,47,174,3.7,1,90,630,7.0,18,9,1,28,7,55,1,1,2
515,2014,13,2015-01-01,Auburn,N,Wisconsin*,L (31-34),16,23,69.6,216,2,43,219,5.1,2,66,435,6.6,9,11,1,21,9,75,0,0,0
516,2014,,13 Games,Auburn,,,,208,332,62.7,2984,23,607,3321,5.5,32,939,6305,6.7,132,172,10,314,92,896,13,7,20
517,2015,1,2015-09-05,Auburn,N,Louisville,W (31-24),11,21,52.4,137,1,41,190,4.6,2,62,327,5.3,8,11,2,21,8,80,0,3,3
518,2015,2,2015-09-12,Auburn,,Jacksonville State,W (27-20),21,32,65.6,236,2,38,165,4.3,1,70,401,5.7,13,10,0,23,3,40,1,2,3
519,2015,3,2015-09-19,Auburn,@,Louisiana State,L (21-45),11,19,57.9,100,2,37,160,4.3,1,56,260,4.6,5,10,1,16,4,26,1,1,2
520,2015,4,2015-09-26,Auburn,,Mississippi State,L (9-17),20,28,71.4,188,0,50,201,4.0,0,78,389,5.0,9,16,0,25,6,40,0,1,1
521,2015,5,2015-10-03,Auburn,,San Jose State,W (35-21),6,10,60.0,108,0,48,234,4.9,5,58,342,5.9,3,12,0,15,1,15,0,0,0
522,2015,6,2015-10-15,Auburn,@,Kentucky,W (30-27),17,28,60.7,255,0,47,152,3.2,3,75,407,5.4,11,9,1,21,5,49,0,0,0
523,2015,7,2015-10-24,Auburn,@,Arkansas,L (46-54),19,34,55.9,254,0,52,162,3.1,6,86,416,4.8,13,8,1,22,2,25,0,0,0
524,2015,8,2015-10-31,Auburn,,Mississippi,L (19-27),13,32,40.6,302,1,41,125,3.0,0,73,427,5.8,10,8,0,18,3,20,0,1,1
525,2015,9,2015-11-07,Auburn,@,Texas A&M,W (26-10),13,17,76.5,132,1,52,311,6.0,1,69,443,6.4,4,16,0,20,6,78,0,0,0
526,2015,10,2015-11-14,Auburn,,Georgia,L (13-20),15,27,55.6,62,0,37,213,5.8,1,64,275,4.3,1,14,1,16,2,16,2,1,3
527,2015,11,2015-11-21,Auburn,,Idaho,W (56-34),13,19,68.4,163,2,51,297,5.8,5,70,460,6.6,9,14,2,25,11,107,0,0,0
528,2015,12,2015-11-28,Auburn,,Alabama,L (13-29),10,23,43.5,169,1,37,91,2.5,0,60,260,4.3,4,6,2,12,8,62,1,0,1
529,2015,13,2015-12-30,Auburn,N,Memphis*,W (31-10),10,16,62.5,150,1,56,252,4.5,3,72,402,5.6,7,16,0,23,3,45,0,3,3
530,2015,,13 Games,Auburn,,,,179,306,58.5,2256,11,587,2553,4.3,28,893,4809,5.4,97,150,10,257,62,603,5,12,17
531,2016,1,2016-09-03,Auburn,,Clemson,L (13-19),15,28,53.6,175,0,41,87,2.1,1,69,262,3.8,8,6,3,17,9,60,1,2,3
532,2016,2,2016-09-10,Auburn,,Arkansas State,W (51-14),17,23,73.9,244,3,62,462,7.5,3,85,706,8.3,10,20,2,32,5,40,1,0,1
533,2016,3,2016-09-17,Auburn,,Texas A&M,L (16-29),22,35,62.9,163,0,54,236,4.4,2,89,399,4.5,9,14,3,26,6,28,1,0,1
534,2016,4,2016-09-24,Auburn,,Louisiana State,W (18-13),19,26,73.1,234,0,49,154,3.1,0,75,388,5.2,10,7,1,18,4,28,1,0,1
535,2016,5,2016-10-01,Auburn,,Louisiana-Monroe,W (58-7),15,18,83.3,278,3,66,410,6.2,5,84,688,8.2,11,23,2,36,3,15,1,0,1
536,2016,6,2016-10-08,Auburn,@,Mississippi State,W (38-14),14,18,77.8,204,1,56,228,4.1,3,74,432,5.8,10,10,2,22,5,40,1,1,2
537,2016,7,2016-10-22,Auburn,,Arkansas,W (56-3),7,12,58.3,89,1,57,543,9.5,7,69,632,9.2,4,22,0,26,2,10,0,0,0
538,2016,8,2016-10-29,Auburn,@,Mississippi,W (40-29),15,22,68.2,247,1,52,307,5.9,3,74,554,7.5,12,14,0,26,4,30,0,0,0
539,2016,9,2016-11-05,Auburn,,Vanderbilt,W (23-16),12,17,70.6,115,1,45,271,6.0,1,62,386,6.2,4,11,1,16,5,56,1,0,1
540,2016,10,2016-11-12,Auburn,@,Georgia,L (7-13),8,22,36.4,37,0,32,127,4.0,1,54,164,3.0,2,8,0,10,3,36,0,1,1
541,2016,11,2016-11-19,Auburn,,Alabama A&M,W (55-0),14,20,70.0,147,1,59,451,7.6,6,79,598,7.6,7,19,1,27,5,50,1,0,1
542,2016,12,2016-11-26,Auburn,@,Alabama,L (12-30),7,19,36.8,116,0,26,66,2.5,0,45,182,4.0,3,4,0,7,4,19,0,1,1
543,2016,13,2017-01-02,Auburn,N,Oklahoma*,L (19-35),13,27,48.1,154,1,46,185,4.0,1,73,339,4.6,7,14,1,22,6,63,0,1,1
544,2016,,13 Games,Auburn,,,,178,287,62.0,2203,12,645,3527,5.5,33,932,5730,6.1,97,172,16,285,61,475,8,6,14
545,2017,1,2017-09-02,Auburn,,Georgia Southern,W (41-7),15,26,57.7,184,2,53,351,6.6,3,79,535,6.8,10,15,0,25,4,42,2,1,3
546,2017,2,2017-09-09,Auburn,@,Clemson,L (6-14),13,24,54.2,79,0,42,38,0.9,0,66,117,1.8,2,9,2,13,5,43,0,0,0
547,2017,3,2017-09-16,Auburn,,Mercer,W (24-10),32,37,86.5,364,0,43,146,3.4,3,80,510,6.4,16,8,2,26,6,65,4,1,5
548,2017,4,2017-09-23,Auburn,@,Missouri,W (51-14),16,21,76.2,219,1,53,263,5.0,5,74,482,6.5,7,12,3,22,5,50,0,0,0
549,2017,5,2017-09-30,Auburn,,Mississippi State,W (49-10),14,17,82.4,267,2,39,244,6.3,4,56,511,9.1,5,8,1,14,1,15,2,0,2
550,2017,6,2017-10-07,Auburn,,Mississippi,W (44-23),14,21,66.7,235,2,51,326,6.4,3,72,561,7.8,8,15,2,25,3,30,0,0,0
551,2017,7,2017-10-14,Auburn,@,Louisiana State,L (23-27),9,26,34.6,165,1,44,189,4.3,1,70,354,5.1,5,9,3,17,6,26,0,0,0
552,2017,8,2017-10-21,Auburn,@,Arkansas,W (52-20),21,30,70.0,284,2,47,345,7.3,5,77,629,8.2,8,17,1,26,3,25,1,1,2
553,2017,9,2017-11-04,Auburn,@,Texas A&M,W (42-27),20,27,74.1,268,3,52,228,4.4,2,79,496,6.3,8,14,1,23,3,34,0,0,0
554,2017,10,2017-11-11,Auburn,,Georgia,W (40-17),17,25,68.0,251,3,46,237,5.2,1,71,488,6.9,8,14,3,25,5,29,0,0,0
555,2017,11,2017-11-18,Auburn,,Louisiana-Monroe,W (42-14),18,24,75.0,235,2,48,317,6.6,3,72,552,7.7,10,15,0,25,5,41,1,1,2
556,2017,12,2017-11-25,Auburn,,Alabama,W (26-14),22,29,75.9,240,1,49,168,3.4,2,78,408,5.2,15,8,2,25,4,40,1,0,1
557,2017,13,2017-12-02,Auburn,N,Georgia,L (7-28),16,32,50.0,145,1,31,114,3.7,0,63,259,4.1,7,9,2,18,5,39,2,0,2
558,2017,14,2018-01-01,Auburn,N,Central Florida*,L (27-34),28,43,65.1,331,1,44,90,2.0,2,87,421,4.8,17,8,3,28,8,61,1,2,3
559,2017,,14 Games,Auburn,,,,255,382,66.8,3267,21,642,3056,4.8,34,1024,6323,6.2,126,161,25,312,63,540,14,6,20
560,2014,1,2014-08-30,Ball State,,Colgate,W (30-10),20,32,62.5,203,2,53,311,5.9,1,85,514,6.0,11,15,3,29,5,60,0,1,1
561,2014,2,2014-09-06,Ball State,@,Iowa,L (13-17),15,30,50.0,129,0,36,90,2.5,0,66,219,3.3,5,6,2,13,6,45,1,0,1
562,2014,3,2014-09-13,Ball State,,Indiana State,L (20-27),24,46,52.2,266,1,37,95,2.6,1,83,361,4.3,13,7,0,20,5,58,1,0,1
563,2014,4,2014-09-20,Ball State,@,Toledo,L (23-34),15,27,55.6,176,2,42,175,4.2,0,69,351,5.1,11,10,2,23,4,40,0,0,0
564,2014,5,2014-10-04,Ball State,@,Army,L (24-33),18,26,69.2,173,1,25,157,6.3,2,51,330,6.5,10,4,1,15,4,36,1,1,2
565,2014,6,2014-10-11,Ball State,,Western Michigan,L (38-42),26,44,59.1,326,4,39,145,3.7,1,83,471,5.7,17,5,1,23,5,55,0,0,0
566,2014,7,2014-10-18,Ball State,@,Central Michigan,W (32-29),21,38,55.3,198,1,38,89,2.3,2,76,287,3.8,12,6,6,24,4,25,1,0,1
567,2014,8,2014-10-25,Ball State,,Akron,W (35-21),18,36,50.0,225,0,40,155,3.9,3,76,380,5.0,7,11,4,22,3,20,0,0,0
568,2014,9,2014-11-05,Ball State,,Northern Illinois,L (21-35),16,39,41.0,174,1,31,133,4.3,2,70,307,4.4,9,8,1,18,2,24,2,3,5
569,2014,10,2014-11-12,Ball State,@,Massachusetts,L (10-24),24,38,63.2,217,1,30,69,2.3,0,68,286,4.2,9,4,1,14,4,46,2,2,4
570,2014,11,2014-11-22,Ball State,,Eastern Michigan,W (45-30),15,24,62.5,217,3,38,223,5.9,2,62,440,7.1,10,8,1,19,5,55,0,0,0
571,2014,12,2014-11-28,Ball State,@,Bowling Green State,W (41-24),20,29,69.0,286,3,39,199,5.1,2,68,485,7.1,11,12,1,24,3,25,0,0,0
572,2014,,12 Games,Ball State,,,,232,409,56.7,2590,19,448,1841,4.1,16,857,4431,5.2,125,96,23,244,50,489,8,7,15
573,2015,1,2015-09-03,Ball State,,Virginia Military Institute,W (48-36),34,53,64.2,338,1,42,229,5.5,5,95,567,6.0,21,11,1,33,6,55,0,1,1
574,2015,2,2015-09-12,Ball State,@,Texas A&M,L (23-56),12,27,44.4,121,0,38,240,6.3,2,65,361,5.6,6,10,3,19,3,15,0,1,1
575,2015,3,2015-09-19,Ball State,@,Eastern Michigan,W (28-17),24,33,72.7,194,1,52,278,5.3,3,85,472,5.6,9,15,2,26,3,30,1,0,1
576,2015,4,2015-09-26,Ball State,@,Northwestern,L (19-24),14,35,40.0,178,2,34,181,5.3,0,69,359,5.2,7,8,2,17,2,10,1,0,1
577,2015,5,2015-10-03,Ball State,,Toledo,L (10-24),23,37,62.2,236,1,30,26,0.9,0,67,262,3.9,9,4,6,19,3,35,1,0,1
578,2015,6,2015-10-10,Ball State,@,Northern Illinois,L (41-59),31,53,58.5,393,4,35,110,3.1,1,88,503,5.7,19,9,2,30,3,40,0,1,1
579,2015,7,2015-10-17,Ball State,,Georgia State,L (19-31),28,48,58.3,218,2,40,154,3.9,0,88,372,4.2,11,12,1,24,6,65,0,1,1
580,2015,8,2015-10-24,Ball State,,Central Michigan,L (21-23),25,40,62.5,187,1,29,112,3.9,1,69,299,4.3,9,7,1,17,5,50,1,0,1
581,2015,9,2015-10-31,Ball State,,Massachusetts,W (20-10),20,32,62.5,275,1,44,152,3.5,1,76,427,5.6,14,7,3,24,3,25,1,1,2
582,2015,10,2015-11-05,Ball State,@,Western Michigan,L (7-54),12,27,44.4,78,1,25,74,3.0,0,52,152,2.9,2,4,1,7,4,45,0,1,1
583,2015,11,2015-11-17,Ball State,@,Ohio,L (31-48),16,34,47.1,247,2,30,174,5.8,2,64,421,6.6,8,9,1,18,5,45,1,0,1
584,2015,12,2015-11-24,Ball State,,Bowling Green State,L (10-48),24,40,60.0,154,1,38,110,2.9,0,78,264,3.4,7,7,1,15,1,10,0,3,3
585,2015,,12 Games,Ball State,,,,263,459,57.3,2619,17,437,1840,4.2,15,896,4459,5.0,122,103,24,249,44,425,6,9,15
586,2016,1,2016-09-02,Ball State,@,Georgia State,W (31-21),15,29,51.7,130,0,52,325,6.3,4,81,455,5.6,8,14,0,22,5,39,0,2,2
587,2016,2,2016-09-10,Ball State,@,Indiana,L (20-30),15,30,50.0,231,1,38,140,3.7,0,68,371,5.5,9,7,2,18,4,25,2,1,3
588,2016,3,2016-09-17,Ball State,,Eastern Kentucky,W (41-14),28,39,71.8,238,2,54,193,3.6,3,93,431,4.6,11,13,4,28,4,35,1,0,1
589,2016,4,2016-09-24,Ball State,@,Florida Atlantic,W (31-27),24,39,61.5,262,2,41,226,5.5,2,80,488,6.1,15,12,1,28,1,5,0,1,1
590,2016,5,2016-10-01,Ball State,,Northern Illinois,L (24-31),23,41,56.1,276,0,44,151,3.4,3,85,427,5.0,16,9,2,27,2,19,0,1,1
591,2016,6,2016-10-08,Ball State,@,Central Michigan,L (21-24),18,30,60.0,174,1,39,166,4.3,2,69,340,4.9,10,8,0,18,3,35,0,2,2
592,2016,7,2016-10-15,Ball State,@,Buffalo,W (31-21),12,22,54.5,212,0,59,356,6.0,4,81,568,7.0,9,14,2,25,5,45,1,2,3
593,2016,8,2016-10-22,Ball State,,Akron,L (25-35),23,34,67.6,187,1,44,256,5.8,2,78,443,5.7,8,20,0,28,4,40,0,1,1
594,2016,9,2016-11-01,Ball State,,Western Michigan,L (20-52),20,38,52.6,199,1,42,298,7.1,1,80,497,6.2,13,12,0,25,6,55,1,2,3
595,2016,10,2016-11-08,Ball State,,Eastern Michigan,L (41-48),30,51,58.8,393,3,34,149,4.4,3,85,542,6.4,16,9,1,26,6,49,3,2,5
596,2016,11,2016-11-16,Ball State,@,Toledo,L (19-37),33,49,67.3,260,2,32,133,4.2,0,81,393,4.9,15,7,1,23,4,45,1,0,1
597,2016,12,2016-11-22,Ball State,@,Miami (OH),L (20-21),22,34,64.7,188,1,40,247,6.2,1,74,435,5.9,9,16,1,26,4,34,0,1,1
598,2016,,12 Games,Ball State,,,,263,436,60.3,2750,14,519,2640,5.1,25,955,5390,5.6,139,141,14,294,48,426,9,15,24
599,2017,1,2017-09-02,Ball State,@,Illinois,L (21-24),21,34,61.8,204,1,51,171,3.4,2,85,375,4.4,8,12,1,21,2,25,1,1,2
600,2017,2,2017-09-09,Ball State,,Alabama-Birmingham,W (51-31),23,35,65.7,217,2,41,168,4.1,4,76,385,5.1,14,7,3,24,4,36,0,0,0
601,2017,3,2017-09-16,Ball State,,Tennessee Tech,W (28-13),23,31,74.2,238,3,33,228,6.9,1,64,466,7.3,14,6,0,20,4,45,1,2,3
602,2017,4,2017-09-23,Ball State,@,Western Kentucky,L (21-33),18,36,50.0,267,0,31,107,3.5,3,67,374,5.6,12,5,0,17,4,35,1,2,3
603,2017,5,2017-09-30,Ball State,@,Western Michigan,L (3-55),23,43,53.5,175,0,30,63,2.1,0,73,238,3.3,8,6,1,15,7,70,1,1,2
604,2017,6,2017-10-07,Ball State,@,Akron,L (3-31),24,46,52.2,221,0,44,155,3.5,0,90,376,4.2,11,11,0,22,1,15,0,3,3
605,2017,7,2017-10-21,Ball State,,Central Michigan,L (9-56),20,34,58.8,127,0,41,81,2.0,0,75,208,2.8,5,7,2,14,5,60,1,0,1
606,2017,8,2017-10-26,Ball State,,Toledo,L (17-58),18,37,48.6,105,0,46,204,4.4,2,83,309,3.7,6,6,4,16,3,25,0,0,0
607,2017,9,2017-11-02,Ball State,@,Eastern Michigan,L (14-56),11,21,52.4,169,2,41,157,3.8,0,62,326,5.3,7,10,2,19,7,53,1,1,2
608,2017,10,2017-11-09,Ball State,@,Northern Illinois,L (17-63),19,30,63.3,162,1,43,83,1.9,1,73,245,3.4,9,7,0,16,4,50,0,1,1
609,2017,11,2017-11-16,Ball State,,Buffalo,L (24-40),15,29,51.7,143,2,37,194,5.2,1,66,337,5.1,7,10,1,18,2,10,0,1,1
610,2017,12,2017-11-21,Ball State,,Miami (OH),L (7-28),13,29,44.8,98,0,56,293,5.2,1,85,391,4.6,6,17,0,23,6,55,1,2,3
611,2017,,12 Games,Ball State,,,,228,405,56.3,2126,11,494,1904,3.9,15,899,4030,4.5,107,104,14,225,49,479,7,14,21
612,2014,1,2014-08-31,Baylor,,Southern Methodist,W (45-0),27,47,57.4,313,3,50,261,5.2,3,97,574,5.9,15,15,1,31,11,96,1,1,2
613,2014,2,2014-09-06,Baylor,,Northwestern State,W (70-6),19,28,67.9,455,5,50,265,5.3,5,78,720,9.2,12,19,1,32,10,91,2,0,2
614,2014,3,2014-09-12,Baylor,@,Buffalo,W (63-21),25,37,67.6,480,5,41,189,4.6,4,78,669,8.6,17,10,0,27,5,40,0,0,0
615,2014,4,2014-09-27,Baylor,@,Iowa State,W (49-28),32,50,64.0,357,1,47,244,5.2,6,97,601,6.2,17,12,3,32,10,78,0,1,1
616,2014,5,2014-10-04,Baylor,@,Texas,W (28-7),7,22,31.8,111,2,60,278,4.6,1,82,389,4.7,5,17,0,22,10,95,0,0,0
617,2014,6,2014-10-11,Baylor,,Texas Christian,W (61-58),28,55,50.9,510,6,54,272,5.0,1,109,782,7.2,17,18,4,39,12,117,1,2,3
618,2014,7,2014-10-18,Baylor,@,West Virginia,L (27-41),16,37,43.2,223,2,42,95,2.3,1,79,318,4.0,10,5,7,22,18,215,0,0,0
619,2014,8,2014-11-01,Baylor,,Kansas,W (60-14),21,36,58.3,343,3,52,326,6.3,4,88,669,7.6,12,17,1,30,6,54,0,0,0
620,2014,9,2014-11-08,Baylor,@,Oklahoma,W (48-14),33,43,76.7,396,1,52,148,2.8,5,95,544,5.7,20,9,2,31,7,40,0,0,0
621,2014,10,2014-11-22,Baylor,,Oklahoma State,W (49-28),18,29,62.1,262,2,58,317,5.5,5,87,579,6.7,10,19,0,29,12,68,0,2,2
622,2014,11,2014-11-29,Baylor,N,Texas Tech,W (48-46),26,42,61.9,292,3,54,255,4.7,3,96,547,5.7,17,14,6,37,8,80,1,0,1
623,2014,12,2014-12-06,Baylor,,Kansas State,W (38-27),34,41,82.9,412,1,37,172,4.6,4,78,584,7.5,24,10,0,34,7,70,0,1,1
624,2014,13,2015-01-01,Baylor,N,Michigan State*,L (41-42),37,52,71.2,603,4,22,-20,-0.9,1,74,583,7.9,17,6,2,25,11,105,0,1,1
625,2014,,13 Games,Baylor,,,,323,519,62.2,4757,38,619,2802,4.5,43,1138,7559,6.6,193,171,27,391,127,1149,5,8,13
626,2015,1,2015-09-04,Baylor,@,Southern Methodist,W (56-21),17,32,53.1,423,6,37,300,8.1,2,69,723,10.5,12,14,1,27,13,105,0,1,1
627,2015,2,2015-09-12,Baylor,,Lamar,W (66-31),26,38,68.4,373,4,56,412,7.4,5,94,785,8.4,16,21,1,38,12,93,1,3,4
628,2015,3,2015-09-26,Baylor,,Rice,W (70-17),19,25,76.0,366,7,53,427,8.1,3,78,793,10.2,15,23,1,39,14,145,1,0,1
629,2015,4,2015-10-03,Baylor,N,Texas Tech,W (63-35),16,24,66.7,312,4,52,368,7.1,5,76,680,8.9,12,12,2,26,8,72,0,1,1
630,2015,5,2015-10-10,Baylor,@,Kansas,W (66-7),27,37,73.0,363,5,45,281,6.2,3,82,644,7.9,16,17,1,34,4,33,1,0,1
631,2015,6,2015-10-17,Baylor,,West Virginia,W (62-38),21,34,61.8,389,6,50,304,6.1,2,84,693,8.3,15,16,3,34,6,80,0,0,0
632,2015,7,2015-10-24,Baylor,,Iowa State,W (45-27),17,38,44.7,209,3,49,276,5.6,3,87,485,5.6,10,16,1,27,9,48,1,1,2
633,2015,8,2015-11-05,Baylor,@,Kansas State,W (31-24),23,33,69.7,419,3,34,103,3.0,1,67,522,7.8,14,5,1,20,11,119,0,0,0
634,2015,9,2015-11-14,Baylor,,Oklahoma,L (34-44),16,27,59.3,257,2,44,159,3.6,3,71,416,5.9,9,7,2,18,6,66,1,2,3
635,2015,10,2015-11-21,Baylor,@,Oklahoma State,W (45-35),17,31,54.8,396,3,73,304,4.2,3,104,700,6.7,11,21,0,32,8,55,2,1,3
636,2015,11,2015-11-27,Baylor,@,Texas Christian,L (21-28),7,24,29.2,62,1,71,273,3.8,2,95,335,3.5,3,16,2,21,6,50,4,1,5
637,2015,12,2015-12-05,Baylor,,Texas,L (17-23),13,28,46.4,84,0,66,395,6.0,2,94,479,5.1,5,22,2,29,10,60,2,2,4
638,2015,13,2015-12-29,Baylor,N,North Carolina*,W (49-38),10,18,55.6,111,0,82,651,7.9,7,100,762,7.6,6,30,2,38,11,117,0,1,1
639,2015,,13 Games,Baylor,,,,229,389,58.9,3764,44,712,4253,6.0,41,1101,8017,7.3,144,220,19,383,118,1043,13,13,26
640,2016,1,2016-09-02,Baylor,,Northwestern State,W (55-7),19,29,65.5,223,5,43,275,6.4,2,72,498,6.9,10,13,0,23,12,93,1,0,1
641,2016,2,2016-09-10,Baylor,,Southern Methodist,W (40-13),26,48,54.2,261,2,55,275,5.0,2,103,536,5.2,9,18,2,29,14,101,1,2,3
642,2016,3,2016-09-16,Baylor,@,Rice,W (38-10),23,42,54.8,342,3,54,296,5.5,2,96,638,6.6,15,16,0,31,8,85,0,1,1
643,2016,4,2016-09-24,Baylor,,Oklahoma State,W (35-24),18,28,64.3,387,4,37,136,3.7,1,65,523,8.0,11,8,1,20,7,70,1,1,2
644,2016,5,2016-10-01,Baylor,@,Iowa State,W (45-42),12,22,54.5,178,1,62,469,7.6,5,84,647,7.7,6,22,2,30,9,79,0,0,0
645,2016,6,2016-10-15,Baylor,,Kansas,W (49-7),13,30,43.3,207,2,49,246,5.0,4,79,453,5.7,4,15,1,20,6,38,1,0,1
646,2016,7,2016-10-29,Baylor,@,Texas,L (34-35),14,28,50.0,226,2,68,398,5.9,2,96,624,6.5,9,22,0,31,10,39,1,1,2
647,2016,8,2016-11-05,Baylor,,Texas Christian,L (22-62),22,43,51.2,282,1,45,133,3.0,2,88,415,4.7,11,7,1,19,11,121,0,1,1
648,2016,9,2016-11-12,Baylor,@,Oklahoma,L (24-45),21,46,45.7,292,2,45,212,4.7,1,91,504,5.5,12,11,1,24,9,55,1,2,3
649,2016,10,2016-11-19,Baylor,,Kansas State,L (21-42),27,46,58.7,258,3,33,110,3.3,0,79,368,4.7,11,8,3,22,9,84,1,3,4
650,2016,11,2016-11-25,Baylor,N,Texas Tech,L (35-54),30,47,63.8,377,3,53,257,4.8,2,100,634,6.3,15,15,2,32,11,78,3,1,4
651,2016,12,2016-12-03,Baylor,@,West Virginia,L (21-24),15,31,48.4,244,2,41,196,4.8,1,72,440,6.1,12,7,0,19,12,100,2,2,4
652,2016,13,2016-12-27,Baylor,N,Boise State*,W (31-12),29,40,72.5,375,3,43,140,3.3,1,83,515,6.2,16,12,1,29,11,125,0,1,1
653,2016,,13 Games,Baylor,,,,269,480,56.0,3652,33,628,3143,5.0,25,1108,6795,6.1,141,174,14,329,129,1068,12,15,27
654,2017,1,2017-09-02,Baylor,,Liberty,L (45-48),14,30,46.7,278,3,34,254,7.5,3,64,532,8.3,9,10,3,22,7,61,0,2,2
655,2017,2,2017-09-09,Baylor,,Texas-San Antonio,L (10-17),11,27,40.7,137,1,31,137,4.4,0,58,274,4.7,5,7,2,14,10,98,0,1,1
656,2017,3,2017-09-16,Baylor,@,Duke,L (20-34),12,34,35.3,263,3,27,57,2.1,0,61,320,5.2,6,3,0,9,11,100,1,3,4
657,2017,4,2017-09-23,Baylor,,Oklahoma,L (41-49),33,50,66.0,463,4,35,60,1.7,0,85,523,6.2,19,2,1,22,6,29,1,0,1
658,2017,5,2017-09-30,Baylor,@,Kansas State,L (20-33),26,44,59.1,291,1,27,84,3.1,1,71,375,5.3,13,4,1,18,10,60,1,1,2
659,2017,6,2017-10-14,Baylor,@,Oklahoma State,L (16-59),14,36,38.9,168,0,46,219,4.8,1,82,387,4.7,10,11,1,22,5,39,1,2,3
660,2017,7,2017-10-21,Baylor,,West Virginia,L (36-38),24,40,60.0,370,2,42,127,3.0,2,82,497,6.1,13,9,8,30,6,20,0,0,0
661,2017,8,2017-10-28,Baylor,,Texas,L (7-38),21,38,55.3,218,0,37,31,0.8,1,75,249,3.3,5,6,1,12,6,34,2,1,3
662,2017,9,2017-11-04,Baylor,@,Kansas,W (38-9),24,30,80.0,335,3,39,120,3.1,2,69,455,6.6,13,7,0,20,7,60,0,0,0
663,2017,10,2017-11-11,Baylor,N,Texas Tech,L (24-38),43,63,68.3,417,3,29,106,3.7,0,92,523,5.7,21,7,3,31,6,65,3,1,4
664,2017,11,2017-11-18,Baylor,,Iowa State,L (13-23),26,36,72.2,198,1,38,133,3.5,0,74,331,4.5,13,10,2,25,4,30,1,1,2
665,2017,12,2017-11-24,Baylor,@,Texas Christian,L (22-45),21,34,61.8,314,2,29,79,2.7,0,63,393,6.2,10,4,0,14,10,75,1,2,3
666,2017,,12 Games,Baylor,,,,269,462,58.2,3452,23,414,1407,3.4,10,876,4859,5.5,137,80,22,239,88,671,11,14,25
667,2014,1,2014-08-28,Boise State,N,Mississippi,L (13-35),36,48,75.0,264,1,37,135,3.6,0,85,399,4.7,12,10,4,26,9,72,0,4,4
668,2014,2,2014-09-06,Boise State,,Colorado State,W (37-24),22,33,66.7,352,2,56,324,5.8,3,89,676,7.6,15,19,1,35,10,101,0,1,1
669,2014,3,2014-09-13,Boise State,@,Connecticut,W (38-21),20,29,69.0,240,3,27,52,1.9,0,56,292,5.2,11,1,1,13,7,65,1,0,1
670,2014,4,2014-09-20,Boise State,,Louisiana,W (34-9),24,31,77.4,237,0,48,262,5.5,4,79,499,6.3,10,14,0,24,8,60,0,0,0
671,2014,5,2014-09-27,Boise State,@,Air Force,L (14-28),30,58,51.7,370,2,29,97,3.3,0,87,467,5.4,16,6,2,24,9,80,2,5,7
672,2014,6,2014-10-04,Boise State,@,Nevada,W (51-46),26,31,83.9,346,2,48,224,4.7,4,79,570,7.2,17,6,2,25,5,63,2,1,3
673,2014,7,2014-10-17,Boise State,,Fresno State,W (37-27),23,32,71.9,228,2,51,264,5.2,2,83,492,5.9,13,10,1,24,6,30,1,0,1
674,2014,8,2014-10-24,Boise State,,Brigham Young,W (55-30),24,31,77.4,410,4,48,227,4.7,3,79,637,8.1,15,13,0,28,8,70,0,1,1
675,2014,9,2014-11-08,Boise State,@,New Mexico,W (60-49),21,32,65.6,367,4,48,291,6.1,4,80,658,8.2,16,17,1,34,3,24,0,0,0
676,2014,10,2014-11-15,Boise State,,San Diego State,W (38-29),19,28,67.9,187,1,47,212,4.5,4,75,399,5.3,10,10,2,22,5,37,0,2,2
677,2014,11,2014-11-22,Boise State,@,Wyoming,W (63-14),13,19,68.4,246,3,49,312,6.4,4,68,558,8.2,9,15,0,24,2,20,1,0,1
678,2014,12,2014-11-29,Boise State,,Utah State,W (50-19),19,28,67.9,215,2,54,283,5.2,5,82,498,6.1,11,14,1,26,7,60,1,0,1
679,2014,13,2014-12-06,Boise State,,Fresno State,W (28-14),9,16,56.3,155,0,33,149,4.5,3,49,304,6.2,4,7,0,11,7,47,0,0,0
680,2014,14,2014-12-31,Boise State,N,Arizona*,W (38-30),24,35,68.6,309,1,34,162,4.8,3,69,471,6.8,14,6,2,22,6,72,1,1,2
681,2014,,14 Games,Boise State,,,,310,451,68.7,3926,27,609,2994,4.9,39,1060,6920,6.5,173,148,17,338,92,801,9,15,24
682,2015,1,2015-09-04,Boise State,,Washington,W (16-13),17,27,63.0,152,0,53,185,3.5,2,80,337,4.2,9,11,1,21,7,71,1,1,2
683,2015,2,2015-09-12,Boise State,@,Brigham Young,L (24-35),25,38,65.8,297,1,31,64,2.1,2,69,361,5.2,0,0,0,17,11,76,0,3,3
684,2015,3,2015-09-18,Boise State,,Idaho State,W (52-0),22,28,78.6,254,1,58,344,5.9,6,86,598,7.0,15,17,0,32,5,25,0,0,0
685,2015,4,2015-09-25,Boise State,@,Virginia,W (56-14),25,38,65.8,358,3,31,89,2.9,1,69,447,6.5,13,5,1,19,4,25,0,0,0
686,2015,5,2015-10-03,Boise State,,Hawaii,W (55-0),20,29,69.0,275,3,59,279,4.7,4,88,554,6.3,11,16,2,29,8,80,0,0,0
687,2015,6,2015-10-10,Boise State,@,Colorado State,W (41-10),24,37,64.9,396,2,44,201,4.6,3,81,597,7.4,17,8,2,27,6,65,0,1,1
688,2015,7,2015-10-16,Boise State,@,Utah State,L (26-52),25,50,50.0,299,0,30,34,1.1,3,80,333,4.2,12,5,3,20,3,30,5,3,8
689,2015,8,2015-10-24,Boise State,,Wyoming,W (34-14),22,28,78.6,211,3,47,207,4.4,1,75,418,5.6,11,12,1,24,8,74,1,0,1
690,2015,9,2015-10-31,Boise State,@,Nevada-Las Vegas,W (55-27),36,53,67.9,473,3,37,232,6.3,4,90,705,7.8,21,10,3,34,8,51,1,0,1
691,2015,10,2015-11-14,Boise State,,New Mexico,L (24-31),40,74,54.1,503,2,40,135,3.4,1,114,638,5.6,25,8,7,40,4,39,1,3,4
692,2015,11,2015-11-20,Boise State,,Air Force,L (30-37),23,48,47.9,237,1,32,141,4.4,2,80,378,4.7,11,5,4,20,4,45,0,0,0
693,2015,12,2015-11-27,Boise State,@,San Jose State,W (40-23),25,34,73.5,197,2,35,300,8.6,3,69,497,7.2,11,13,2,26,6,50,0,0,0
694,2015,13,2015-12-23,Boise State,N,Northern Illinois*,W (55-7),29,40,72.5,377,3,56,277,4.9,4,96,654,6.8,19,16,0,35,8,65,1,1,2
695,2015,,13 Games,Boise State,,,,333,524,63.5,4029,24,553,2488,4.5,36,1077,6517,6.1,175,126,26,344,82,696,10,12,22
696,2016,1,2016-09-03,Boise State,@,Louisiana,W (45-10),24,35,68.6,426,3,38,158,4.2,3,73,584,8.0,18,9,1,28,7,60,0,0,0
697,2016,2,2016-09-10,Boise State,,Washington State,W (31-28),19,35,54.3,299,1,26,121,4.7,2,61,420,6.9,14,6,1,21,3,35,0,3,3
698,2016,3,2016-09-24,Boise State,@,Oregon State,W (38-24),20,37,54.1,238,1,42,274,6.5,3,79,512,6.5,13,14,0,27,6,55,2,0,2
699,2016,4,2016-10-01,Boise State,,Utah State,W (21-10),17,26,65.4,230,3,40,154,3.9,0,66,384,5.8,9,8,2,19,8,101,1,0,1
700,2016,5,2016-10-07,Boise State,@,New Mexico,W (49-21),21,30,70.0,391,5,29,65,2.2,2,59,456,7.7,16,2,4,22,2,15,0,0,0
701,2016,6,2016-10-15,Boise State,,Colorado State,W (28-23),17,25,68.0,218,2,48,226,4.7,2,73,444,6.1,10,11,0,21,3,19,0,0,0
702,2016,7,2016-10-20,Boise State,,Brigham Young,W (28-27),25,39,64.1,442,3,35,129,3.7,1,74,571,7.7,18,6,0,24,8,65,3,2,5
703,2016,8,2016-10-29,Boise State,@,Wyoming,L (28-30),23,36,63.9,328,1,27,159,5.9,3,63,487,7.7,16,8,0,24,4,24,1,1,2
704,2016,9,2016-11-04,Boise State,,San Jose State,W (45-31),16,21,76.2,219,3,54,298,5.5,3,75,517,6.9,12,15,3,30,2,10,0,0,0
705,2016,10,2016-11-12,Boise State,@,Hawaii,W (52-16),20,24,83.3,357,4,44,246,5.6,3,68,603,8.9,11,11,3,25,6,55,0,0,0
706,2016,11,2016-11-18,Boise State,,Nevada-Las Vegas,W (42-25),10,21,47.6,109,0,47,271,5.8,6,68,380,5.6,6,14,2,22,1,10,1,0,1
707,2016,12,2016-11-25,Boise State,@,Air Force,L (20-27),9,26,34.6,316,1,25,84,3.4,1,51,400,7.8,8,3,1,12,3,27,1,0,1
708,2016,13,2016-12-27,Boise State,N,Baylor*,L (12-31),32,51,62.7,305,1,38,83,2.2,0,89,388,4.4,16,8,1,25,3,15,1,2,3
709,2016,,13 Games,Boise State,,,,253,406,62.3,3878,28,493,2268,4.6,29,899,6146,6.8,167,115,18,300,56,491,10,8,18
710,2017,1,2017-09-02,Boise State,,Troy,W (24-13),19,32,59.4,210,1,44,147,3.3,1,76,357,4.7,11,7,1,19,7,47,1,1,2
711,2017,2,2017-09-09,Boise State,@,Washington State,L (44-47),19,28,67.9,237,2,42,168,4.0,2,70,405,5.8,10,9,0,19,5,34,3,1,4
712,2017,3,2017-09-14,Boise State,,New Mexico,W (28-14),15,19,78.9,137,2,32,127,4.0,2,51,264,5.2,7,5,0,12,8,73,0,0,0
713,2017,4,2017-09-22,Boise State,,Virginia,L (23-42),28,53,52.8,353,1,24,30,1.3,2,77,383,5.0,16,3,3,22,9,64,0,1,1
714,2017,5,2017-10-06,Boise State,@,Brigham Young,W (24-7),13,20,65.0,142,1,47,158,3.4,2,67,300,4.5,8,10,1,19,1,5,0,1,1
715,2017,6,2017-10-14,Boise State,@,San Diego State,W (31-14),14,23,60.9,125,1,34,186,5.5,1,57,311,5.5,4,10,1,15,3,35,0,0,0
716,2017,7,2017-10-21,Boise State,,Wyoming,W (24-14),18,24,75.0,177,1,43,166,3.9,2,67,343,5.1,9,11,1,21,3,35,0,0,0
717,2017,8,2017-10-28,Boise State,@,Utah State,W (41-14),24,34,70.6,370,5,45,163,3.6,0,79,533,6.7,17,7,3,27,9,72,0,0,0
718,2017,9,2017-11-04,Boise State,,Nevada,W (41-14),25,34,73.5,339,2,35,140,4.0,3,69,479,6.9,15,8,1,24,6,60,0,0,0
719,2017,10,2017-11-11,Boise State,@,Colorado State,W (59-52),23,45,51.1,331,4,39,310,7.9,4,84,641,7.6,18,14,1,33,6,54,1,1,2
720,2017,11,2017-11-18,Boise State,,Air Force,W (44-19),18,26,69.2,338,3,29,90,3.1,1,55,428,7.8,11,4,4,19,6,53,0,0,0
721,2017,12,2017-11-25,Boise State,@,Fresno State,L (17-28),25,36,69.4,294,1,31,107,3.5,1,67,401,6.0,11,7,1,19,6,48,0,0,0
722,2017,13,2017-12-02,Boise State,,Fresno State,W (17-14),17,32,53.1,255,0,38,109,2.9,2,70,364,5.2,11,6,2,19,9,70,0,0,0
723,2017,14,2017-12-16,Boise State,N,Oregon*,W (38-28),23,43,53.5,369,2,47,112,2.4,2,90,481,5.3,16,8,4,28,4,50,1,2,3
724,2017,,14 Games,Boise State,,,,281,449,62.6,3677,26,530,2013,3.8,25,979,5690,5.8,164,109,23,296,82,700,6,7,13
725,2014,1,2014-08-30,Boston College,N,Massachusetts,W (30-7),17,25,68.0,173,1,61,338,5.5,2,86,511,5.9,9,17,1,27,7,55,0,1,1
726,2014,2,2014-09-05,Boston College,,Pittsburgh,L (20-30),10,28,35.7,134,1,34,142,4.2,2,62,276,4.5,5,9,1,15,3,25,0,2,2
727,2014,3,2014-09-13,Boston College,,Southern California,W (37-31),5,14,35.7,54,0,54,452,8.4,5,68,506,7.4,2,17,0,19,2,25,0,1,1
728,2014,4,2014-09-20,Boston College,,Maine,W (40-10),12,21,57.1,136,1,64,413,6.5,4,85,549,6.5,4,24,0,28,3,26,0,1,1
729,2014,5,2014-09-27,Boston College,,Colorado State,L (21-24),12,18,66.7,169,0,49,239,4.9,3,67,408,6.1,9,9,3,21,5,35,0,1,1
730,2014,6,2014-10-11,Boston College,@,North Carolina State,W (30-14),12,19,63.2,101,0,57,310,5.4,4,76,411,5.4,6,17,1,24,4,30,1,0,1
731,2014,7,2014-10-18,Boston College,,Clemson,L (13-17),9,20,45.0,143,2,36,120,3.3,0,56,263,4.7,5,5,1,11,3,30,0,0,0
732,2014,8,2014-10-25,Boston College,@,Wake Forest,W (23-17),11,15,73.3,165,1,44,202,4.6,2,59,367,6.2,7,11,2,20,7,54,1,0,1
733,2014,9,2014-11-01,Boston College,@,Virginia Tech,W (33-31),8,15,53.3,110,2,47,258,5.5,2,62,368,5.9,3,7,1,11,3,20,0,0,0
734,2014,10,2014-11-08,Boston College,,Louisville,L (19-38),9,20,45.0,166,1,43,166,3.9,2,63,332,5.3,7,7,4,18,5,45,0,4,4
735,2014,11,2014-11-22,Boston College,@,Florida State,L (17-20),6,11,54.5,73,1,51,240,4.7,1,62,313,5.0,2,16,1,19,3,20,0,0,0
736,2014,12,2014-11-29,Boston College,,Syracuse,W (28-7),13,17,76.5,160,1,49,142,2.9,2,66,302,4.6,10,7,2,19,4,36,1,0,1
737,2014,13,2014-12-27,Boston College,N,Penn State*,L (30-31),11,20,55.0,97,2,46,289,6.3,2,66,386,5.8,4,11,1,16,9,97,0,0,0
738,2014,,13 Games,Boston College,,,,135,243,55.6,1681,13,635,3311,5.2,31,878,4992,5.7,73,157,18,248,58,498,3,10,13
739,2015,1,2015-09-05,Boston College,,Maine,W (24-3),14,25,56.0,155,1,49,204,4.2,2,74,359,4.9,10,9,2,21,5,35,0,0,0
740,2015,2,2015-09-12,Boston College,,Howard,W (76-0),12,15,80.0,136,2,40,347,8.7,8,55,483,8.8,5,18,1,24,6,40,0,0,0
741,2015,3,2015-09-18,Boston College,,Florida State,L (0-14),5,15,33.3,56,0,43,139,3.2,0,58,195,3.4,3,8,1,12,6,66,1,1,2
742,2015,4,2015-09-26,Boston College,,Northern Illinois,W (17-14),5,14,35.7,92,1,63,234,3.7,1,77,326,4.2,4,13,1,18,5,55,0,1,1
743,2015,5,2015-10-03,Boston College,@,Duke,L (7-9),8,21,38.1,141,1,41,164,4.0,0,62,305,4.9,5,8,0,13,6,60,1,0,1
744,2015,6,2015-10-10,Boston College,,Wake Forest,L (0-3),6,20,30.0,74,0,54,196,3.6,0,74,270,3.6,3,10,5,18,9,51,3,1,4
745,2015,7,2015-10-17,Boston College,@,Clemson,L (17-34),7,23,30.4,87,1,38,159,4.2,1,61,246,4.0,3,7,1,11,8,80,0,0,0
746,2015,8,2015-10-24,Boston College,@,Louisville,L (14-17),9,22,40.9,93,0,30,-14,-0.5,1,52,79,1.5,3,1,0,4,4,25,1,0,1
747,2015,9,2015-10-31,Boston College,,Virginia Tech,L (10-26),8,21,38.1,143,0,35,75,2.1,1,56,218,3.9,6,3,6,15,6,48,3,1,4
748,2015,10,2015-11-07,Boston College,,North Carolina State,L (8-24),23,37,62.2,257,1,34,28,0.8,0,71,285,4.0,11,4,1,16,3,35,1,3,4
749,2015,11,2015-11-21,Boston College,N,Notre Dame,L (16-19),12,22,54.5,88,1,36,214,5.9,1,58,302,5.2,5,7,1,13,9,75,1,0,1
750,2015,12,2015-11-28,Boston College,@,Syracuse,L (17-20),1,13,7.7,9,0,40,230,5.8,2,53,239,4.5,1,8,0,9,11,119,0,2,2
751,2015,,12 Games,Boston College,,,,110,248,44.4,1331,8,503,1976,3.9,17,751,3307,4.4,59,96,19,174,78,689,11,9,20
752,2016,1,2016-09-03,Boston College,N,Georgia Tech,L (14-17),11,17,64.7,144,0,37,176,4.8,2,54,320,5.9,6,7,2,15,7,39,2,1,3
753,2016,2,2016-09-10,Boston College,@,Massachusetts,W (26-7),12,22,54.5,191,2,41,153,3.7,1,63,344,5.5,8,6,0,14,5,45,0,1,1
754,2016,3,2016-09-17,Boston College,@,Virginia Tech,L (0-49),9,29,31.0,80,0,28,44,1.6,0,57,124,2.2,4,2,0,6,12,93,1,1,2
755,2016,4,2016-09-24,Boston College,,Wagner,W (42-10),12,20,60.0,190,2,56,300,5.4,4,76,490,6.4,9,14,0,23,7,85,0,0,0
756,2016,5,2016-10-01,Boston College,,Buffalo,W (35-3),15,27,55.6,258,2,57,142,2.5,3,84,400,4.8,10,10,1,21,4,28,2,0,2
757,2016,6,2016-10-07,Boston College,,Clemson,L (10-56),12,24,50.0,96,1,48,155,3.2,0,72,251,3.5,7,7,1,15,6,52,1,1,2
758,2016,7,2016-10-22,Boston College,,Syracuse,L (20-28),7,20,35.0,64,0,40,223,5.6,1,60,287,4.8,4,8,4,16,8,66,1,1,2
759,2016,8,2016-10-29,Boston College,@,North Carolina State,W (21-14),19,34,55.9,218,1,44,168,3.8,1,78,386,4.9,11,7,3,21,6,44,1,1,2
760,2016,9,2016-11-05,Boston College,,Louisville,L (7-52),14,25,56.0,150,1,37,57,1.5,0,62,207,3.3,6,3,0,9,6,70,2,1,3
761,2016,10,2016-11-11,Boston College,@,Florida State,L (7-45),4,13,30.8,50,0,35,96,2.7,1,48,146,3.0,2,4,2,8,6,50,0,0,0
762,2016,11,2016-11-19,Boston College,,Connecticut,W (30-0),14,19,73.7,183,1,52,154,3.0,1,71,337,4.7,7,8,1,16,9,73,0,0,0
763,2016,12,2016-11-26,Boston College,@,Wake Forest,W (17-14),10,23,43.5,74,1,39,93,2.4,1,62,167,2.7,6,4,0,10,8,55,1,0,1
764,2016,13,2016-12-26,Boston College,N,Maryland*,W (36-30),11,23,47.8,171,3,52,177,3.4,1,75,348,4.6,7,8,0,15,6,46,1,1,2
765,2016,,13 Games,Boston College,,,,150,296,50.7,1869,14,566,1938,3.4,16,862,3807,4.4,87,88,14,189,90,746,12,8,20
766,2017,1,2017-09-01,Boston College,@,Northern Illinois,W (23-20),26,42,61.9,191,2,50,148,3.0,0,92,339,3.7,8,11,2,21,8,79,0,1,1
767,2017,2,2017-09-09,Boston College,,Wake Forest,L (10-34),18,41,43.9,163,1,41,142,3.5,0,82,305,3.7,8,10,1,19,0,0,1,3,4
768,2017,3,2017-09-16,Boston College,,Notre Dame,L (20-49),24,41,58.5,215,2,44,185,4.2,0,85,400,4.7,12,10,0,22,6,35,1,2,3
769,2017,4,2017-09-23,Boston College,@,Clemson,L (7-34),15,32,46.9,141,0,34,97,2.9,1,66,238,3.6,6,5,1,12,2,20,0,2,2
770,2017,5,2017-09-30,Boston College,,Central Michigan,W (28-8),14,21,66.7,85,1,53,224,4.2,3,74,309,4.2,4,10,3,17,6,43,2,0,2
771,2017,6,2017-10-07,Boston College,,Virginia Tech,L (10-23),14,33,42.4,191,1,33,153,4.6,0,66,344,5.2,7,7,2,16,5,27,0,0,0
772,2017,7,2017-10-14,Boston College,@,Louisville,W (45-42),12,28,42.9,191,1,59,364,6.2,5,87,555,6.4,11,16,0,27,1,10,0,1,1
773,2017,8,2017-10-21,Boston College,@,Virginia,W (41-10),19,24,79.2,275,3,47,237,5.0,1,71,512,7.2,12,7,0,19,5,52,0,0,0
774,2017,9,2017-10-27,Boston College,,Florida State,W (35-3),7,21,33.3,88,2,55,241,4.4,3,76,329,4.3,3,12,4,19,1,10,0,0,0
775,2017,10,2017-11-11,Boston College,,North Carolina State,L (14-17),10,22,45.5,111,0,54,236,4.4,2,76,347,4.6,6,14,0,20,3,15,1,1,2
776,2017,11,2017-11-18,Boston College,N,Connecticut,W (39-16),7,15,46.7,55,1,49,330,6.7,4,64,385,6.0,1,12,1,14,3,25,1,0,1
777,2017,12,2017-11-25,Boston College,@,Syracuse,W (42-14),16,20,80.0,248,1,56,333,5.9,4,76,581,7.6,11,13,0,24,1,15,1,0,1
778,2017,13,2017-12-27,Boston College,N,Iowa*,L (20-27),16,27,59.3,208,1,43,175,4.1,1,70,383,5.5,12,4,0,16,6,57,1,2,3
779,2017,,13 Games,Boston College,,,,198,367,54.0,2162,16,618,2865,4.6,24,985,5027,5.1,101,131,14,246,47,388,8,12,20
780,2014,1,2014-08-29,Bowling Green State,@,Western Kentucky,L (31-59),25,36,69.4,313,1,35,152,4.3,3,71,465,6.5,17,7,2,26,11,90,0,0,0
781,2014,2,2014-09-06,Bowling Green State,,Virginia Military Institute,W (48-7),25,34,73.5,266,1,37,260,7.0,4,71,526,7.4,11,15,0,26,7,87,1,1,2
782,2014,3,2014-09-13,Bowling Green State,,Indiana,W (45-42),46,73,63.0,395,3,40,176,4.4,2,113,571,5.1,22,10,7,39,4,42,1,1,2
783,2014,4,2014-09-20,Bowling Green State,@,Wisconsin,L (17-68),15,33,45.5,178,0,29,93,3.2,2,62,271,4.4,7,2,2,11,7,36,1,1,2
784,2014,5,2014-09-27,Bowling Green State,@,Massachusetts,W (47-42),38,60,63.3,443,3,48,225,4.7,3,108,668,6.2,15,14,1,30,13,112,0,3,3
785,2014,6,2014-10-04,Bowling Green State,,Buffalo,W (36-35),20,39,51.3,321,1,37,187,5.1,3,76,508,6.7,11,11,4,26,11,82,2,1,3
786,2014,7,2014-10-11,Bowling Green State,@,Ohio,W (31-13),20,39,51.3,260,2,27,95,3.5,2,66,355,5.4,11,5,3,19,8,75,0,1,1
787,2014,8,2014-10-18,Bowling Green State,,Western Michigan,L (14-26),20,33,60.6,139,0,31,135,4.4,2,64,274,4.3,7,6,1,14,5,40,1,1,2
788,2014,9,2014-11-04,Bowling Green State,@,Akron,W (27-10),17,34,50.0,170,1,51,219,4.3,1,85,389,4.6,7,11,3,21,9,61,1,0,1
789,2014,10,2014-11-12,Bowling Green State,,Kent State,W (30-20),22,36,61.1,315,1,60,207,3.5,2,96,522,5.4,12,12,3,27,10,66,1,1,2
790,2014,11,2014-11-19,Bowling Green State,@,Toledo,L (20-27),12,37,32.4,167,1,38,104,2.7,1,75,271,3.6,8,7,2,17,9,61,0,0,0
791,2014,12,2014-11-28,Bowling Green State,,Ball State,L (24-41),18,27,66.7,140,0,39,314,8.1,2,66,454,6.9,8,9,1,18,6,36,0,0,0
792,2014,13,2014-12-05,Bowling Green State,N,Northern Illinois,L (17-51),13,25,52.0,163,1,35,124,3.5,1,60,287,4.8,8,4,1,13,2,5,1,3,4
793,2014,14,2014-12-20,Bowling Green State,N,South Alabama*,W (33-28),26,41,63.4,369,2,49,131,2.7,2,90,500,5.6,14,7,3,24,8,79,1,0,1
794,2014,,14 Games,Bowling Green State,,,,317,547,58.0,3639,17,556,2422,4.4,30,1103,6061,5.5,158,120,33,311,110,872,10,13,23
795,2015,1,2015-09-05,Bowling Green State,N,Tennessee,L (30-59),29,51,56.9,433,2,34,124,3.6,1,85,557,6.6,16,7,1,24,12,128,1,0,1
796,2015,2,2015-09-12,Bowling Green State,@,Maryland,W (48-27),36,55,65.5,491,6,50,201,4.0,1,105,692,6.6,19,13,3,35,10,80,0,1,1
797,2015,3,2015-09-19,Bowling Green State,,Memphis,L (41-44),28,45,62.2,443,4,29,136,4.7,2,74,579,7.8,14,8,2,24,10,92,0,0,0
798,2015,4,2015-09-26,Bowling Green State,@,Purdue,W (35-28),43,59,72.9,402,1,33,137,4.2,4,92,539,5.9,22,12,5,39,10,98,1,1,2
799,2015,5,2015-10-03,Bowling Green State,@,Buffalo,W (28-22),23,29,79.3,324,1,42,212,5.0,3,71,536,7.5,12,11,2,25,7,70,0,0,0
800,2015,6,2015-10-10,Bowling Green State,,Massachusetts,W (62-38),37,45,82.2,519,5,46,206,4.5,3,91,725,8.0,22,12,3,37,10,113,0,1,1
801,2015,7,2015-10-17,Bowling Green State,,Akron,W (59-10),27,33,81.8,412,5,42,120,2.9,3,75,532,7.1,16,9,2,27,7,64,0,0,0
802,2015,8,2015-10-24,Bowling Green State,@,Kent State,W (48-0),29,45,64.4,449,5,46,153,3.3,1,91,602,6.6,18,10,3,31,8,85,0,0,0
803,2015,9,2015-11-04,Bowling Green State,,Ohio,W (62-24),29,39,74.4,399,5,30,182,6.1,3,69,581,8.4,16,11,2,29,9,66,0,0,0
804,2015,10,2015-11-11,Bowling Green State,@,Western Michigan,W (41-27),23,41,56.1,269,3,41,236,5.8,3,82,505,6.2,13,14,1,28,6,38,0,1,1
805,2015,11,2015-11-17,Bowling Green State,,Toledo,L (28-44),28,46,60.9,274,3,30,94,3.1,1,76,368,4.8,13,10,5,28,8,85,3,2,5
806,2015,12,2015-11-24,Bowling Green State,@,Ball State,W (48-10),26,35,74.3,239,2,37,337,9.1,5,72,576,8.0,10,11,1,22,6,45,0,0,0
807,2015,13,2015-12-04,Bowling Green State,N,Northern Illinois,W (34-14),25,37,67.6,235,2,53,266,5.0,3,90,501,5.6,10,13,2,25,13,110,0,2,2
808,2015,14,2015-12-23,Bowling Green State,N,Georgia Southern*,L (27-58),15,34,44.1,246,3,29,116,4.0,1,63,362,5.7,10,3,2,15,7,59,2,0,2
809,2015,,14 Games,Bowling Green State,,,,398,594,67.0,5135,47,542,2520,4.6,34,1136,7655,6.7,211,144,34,389,123,1133,7,8,15
810,2016,1,2016-09-03,Bowling Green State,@,Ohio State,L (10-77),21,44,47.7,175,0,28,69,2.5,0,72,244,3.4,10,4,2,16,5,45,0,3,3
811,2016,2,2016-09-10,Bowling Green State,,North Dakota,W (27-26),24,42,57.1,327,3,33,90,2.7,1,75,417,5.6,12,9,1,22,5,40,0,3,3
812,2016,3,2016-09-17,Bowling Green State,,Middle Tennessee State,L (21-41),18,32,56.3,129,0,61,304,5.0,3,93,433,4.7,6,17,1,24,8,79,2,2,4
813,2016,4,2016-09-24,Bowling Green State,@,Memphis,L (3-77),24,48,50.0,203,0,28,91,3.3,0,76,294,3.9,9,3,2,14,4,59,0,4,4
814,2016,5,2016-10-01,Bowling Green State,,Eastern Michigan,L (25-28),23,47,48.9,250,1,42,206,4.9,2,89,456,5.1,14,11,4,29,4,48,0,1,1
815,2016,6,2016-10-08,Bowling Green State,@,Ohio,L (24-30),22,38,57.9,253,2,39,114,2.9,1,77,367,4.8,12,9,3,24,7,71,1,3,4
816,2016,7,2016-10-15,Bowling Green State,@,Toledo,L (35-42),25,38,65.8,335,5,34,167,4.9,0,72,502,7.0,12,10,2,24,10,83,0,1,1
817,2016,8,2016-10-22,Bowling Green State,,Miami (OH),L (26-40),30,49,61.2,389,3,23,57,2.5,0,72,446,6.2,16,4,6,26,10,104,1,3,4
818,2016,9,2016-11-01,Bowling Green State,@,Northern Illinois,L (20-45),21,43,48.8,224,3,35,90,2.6,0,78,314,4.0,14,6,2,20,9,84,0,2,2
819,2016,10,2016-11-09,Bowling Green State,@,Akron,W (38-28),11,23,47.8,105,0,46,218,4.7,4,69,323,4.7,13,4,1,18,4,43,1,1,2
820,2016,11,2016-11-15,Bowling Green State,,Kent State,W (42-7),12,24,50.0,177,2,66,420,6.4,4,90,597,6.6,10,22,3,35,4,40,1,2,3
821,2016,12,2016-11-25,Bowling Green State,,Buffalo,W (27-19),12,21,57.1,146,0,67,346,5.2,3,88,492,5.6,10,17,0,27,0,0,2,0,2
822,2016,,12 Games,Bowling Green State,,,,243,449,54.1,2713,19,502,2172,4.3,18,951,4885,5.1,138,116,27,279,70,696,8,25,33
823,2017,1,2017-09-02,Bowling Green State,@,Michigan State,L (10-35),10,31,32.3,145,0,24,67,2.8,0,55,212,3.9,6,3,0,9,4,20,0,1,1
824,2017,2,2017-09-09,Bowling Green State,,South Dakota,L (27-35),20,49,40.8,311,2,34,161,4.7,0,83,472,5.7,13,7,3,23,14,155,2,1,3
825,2017,3,2017-09-16,Bowling Green State,@,Northwestern,L (7-49),27,44,61.4,256,0,30,96,3.2,1,74,352,4.8,14,6,1,21,3,15,1,0,1
826,2017,4,2017-09-23,Bowling Green State,@,Middle Tennessee State,L (13-24),21,35,60.0,283,1,29,41,1.4,0,64,324,5.1,11,3,0,14,6,50,0,0,0
827,2017,5,2017-09-30,Bowling Green State,,Akron,L (23-34),25,39,64.1,195,2,41,181,4.4,1,80,376,4.7,6,11,0,17,8,77,2,2,4
828,2017,6,2017-10-07,Bowling Green State,@,Miami (OH),W (37-29),12,26,46.2,230,3,41,275,6.7,1,67,505,7.5,7,14,5,26,10,95,0,1,1
829,2017,7,2017-10-14,Bowling Green State,,Ohio,L (30-48),17,43,39.5,192,1,47,229,4.9,2,90,421,4.7,10,10,2,22,5,55,2,2,4
830,2017,8,2017-10-21,Bowling Green State,,Northern Illinois,L (17-48),13,23,56.5,175,1,44,192,4.4,1,67,367,5.5,8,9,1,18,6,53,2,3,5
831,2017,9,2017-10-31,Bowling Green State,@,Kent State,W (44-16),14,19,73.7,174,2,46,227,4.9,3,65,401,6.2,7,10,1,18,10,73,0,0,0
832,2017,10,2017-11-07,Bowling Green State,@,Buffalo,L (28-38),28,43,65.1,294,3,30,100,3.3,1,73,394,5.4,11,8,2,21,6,54,3,0,3
833,2017,11,2017-11-15,Bowling Green State,,Toledo,L (37-66),18,31,58.1,309,4,33,82,2.5,1,64,391,6.1,13,4,3,21,9,102,0,1,1
834,2017,12,2017-11-21,Bowling Green State,@,Eastern Michigan,L (31-34),21,34,61.8,256,2,31,209,6.7,2,65,465,7.2,11,8,3,22,8,78,1,1,2
835,2017,,12 Games,Bowling Green State,,,,226,417,54.2,2820,21,430,1860,4.3,13,847,4680,5.5,117,93,21,232,89,827,13,12,25
836,2014,1,2014-08-29,Brigham Young,@,Connecticut,W (35-10),28,36,77.8,308,3,37,205,5.5,2,73,513,7.0,13,11,3,27,15,150,2,0,2
837,2014,2,2014-09-06,Brigham Young,@,Texas,W (41-7),18,28,64.3,181,0,60,248,4.1,5,88,429,4.9,12,15,1,28,6,40,1,1,2
838,2014,3,2014-09-11,Brigham Young,,Houston,W (33-25),21,34,61.8,200,1,62,323,5.2,3,96,523,5.4,9,19,4,32,11,98,1,2,3
839,2014,4,2014-09-20,Brigham Young,,Virginia,W (41-33),13,23,56.5,187,2,37,145,3.9,2,60,332,5.5,7,7,2,16,12,133,0,0,0
840,2014,5,2014-10-03,Brigham Young,,Utah State,L (20-35),18,40,45.0,271,1,34,154,4.5,1,74,425,5.7,8,12,3,23,9,60,1,3,4
841,2014,6,2014-10-09,Brigham Young,@,Central Florida,L (24-31),22,37,59.5,153,3,49,189,3.9,0,86,342,4.0,7,14,0,21,9,71,1,1,2
842,2014,7,2014-10-18,Brigham Young,,Nevada,L (35-42),39,63,61.9,408,4,39,193,4.9,1,102,601,5.9,25,13,0,38,6,75,3,0,3
843,2014,8,2014-10-24,Brigham Young,@,Boise State,L (30-55),23,38,60.5,259,1,26,63,2.4,2,64,322,5.0,12,4,1,17,7,70,1,1,2
844,2014,9,2014-11-01,Brigham Young,@,Middle Tennessee State,W (27-7),28,45,62.2,316,2,39,128,3.3,2,84,444,5.3,15,9,1,25,7,70,0,0,0
845,2014,10,2014-11-15,Brigham Young,,Nevada-Las Vegas,W (42-23),18,32,56.3,325,3,41,267,6.5,3,73,592,8.1,12,10,1,23,5,50,2,0,2
846,2014,11,2014-11-22,Brigham Young,,Savannah State,W (64-0),15,20,75.0,234,4,62,264,4.3,4,82,498,6.1,9,17,1,27,7,75,1,0,1
847,2014,12,2014-11-29,Brigham Young,@,California,W (42-35),23,38,60.5,433,5,39,107,2.7,1,77,540,7.0,16,6,4,26,9,90,1,1,2
848,2014,13,2014-12-22,Brigham Young,N,Memphis*,L (48-55),23,49,46.9,348,3,42,77,1.8,2,91,425,4.7,15,6,1,22,7,70,1,3,4
849,2014,,13 Games,Brigham Young,,,,289,483,59.8,3623,32,567,2363,4.2,28,1050,5986,5.7,160,143,22,325,110,1052,15,12,27
850,2015,1,2015-09-05,Brigham Young,@,Nebraska,W (33-28),28,46,60.9,379,2,26,132,5.1,2,72,511,7.1,13,7,1,21,4,30,0,1,1
851,2015,2,2015-09-12,Brigham Young,,Boise State,W (35-24),17,29,58.6,309,2,39,72,1.8,2,68,381,5.6,0,0,0,16,5,54,0,2,2
852,2015,3,2015-09-19,Brigham Young,@,UCLA,L (23-24),30,47,63.8,244,1,41,161,3.9,1,88,405,4.6,13,11,2,26,5,35,0,1,1
853,2015,4,2015-09-26,Brigham Young,@,Michigan,L (0-31),12,28,42.9,55,0,22,50,2.3,0,50,105,2.1,2,4,2,8,5,45,0,0,0
854,2015,5,2015-10-02,Brigham Young,,Connecticut,W (30-13),35,54,64.8,365,2,41,174,4.2,1,95,539,5.7,20,9,2,31,7,70,1,2,3
855,2015,6,2015-10-10,Brigham Young,,East Carolina,W (45-38),25,38,65.8,341,3,43,167,3.9,3,81,508,6.3,13,11,2,26,7,61,1,1,2
856,2015,7,2015-10-16,Brigham Young,,Cincinnati,W (38-24),19,32,59.4,252,2,29,197,6.8,3,61,449,7.4,10,7,5,22,10,74,0,1,1
857,2015,8,2015-10-24,Brigham Young,,Wagner,W (70-6),23,27,85.2,411,4,42,330,7.9,6,69,741,10.7,16,15,0,31,7,55,0,0,0
858,2015,9,2015-11-06,Brigham Young,@,San Jose State,W (17-16),23,37,62.2,293,1,25,36,1.4,1,62,329,5.3,14,3,0,17,7,84,0,1,1
859,2015,10,2015-11-14,Brigham Young,N,Missouri,L (16-20),23,41,56.1,244,1,15,46,3.1,1,56,290,5.2,11,3,4,18,6,42,2,0,2
860,2015,11,2015-11-21,Brigham Young,,Fresno State,W (52-10),26,39,66.7,362,2,34,158,4.6,4,73,520,7.1,18,4,0,22,7,70,2,0,2
861,2015,12,2015-11-28,Brigham Young,@,Utah State,W (51-28),16,30,53.3,284,4,31,74,2.4,2,61,358,5.9,9,4,2,15,9,76,0,0,0
862,2015,13,2015-12-19,Brigham Young,N,Utah*,L (28-35),25,56,44.6,315,2,25,71,2.8,2,81,386,4.8,12,5,4,22,6,54,2,3,5
863,2015,,13 Games,Brigham Young,,,,302,504,59.9,3854,26,413,1668,4.0,28,917,5522,6.0,151,83,24,275,85,750,8,12,20
864,2016,1,2016-09-03,Brigham Young,N,Arizona,W (18-16),21,29,72.4,202,1,47,213,4.5,1,76,415,5.5,10,14,0,24,8,65,0,0,0
865,2016,2,2016-09-10,Brigham Young,@,Utah,L (19-20),22,39,56.4,185,0,28,146,5.2,2,67,331,4.9,11,6,1,18,10,112,0,2,2
866,2016,3,2016-09-17,Brigham Young,,UCLA,L (14-17),26,49,53.1,250,1,25,23,0.9,1,74,273,3.7,12,4,3,19,2,15,0,1,1
867,2016,4,2016-09-24,Brigham Young,N,West Virginia,L (32-35),23,36,63.9,241,2,40,280,7.0,2,76,521,6.9,14,12,1,27,8,51,1,3,4
868,2016,5,2016-09-30,Brigham Young,,Toledo,W (55-53),11,21,52.4,248,1,45,338,7.5,6,66,586,8.9,10,14,2,26,7,82,0,0,0
869,2016,6,2016-10-08,Brigham Young,@,Michigan State,W (31-14),18,29,62.1,138,1,49,260,5.3,3,78,398,5.1,7,15,2,24,3,24,0,0,0
870,2016,7,2016-10-14,Brigham Young,,Mississippi State,W (28-21),16,28,57.1,165,3,46,147,3.2,1,74,312,4.2,8,8,4,20,9,84,1,1,2
871,2016,8,2016-10-20,Brigham Young,@,Boise State,L (27-28),21,41,51.2,187,0,38,135,3.6,1,79,322,4.1,9,9,1,19,7,61,0,0,0
872,2016,9,2016-11-05,Brigham Young,@,Cincinnati,W (20-3),15,25,60.0,130,0,47,207,4.4,2,72,337,4.7,9,12,2,23,5,28,0,1,1
873,2016,10,2016-11-12,Brigham Young,,Southern Utah,W (37-7),33,42,78.6,441,2,40,155,3.9,2,82,596,7.3,19,14,0,33,6,65,2,1,3
874,2016,11,2016-11-19,Brigham Young,,Massachusetts,W (51-9),20,34,58.8,184,1,49,247,5.0,4,83,431,5.2,11,12,4,27,5,64,1,0,1
875,2016,12,2016-11-26,Brigham Young,,Utah State,W (28-10),11,22,50.0,106,2,54,249,4.6,1,76,355,4.7,5,14,7,26,8,68,0,2,2
876,2016,13,2016-12-21,Brigham Young,N,Wyoming*,W (24-21),8,15,53.3,96,1,35,216,6.2,2,50,312,6.2,5,7,1,13,5,63,1,1,2
877,2016,,13 Games,Brigham Young,,,,245,410,59.8,2573,15,543,2616,4.8,28,953,5189,5.4,130,141,28,299,83,782,6,12,18
878,2017,1,2017-08-26,Brigham Young,,Portland State,W (20-6),16,27,59.3,194,1,33,173,5.2,1,60,367,6.1,10,3,0,13,7,70,0,0,0
879,2017,2,2017-09-02,Brigham Young,N,Louisiana State,L (0-27),12,24,50.0,102,0,14,-5,-0.4,0,38,97,2.6,4,1,1,6,5,39,0,1,1
880,2017,3,2017-09-09,Brigham Young,,Utah,L (13-19),21,39,53.8,170,1,24,63,2.6,1,63,233,3.7,8,3,2,13,4,35,0,3,3
881,2017,4,2017-09-16,Brigham Young,,Wisconsin,L (6-40),11,20,55.0,111,0,26,81,3.1,0,46,192,4.2,5,5,1,11,5,33,0,2,2
882,2017,5,2017-09-29,Brigham Young,@,Utah State,L (24-40),12,29,41.4,186,2,46,210,4.6,0,75,396,5.3,9,11,0,20,8,55,3,4,7
883,2017,6,2017-10-06,Brigham Young,,Boise State,L (7-24),20,37,54.1,172,0,23,66,2.9,1,60,238,4.0,8,4,0,12,3,35,0,2,2
884,2017,7,2017-10-14,Brigham Young,@,Mississippi State,L (10-35),17,29,58.6,147,1,17,29,1.7,0,46,176,3.8,4,2,2,8,2,22,1,1,2
885,2017,8,2017-10-21,Brigham Young,@,East Carolina,L (17-33),26,41,63.4,319,2,31,102,3.3,0,72,421,5.8,14,7,1,22,8,69,0,1,1
886,2017,9,2017-10-28,Brigham Young,,San Jose State,W (41-20),21,38,55.3,332,3,39,266,6.8,2,77,598,7.8,15,7,0,22,6,65,1,1,2
887,2017,10,2017-11-04,Brigham Young,@,Fresno State,L (13-20),23,43,53.5,214,0,27,122,4.5,1,70,336,4.8,10,10,1,21,3,25,1,0,1
888,2017,11,2017-11-10,Brigham Young,@,Nevada-Las Vegas,W (31-21),14,22,63.6,160,1,42,265,6.3,3,64,425,6.6,9,13,2,24,2,20,0,0,0
889,2017,12,2017-11-18,Brigham Young,,Massachusetts,L (10-16),21,45,46.7,257,1,26,42,1.6,0,71,299,4.2,10,7,0,17,5,35,0,4,4
890,2017,13,2017-11-25,Brigham Young,@,Hawaii,W (30-20),14,24,58.3,166,1,54,285,5.3,3,78,451,5.8,10,14,2,26,1,6,2,0,2
891,2017,,13 Games,Brigham Young,,,,228,418,54.5,2530,13,402,1699,4.2,12,820,4229,5.2,116,87,12,215,59,509,8,19,27
892,2014,1,2014-08-30,Buffalo,,Duquesne,W (38-28),25,36,69.4,298,3,49,174,3.6,2,85,472,5.6,14,10,2,26,3,31,1,1,2
893,2014,2,2014-09-06,Buffalo,@,Army,L (39-47),34,50,68.0,396,5,29,153,5.3,0,79,549,6.9,21,8,4,33,7,59,0,3,3
894,2014,3,2014-09-12,Buffalo,,Baylor,L (21-63),18,31,58.1,255,2,39,139,3.6,1,70,394,5.6,8,5,2,15,8,59,1,0,1
895,2014,4,2014-09-20,Buffalo,,Norfolk State,W (36-7),15,29,51.7,262,4,44,169,3.8,1,73,431,5.9,10,9,3,22,4,55,0,0,0
896,2014,5,2014-09-27,Buffalo,,Miami (OH),W (35-27),29,39,74.4,302,2,49,273,5.6,3,88,575,6.5,14,14,1,29,5,58,0,0,0
897,2014,6,2014-10-04,Buffalo,@,Bowling Green State,L (35-36),16,24,66.7,134,1,47,234,5.0,4,71,368,5.2,9,11,3,23,6,70,0,1,1
898,2014,7,2014-10-11,Buffalo,@,Eastern Michigan,L (27-37),27,45,60.0,383,3,36,154,4.3,0,81,537,6.6,12,7,3,22,7,60,1,2,3
899,2014,8,2014-10-25,Buffalo,,Central Michigan,L (14-20),21,37,56.8,233,2,22,38,1.7,0,59,271,4.6,10,3,2,15,3,40,0,2,2
900,2014,9,2014-11-05,Buffalo,@,Ohio,L (14-37),12,25,48.0,106,1,25,28,1.1,0,50,134,2.7,5,2,0,7,3,21,2,2,4
901,2014,10,2014-11-11,Buffalo,,Akron,W (55-24),17,23,73.9,226,5,54,310,5.7,3,77,536,7.0,9,16,4,29,7,75,1,1,2
902,2014,11,2014-11-28,Buffalo,@,Massachusetts,W (41-21),20,27,74.1,255,4,49,293,6.0,2,76,548,7.2,10,12,1,23,5,55,0,0,0
903,2014,,11 Games,Buffalo,,,,234,366,63.9,2850,32,443,1965,4.4,16,809,4815,6.0,122,97,25,244,58,583,6,12,18
904,2015,1,2015-09-05,Buffalo,,Albany,W (51-14),22,29,75.9,255,2,43,212,4.9,4,72,467,6.5,11,10,3,24,7,56,0,0,0
905,2015,2,2015-09-12,Buffalo,@,Penn State,L (14-27),24,35,68.6,205,2,33,69,2.1,0,68,274,4.0,10,4,1,15,14,107,0,1,1
906,2015,3,2015-09-19,Buffalo,@,Florida Atlantic,W (33-15),10,20,50.0,105,0,45,185,4.1,1,65,290,4.5,5,8,0,13,8,75,0,1,1
907,2015,4,2015-09-26,Buffalo,,Nevada,L (21-24),28,46,60.9,338,2,35,149,4.3,0,81,487,6.0,15,7,1,23,9,90,1,2,3
908,2015,5,2015-10-03,Buffalo,,Bowling Green State,L (22-28),35,59,59.3,348,1,37,152,4.1,1,96,500,5.2,21,11,2,34,8,85,0,1,1
909,2015,6,2015-10-17,Buffalo,@,Central Michigan,L (14-51),14,28,50.0,149,1,29,92,3.2,0,57,241,4.2,7,5,1,13,5,63,2,2,4
910,2015,7,2015-10-24,Buffalo,,Ohio,W (41-17),21,32,65.6,212,0,34,161,4.7,3,66,373,5.7,10,8,1,19,8,65,0,0,0
911,2015,8,2015-10-29,Buffalo,@,Miami (OH),W (29-24),22,29,75.9,289,2,40,144,3.6,2,69,433,6.3,11,6,1,18,6,65,0,1,1
912,2015,9,2015-11-05,Buffalo,@,Kent State,W (18-17),25,39,64.1,190,2,35,116,3.3,1,74,306,4.1,10,8,2,20,3,26,0,1,1
913,2015,10,2015-11-11,Buffalo,,Northern Illinois,L (30-41),31,47,66.0,354,2,23,78,3.4,1,70,432,6.2,15,5,3,23,5,26,0,3,3
914,2015,11,2015-11-21,Buffalo,@,Akron,L (21-42),32,51,62.7,262,1,28,130,4.6,2,79,392,5.0,16,5,2,23,6,64,1,2,3
915,2015,12,2015-11-27,Buffalo,,Massachusetts,L (26-31),19,40,47.5,287,1,43,160,3.7,2,83,447,5.4,11,9,1,21,5,46,0,2,2
916,2015,,12 Games,Buffalo,,,,283,455,62.2,2994,16,425,1648,3.9,17,880,4642,5.3,142,86,18,246,84,768,4,16,20
917,2016,1,2016-09-02,Buffalo,,Albany,L (16-22),17,34,50.0,177,1,48,226,4.7,0,82,403,4.9,10,11,2,23,9,83,1,3,4
918,2016,2,2016-09-17,Buffalo,@,Nevada,L (14-38),7,23,30.4,130,1,35,231,6.6,1,58,361,6.2,4,13,0,17,4,24,0,0,0
919,2016,3,2016-09-24,Buffalo,,Army,W (23-20),20,31,64.5,178,1,33,87,2.6,2,64,265,4.1,7,5,1,13,5,35,0,1,1
920,2016,4,2016-10-01,Buffalo,@,Boston College,L (3-35),10,23,43.5,41,0,19,26,1.4,0,42,67,1.6,3,1,1,5,5,39,1,0,1
921,2016,5,2016-10-08,Buffalo,,Kent State,L (20-44),21,40,52.5,256,1,37,116,3.1,1,77,372,4.8,11,8,1,20,2,18,1,0,1
922,2016,6,2016-10-15,Buffalo,,Ball State,L (21-31),28,46,60.9,306,3,37,153,4.1,0,83,459,5.5,16,7,1,24,6,49,0,0,0
923,2016,7,2016-10-22,Buffalo,@,Northern Illinois,L (7-44),25,41,61.0,203,0,29,135,4.7,1,70,338,4.8,12,7,1,20,6,53,0,4,4
924,2016,8,2016-10-27,Buffalo,,Akron,W (41-20),7,21,33.3,140,1,42,378,9.0,4,63,518,8.2,4,15,0,19,6,66,0,1,1
925,2016,9,2016-11-03,Buffalo,@,Ohio,L (10-34),24,40,60.0,308,1,38,105,2.8,0,78,413,5.3,12,6,1,19,8,66,1,1,2
926,2016,10,2016-11-12,Buffalo,,Miami (OH),L (24-35),21,40,52.5,193,0,46,187,4.1,2,86,380,4.4,12,12,3,27,5,36,1,1,2
927,2016,11,2016-11-19,Buffalo,@,Western Michigan,L (0-38),12,22,54.5,140,0,30,128,4.3,0,52,268,5.2,6,6,1,13,4,32,1,0,1
928,2016,12,2016-11-25,Buffalo,@,Bowling Green State,L (19-27),20,36,55.6,334,2,32,67,2.1,1,68,401,5.9,15,5,0,20,3,16,2,0,2
929,2016,,12 Games,Buffalo,,,,212,397,53.4,2406,11,426,1839,4.3,12,823,4245,5.2,112,96,12,220,63,517,8,11,19
930,2017,1,2017-08-31,Buffalo,@,Minnesota,L (7-17),22,42,52.4,211,1,22,51,2.3,0,64,262,4.1,10,2,1,13,4,35,0,1,1
931,2017,2,2017-09-09,Buffalo,@,Army,L (17-21),9,16,56.3,193,1,23,119,5.2,1,39,312,8.0,8,3,0,11,3,25,2,0,2
932,2017,3,2017-09-16,Buffalo,,Colgate,W (33-10),9,16,56.3,184,1,58,302,5.2,3,74,486,6.6,7,17,2,26,7,70,0,0,0
933,2017,4,2017-09-23,Buffalo,,Florida Atlantic,W (34-31),18,27,66.7,254,1,57,204,3.6,3,84,458,5.5,15,9,4,28,7,52,0,0,0
934,2017,5,2017-09-30,Buffalo,@,Kent State,W (27-13),11,18,61.1,142,1,44,235,5.3,3,62,377,6.1,6,7,5,18,6,56,0,1,1
935,2017,6,2017-10-07,Buffalo,,Western Michigan,L (68-71),35,61,57.4,597,7,33,86,2.6,2,94,683,7.3,19,6,5,30,8,64,2,0,2
936,2017,7,2017-10-14,Buffalo,,Northern Illinois,L (13-14),21,34,61.8,344,1,27,39,1.4,0,61,383,6.3,11,2,2,15,8,77,0,1,1
937,2017,8,2017-10-21,Buffalo,@,Miami (OH),L (14-24),17,41,41.5,202,2,25,69,2.8,0,66,271,4.1,10,2,2,14,5,50,1,1,2
938,2017,9,2017-10-28,Buffalo,@,Akron,L (20-21),34,50,68.0,313,0,34,141,4.1,2,84,454,5.4,17,9,2,28,4,31,0,1,1
939,2017,10,2017-11-07,Buffalo,,Bowling Green State,W (38-28),23,37,62.2,406,3,40,176,4.4,2,77,582,7.6,16,8,2,26,6,51,2,0,2
940,2017,11,2017-11-16,Buffalo,@,Ball State,W (40-24),16,28,57.1,350,4,39,215,5.5,1,67,565,8.4,14,11,1,26,5,47,0,1,1
941,2017,12,2017-11-24,Buffalo,,Ohio,W (31-24),19,30,63.3,294,2,26,56,2.2,1,56,350,6.3,12,3,1,16,4,39,0,0,0
942,2017,,12 Games,Buffalo,,,,234,400,58.5,3490,24,428,1693,4.0,18,828,5183,6.3,145,79,27,251,67,597,7,6,13
943,2014,1,2014-08-30,California,@,Northwestern,W (31-24),23,39,59.0,300,3,45,114,2.5,1,84,414,4.9,13,10,0,23,6,59,0,2,2
944,2014,2,2014-09-06,California,,Sacramento State,W (55-14),21,29,72.4,326,5,47,253,5.4,2,76,579,7.6,14,10,2,26,10,100,1,0,1
945,2014,3,2014-09-20,California,@,Arizona,L (45-49),18,30,60.0,380,3,42,193,4.6,3,72,573,8.0,13,9,2,24,10,99,1,1,2
946,2014,4,2014-09-27,California,,Colorado,W (59-56),23,41,56.1,449,7,30,127,4.2,1,71,576,8.1,15,7,2,24,12,113,1,1,2
947,2014,5,2014-10-04,California,@,Washington State,W (60-59),37,53,69.8,527,5,18,62,3.4,1,71,589,8.3,19,5,3,27,8,34,0,0,0
948,2014,6,2014-10-11,California,,Washington,L (7-31),35,51,68.6,304,0,33,64,1.9,1,84,368,4.4,18,5,2,25,7,56,3,0,3
949,2014,7,2014-10-18,California,,UCLA,L (34-36),26,42,61.9,310,3,31,56,1.8,2,73,366,5.0,12,6,3,21,4,40,0,1,1
950,2014,8,2014-10-24,California,,Oregon,L (41-59),33,55,60.0,367,2,38,193,5.1,4,93,560,6.0,16,11,3,30,11,111,2,0,2
951,2014,9,2014-11-01,California,@,Oregon State,W (45-31),24,47,51.1,277,1,47,269,5.7,4,94,546,5.8,16,14,4,34,9,71,0,0,0
952,2014,10,2014-11-13,California,@,Southern California,L (30-38),29,47,61.7,279,3,31,105,3.4,1,78,384,4.9,15,6,6,27,11,117,1,0,1
953,2014,11,2014-11-22,California,,Stanford,L (17-38),21,40,52.5,231,1,36,179,5.0,1,76,410,5.4,14,8,1,23,12,113,1,4,5
954,2014,12,2014-11-29,California,,Brigham Young,L (35-42),38,60,63.3,393,4,41,173,4.2,1,101,566,5.6,22,8,4,34,7,78,0,1,1
955,2014,,12 Games,California,,,,328,534,61.4,4143,37,439,1788,4.1,22,973,5931,6.1,187,99,32,318,107,991,10,10,20
956,2015,1,2015-09-05,California,,Grambling State,W (73-14),34,49,69.4,471,4,39,185,4.7,4,88,656,7.5,22,8,1,31,3,36,1,2,3
957,2015,2,2015-09-12,California,,San Diego State,W (35-7),17,25,68.0,321,3,36,164,4.6,2,61,485,8.0,10,10,4,24,5,50,0,1,1
958,2015,3,2015-09-19,California,@,Texas,W (45-44),27,37,73.0,268,3,41,280,6.8,3,78,548,7.0,12,11,3,26,6,50,2,0,2
959,2015,4,2015-09-26,California,@,Washington,W (30-24),24,41,58.5,342,2,51,139,2.7,1,92,481,5.2,15,11,2,28,6,35,1,1,2
960,2015,5,2015-10-03,California,,Washington State,W (34-28),33,45,73.3,390,4,30,79,2.6,0,75,469,6.3,19,6,0,25,4,15,1,1,2
961,2015,6,2015-10-10,California,@,Utah,L (24-30),25,47,53.2,340,2,28,127,4.5,1,75,467,6.2,15,8,2,25,4,43,1,5,6
962,2015,7,2015-10-22,California,@,UCLA,L (24-40),32,53,60.4,295,3,35,131,3.7,0,88,426,4.8,16,8,1,25,5,37,0,0,0
963,2015,8,2015-10-31,California,,Southern California,L (21-27),23,31,74.2,272,2,30,117,3.9,1,61,389,6.4,14,6,3,23,3,26,1,2,3
964,2015,9,2015-11-07,California,@,Oregon,L (28-44),18,42,42.9,329,2,24,103,4.3,1,66,432,6.5,11,6,3,20,6,64,0,1,1
965,2015,10,2015-11-14,California,,Oregon State,W (54-24),26,37,70.3,453,6,46,307,6.7,1,83,760,9.2,17,16,3,36,9,85,0,1,1
966,2015,11,2015-11-21,California,@,Stanford,L (22-35),38,55,69.1,397,2,23,98,4.3,0,78,495,6.3,15,7,1,23,8,63,0,0,0
967,2015,12,2015-11-28,California,,Arizona State,W (48-46),30,51,58.8,542,5,22,138,6.3,1,73,680,9.3,19,8,1,28,3,35,1,0,1
968,2015,13,2015-12-29,California,N,Air Force*,W (55-36),25,37,67.6,467,6,34,119,3.5,1,71,586,8.3,16,9,2,27,5,29,1,0,1
969,2015,,13 Games,California,,,,352,550,64.0,4887,44,439,1987,4.5,16,989,6874,7.0,201,114,26,341,67,568,9,14,23
970,2016,1,2016-08-26,California,N,Hawaii,W (51-31),38,54,70.4,441,4,35,189,5.4,2,89,630,7.1,19,9,2,30,6,80,0,0,0
971,2016,2,2016-09-10,California,@,San Diego State,L (40-45),41,72,56.9,522,5,22,82,3.7,0,94,604,6.4,23,5,2,30,5,55,1,3,4
972,2016,3,2016-09-17,California,,Texas,W (50-43),27,40,67.5,396,4,40,111,2.8,3,80,507,6.3,19,4,1,24,6,71,0,0,0
973,2016,4,2016-09-24,California,@,Arizona State,L (41-51),32,56,57.1,478,5,37,159,4.3,0,93,637,6.8,20,8,1,29,8,60,1,2,3
974,2016,5,2016-10-01,California,,Utah,W (28-23),22,35,62.9,306,4,14,56,4.0,0,49,362,7.4,12,4,1,17,8,65,0,1,1
975,2016,6,2016-10-08,California,@,Oregon State,L (44-47),24,45,53.3,124,0,44,317,7.2,4,89,441,5.0,5,17,5,27,10,85,0,1,1
976,2016,7,2016-10-21,California,,Oregon,W (52-49),42,61,68.9,325,5,57,311,5.5,1,118,636,5.4,20,18,2,40,14,145,0,0,0
977,2016,8,2016-10-27,California,@,Southern California,L (24-45),34,53,64.2,333,2,30,142,4.7,1,83,475,5.7,16,8,5,29,7,65,1,1,2
978,2016,9,2016-11-05,California,,Washington,L (27-66),23,47,48.9,262,1,27,100,3.7,2,74,362,4.9,10,6,2,18,9,93,0,3,3
979,2016,10,2016-11-12,California,@,Washington State,L (21-56),34,53,64.2,425,3,30,100,3.3,0,83,525,6.3,19,7,4,30,10,120,0,1,1
980,2016,11,2016-11-19,California,,Stanford,L (31-45),34,57,59.6,393,2,24,90,3.8,2,81,483,6.0,19,6,2,27,4,45,0,0,0
981,2016,12,2016-11-26,California,,UCLA,W (36-10),32,48,66.7,301,2,54,195,3.6,1,102,496,4.9,15,11,8,34,2,25,0,0,0
982,2016,,12 Games,California,,,,383,621,61.7,4306,37,414,1852,4.5,16,1035,6158,5.9,197,103,35,335,89,909,3,12,15
983,2017,1,2017-09-02,California,@,North Carolina,W (35-30),24,38,63.2,363,4,35,106,3.0,1,73,469,6.4,13,6,1,20,9,57,0,2,2
984,2017,2,2017-09-09,California,,Weber State,W (33-20),20,28,71.4,200,0,34,231,6.8,4,62,431,7.0,8,9,2,19,6,34,1,0,1
985,2017,3,2017-09-16,California,,Mississippi,W (27-16),24,48,50.0,236,1,40,163,4.1,1,88,399,4.5,13,8,4,25,7,90,0,2,2
986,2017,4,2017-09-23,California,,Southern California,L (20-30),22,52,42.3,303,1,33,113,3.4,1,85,416,4.9,10,9,2,21,6,44,2,4,6
987,2017,5,2017-09-30,California,@,Oregon,L (24-45),23,43,53.5,255,3,29,8,0.3,0,72,263,3.7,10,3,4,17,4,37,2,0,2
988,2017,6,2017-10-07,California,@,Washington,L (7-38),16,26,61.5,133,0,26,-40,-1.5,0,52,93,1.8,5,3,1,9,4,31,1,0,1
989,2017,7,2017-10-13,California,,Washington State,W (37-3),21,38,55.3,259,1,32,106,3.3,2,70,365,5.2,12,7,1,18,8,75,0,0,0
990,2017,8,2017-10-21,California,,Arizona,L (44-45),29,49,59.2,301,2,47,172,3.7,4,96,473,4.9,17,9,5,31,7,58,0,2,2
991,2017,9,2017-10-28,California,@,Colorado,L (28-44),30,53,56.6,374,4,25,61,2.4,0,78,435,5.6,16,8,2,26,4,35,0,1,1
992,2017,10,2017-11-04,California,,Oregon State,W (37-23),24,31,77.4,259,2,45,216,4.8,2,76,475,6.3,15,14,5,34,7,68,1,0,1
993,2017,11,2017-11-18,California,@,Stanford,L (14-17),20,29,69.0,182,0,28,155,5.5,1,57,337,5.9,9,10,0,19,5,45,0,1,1
994,2017,12,2017-11-24,California,@,UCLA,L (27-30),25,41,61.0,242,1,42,216,5.1,1,83,458,5.5,11,12,3,26,11,84,1,0,1
995,2017,,12 Games,California,,,,278,476,58.4,3107,19,416,1507,3.6,17,892,4614,5.2,139,98,30,265,78,658,8,12,20
996,2014,1,2014-08-28,Central Michigan,,Chattanooga,W (20-16),15,26,57.7,173,2,46,148,3.2,1,72,321,4.5,8,9,2,20,7,55,1,0,1
997,2014,2,2014-09-06,Central Michigan,@,Purdue,W (38-17),11,16,68.8,172,2,43,161,3.7,2,59,333,5.6,5,12,2,19,1,5,0,1,1
998,2014,3,2014-09-13,Central Michigan,,Syracuse,L (3-40),18,34,52.9,183,0,23,34,1.5,0,57,217,3.8,10,3,1,14,5,49,2,0,2
999,2014,4,2014-09-20,Central Michigan,@,Kansas,L (10-24),18,26,69.2,178,0,35,101,2.9,1,61,279,4.6,10,6,2,18,5,43,2,1,3
1000,2014,5,2014-09-27,Central Michigan,@,Toledo,L (28-42),24,31,77.4,291,2,26,95,3.7,2,57,386,6.8,13,6,1,20,3,35,1,1,2
1001,2014,6,2014-10-04,Central Michigan,,Ohio,W (28-10),17,27,63.0,233,2,52,234,4.5,2,79,467,5.9,8,16,1,25,7,62,1,0,1
1002,2014,7,2014-10-11,Central Michigan,@,Northern Illinois,W (34-17),20,31,64.5,269,2,46,283,6.2,2,77,552,7.2,16,12,2,30,3,29,0,1,1
1003,2014,8,2014-10-18,Central Michigan,,Ball State,L (29-32),20,32,62.5,245,3,37,181,4.9,1,69,426,6.2,12,10,2,24,10,91,3,2,5
1004,2014,9,2014-10-25,Central Michigan,@,Buffalo,W (20-14),14,24,58.3,231,1,49,110,2.2,2,73,341,4.7,11,8,2,21,8,49,1,1,2
1005,2014,10,2014-11-01,Central Michigan,@,Eastern Michigan,W (38-7),18,23,78.3,223,1,55,278,5.1,4,78,501,6.4,13,14,0,27,5,41,1,1,2
1006,2014,11,2014-11-15,Central Michigan,,Miami (OH),W (34-27),16,23,69.6,218,3,40,209,5.2,2,63,427,6.8,10,12,1,23,5,38,1,1,2
1007,2014,12,2014-11-22,Central Michigan,,Western Michigan,L (20-32),24,44,54.5,248,2,23,70,3.0,0,67,318,4.7,12,3,4,19,3,30,1,3,4
1008,2014,13,2014-12-24,Central Michigan,N,Western Kentucky*,L (48-49),28,45,62.2,493,7,29,114,3.9,0,74,607,8.2,20,6,2,28,8,77,0,1,1
1009,2014,,13 Games,Central Michigan,,,,243,382,63.6,3157,27,504,2018,4.0,19,886,5175,5.8,148,117,22,288,70,604,14,13,27
1010,2015,1,2015-09-03,Central Michigan,,Oklahoma State,L (13-24),29,42,69.0,265,0,28,78,2.8,1,70,343,4.9,12,5,1,18,6,30,0,1,1
1011,2015,2,2015-09-12,Central Michigan,,Monmouth,W (31-10),25,36,69.4,328,3,34,74,2.2,1,70,402,5.7,15,6,1,22,7,75,0,1,1
1012,2015,3,2015-09-19,Central Michigan,@,Syracuse,L (27-30),37,51,72.5,430,2,40,90,2.3,1,91,520,5.7,19,9,2,30,5,44,1,1,2
1013,2015,4,2015-09-26,Central Michigan,@,Michigan State,L (10-30),26,39,66.7,285,1,26,55,2.1,0,65,340,5.2,12,2,3,17,9,70,1,0,1
1014,2015,5,2015-10-03,Central Michigan,,Northern Illinois,W (29-19),16,32,50.0,182,2,34,93,2.7,1,66,275,4.2,10,4,1,15,1,5,0,1,1
1015,2015,6,2015-10-10,Central Michigan,@,Western Michigan,L (39-41),23,32,71.9,321,4,31,161,5.2,1,63,482,7.7,14,9,1,24,8,75,1,1,2
1016,2015,7,2015-10-17,Central Michigan,,Buffalo,W (51-14),23,30,76.7,313,4,45,150,3.3,3,75,463,6.2,16,7,2,25,9,87,0,1,1
1017,2015,8,2015-10-24,Central Michigan,@,Ball State,W (23-21),30,39,76.9,316,2,31,118,3.8,0,70,434,6.2,13,5,2,20,10,55,1,1,2
1018,2015,9,2015-10-31,Central Michigan,@,Akron,W (14-6),23,37,62.2,226,2,24,39,1.6,0,61,265,4.3,11,3,2,16,5,44,0,1,1
1019,2015,10,2015-11-10,Central Michigan,,Toledo,L (23-28),33,53,62.3,354,2,20,59,3.0,0,73,413,5.7,14,5,2,21,5,63,0,1,1
1020,2015,11,2015-11-18,Central Michigan,@,Kent State,W (27-14),20,34,58.8,337,1,44,105,2.4,2,78,442,5.7,15,6,0,21,2,20,0,0,0
1021,2015,12,2015-11-27,Central Michigan,,Eastern Michigan,W (35-28),26,40,65.0,408,2,35,175,5.0,3,75,583,7.8,17,10,1,28,11,105,1,1,2
1022,2015,13,2015-12-28,Central Michigan,N,Minnesota*,L (14-21),15,30,50.0,145,0,28,104,3.7,2,58,249,4.3,7,10,0,17,3,25,0,1,1
1023,2015,,13 Games,Central Michigan,,,,326,495,65.9,3910,25,420,1301,3.1,15,915,5211,5.7,175,81,18,274,81,698,5,11,16
1024,2016,1,2016-09-01,Central Michigan,,Presbyterian,W (49-3),16,27,59.3,237,1,38,255,6.7,5,65,492,7.6,8,12,3,23,7,56,0,2,2
1025,2016,2,2016-09-10,Central Michigan,@,Oklahoma State,W (30-27),31,43,72.1,368,4,26,50,1.9,0,69,418,6.1,15,6,2,23,5,60,1,1,2
1026,2016,3,2016-09-17,Central Michigan,,Nevada-Las Vegas,W (44-21),20,35,57.1,352,6,34,147,4.3,0,69,499,7.2,15,5,3,23,4,40,1,0,1
1027,2016,4,2016-09-24,Central Michigan,@,Virginia,L (35-49),25,45,55.6,402,2,34,93,2.7,2,79,495,6.3,17,4,1,22,4,50,0,1,1
1028,2016,5,2016-10-01,Central Michigan,,Western Michigan,L (10-49),17,29,58.6,178,1,33,99,3.0,0,62,277,4.5,9,9,0,18,5,60,1,1,2
1029,2016,6,2016-10-08,Central Michigan,,Ball State,W (24-21),21,32,65.6,269,1,37,153,4.1,1,69,422,6.1,12,4,2,18,7,68,0,0,0
1030,2016,7,2016-10-15,Central Michigan,@,Northern Illinois,W (34-28),19,35,54.3,254,3,50,230,4.6,2,85,484,5.7,11,13,1,25,4,50,1,2,3
1031,2016,8,2016-10-22,Central Michigan,@,Toledo,L (17-31),19,33,57.6,247,1,23,97,4.2,1,56,344,6.1,11,5,2,18,6,77,1,1,2
1032,2016,9,2016-10-29,Central Michigan,,Kent State,L (24-27),20,43,46.5,244,2,30,105,3.5,0,73,349,4.8,10,9,0,19,4,45,1,3,4
1033,2016,10,2016-11-04,Central Michigan,@,Miami (OH),L (17-37),21,32,65.6,242,0,23,50,2.2,2,55,292,5.3,9,4,2,15,4,45,1,1,2
1034,2016,11,2016-11-15,Central Michigan,,Ohio,W (27-20),25,32,78.1,268,2,31,18,0.6,1,63,286,4.5,11,4,1,16,5,48,1,0,1
1035,2016,12,2016-11-22,Central Michigan,@,Eastern Michigan,L (21-26),21,35,60.0,256,0,26,127,4.9,3,61,383,6.3,11,7,1,19,2,10,0,1,1
1036,2016,13,2016-12-19,Central Michigan,N,Tulsa*,L (10-55),25,50,50.0,272,0,22,83,3.8,1,72,355,4.9,14,4,1,19,5,40,0,3,3
1037,2016,,13 Games,Central Michigan,,,,280,471,59.4,3589,23,407,1507,3.7,18,878,5096,5.8,153,86,19,258,62,649,8,16,24
1038,2017,1,2017-08-31,Central Michigan,,Rhode Island,W (30-27),28,54,51.9,253,1,50,246,4.9,2,104,499,4.8,11,10,3,24,9,87,3,1,4
1039,2017,2,2017-09-09,Central Michigan,@,Kansas,W (45-27),28,37,75.7,467,5,35,123,3.5,1,72,590,8.2,16,7,3,26,9,80,1,0,1
1040,2017,3,2017-09-16,Central Michigan,@,Syracuse,L (17-41),23,46,50.0,277,2,34,105,3.1,0,80,382,4.8,11,7,4,22,5,38,1,2,3
1041,2017,4,2017-09-23,Central Michigan,,Miami (OH),L (14-31),20,39,51.3,228,1,38,117,3.1,1,77,345,4.5,10,6,3,19,6,80,0,2,2
1042,2017,5,2017-09-30,Central Michigan,@,Boston College,L (8-28),22,43,51.2,180,0,33,116,3.5,1,76,296,3.9,10,7,1,18,6,53,0,3,3
1043,2017,6,2017-10-07,Central Michigan,@,Ohio,W (26-23),25,35,71.4,249,2,30,69,2.3,1,65,318,4.9,12,3,3,18,8,78,0,1,1
1044,2017,7,2017-10-14,Central Michigan,,Toledo,L (10-30),17,38,44.7,182,1,21,62,3.0,0,59,244,4.1,9,3,0,12,2,18,0,2,2
1045,2017,8,2017-10-21,Central Michigan,@,Ball State,W (56-9),16,23,69.6,199,4,45,256,5.7,3,68,455,6.7,5,14,3,22,4,50,1,0,1
1046,2017,9,2017-11-01,Central Michigan,@,Western Michigan,W (35-28),12,31,38.7,243,2,32,175,5.5,3,63,418,6.6,7,6,2,15,6,57,2,0,2
1047,2017,10,2017-11-08,Central Michigan,,Eastern Michigan,W (42-30),11,18,61.1,155,3,42,177,4.2,2,60,332,5.5,5,7,0,12,5,55,1,0,1
1048,2017,11,2017-11-14,Central Michigan,@,Kent State,W (42-23),15,23,65.2,298,2,30,152,5.1,3,53,450,8.5,10,4,2,16,7,60,1,1,2
1049,2017,12,2017-11-24,Central Michigan,,Northern Illinois,W (31-24),20,39,51.3,247,3,33,139,4.2,1,72,386,5.4,10,4,2,16,9,87,0,1,1
1050,2017,13,2017-12-22,Central Michigan,N,Wyoming*,L (14-37),26,43,60.5,346,1,27,18,0.7,1,70,364,5.2,12,3,3,18,7,61,4,4,8
1051,2017,,13 Games,Central Michigan,,,,263,469,56.1,3324,27,450,1755,3.9,19,919,5079,5.5,128,81,29,238,83,804,14,17,31
1052,2015,1,2015-09-04,Charlotte,@,Georgia State,W (23-20),19,32,59.4,244,1,54,164,3.0,0,86,408,4.7,12,11,1,24,4,31,2,2,4
1053,2015,2,2015-09-12,Charlotte,,Presbyterian,W (34-10),20,29,69.0,276,3,47,192,4.1,1,76,468,6.2,11,12,0,23,6,57,1,0,1
1054,2015,3,2015-09-19,Charlotte,@,Middle Tennessee State,L (14-73),13,33,39.4,102,0,38,117,3.1,1,71,219,3.1,5,5,1,11,8,75,3,4,7
1055,2015,4,2015-09-26,Charlotte,,Florida Atlantic,L (7-17),11,34,32.4,89,0,49,117,2.4,0,83,206,2.5,3,11,2,16,5,56,1,6,7
1056,2015,5,2015-10-02,Charlotte,,Temple,L (3-37),13,27,48.1,131,0,44,223,5.1,0,71,354,5.0,6,10,0,16,4,47,0,1,1
1057,2015,6,2015-10-17,Charlotte,@,Old Dominion,L (34-37),24,36,66.7,227,0,70,309,4.4,4,106,536,5.1,12,18,1,31,5,50,2,1,3
1058,2015,7,2015-10-24,Charlotte,,Southern Mississippi,L (10-44),12,30,40.0,120,0,36,137,3.8,1,66,257,3.9,6,7,0,13,5,60,0,3,3
1059,2015,8,2015-10-31,Charlotte,,Marshall,L (10-34),19,36,52.8,141,0,43,166,3.9,1,79,307,3.9,6,13,3,22,4,39,1,1,2
1060,2015,9,2015-11-07,Charlotte,@,Florida International,L (31-48),25,38,65.8,264,3,48,131,2.7,1,86,395,4.6,11,14,2,27,7,77,0,1,1
1061,2015,10,2015-11-14,Charlotte,,Texas-San Antonio,L (27-30),15,29,51.7,243,3,54,134,2.5,0,83,377,4.5,12,9,1,22,9,110,0,2,2
1062,2015,11,2015-11-21,Charlotte,@,Kentucky,L (10-58),11,25,44.0,87,1,48,146,3.0,0,73,233,3.2,5,7,2,14,2,15,1,2,3
1063,2015,12,2015-11-28,Charlotte,@,Rice,L (7-27),14,26,53.8,158,1,32,127,4.0,0,58,285,4.9,7,6,2,15,5,42,0,0,0
1064,2015,,12 Games,Charlotte,,,,196,375,52.3,2082,12,563,1963,3.5,9,938,4045,4.3,96,123,15,234,64,659,11,23,34
1065,2016,1,2016-09-01,Charlotte,@,Louisville,L (14-70),18,32,56.3,160,1,31,48,1.5,0,63,208,3.3,6,4,2,12,13,118,1,0,1
1066,2016,2,2016-09-10,Charlotte,,Elon,W (47-14),24,34,70.6,274,4,35,232,6.6,2,69,506,7.3,7,9,2,18,8,95,0,0,0
1067,2016,3,2016-09-17,Charlotte,,Eastern Michigan,L (19-37),23,44,52.3,199,2,39,157,4.0,0,83,356,4.3,9,9,5,23,7,81,1,2,3
1068,2016,4,2016-09-24,Charlotte,@,Temple,L (20-48),17,42,40.5,198,1,42,231,5.5,2,84,429,5.1,11,11,3,25,5,40,1,0,1
1069,2016,5,2016-10-01,Charlotte,,Old Dominion,L (17-52),18,36,50.0,176,1,49,178,3.6,1,85,354,4.2,9,10,3,22,5,25,2,1,3
1070,2016,6,2016-10-09,Charlotte,@,Florida Atlantic,W (28-23),14,17,82.4,223,3,48,219,4.6,1,65,442,6.8,8,13,1,22,5,37,1,1,2
1071,2016,7,2016-10-15,Charlotte,,Florida International,L (26-27),21,31,67.7,171,1,47,232,4.9,2,78,403,5.2,9,13,2,24,8,71,2,1,3
1072,2016,8,2016-10-22,Charlotte,@,Marshall,W (27-24),17,31,54.8,203,0,47,191,4.1,3,78,394,5.1,12,8,4,24,8,77,0,1,1
1073,2016,9,2016-11-05,Charlotte,@,Southern Mississippi,W (38-27),12,25,48.0,136,1,46,303,6.6,3,71,439,6.2,7,10,1,18,3,28,0,0,0
1074,2016,10,2016-11-12,Charlotte,,Rice,L (21-22),13,27,48.1,105,1,36,158,4.4,1,63,263,4.2,6,9,2,17,5,45,1,0,1
1075,2016,11,2016-11-19,Charlotte,,Middle Tennessee State,L (31-38),22,50,44.0,239,1,45,164,3.6,3,95,403,4.2,11,9,2,22,8,85,0,0,0
1076,2016,12,2016-11-26,Charlotte,@,Texas-San Antonio,L (14-33),15,44,34.1,229,1,19,8,0.4,0,63,237,3.8,7,1,2,10,13,116,0,0,0
1077,2016,,12 Games,Charlotte,,,,214,413,51.8,2313,17,484,2121,4.4,18,897,4434,4.9,102,106,29,237,88,818,9,6,15
1078,2017,1,2017-09-01,Charlotte,@,Eastern Michigan,L (7-24),12,29,41.4,114,1,35,166,4.7,0,64,280,4.4,6,6,1,13,11,112,0,3,3
1079,2017,2,2017-09-09,Charlotte,@,Kansas State,L (7-55),10,25,40.0,58,0,28,110,3.9,1,53,168,3.2,3,6,1,10,7,50,1,2,3
1080,2017,3,2017-09-16,Charlotte,,North Carolina A&T,L (31-35),13,29,44.8,170,3,46,266,5.8,1,75,436,5.8,8,17,2,27,7,60,1,2,3
1081,2017,4,2017-09-23,Charlotte,,Georgia State,L (0-28),16,29,55.2,179,0,34,94,2.8,0,63,273,4.3,8,6,0,14,6,51,1,2,3
1082,2017,5,2017-09-30,Charlotte,@,Florida International,L (29-30),16,28,57.1,155,1,49,349,7.1,3,77,504,6.5,8,13,2,23,5,40,0,0,0
1083,2017,6,2017-10-07,Charlotte,,Marshall,L (3-14),10,26,38.5,132,0,26,80,3.1,0,52,212,4.1,5,4,0,9,6,65,0,1,1
1084,2017,7,2017-10-14,Charlotte,@,Western Kentucky,L (14-45),9,19,47.4,61,0,34,248,7.3,2,53,309,5.8,2,6,1,9,6,80,0,1,1
1085,2017,8,2017-10-21,Charlotte,,Alabama-Birmingham,W (25-24),14,28,50.0,154,1,49,222,4.5,2,77,376,4.9,5,7,2,14,12,135,0,2,2
1086,2017,9,2017-11-04,Charlotte,@,Old Dominion,L (0-6),9,22,40.9,95,0,27,136,5.0,0,49,231,4.7,4,4,0,8,4,39,1,0,1
1087,2017,10,2017-11-11,Charlotte,,Middle Tennessee State,L (21-35),18,30,60.0,258,2,32,98,3.1,1,62,356,5.7,9,5,2,16,7,78,0,1,1
1088,2017,11,2017-11-18,Charlotte,@,Southern Mississippi,L (21-66),9,25,36.0,96,1,38,142,3.7,2,63,238,3.8,6,7,1,14,5,55,0,2,2
1089,2017,12,2017-11-25,Charlotte,,Florida Atlantic,L (12-31),10,22,45.5,171,1,30,84,2.8,1,52,255,4.9,6,4,0,10,2,15,0,0,0
1090,2017,,12 Games,Charlotte,,,,146,312,46.8,1643,10,428,1995,4.7,13,740,3638,4.9,70,85,12,167,78,780,4,16,20
1091,2016,1,2016-11-19,Chattanooga,@,Alabama,L (3-31),17,24,70.8,114,0,30,70,2.3,0,54,184,3.4,7,3,0,10,2,10,2,0,2
1092,2017,1,2017-09-09,Chattanooga,@,Louisiana State,L (10-45),15,32,46.9,174,0,27,68,2.5,1,59,242,4.1,8,3,1,12,4,10,0,2,2
1093,2014,1,2014-09-12,Cincinnati,,Toledo,W (58-34),29,42,69.0,436,6,30,148,4.9,2,72,584,8.1,21,6,1,28,2,30,0,0,0
1094,2014,2,2014-09-20,Cincinnati,N,Miami (OH),W (31-24),25,39,64.1,271,4,30,99,3.3,0,69,370,5.4,13,7,2,22,4,30,0,2,2
1095,2014,3,2014-09-27,Cincinnati,@,Ohio State,L (28-50),21,33,63.6,352,4,19,70,3.7,0,52,422,8.1,10,5,0,15,6,40,0,0,0
1096,2014,4,2014-10-04,Cincinnati,N,Memphis,L (14-41),16,40,40.0,255,1,25,97,3.9,1,65,352,5.4,13,4,2,19,6,55,1,1,2
1097,2014,5,2014-10-11,Cincinnati,@,Miami (FL),L (34-55),31,60,51.7,355,3,29,67,2.3,0,89,422,4.7,17,5,4,26,5,54,0,3,3
1098,2014,6,2014-10-18,Cincinnati,@,Southern Methodist,W (41-3),17,27,63.0,268,1,46,240,5.2,3,73,508,7.0,12,14,3,29,6,69,0,0,0
1099,2014,7,2014-10-24,Cincinnati,N,South Florida,W (34-17),27,37,73.0,317,1,50,273,5.5,3,87,590,6.8,16,12,3,31,4,37,3,0,3
1100,2014,8,2014-10-31,Cincinnati,@,Tulane,W (38-14),17,26,65.4,214,3,35,265,7.6,1,61,479,7.9,11,8,2,21,5,35,1,2,3
1101,2014,9,2014-11-13,Cincinnati,N,East Carolina,W (54-46),29,45,64.4,436,4,33,150,4.5,2,78,586,7.5,19,9,1,29,8,64,1,3,4
1102,2014,10,2014-11-22,Cincinnati,@,Connecticut,W (41-0),20,36,55.6,176,3,48,249,5.2,2,84,425,5.1,10,13,1,24,2,25,0,1,1
1103,2014,11,2014-11-29,Cincinnati,@,Temple,W (14-6),19,31,61.3,174,1,33,81,2.5,1,64,255,4.0,9,4,1,14,3,20,1,0,1
1104,2014,12,2014-12-06,Cincinnati,N,Houston,W (38-31),25,38,65.8,348,2,43,152,3.5,3,81,500,6.2,20,11,2,33,1,10,0,0,0
1105,2014,13,2014-12-27,Cincinnati,N,Virginia Tech*,L (17-33),18,37,48.6,345,2,33,144,4.4,0,70,489,7.0,14,5,0,19,7,73,1,2,3
1106,2014,,13 Games,Cincinnati,,,,294,491,59.9,3947,35,454,2035,4.5,18,945,5982,6.3,185,103,22,310,59,542,8,14,22
1107,2015,1,2015-09-05,Cincinnati,,Alabama A&M,W (52-10),26,38,68.4,340,3,51,296,5.8,4,89,636,7.1,17,14,3,34,8,79,2,0,2
1108,2015,2,2015-09-12,Cincinnati,,Temple,L (26-34),30,52,57.7,427,2,31,130,4.2,1,83,557,6.7,21,8,5,34,5,51,1,4,5
1109,2015,3,2015-09-19,Cincinnati,@,Miami (OH),W (37-33),22,40,55.0,263,1,54,282,5.2,3,94,545,5.8,15,15,3,33,7,55,2,2,4
1110,2015,4,2015-09-24,Cincinnati,@,Memphis,L (46-53),38,64,59.4,620,4,36,132,3.7,1,100,752,7.5,27,8,3,38,11,101,0,3,3
1111,2015,5,2015-10-01,Cincinnati,,Miami (FL),W (34-23),22,33,66.7,279,2,34,167,4.9,2,67,446,6.7,13,9,0,22,7,75,0,1,1
1112,2015,6,2015-10-16,Cincinnati,@,Brigham Young,L (24-38),16,31,51.6,220,1,46,121,2.6,2,77,341,4.4,13,6,2,21,9,65,0,0,0
1113,2015,7,2015-10-24,Cincinnati,,Connecticut,W (37-13),26,35,74.3,327,2,49,285,5.8,2,84,612,7.3,14,14,0,28,10,105,1,0,1
1114,2015,8,2015-10-31,Cincinnati,,Central Florida,W (52-7),27,32,84.4,489,6,42,237,5.6,1,74,726,9.8,17,11,5,33,7,62,0,1,1
1115,2015,9,2015-11-07,Cincinnati,@,Houston,L (30-33),28,51,54.9,523,4,18,66,3.7,0,69,589,8.5,20,3,1,24,11,85,1,2,3
1116,2015,10,2015-11-14,Cincinnati,,Tulsa,W (49-38),29,42,69.0,386,2,41,266,6.5,5,83,652,7.9,21,11,1,33,10,68,2,1,3
1117,2015,11,2015-11-20,Cincinnati,@,South Florida,L (27-65),28,51,54.9,333,1,35,97,2.8,2,86,430,5.0,14,10,1,25,4,42,2,4,6
1118,2015,12,2015-11-28,Cincinnati,@,East Carolina,W (19-16),30,47,63.8,270,1,43,157,3.7,1,90,427,4.7,16,12,2,30,5,50,0,1,1
1119,2015,13,2015-12-24,Cincinnati,N,San Diego State*,L (7-42),19,31,61.3,202,0,32,77,2.4,1,63,279,4.4,9,5,1,15,10,110,0,3,3
1120,2015,,13 Games,Cincinnati,,,,341,547,62.3,4679,29,512,2313,4.5,25,1059,6992,6.6,217,126,27,370,104,948,11,22,33
1121,2016,1,2016-09-01,Cincinnati,,Tennessee-Martin,W (28-7),21,34,61.8,260,2,34,140,4.1,1,68,400,5.9,13,8,1,22,5,60,2,1,3
1122,2016,2,2016-09-10,Cincinnati,@,Purdue,W (38-20),19,32,59.4,250,3,46,262,5.7,2,78,512,6.6,12,9,1,22,5,45,0,0,0
1123,2016,3,2016-09-15,Cincinnati,,Houston,L (16-40),22,39,56.4,277,2,25,30,1.2,0,64,307,4.8,11,1,1,13,2,15,0,3,3
1124,2016,4,2016-09-24,Cincinnati,,Miami (OH),W (27-20),25,38,65.8,276,0,48,187,3.9,3,86,463,5.4,15,12,1,28,5,60,1,2,3
1125,2016,5,2016-10-01,Cincinnati,,South Florida,L (20-45),23,41,56.1,263,1,35,130,3.7,2,76,393,5.2,11,8,2,21,4,40,1,3,4
1126,2016,6,2016-10-08,Cincinnati,@,Connecticut,L (9-20),29,56,51.8,315,0,22,2,0.1,0,78,317,4.1,18,2,2,22,5,57,0,1,1
1127,2016,7,2016-10-22,Cincinnati,,East Carolina,W (31-19),23,40,57.5,348,4,35,165,4.7,0,75,513,6.8,11,12,2,25,9,82,0,0,0
1128,2016,8,2016-10-29,Cincinnati,@,Temple,L (13-34),15,27,55.6,119,2,22,67,3.0,0,49,186,3.8,8,2,0,10,4,35,2,0,2
1129,2016,9,2016-11-05,Cincinnati,,Brigham Young,L (3-20),19,32,59.4,199,0,25,96,3.8,0,57,295,5.2,12,4,0,16,4,40,0,1,1
1130,2016,10,2016-11-12,Cincinnati,@,Central Florida,L (3-24),19,42,45.2,220,0,36,107,3.0,0,78,327,4.2,11,6,1,18,2,15,1,2,3
1131,2016,11,2016-11-18,Cincinnati,,Memphis,L (7-34),23,34,67.6,144,1,35,100,2.9,0,69,244,3.5,9,7,1,17,5,52,1,2,3
1132,2016,12,2016-11-25,Cincinnati,@,Tulsa,L (37-40),21,38,55.3,400,4,33,134,4.1,0,71,534,7.5,12,5,1,18,5,43,0,0,0
1133,2016,,12 Games,Cincinnati,,,,259,453,57.2,3071,19,396,1420,3.6,8,849,4491,5.3,143,76,13,232,55,544,8,15,23
1134,2017,1,2017-08-31,Cincinnati,,Austin Peay,W (26-14),17,28,60.7,151,3,29,97,3.3,1,57,248,4.4,7,6,2,15,7,70,0,0,0
1135,2017,2,2017-09-09,Cincinnati,@,Michigan,L (14-36),15,40,37.5,132,1,30,68,2.3,1,70,200,2.9,6,4,3,13,4,30,0,2,2
1136,2017,3,2017-09-16,Cincinnati,@,Miami (OH),W (21-17),24,43,55.8,222,1,35,139,4.0,0,78,361,4.6,10,8,3,21,6,56,0,2,2
1137,2017,4,2017-09-23,Cincinnati,@,Navy,L (32-42),28,46,60.9,381,3,23,58,2.5,1,69,439,6.4,19,3,0,22,6,60,1,0,1
1138,2017,5,2017-09-30,Cincinnati,,Marshall,L (21-38),22,45,48.9,211,1,26,138,5.3,2,71,349,4.9,9,7,5,21,7,78,3,0,3
1139,2017,6,2017-10-07,Cincinnati,,Central Florida,L (23-51),23,40,57.5,278,1,26,113,4.3,2,66,391,5.9,13,6,2,21,9,74,0,1,1
1140,2017,7,2017-10-14,Cincinnati,@,South Florida,L (3-33),21,37,56.8,178,0,33,95,2.9,0,70,273,3.9,9,7,5,21,11,98,1,1,2
1141,2017,8,2017-10-21,Cincinnati,,Southern Methodist,L (28-31),22,35,62.9,189,2,42,249,5.9,1,77,438,5.7,11,14,1,26,6,46,1,1,2
1142,2017,9,2017-11-04,Cincinnati,@,Tulane,W (17-16),18,27,66.7,248,1,35,208,5.9,1,62,456,7.4,11,8,0,19,12,123,0,0,0
1143,2017,10,2017-11-10,Cincinnati,,Temple,L (24-35),21,37,56.8,221,2,35,184,5.3,1,72,405,5.6,8,10,3,21,11,107,1,0,1
1144,2017,11,2017-11-18,Cincinnati,@,East Carolina,L (20-48),15,28,53.6,187,3,31,139,4.5,0,59,326,5.5,6,11,0,17,10,90,0,1,1
1145,2017,12,2017-11-25,Cincinnati,,Connecticut,W (22-21),19,28,67.9,199,2,26,136,5.2,1,54,335,6.2,11,8,0,19,5,44,0,1,1
1146,2017,,12 Games,Cincinnati,,,,245,434,56.5,2597,20,371,1624,4.4,11,805,4221,5.2,120,92,24,236,94,876,7,9,16
1147,2016,1,2016-11-19,Citadel,@,North Carolina,L (7-41),3,8,37.5,27,0,72,344,4.8,1,80,371,4.6,1,19,1,21,4,34,3,1,4
1148,2017,1,2017-11-18,Citadel,@,Clemson,L (3-61),1,8,12.5,61,0,54,155,2.9,0,62,216,3.5,1,8,1,10,5,41,0,2,2
1149,2014,1,2014-08-30,Clemson,@,Georgia,L (21-45),18,33,54.5,203,1,43,88,2.0,2,76,291,3.8,7,6,2,15,3,40,0,1,1
1150,2014,2,2014-09-06,Clemson,,South Carolina State,W (73-7),32,42,76.2,467,4,51,268,5.3,4,93,735,7.9,17,15,0,32,1,5,1,0,1
1151,2014,3,2014-09-20,Clemson,@,Florida State,L (17-23),22,33,66.7,306,0,40,101,2.5,2,73,407,5.6,12,4,1,17,3,30,1,0,1
1152,2014,4,2014-09-27,Clemson,,North Carolina,W (50-35),28,39,71.8,436,6,44,92,2.1,0,83,528,6.4,16,6,5,27,4,19,0,1,1
1153,2014,5,2014-10-04,Clemson,,North Carolina State,W (41-0),17,30,56.7,267,2,50,226,4.5,2,80,493,6.2,11,13,1,25,9,103,0,0,0
1154,2014,6,2014-10-11,Clemson,,Louisville,W (23-17),22,39,56.4,157,0,33,72,2.2,0,72,229,3.2,7,5,0,12,3,14,0,2,2
1155,2014,7,2014-10-18,Clemson,@,Boston College,W (17-13),29,46,63.0,285,0,35,113,3.2,2,81,398,4.9,16,6,0,22,4,30,0,0,0
1156,2014,8,2014-10-25,Clemson,,Syracuse,W (16-6),24,35,68.6,209,1,48,166,3.5,0,83,375,4.5,12,10,1,23,2,15,2,2,4
1157,2014,9,2014-11-06,Clemson,@,Wake Forest,W (34-20),27,42,64.3,282,3,37,145,3.9,1,79,427,5.4,11,7,2,20,8,75,1,1,2
1158,2014,10,2014-11-15,Clemson,@,Georgia Tech,L (6-28),11,21,52.4,59,0,33,131,4.0,0,54,190,3.5,3,7,0,10,3,21,0,3,3
1159,2014,11,2014-11-22,Clemson,,Georgia State,W (28-0),21,33,63.6,148,1,43,209,4.9,3,76,357,4.7,10,11,1,22,4,40,1,1,2
1160,2014,12,2014-11-29,Clemson,,South Carolina,W (35-17),15,21,71.4,266,2,40,225,5.6,3,61,491,8.0,9,10,1,20,4,44,0,1,1
1161,2014,13,2014-12-29,Clemson,N,Oklahoma*,W (40-6),26,37,70.3,319,3,42,68,1.6,1,79,387,4.9,14,5,3,22,4,20,0,0,0
1162,2014,,13 Games,Clemson,,,,292,451,64.7,3404,23,539,1904,3.5,20,990,5308,5.4,145,105,17,267,52,456,6,12,18
1163,2015,1,2015-09-05,Clemson,,Wofford,W (49-10),30,37,81.1,311,2,43,222,5.2,5,80,533,6.7,14,12,1,27,6,55,2,0,2
1164,2015,2,2015-09-12,Clemson,,Appalachian State,W (41-10),21,31,67.7,252,3,44,140,3.2,1,75,392,5.2,12,8,2,22,9,75,0,2,2
1165,2015,3,2015-09-17,Clemson,@,Louisville,W (20-17),21,30,70.0,199,2,40,202,5.1,0,70,401,5.7,10,10,0,20,6,53,0,2,2
1166,2015,4,2015-10-03,Clemson,,Notre Dame,W (24-22),11,22,50.0,97,2,42,199,4.7,1,64,296,4.6,6,8,1,15,5,44,0,1,1
1167,2015,5,2015-10-10,Clemson,,Georgia Tech,W (43-24),23,33,69.7,336,2,41,201,4.9,3,74,537,7.3,15,7,2,24,4,45,2,1,3
1168,2015,6,2015-10-17,Clemson,,Boston College,W (34-17),27,42,64.3,420,3,36,112,3.1,1,78,532,6.8,15,5,4,24,6,45,0,2,2
1169,2015,7,2015-10-24,Clemson,@,Miami (FL),W (58-0),17,25,68.0,151,1,63,416,6.6,6,88,567,6.4,10,19,4,33,4,29,1,0,1
1170,2015,8,2015-10-31,Clemson,@,North Carolina State,W (56-41),23,30,76.7,383,5,50,240,4.8,2,80,623,7.8,15,12,0,27,6,39,1,0,1
1171,2015,9,2015-11-07,Clemson,,Florida State,W (23-13),28,43,65.1,297,1,42,215,5.1,1,85,512,6.0,16,10,3,29,3,32,0,0,0
1172,2015,10,2015-11-14,Clemson,@,Syracuse,W (37-27),34,47,72.3,360,2,37,210,5.7,2,84,570,6.8,15,10,4,29,8,69,2,1,3
1173,2015,11,2015-11-21,Clemson,,Wake Forest,W (33-13),28,40,70.0,381,3,42,171,4.1,1,82,552,6.7,16,6,2,24,6,56,1,3,4
1174,2015,12,2015-11-28,Clemson,@,South Carolina,W (37-32),20,27,74.1,279,1,47,236,5.0,4,74,515,7.0,11,14,0,25,1,5,3,0,3
1175,2015,13,2015-12-05,Clemson,N,North Carolina,W (45-37),26,42,61.9,289,3,56,319,5.7,3,98,608,6.2,13,18,2,33,11,80,0,1,1
1176,2015,14,2015-12-31,Clemson,N,Oklahoma*,W (37-17),17,32,53.1,218,1,58,312,5.4,3,90,530,5.9,10,17,3,30,5,40,0,1,1
1177,2015,15,2016-01-11,Clemson,N,Alabama*,L (40-45),30,47,63.8,405,4,38,145,3.8,1,85,550,6.5,20,9,2,31,4,27,0,1,1
1178,2015,,15 Games,Clemson,,,,356,528,67.4,4378,35,679,3340,4.9,34,1207,7718,6.4,198,165,30,393,84,694,12,15,27
1179,2016,1,2016-09-03,Clemson,@,Auburn,W (19-13),19,34,55.9,248,1,44,151,3.4,1,78,399,5.1,9,7,3,19,6,55,1,1,2
1180,2016,2,2016-09-10,Clemson,,Troy,W (30-24),27,53,50.9,292,3,32,122,3.8,0,85,414,4.9,13,8,3,24,7,71,1,2,3
1181,2016,3,2016-09-17,Clemson,,South Carolina State,W (59-0),27,35,77.1,328,5,43,227,5.3,2,78,555,7.1,15,10,2,27,7,59,0,0,0
1182,2016,4,2016-09-22,Clemson,@,Georgia Tech,W (26-7),32,48,66.7,304,2,34,138,4.1,1,82,442,5.4,15,9,0,24,10,80,0,1,1
1183,2016,5,2016-10-01,Clemson,,Louisville,W (42-36),20,31,64.5,306,5,31,201,6.5,1,62,507,8.2,15,8,3,26,6,59,2,3,5
1184,2016,6,2016-10-07,Clemson,@,Boston College,W (56-10),16,26,61.5,278,4,35,230,6.6,3,61,508,8.3,11,7,3,21,4,18,1,0,1
1185,2016,7,2016-10-15,Clemson,,North Carolina State,W (24-17),39,52,75.0,378,2,38,126,3.3,1,90,504,5.6,20,7,3,30,5,40,3,1,4
1186,2016,8,2016-10-29,Clemson,@,Florida State,W (37-34),27,43,62.8,378,2,38,133,3.5,2,81,511,6.3,16,7,2,25,9,84,0,2,2
1187,2016,9,2016-11-05,Clemson,,Syracuse,W (54-0),27,40,67.5,370,4,44,195,4.4,2,84,565,6.7,16,11,1,28,3,30,0,0,0
1188,2016,10,2016-11-12,Clemson,,Pittsburgh,L (42-43),52,70,74.3,580,3,25,50,2.0,3,95,630,6.6,31,0,2,33,9,101,0,3,3
1189,2016,11,2016-11-19,Clemson,@,Wake Forest,W (35-13),23,33,69.7,202,1,42,254,6.0,4,75,456,6.1,9,11,1,21,6,33,1,0,1
1190,2016,12,2016-11-26,Clemson,,South Carolina,W (56-7),30,36,83.3,372,6,53,250,4.7,2,89,622,7.0,20,17,3,41,7,75,0,1,1
1191,2016,13,2016-12-03,Clemson,N,Virginia Tech,W (42-35),23,34,67.6,288,3,41,182,4.4,3,75,470,6.3,14,11,5,30,8,65,0,1,1
1192,2016,14,2016-12-31,Clemson,N,Ohio State,W (31-0),24,37,64.9,265,1,48,205,4.3,3,85,470,5.5,12,12,0,24,5,60,0,2,2
1193,2016,15,2017-01-09,Clemson,N,Alabama,W (35-31),36,57,63.2,420,3,42,91,2.2,2,99,511,5.2,19,8,4,31,3,35,2,0,2
1194,2016,,15 Games,Clemson,,,,422,629,67.1,5009,45,590,2555,4.3,30,1219,7564,6.2,235,133,35,404,95,865,11,17,28
1195,2017,1,2017-09-02,Clemson,,Kent State,W (56-3),25,34,73.5,312,2,42,366,8.7,6,76,678,8.9,14,15,5,34,4,45,0,1,1
1196,2017,2,2017-09-09,Clemson,,Auburn,W (14-6),20,31,64.5,185,0,36,96,2.7,2,67,281,4.2,10,6,2,18,8,60,2,0,2
1197,2017,3,2017-09-16,Clemson,@,Louisville,W (47-21),23,33,69.7,316,1,48,297,6.2,4,81,613,7.6,12,13,0,25,4,30,0,0,0
1198,2017,4,2017-09-23,Clemson,,Boston College,W (34-7),17,26,65.4,140,0,58,342,5.9,5,84,482,5.7,8,19,0,27,2,10,0,2,2
1199,2017,5,2017-09-30,Clemson,@,Virginia Tech,W (31-17),12,21,57.1,186,1,43,146,3.4,2,64,332,5.2,5,8,1,14,4,20,0,0,0
1200,2017,6,2017-10-07,Clemson,,Wake Forest,W (28-14),29,41,70.7,263,2,48,190,4.0,2,89,453,5.1,13,12,0,25,9,79,1,1,2
1201,2017,7,2017-10-13,Clemson,@,Syracuse,L (24-27),22,32,68.8,204,0,25,113,4.5,2,57,317,5.6,11,4,1,16,11,119,0,0,0
1202,2017,8,2017-10-28,Clemson,,Georgia Tech,W (24-10),22,33,66.7,207,2,45,221,4.9,1,78,428,5.5,9,12,0,21,5,45,1,0,1
1203,2017,9,2017-11-04,Clemson,@,North Carolina State,W (38-31),20,38,52.6,191,1,35,224,6.4,3,73,415,5.7,10,5,4,19,3,23,0,1,1
1204,2017,10,2017-11-11,Clemson,,Florida State,W (31-14),20,30,66.7,151,0,52,227,4.4,4,82,378,4.6,10,12,2,24,7,80,2,0,2
1205,2017,11,2017-11-18,Clemson,,Citadel,W (61-3),31,41,75.6,479,5,26,183,7.0,3,67,662,9.9,19,7,1,27,4,30,0,0,0
1206,2017,12,2017-11-25,Clemson,@,South Carolina,W (34-10),25,38,65.8,285,2,45,184,4.1,2,83,469,5.7,12,12,3,27,2,25,0,2,2
1207,2017,13,2017-12-02,Clemson,N,Miami (FL),W (38-3),25,34,73.5,254,1,41,77,1.9,4,75,331,4.4,13,5,0,18,2,13,1,0,1
1208,2017,14,2018-01-01,Clemson,N,Alabama*,L (6-24),18,37,48.6,124,0,33,64,1.9,0,70,188,2.7,8,5,0,14,4,29,0,2,2
1209,2017,,14 Games,Clemson,,,,309,469,65.9,3297,17,577,2730,4.7,40,1046,6027,5.8,154,135,19,309,69,608,7,9,16
1210,2017,1,2017-09-02,Coastal Carolina,,Massachusetts,W (38-28),10,18,55.6,80,1,47,321,6.8,4,65,401,6.2,3,16,1,20,6,68,0,0,0
1211,2017,2,2017-09-16,Coastal Carolina,@,Alabama-Birmingham,L (23-30),9,23,39.1,100,0,49,227,4.6,2,72,327,4.5,6,13,4,23,9,75,0,3,3
1212,2017,3,2017-09-23,Coastal Carolina,,Western Illinois,L (10-52),11,23,47.8,137,0,35,170,4.9,1,58,307,5.3,6,9,0,15,7,66,1,3,4
1213,2017,4,2017-09-30,Coastal Carolina,@,Louisiana-Monroe,L (43-51),18,32,56.3,329,4,38,112,2.9,2,70,441,6.3,11,8,2,21,7,80,1,2,3
1214,2017,5,2017-10-07,Coastal Carolina,,Georgia State,L (21-27),18,26,69.2,239,3,32,127,4.0,0,58,366,6.3,10,7,0,17,7,58,0,0,0
1215,2017,6,2017-10-14,Coastal Carolina,@,Arkansas State,L (17-51),13,29,44.8,231,1,38,197,5.2,1,67,428,6.4,9,11,4,23,6,40,1,0,1
1216,2017,7,2017-10-21,Coastal Carolina,@,Appalachian State,L (29-37),17,29,58.6,332,2,30,102,3.4,1,59,434,7.4,13,3,2,18,10,85,2,0,2
1217,2017,8,2017-10-28,Coastal Carolina,,Texas State,L (7-27),13,27,48.1,149,0,20,34,1.7,0,47,183,3.9,7,2,0,9,14,123,1,0,1
1218,2017,9,2017-11-04,Coastal Carolina,@,Arkansas,L (38-39),15,28,53.6,228,3,38,131,3.4,1,66,359,5.4,10,8,3,21,6,55,0,0,0
1219,2017,10,2017-11-11,Coastal Carolina,,Troy,L (17-42),14,28,50.0,164,2,37,94,2.5,0,65,258,4.0,7,9,0,16,5,59,0,2,2
1220,2017,11,2017-11-18,Coastal Carolina,@,Idaho,W (13-7),11,24,45.8,100,0,40,175,4.4,1,64,275,4.3,7,11,2,20,3,15,1,0,1
1221,2017,12,2017-12-02,Coastal Carolina,,Georgia Southern,W (28-17),9,17,52.9,180,2,42,185,4.4,2,59,365,6.2,6,11,0,17,4,30,0,1,1
1222,2017,,12 Games,Coastal Carolina,,,,158,304,52.0,2269,18,446,1875,4.2,15,750,4144,5.5,95,108,18,220,84,754,7,11,18
1223,2016,1,2016-09-02,Colgate,@,Syracuse,L (7-33),11,24,45.8,98,1,32,45,1.4,0,56,143,2.6,5,5,1,11,3,35,0,0,0
1224,2017,1,2017-09-16,Colgate,@,Buffalo,L (10-33),6,23,26.1,56,0,38,167,4.4,1,61,223,3.7,4,12,2,18,3,25,0,0,0
1225,2014,1,2014-08-29,Colorado,N,Colorado State,L (17-31),24,39,61.5,241,2,34,134,3.9,0,73,375,5.1,11,8,3,22,6,65,0,0,0
1226,2014,2,2014-09-06,Colorado,N,Massachusetts,W (41-38),26,42,61.9,318,3,47,156,3.3,2,89,474,5.3,15,9,5,29,12,124,0,1,1
1227,2014,3,2014-09-13,Colorado,,Arizona State,L (24-38),35,54,64.8,313,3,37,232,6.3,0,91,545,6.0,17,8,3,28,8,75,1,2,3
1228,2014,4,2014-09-20,Colorado,,Hawaii,W (21-12),29,45,64.4,287,2,36,118,3.3,1,81,405,5.0,15,4,1,20,9,83,0,2,2
1229,2014,5,2014-09-27,Colorado,@,California,L (56-59),46,67,68.7,449,7,43,180,4.2,1,110,629,5.7,26,8,5,39,9,75,0,1,1
1230,2014,6,2014-10-04,Colorado,,Oregon State,L (31-36),32,49,65.3,308,2,28,123,4.4,2,77,431,5.6,14,9,2,25,6,67,0,1,1
1231,2014,7,2014-10-18,Colorado,@,Southern California,L (28-56),31,49,63.3,231,2,46,172,3.7,2,95,403,4.2,12,11,4,27,7,61,0,2,2
1232,2014,8,2014-10-25,Colorado,,UCLA,L (37-40),28,46,60.9,267,2,45,233,5.2,2,91,500,5.5,11,15,5,31,6,50,0,2,2
1233,2014,9,2014-11-01,Colorado,,Washington,L (23-38),36,52,69.2,314,2,37,181,4.9,0,89,495,5.6,14,10,0,24,5,39,3,1,4
1234,2014,10,2014-11-08,Colorado,@,Arizona,L (20-38),25,39,64.1,259,2,36,94,2.6,0,75,353,4.7,9,8,2,19,10,103,2,2,4
1235,2014,11,2014-11-22,Colorado,@,Oregon,L (10-44),16,32,50.0,105,1,30,121,4.0,0,62,226,3.6,5,5,4,14,4,36,0,0,0
1236,2014,12,2014-11-29,Colorado,,Utah,L (34-38),20,31,64.5,317,1,32,116,3.6,3,63,433,6.9,10,6,2,18,4,35,0,1,1
1237,2014,,12 Games,Colorado,,,,348,545,63.9,3409,29,451,1860,4.1,13,996,5269,5.3,159,101,36,296,86,813,6,15,21
1238,2015,1,2015-09-03,Colorado,@,Hawaii,L (20-28),23,40,57.5,156,0,53,215,4.1,2,93,371,4.0,8,14,1,23,5,70,2,1,3
1239,2015,2,2015-09-12,Colorado,,Massachusetts,W (48-14),15,24,62.5,168,1,59,390,6.6,5,83,558,6.7,8,22,2,32,7,65,0,0,0
1240,2015,3,2015-09-19,Colorado,N,Colorado State,W (27-24),15,29,51.7,220,2,32,125,3.9,0,61,345,5.7,9,6,3,18,6,65,0,0,0
1241,2015,4,2015-09-26,Colorado,,Nicholls State,W (48-0),18,31,58.1,278,1,62,358,5.8,5,93,636,6.8,14,16,3,33,4,30,1,0,1
1242,2015,5,2015-10-03,Colorado,,Oregon,L (24-41),25,42,59.5,231,1,36,77,2.1,2,78,308,3.9,13,5,0,18,6,41,2,1,3
1243,2015,6,2015-10-10,Colorado,@,Arizona State,L (23-48),26,41,63.4,401,1,28,49,1.8,2,69,450,6.5,13,5,1,19,9,88,1,1,2
1244,2015,7,2015-10-17,Colorado,,Arizona,L (31-38),28,44,63.6,339,2,43,128,3.0,2,87,467,5.4,15,6,1,22,9,65,1,0,1
1245,2015,8,2015-10-24,Colorado,@,Oregon State,W (17-13),16,23,69.6,140,1,45,188,4.2,1,68,328,4.8,8,11,1,20,9,80,0,0,0
1246,2015,9,2015-10-31,Colorado,@,UCLA,L (31-35),37,58,63.8,312,0,56,242,4.3,2,114,554,4.9,14,18,2,34,7,68,0,2,2
1247,2015,10,2015-11-07,Colorado,,Stanford,L (10-42),13,23,56.5,148,0,30,83,2.8,1,53,231,4.4,7,7,1,15,3,21,0,2,2
1248,2015,11,2015-11-13,Colorado,,Southern California,L (24-27),24,31,77.4,222,2,36,59,1.6,1,67,281,4.2,12,7,2,21,5,39,1,0,1
1249,2015,12,2015-11-21,Colorado,@,Washington State,L (3-27),26,41,63.4,238,0,30,85,2.8,0,71,323,4.5,12,4,1,17,7,61,0,2,2
1250,2015,13,2015-11-28,Colorado,@,Utah,L (14-20),19,38,50.0,258,2,33,49,1.5,0,71,307,4.3,11,5,3,19,3,31,1,3,4
1251,2015,,13 Games,Colorado,,,,285,465,61.3,3111,13,543,2048,3.8,23,1008,5159,5.1,144,126,21,291,80,724,9,12,21
1252,2016,1,2016-09-02,Colorado,N,Colorado State,W (44-7),23,33,69.7,318,1,56,260,4.6,3,89,578,6.5,12,15,1,28,4,35,2,0,2
1253,2016,2,2016-09-10,Colorado,,Idaho State,W (56-7),22,31,71.0,335,4,57,262,4.6,4,88,597,6.8,13,15,4,32,5,37,1,0,1
1254,2016,3,2016-09-17,Colorado,@,Michigan,L (28-45),18,34,52.9,261,3,33,64,1.9,0,67,325,4.9,8,5,2,15,7,46,0,0,0
1255,2016,4,2016-09-24,Colorado,@,Oregon,W (41-38),23,32,71.9,333,3,52,260,5.0,2,84,593,7.1,15,14,3,32,5,47,0,2,2
1256,2016,5,2016-10-01,Colorado,,Oregon State,W (47-6),21,30,70.0,316,3,54,247,4.6,2,84,563,6.7,13,13,0,26,5,55,0,0,0
1257,2016,6,2016-10-08,Colorado,@,Southern California,L (17-21),28,44,63.6,275,2,29,96,3.3,0,73,371,5.1,15,4,1,20,5,26,0,1,1
1258,2016,7,2016-10-15,Colorado,,Arizona State,W (40-16),23,32,71.9,265,0,52,315,6.1,5,84,580,6.9,9,18,0,27,3,20,2,0,2
1259,2016,8,2016-10-22,Colorado,@,Stanford,W (10-5),12,25,48.0,135,1,44,241,5.5,0,69,376,5.4,7,15,1,23,6,60,0,0,0
1260,2016,9,2016-11-03,Colorado,,UCLA,W (20-10),20,33,60.6,160,0,52,144,2.8,1,85,304,3.6,10,8,6,24,12,128,1,3,4
1261,2016,10,2016-11-12,Colorado,@,Arizona,W (49-24),19,27,70.4,213,3,46,175,3.8,4,73,388,5.3,8,11,6,25,7,62,0,1,1
1262,2016,11,2016-11-19,Colorado,,Washington State,W (38-24),27,41,65.9,345,0,59,258,4.4,5,100,603,6.0,15,15,1,31,9,75,1,0,1
1263,2016,12,2016-11-26,Colorado,,Utah,W (27-22),23,44,52.3,270,1,38,108,2.8,1,82,378,4.6,10,6,2,18,0,0,2,0,2
1264,2016,13,2016-12-02,Colorado,N,Washington,L (10-41),8,25,32.0,81,0,29,82,2.8,1,54,163,3.0,3,4,2,9,3,35,0,3,3
1265,2016,14,2016-12-29,Colorado,N,Oklahoma State*,L (8-38),22,38,57.9,256,0,29,62,2.1,1,67,318,4.7,11,6,1,18,5,35,0,1,1
1266,2016,,14 Games,Colorado,,,,289,469,61.6,3563,21,630,2574,4.1,29,1099,6137,5.6,149,149,30,328,76,661,9,11,20
1267,2017,1,2017-09-01,Colorado,N,Colorado State,W (17-3),21,29,72.4,202,1,36,145,4.0,1,65,347,5.3,9,7,3,19,7,59,0,2,2
1268,2017,2,2017-09-09,Colorado,,Texas State,W (37-3),23,36,63.9,339,1,39,94,2.4,2,75,433,5.8,14,6,1,21,5,35,0,0,0
1269,2017,3,2017-09-16,Colorado,,Northern Colorado,W (41-21),29,41,70.7,357,4,39,212,5.4,1,80,569,7.1,16,12,2,30,14,114,2,1,3
1270,2017,4,2017-09-23,Colorado,,Washington,L (10-37),22,30,73.3,191,0,42,131,3.1,1,72,322,4.5,9,11,0,20,3,35,0,3,3
1271,2017,5,2017-09-30,Colorado,@,UCLA,L (23-27),17,38,44.7,243,1,38,191,5.0,1,76,434,5.7,10,9,5,24,6,53,0,0,0
1272,2017,6,2017-10-07,Colorado,,Arizona,L (42-45),19,32,59.4,251,3,58,300,5.2,3,90,551,6.1,11,18,0,29,12,110,0,0,0
1273,2017,7,2017-10-14,Colorado,@,Oregon State,W (36-33),15,25,60.0,179,3,41,206,5.0,2,66,385,5.8,9,13,3,25,3,14,0,0,0
1274,2017,8,2017-10-21,Colorado,@,Washington State,L (0-28),13,34,38.2,94,0,40,80,2.0,0,74,174,2.4,3,8,2,13,5,45,1,0,1
1275,2017,9,2017-10-28,Colorado,,California,W (44-28),21,27,77.8,353,3,53,200,3.8,1,80,553,6.9,10,16,1,27,7,58,1,0,1
1276,2017,10,2017-11-04,Colorado,@,Arizona State,L (30-41),23,41,56.1,345,1,39,109,2.8,2,80,454,5.7,15,8,0,23,3,25,0,1,1
1277,2017,11,2017-11-11,Colorado,,Southern California,L (24-38),27,49,55.1,376,2,34,110,3.2,1,83,486,5.9,15,7,1,23,4,45,0,2,2
1278,2017,12,2017-11-25,Colorado,@,Utah,L (13-34),14,28,50.0,195,0,35,124,3.5,2,63,319,5.1,7,9,1,17,6,75,1,0,1
1279,2017,,12 Games,Colorado,,,,244,410,59.5,3125,19,494,1902,3.9,17,904,5027,5.6,128,124,19,271,75,668,5,9,14
1280,2014,1,2014-08-29,Colorado State,N,Colorado,W (31-17),13,23,56.5,134,1,45,266,5.9,3,68,400,5.9,10,14,3,27,6,63,1,0,1
1281,2014,2,2014-09-06,Colorado State,@,Boise State,L (24-37),31,58,53.4,434,3,23,28,1.2,0,81,462,5.7,20,2,1,23,2,20,1,2,3
1282,2014,3,2014-09-13,Colorado State,,California-Davis,W (49-21),25,34,73.5,452,4,33,224,6.8,3,67,676,10.1,17,11,0,28,3,31,0,0,0
1283,2014,4,2014-09-27,Colorado State,@,Boston College,W (24-21),27,41,65.9,268,2,24,162,6.8,1,65,430,6.6,18,6,1,25,7,69,0,2,2
1284,2014,5,2014-10-04,Colorado State,,Tulsa,W (42-17),16,26,61.5,298,4,31,234,7.5,2,57,532,9.3,6,10,1,17,7,74,1,1,2
1285,2014,6,2014-10-11,Colorado State,@,Nevada,W (31-24),26,36,72.2,326,3,34,119,3.5,1,70,445,6.4,15,6,0,21,2,25,1,0,1
1286,2014,7,2014-10-18,Colorado State,,Utah State,W (16-13),20,32,62.5,243,0,39,75,1.9,1,71,318,4.5,8,7,4,19,11,116,0,0,0
1287,2014,8,2014-10-25,Colorado State,,Wyoming,W (45-31),20,24,83.3,411,5,30,147,4.9,1,54,558,10.3,17,6,1,24,9,87,0,0,0
1288,2014,9,2014-11-01,Colorado State,@,San Jose State,W (38-31),22,28,78.6,290,1,37,113,3.1,4,65,403,6.2,12,8,0,20,2,17,2,0,2
1289,2014,10,2014-11-08,Colorado State,,Hawaii,W (49-22),16,28,57.1,287,4,43,293,6.8,3,71,580,8.2,11,14,1,26,7,46,1,0,1
1290,2014,11,2014-11-22,Colorado State,,New Mexico,W (58-20),26,36,72.2,406,3,45,292,6.5,5,81,698,8.6,18,11,3,32,7,76,2,0,2
1291,2014,12,2014-11-28,Colorado State,@,Air Force,L (24-27),23,46,50.0,366,3,32,106,3.3,0,78,472,6.1,15,8,1,24,2,14,0,1,1
1292,2014,13,2014-12-20,Colorado State,N,Utah*,L (10-45),21,35,60.0,266,1,19,12,0.6,0,54,278,5.1,9,2,2,13,7,73,1,1,2
1293,2014,,13 Games,Colorado State,,,,286,447,64.0,4181,34,435,2071,4.8,24,882,6252,7.1,176,105,18,299,72,711,10,7,17
1294,2015,1,2015-09-05,Colorado State,,Savannah State,W (65-13),27,36,75.0,381,6,33,217,6.6,2,69,598,8.7,20,11,2,33,6,62,4,1,5
1295,2015,2,2015-09-12,Colorado State,,Minnesota,L (20-23),16,32,50.0,142,1,41,172,4.2,1,73,314,4.3,5,8,1,14,10,86,2,2,4
1296,2015,3,2015-09-19,Colorado State,N,Colorado,L (24-27),25,39,64.1,282,1,49,218,4.4,2,88,500,5.7,16,9,2,27,8,65,0,2,2
1297,2015,4,2015-09-26,Colorado State,@,Texas-San Antonio,W (33-31),16,30,53.3,267,3,46,171,3.7,1,76,438,5.8,12,11,2,25,9,71,0,0,0
1298,2015,5,2015-10-03,Colorado State,@,Utah State,L (18-33),21,46,45.7,252,1,31,109,3.5,1,77,361,4.7,12,9,3,24,12,110,2,1,3
1299,2015,6,2015-10-10,Colorado State,,Boise State,L (10-41),14,30,46.7,151,1,37,105,2.8,0,67,256,3.8,6,7,1,14,9,93,1,2,3
1300,2015,7,2015-10-17,Colorado State,,Air Force,W (38-23),23,30,76.7,296,3,37,160,4.3,2,67,456,6.8,14,7,1,22,9,87,0,1,1
1301,2015,8,2015-10-31,Colorado State,,San Diego State,L (17-41),17,28,60.7,205,2,33,163,4.9,0,61,368,6.0,10,8,4,22,7,78,1,3,4
1302,2015,9,2015-11-07,Colorado State,@,Wyoming,W (26-7),11,15,73.3,120,0,55,228,4.1,3,70,348,5.0,6,14,3,23,10,101,0,1,1
1303,2015,10,2015-11-14,Colorado State,,Nevada-Las Vegas,W (49-35),13,19,68.4,209,4,46,325,7.1,3,65,534,8.2,7,15,2,24,3,35,1,1,2
1304,2015,11,2015-11-21,Colorado State,@,New Mexico,W (28-21),16,23,69.6,264,1,45,221,4.9,2,68,485,7.1,12,13,1,26,4,29,0,0,0
1305,2015,12,2015-11-28,Colorado State,@,Fresno State,W (34-31),11,21,52.4,85,1,40,261,6.5,1,61,346,5.7,4,14,0,18,4,45,0,1,1
1306,2015,13,2015-12-29,Colorado State,N,Nevada*,L (23-28),22,42,52.4,310,0,42,222,5.3,2,84,532,6.3,17,12,1,30,7,65,1,0,1
1307,2015,,13 Games,Colorado State,,,,232,391,59.3,2964,24,535,2572,4.8,20,926,5536,6.0,141,138,23,302,98,927,12,15,27
1308,2016,1,2016-09-02,Colorado State,N,Colorado,L (7-44),12,29,41.4,63,1,35,162,4.6,0,64,225,3.5,5,7,0,12,2,15,2,2,4
1309,2016,2,2016-09-10,Colorado State,,Texas-San Antonio,W (23-14),8,23,34.8,108,0,47,220,4.7,2,70,328,4.7,6,11,2,19,7,70,0,0,0
1310,2016,3,2016-09-17,Colorado State,,Northern Colorado,W (47-21),22,28,78.6,324,4,43,245,5.7,2,71,569,8.0,13,12,4,29,8,80,1,0,1
1311,2016,4,2016-09-24,Colorado State,@,Minnesota,L (24-31),16,31,51.6,211,1,48,158,3.3,2,79,369,4.7,9,12,3,24,3,25,1,1,2
1312,2016,5,2016-10-01,Colorado State,,Wyoming,L (17-38),23,42,54.8,370,1,33,111,3.4,1,75,481,6.4,15,5,0,20,6,37,1,1,2
1313,2016,6,2016-10-08,Colorado State,,Utah State,W (31-24),17,32,53.1,240,2,47,224,4.8,2,79,464,5.9,9,12,1,22,8,79,0,0,0
1314,2016,7,2016-10-15,Colorado State,@,Boise State,L (23-28),17,31,54.8,189,2,36,184,5.1,1,67,373,5.6,6,13,0,19,6,30,0,0,0
1315,2016,8,2016-10-22,Colorado State,@,Nevada-Las Vegas,W (42-23),21,28,75.0,237,2,50,230,4.6,4,78,467,6.0,11,15,0,26,4,21,1,0,1
1316,2016,9,2016-11-05,Colorado State,,Fresno State,W (37-0),18,25,72.0,237,2,48,257,5.4,3,73,494,6.8,13,13,2,28,7,80,0,0,0
1317,2016,10,2016-11-12,Colorado State,@,Air Force,L (46-49),22,29,75.9,374,2,35,185,5.3,3,64,559,8.7,12,9,1,22,3,35,1,1,2
1318,2016,11,2016-11-19,Colorado State,,New Mexico,W (49-31),9,10,90.0,164,2,42,412,9.8,5,52,576,11.1,7,15,1,23,8,70,0,0,0
1319,2016,12,2016-11-26,Colorado State,@,San Diego State,W (63-31),11,16,68.8,216,5,46,291,6.3,3,62,507,8.2,10,13,0,23,6,65,0,0,0
1320,2016,13,2016-12-22,Colorado State,N,Idaho*,L (50-61),21,36,58.3,445,5,30,155,5.2,2,66,600,9.1,14,7,4,25,10,92,1,2,3
1321,2016,,13 Games,Colorado State,,,,217,360,60.3,3178,29,540,2834,5.2,30,900,6012,6.7,130,144,18,292,78,699,8,7,15
1322,2017,1,2017-08-26,Colorado State,,Oregon State,W (58-27),26,39,66.7,334,3,43,191,4.4,3,82,525,6.4,14,16,1,31,8,40,1,1,2
1323,2017,2,2017-09-01,Colorado State,N,Colorado,L (3-17),24,47,51.1,309,0,33,88,2.7,0,80,397,5.0,15,7,1,23,10,120,1,2,3
1324,2017,3,2017-09-09,Colorado State,,Abilene Christian,W (38-10),25,40,62.5,342,3,38,273,7.2,2,78,615,7.9,15,12,3,30,8,88,1,1,2
1325,2017,4,2017-09-16,Colorado State,@,Alabama,L (23-41),21,38,55.3,247,2,40,144,3.6,1,78,391,5.0,11,8,3,22,3,14,0,2,2
1326,2017,5,2017-09-30,Colorado State,@,Hawaii,W (51-21),18,22,81.8,351,4,37,259,7.0,3,59,610,10.3,13,11,1,25,3,25,0,0,0
1327,2017,6,2017-10-07,Colorado State,@,Utah State,W (27-14),22,31,71.0,293,2,52,216,4.2,1,83,509,6.1,16,10,3,29,8,85,0,0,0
1328,2017,7,2017-10-14,Colorado State,,Nevada,W (44-42),26,37,70.3,384,4,34,224,6.6,2,71,608,8.6,15,8,0,23,11,98,1,0,1
1329,2017,8,2017-10-20,Colorado State,@,New Mexico,W (27-24),17,33,51.5,231,2,35,180,5.1,1,68,411,6.0,13,8,2,23,8,88,0,0,0
1330,2017,9,2017-10-28,Colorado State,,Air Force,L (28-45),17,31,54.8,269,2,23,166,7.2,2,54,435,8.1,13,7,2,22,4,40,0,3,3
1331,2017,10,2017-11-04,Colorado State,@,Wyoming,L (13-16),8,14,57.1,110,0,55,235,4.3,1,69,345,5.0,5,13,0,18,7,55,0,0,0
1332,2017,11,2017-11-11,Colorado State,,Boise State,L (52-59),29,43,67.4,309,2,52,261,5.0,5,95,570,6.0,15,16,2,33,2,19,1,1,2
1333,2017,12,2017-11-18,Colorado State,,San Jose State,W (42-14),26,32,81.3,305,3,45,301,6.7,3,77,606,7.9,14,12,0,26,6,54,1,0,1
1334,2017,13,2017-12-16,Colorado State,N,Marshall*,L (28-31),25,52,48.1,320,2,31,70,2.3,2,83,390,4.7,15,6,5,26,3,15,0,0,0
1335,2017,,13 Games,Colorado State,,,,284,459,61.9,3804,29,518,2608,5.0,26,977,6412,6.6,174,134,23,331,81,741,6,10,16
1336,2014,1,2014-08-29,Connecticut,,Brigham Young,L (10-35),25,48,52.1,284,0,31,71,2.3,1,79,355,4.5,14,3,6,23,8,90,1,1,2
1337,2014,2,2014-09-06,Connecticut,,Stony Brook,W (19-16),12,27,44.4,142,1,37,81,2.2,0,64,223,3.5,7,5,3,15,3,25,2,0,2
1338,2014,3,2014-09-13,Connecticut,,Boise State,L (21-38),22,38,57.9,242,2,36,48,1.3,0,74,290,3.9,11,6,1,183,3,30,1,2,3
1339,2014,4,2014-09-19,Connecticut,@,South Florida,L (14-17),6,10,60.0,88,1,26,57,2.2,0,36,145,4.0,3,2,1,6,9,61,1,0,1
1340,2014,5,2014-09-27,Connecticut,,Temple,L (10-36),14,28,50.0,174,1,43,133,3.1,0,71,307,4.3,6,10,2,18,7,70,1,2,3
1341,2014,6,2014-10-11,Connecticut,@,Tulane,L (3-12),17,26,65.4,141,0,28,76,2.7,0,54,217,4.0,6,6,1,13,1,15,2,1,3
1342,2014,7,2014-10-23,Connecticut,@,East Carolina,L (21-31),20,32,62.5,313,2,26,84,3.2,1,58,397,6.8,10,3,3,16,12,118,0,1,1
1343,2014,8,2014-11-01,Connecticut,,Central Florida,W (37-29),14,28,50.0,148,2,40,179,4.5,3,68,327,4.8,6,7,3,16,10,102,1,0,1
1344,2014,9,2014-11-08,Connecticut,N,Army,L (21-35),23,37,62.2,190,2,24,169,7.0,1,61,359,5.9,9,8,1,18,5,37,0,2,2
1345,2014,10,2014-11-22,Connecticut,,Cincinnati,L (0-41),14,27,51.9,81,0,27,48,1.8,0,54,129,2.4,5,5,0,10,2,20,2,1,3
1346,2014,11,2014-11-29,Connecticut,@,Memphis,L (10-41),13,27,48.1,162,1,36,107,3.0,0,63,269,4.3,7,6,1,14,10,115,1,1,2
1347,2014,12,2014-12-06,Connecticut,,Southern Methodist,L (20-27),5,14,35.7,67,0,41,249,6.1,2,55,316,5.7,3,8,0,11,4,44,4,1,5
1348,2014,,12 Games,Connecticut,,,,185,342,54.1,2032,12,395,1302,3.3,8,737,3334,4.5,87,69,22,343,74,727,16,12,28
1349,2015,1,2015-09-03,Connecticut,,Villanova,W (20-15),12,20,60.0,202,2,39,105,2.7,1,59,307,5.2,9,8,2,19,4,30,0,1,1
1350,2015,2,2015-09-12,Connecticut,,Army,W (22-17),19,25,76.0,270,0,46,145,3.2,2,71,415,5.8,10,11,2,23,7,50,1,0,1
1351,2015,3,2015-09-19,Connecticut,@,Missouri,L (6-9),17,28,60.7,156,0,33,77,2.3,1,61,233,3.8,7,4,0,11,8,85,1,1,2
1352,2015,4,2015-09-26,Connecticut,,Navy,L (18-28),19,32,59.4,219,2,31,106,3.4,0,63,325,5.2,10,8,2,20,3,22,1,0,1
1353,2015,5,2015-10-02,Connecticut,@,Brigham Young,L (13-30),14,28,50.0,168,1,27,62,2.3,0,55,230,4.2,9,3,2,14,5,43,0,2,2
1354,2015,6,2015-10-10,Connecticut,@,Central Florida,W (40-13),18,24,75.0,263,1,45,170,3.8,4,69,433,6.3,10,10,0,20,11,69,0,0,0
1355,2015,7,2015-10-17,Connecticut,,South Florida,L (20-28),28,42,66.7,365,1,38,163,4.3,1,80,528,6.6,16,9,1,26,4,39,0,1,1
1356,2015,8,2015-10-24,Connecticut,@,Cincinnati,L (13-37),17,41,41.5,130,0,30,136,4.5,1,71,266,3.7,6,8,5,19,3,25,1,1,2
1357,2015,9,2015-10-30,Connecticut,,East Carolina,W (31-13),12,21,57.1,184,1,44,220,5.0,3,65,404,6.2,7,7,3,17,5,34,1,1,2
1358,2015,10,2015-11-07,Connecticut,@,Tulane,W (7-3),8,19,42.1,81,0,42,146,3.5,0,61,227,3.7,2,7,0,9,4,45,0,1,1
1359,2015,11,2015-11-21,Connecticut,,Houston,W (20-17),14,24,58.3,159,2,43,156,3.6,0,67,315,4.7,6,6,1,13,10,63,0,0,0
1360,2015,12,2015-11-28,Connecticut,@,Temple,L (3-27),13,21,61.9,129,0,26,9,0.3,0,47,138,2.9,7,2,0,9,7,65,1,1,2
1361,2015,13,2015-12-26,Connecticut,N,Marshall*,L (10-16),10,17,58.8,86,0,33,127,3.8,1,50,213,4.3,6,7,2,15,3,25,0,1,1
1362,2015,,13 Games,Connecticut,,,,201,342,58.8,2412,10,477,1622,3.4,14,819,4034,4.9,105,90,20,215,74,595,6,10,16
1363,2016,1,2016-09-01,Connecticut,,Maine,W (24-21),16,23,69.6,162,0,50,200,4.0,3,73,362,5.0,11,11,1,23,3,30,1,0,1
1364,2016,2,2016-09-10,Connecticut,@,Navy,L (24-28),24,27,88.9,264,1,34,90,2.6,1,61,354,5.8,12,6,1,19,2,6,2,0,2
1365,2016,3,2016-09-17,Connecticut,,Virginia,W (13-10),13,24,54.2,154,0,40,123,3.1,1,64,277,4.3,9,4,5,18,3,35,1,1,2
1366,2016,4,2016-09-24,Connecticut,,Syracuse,L (24-31),28,46,60.9,281,1,45,144,3.2,2,91,425,4.7,13,10,0,23,1,5,0,1,1
1367,2016,5,2016-09-29,Connecticut,@,Houston,L (14-42),16,36,44.4,273,1,27,62,2.3,1,63,335,5.3,12,2,0,14,4,38,0,0,0
1368,2016,6,2016-10-08,Connecticut,,Cincinnati,W (20-9),18,33,54.5,224,2,41,188,4.6,0,74,412,5.6,10,8,3,21,8,69,0,2,2
1369,2016,7,2016-10-15,Connecticut,@,South Florida,L (27-42),22,39,56.4,306,2,36,72,2.0,1,75,378,5.0,11,7,2,20,3,20,0,0,0
1370,2016,8,2016-10-22,Connecticut,,Central Florida,L (16-24),18,35,51.4,242,0,45,171,3.8,1,80,413,5.2,11,13,0,24,4,30,0,0,0
1371,2016,9,2016-10-29,Connecticut,@,East Carolina,L (3-41),18,35,51.4,206,0,31,89,2.9,0,66,295,4.5,9,4,1,14,4,34,1,2,3
1372,2016,10,2016-11-04,Connecticut,,Temple,L (0-21),12,21,57.1,69,0,28,91,3.3,0,49,160,3.3,5,3,0,8,4,23,0,0,0
1373,2016,11,2016-11-19,Connecticut,@,Boston College,L (0-30),13,30,43.3,127,0,17,-6,-0.4,0,47,121,2.6,6,1,1,8,6,46,1,3,4
1374,2016,12,2016-11-26,Connecticut,,Tulane,L (13-38),15,31,48.4,124,1,24,184,7.7,1,55,308,5.6,8,4,1,13,1,3,2,2,4
1375,2016,,12 Games,Connecticut,,,,213,380,56.1,2432,8,418,1408,3.4,11,798,3840,4.8,117,73,15,205,43,339,8,11,19
1376,2017,1,2017-08-31,Connecticut,,Holy Cross,W (27-20),28,41,68.3,278,1,37,160,4.3,3,78,438,5.6,10,7,1,18,4,40,2,0,2
1377,2017,2,2017-09-16,Connecticut,@,Virginia,L (18-38),18,26,69.2,227,2,41,207,5.0,1,67,434,6.5,10,9,4,23,1,5,1,1,2
1378,2017,3,2017-09-24,Connecticut,,East Carolina,L (38-41),24,39,61.5,406,3,38,190,5.0,2,77,596,7.7,15,9,3,27,4,40,0,1,1
1379,2017,4,2017-09-30,Connecticut,@,Southern Methodist,L (28-49),22,28,78.6,408,2,36,-8,-0.2,1,64,400,6.3,13,2,3,18,5,42,1,0,1
1380,2017,5,2017-10-06,Connecticut,,Memphis,L (31-70),21,35,60.0,310,1,34,167,4.9,3,69,477,6.9,14,7,3,24,6,55,2,1,3
1381,2017,6,2017-10-14,Connecticut,@,Temple,W (28-24),18,28,64.3,105,3,36,143,4.0,0,64,248,3.9,6,6,3,15,6,51,1,1,2
1382,2017,7,2017-10-21,Connecticut,,Tulsa,W (20-14),23,29,79.3,372,1,42,69,1.6,1,71,441,6.2,11,6,2,19,11,105,0,0,0
1383,2017,8,2017-10-28,Connecticut,,Missouri,L (12-52),22,52,42.3,233,0,41,121,3.0,1,93,354,3.8,9,11,3,23,5,65,0,1,1
1384,2017,9,2017-11-04,Connecticut,,South Florida,L (20-37),21,28,75.0,176,1,41,148,3.6,2,69,324,4.7,12,7,3,22,2,20,0,1,1
1385,2017,10,2017-11-11,Connecticut,@,Central Florida,L (24-49),18,31,58.1,201,2,45,212,4.7,1,76,413,5.4,9,11,3,23,8,79,1,1,2
1386,2017,11,2017-11-18,Connecticut,N,Boston College,L (16-39),14,33,42.4,241,1,41,171,4.2,1,74,412,5.6,8,7,0,15,7,47,0,3,3
1387,2017,12,2017-11-25,Connecticut,@,Cincinnati,L (21-22),27,51,52.9,273,1,52,176,3.4,1,103,449,4.4,13,13,3,29,4,37,0,1,1
1388,2017,,12 Games,Connecticut,,,,256,421,60.8,3230,18,484,1756,3.6,17,905,4986,5.5,130,95,31,256,63,586,8,11,19
1389,2014,1,2014-08-30,Duke,,Elon,W (52-13),28,42,66.7,292,4,44,275,6.3,3,86,567,6.6,14,17,0,31,2,15,0,0,0
1390,2014,2,2014-09-06,Duke,@,Troy,W (34-17),28,42,66.7,270,2,41,182,4.4,2,83,452,5.4,15,10,0,25,6,43,0,0,0
1391,2014,3,2014-09-13,Duke,,Kansas,W (41-3),20,34,58.8,180,2,36,331,9.2,3,70,511,7.3,9,10,4,23,5,41,0,0,0
1392,2014,4,2014-09-20,Duke,,Tulane,W (47-13),15,28,53.6,181,0,42,256,6.1,4,70,437,6.2,8,12,3,23,7,80,1,1,2
1393,2014,5,2014-09-27,Duke,@,Miami (FL),L (10-22),22,51,43.1,179,0,25,85,3.4,1,76,264,3.5,8,5,4,17,8,50,1,2,3
1394,2014,6,2014-10-11,Duke,@,Georgia Tech,W (31-25),16,26,61.5,131,1,47,242,5.1,3,73,373,5.1,5,16,4,25,5,35,0,0,0
1395,2014,7,2014-10-18,Duke,,Virginia,W (20-13),23,38,60.5,179,2,30,155,5.2,0,68,334,4.9,7,10,2,19,3,30,0,0,0
1396,2014,8,2014-11-01,Duke,@,Pittsburgh,W (51-48),23,31,74.2,266,3,27,172,6.4,3,58,438,7.6,12,11,2,25,3,20,0,0,0
1397,2014,9,2014-11-08,Duke,@,Syracuse,W (27-10),15,33,45.5,161,2,33,98,3.0,0,66,259,3.9,6,5,1,12,5,40,0,1,1
1398,2014,10,2014-11-15,Duke,,Virginia Tech,L (16-17),19,41,46.3,185,0,41,141,3.4,1,82,326,4.0,12,9,2,23,8,50,1,2,3
1399,2014,11,2014-11-20,Duke,,North Carolina,L (20-45),22,40,55.0,262,2,37,116,3.1,1,77,378,4.9,12,8,1,21,5,35,2,1,3
1400,2014,12,2014-11-29,Duke,,Wake Forest,W (41-21),20,32,62.5,293,2,45,146,3.2,3,77,439,5.7,11,10,0,21,3,29,1,0,1
1401,2014,13,2014-12-27,Duke,N,Arizona State*,L (31-36),17,33,51.5,235,3,44,165,3.8,0,77,400,5.2,11,10,0,21,4,35,1,1,2
1402,2014,,13 Games,Duke,,,,268,471,56.9,2814,23,492,2364,4.8,24,963,5178,5.4,130,133,23,286,64,503,7,8,15
1403,2015,1,2015-09-03,Duke,@,Tulane,W (37-7),29,44,65.9,324,2,49,206,4.2,1,93,530,5.7,16,11,2,29,8,78,2,0,2
1404,2015,2,2015-09-12,Duke,,North Carolina Central,W (55-0),19,26,73.1,367,3,59,288,4.9,4,85,655,7.7,9,17,3,29,3,34,0,0,0
1405,2015,3,2015-09-19,Duke,,Northwestern,L (10-19),24,39,61.5,150,0,35,177,5.1,1,74,327,4.4,6,9,1,16,4,39,2,1,3
1406,2015,4,2015-09-26,Duke,,Georgia Tech,W (34-20),17,25,68.0,114,1,36,165,4.6,3,61,279,4.6,6,5,0,11,4,35,1,2,3
1407,2015,5,2015-10-03,Duke,,Boston College,W (9-7),18,36,50.0,195,0,35,33,0.9,0,71,228,3.2,9,4,3,16,5,31,0,0,0
1408,2015,6,2015-10-10,Duke,@,Army,W (44-3),20,30,66.7,243,1,48,215,4.5,4,78,458,5.9,14,8,3,25,5,50,0,0,0
1409,2015,7,2015-10-24,Duke,@,Virginia Tech,W (45-43),19,40,47.5,270,4,32,179,5.6,1,72,449,6.2,12,7,1,20,7,22,0,0,0
1410,2015,8,2015-10-31,Duke,,Miami (FL),L (27-30),31,52,59.6,258,1,39,182,4.7,2,91,440,4.8,15,11,8,34,5,41,1,0,1
1411,2015,9,2015-11-07,Duke,@,North Carolina,L (31-66),20,40,50.0,206,1,44,327,7.4,3,84,533,6.3,13,15,2,30,8,72,1,2,3
1412,2015,10,2015-11-14,Duke,,Pittsburgh,L (13-31),23,43,53.5,248,0,22,113,5.1,1,65,361,5.6,11,5,2,18,4,44,2,1,3
1413,2015,11,2015-11-21,Duke,@,Virginia,L (34-42),30,53,56.6,385,2,31,100,3.2,1,84,485,5.8,19,6,4,29,9,80,2,1,3
1414,2015,12,2015-11-28,Duke,@,Wake Forest,W (27-21),27,41,65.9,280,2,48,151,3.1,1,89,431,4.8,19,7,4,30,4,34,0,0,0
1415,2015,13,2015-12-26,Duke,N,Indiana*,W (44-41),17,40,42.5,163,1,46,373,8.1,3,86,536,6.2,7,15,1,23,5,61,0,3,3
1416,2015,,13 Games,Duke,,,,294,509,57.8,3203,18,524,2509,4.8,25,1033,5712,5.5,156,120,34,310,71,621,11,10,21
1417,2016,1,2016-09-03,Duke,,North Carolina Central,W (49-6),16,26,61.5,227,3,63,308,4.9,4,89,535,6.0,9,17,3,29,10,85,5,0,5
1418,2016,2,2016-09-10,Duke,,Wake Forest,L (14-24),31,48,64.6,332,0,30,37,1.2,2,78,369,4.7,15,5,1,21,5,22,2,1,3
1419,2016,3,2016-09-17,Duke,@,Northwestern,L (13-24),27,49,55.1,279,0,34,117,3.4,2,83,396,4.8,15,7,1,23,7,62,1,1,2
1420,2016,4,2016-09-24,Duke,@,Notre Dame,W (38-35),24,32,75.0,290,3,42,208,5.0,1,74,498,6.7,12,11,1,24,1,5,0,1,1
1421,2016,5,2016-10-01,Duke,,Virginia,L (20-34),33,54,61.1,324,1,31,106,3.4,1,85,430,5.1,17,6,2,25,2,25,1,5,6
1422,2016,6,2016-10-08,Duke,,Army,W (13-6),8,16,50.0,44,2,50,145,2.9,0,66,189,2.9,3,6,0,9,6,39,1,0,1
1423,2016,7,2016-10-14,Duke,@,Louisville,L (14-24),14,21,66.7,129,2,39,110,2.8,0,60,239,4.0,7,5,1,13,3,25,0,0,0
1424,2016,8,2016-10-29,Duke,@,Georgia Tech,L (35-38),22,36,61.1,305,2,37,254,6.9,3,73,559,7.7,13,9,1,23,4,20,2,1,3
1425,2016,9,2016-11-05,Duke,,Virginia Tech,L (21-24),18,31,58.1,148,0,45,227,5.0,3,76,375,4.9,9,12,3,24,6,46,0,0,0
1426,2016,10,2016-11-10,Duke,,North Carolina,W (28-27),22,34,64.7,240,1,55,227,4.1,3,89,467,5.2,15,10,2,27,5,60,0,0,0
1427,2016,11,2016-11-19,Duke,@,Pittsburgh,L (14-56),28,46,60.9,243,1,22,25,1.1,0,68,268,3.9,14,2,2,18,6,45,2,0,2
1428,2016,12,2016-11-26,Duke,@,Miami (FL),L (21-40),34,50,68.0,316,3,26,79,3.0,0,76,395,5.2,14,5,3,22,7,51,0,0,0
1429,2016,,12 Games,Duke,,,,277,443,62.5,2877,18,474,1843,3.9,19,917,4720,5.1,143,95,20,258,62,485,14,9,23
1430,2017,1,2017-09-02,Duke,,North Carolina Central,W (60-7),26,34,76.5,281,3,47,243,5.2,4,81,524,6.5,13,15,2,30,3,40,0,0,0
1431,2017,2,2017-09-09,Duke,,Northwestern,W (41-17),29,45,64.4,305,2,59,233,3.9,3,104,538,5.2,17,14,3,34,8,55,1,1,2
1432,2017,3,2017-09-16,Duke,,Baylor,W (34-20),20,35,57.1,184,0,51,246,4.8,3,86,430,5.0,7,14,3,24,5,54,1,1,2
1433,2017,4,2017-09-23,Duke,@,North Carolina,W (27-17),18,34,52.9,202,1,45,186,4.1,1,79,388,4.9,8,12,0,20,2,12,0,0,0
1434,2017,5,2017-09-29,Duke,,Miami (FL),L (6-31),21,42,50.0,166,0,46,183,4.0,0,88,349,4.0,7,14,3,24,7,82,1,1,2
1435,2017,6,2017-10-07,Duke,@,Virginia,L (21-28),14,42,33.3,124,1,32,131,4.1,1,74,255,3.4,8,7,2,17,7,68,0,2,2
1436,2017,7,2017-10-14,Duke,,Florida State,L (10-17),22,37,59.5,204,0,25,111,4.4,1,62,315,5.1,10,7,0,17,5,37,0,1,1
1437,2017,8,2017-10-21,Duke,,Pittsburgh,L (17-24),16,34,47.1,283,2,26,76,2.9,0,60,359,6.0,13,6,3,22,7,32,1,1,2
1438,2017,9,2017-10-28,Duke,@,Virginia Tech,L (3-24),10,24,41.7,82,0,35,101,2.9,0,59,183,3.1,3,5,2,10,7,53,1,1,2
1439,2017,10,2017-11-11,Duke,@,Army,L (16-21),19,30,63.3,164,0,33,89,2.7,2,63,253,4.0,12,7,3,22,4,43,1,1,2
1440,2017,11,2017-11-18,Duke,,Georgia Tech,W (43-20),19,28,67.9,181,3,51,319,6.3,2,79,500,6.3,9,20,1,30,1,15,0,0,0
1441,2017,12,2017-11-25,Duke,@,Wake Forest,W (31-23),25,44,56.8,346,2,45,97,2.2,2,89,443,5.0,16,6,0,22,4,20,0,3,3
1442,2017,13,2017-12-26,Duke,N,Northern Illinois*,W (36-14),27,40,67.5,252,2,52,213,4.1,3,92,465,5.1,13,14,0,27,2,30,1,0,1
1443,2017,,13 Games,Duke,,,,266,469,56.7,2774,16,547,2228,4.1,22,1016,5002,4.9,136,141,22,299,62,541,7,12,19
1444,2014,1,2014-08-30,East Carolina,,North Carolina Central,W (52-7),33,46,71.7,374,4,28,208,7.4,3,74,582,7.9,19,9,4,32,8,72,1,1,2
1445,2014,2,2014-09-06,East Carolina,@,South Carolina,L (23-33),32,46,69.6,321,1,21,132,6.3,1,67,453,6.8,20,4,3,27,4,40,0,2,2
1446,2014,3,2014-09-13,East Carolina,@,Virginia Tech,W (28-21),23,47,48.9,427,3,25,75,3.0,1,72,502,7.0,16,2,2,20,13,114,1,0,1
1447,2014,4,2014-09-20,East Carolina,,North Carolina,W (70-41),32,51,62.7,446,4,46,343,7.5,5,97,789,8.1,21,14,4,39,9,74,0,1,1
1448,2014,5,2014-10-04,East Carolina,,Southern Methodist,W (45-24),31,41,75.6,410,4,33,171,5.2,2,74,581,7.9,20,10,0,30,5,53,1,0,1
1449,2014,6,2014-10-11,East Carolina,@,South Florida,W (28-17),24,34,70.6,250,1,37,231,6.2,3,71,481,6.8,16,9,0,25,12,148,0,1,1
1450,2014,7,2014-10-23,East Carolina,,Connecticut,W (31-21),39,65,60.0,445,2,35,135,3.9,2,100,580,5.8,18,8,5,31,11,105,0,1,1
1451,2014,8,2014-11-01,East Carolina,@,Temple,L (10-20),24,42,57.1,217,0,46,211,4.6,1,88,428,4.9,12,15,3,30,12,116,5,0,5
1452,2014,9,2014-11-13,East Carolina,N,Cincinnati,L (46-54),35,62,56.5,425,2,32,154,4.8,4,94,579,6.2,19,6,5,30,5,38,2,0,2
1453,2014,10,2014-11-22,East Carolina,,Tulane,W (34-6),31,44,70.5,358,1,33,139,4.2,3,77,497,6.5,17,12,1,30,5,40,0,0,0
1454,2014,11,2014-11-28,East Carolina,@,Tulsa,W (49-32),28,42,66.7,338,4,37,172,4.6,2,79,510,6.5,17,7,2,26,8,42,0,1,1
1455,2014,12,2014-12-04,East Carolina,,Central Florida,L (30-32),36,49,73.5,397,3,27,14,0.5,1,76,411,5.4,20,5,1,26,12,127,1,2,3
1456,2014,13,2015-01-03,East Carolina,N,Florida*,L (20-28),34,68,50.0,427,2,33,109,3.3,0,101,536,5.3,23,6,3,32,5,35,1,2,3
1457,2014,,13 Games,East Carolina,,,,402,637,63.1,4835,31,433,2094,4.8,28,1070,6929,6.5,238,107,33,378,109,1004,12,11,23
1458,2015,1,2015-09-05,East Carolina,,Towson,W (28-20),29,37,78.4,230,0,34,210,6.2,4,71,440,6.2,11,11,1,23,8,102,0,0,0
1459,2015,2,2015-09-12,East Carolina,@,Florida,L (24-31),37,58,63.8,346,3,22,-13,-0.6,0,80,333,4.2,16,1,3,20,9,65,2,1,3
1460,2015,3,2015-09-19,East Carolina,@,Navy,L (21-45),36,49,73.5,325,3,21,80,3.8,0,70,405,5.8,17,7,1,25,6,47,1,1,2
1461,2015,4,2015-09-26,East Carolina,,Virginia Tech,W (35-28),14,20,70.0,228,2,43,182,4.2,3,63,410,6.5,10,6,3,19,7,97,1,1,2
1462,2015,5,2015-10-03,East Carolina,@,Southern Methodist,W (49-23),19,26,73.1,249,3,54,306,5.7,4,80,555,6.9,11,14,1,26,5,45,0,2,2
1463,2015,6,2015-10-10,East Carolina,@,Brigham Young,L (38-45),30,42,71.4,385,2,32,133,4.2,2,74,518,7.0,17,8,2,27,7,64,2,1,3
1464,2015,7,2015-10-17,East Carolina,,Tulsa,W (30-17),20,29,69.0,239,1,43,143,3.3,1,72,382,5.3,11,7,0,18,9,78,0,1,1
1465,2015,8,2015-10-22,East Carolina,,Temple,L (14-24),33,53,62.3,283,1,35,95,2.7,1,88,378,4.3,16,6,2,24,9,99,1,1,2
1466,2015,9,2015-10-30,East Carolina,@,Connecticut,L (13-31),19,33,57.6,137,0,36,203,5.6,1,69,340,4.9,7,9,0,16,7,64,0,4,4
1467,2015,10,2015-11-07,East Carolina,,South Florida,L (17-22),14,23,60.9,158,0,34,62,1.8,2,57,220,3.9,5,2,1,8,5,40,0,0,0
1468,2015,11,2015-11-19,East Carolina,@,Central Florida,W (44-7),36,52,69.2,473,4,33,149,4.5,1,85,622,7.3,17,12,2,31,11,93,0,0,0
1469,2015,12,2015-11-28,East Carolina,,Cincinnati,L (16-19),34,51,66.7,317,2,18,68,3.8,0,69,385,5.6,20,3,0,23,6,64,0,0,0
1470,2015,,12 Games,East Carolina,,,,321,473,67.9,3370,21,405,1618,4.0,19,878,4988,5.7,158,86,16,260,89,858,7,12,19
1471,2016,1,2016-09-03,East Carolina,,Western Carolina,W (52-7),29,33,87.9,413,5,38,275,7.2,2,71,688,9.7,17,11,0,28,3,25,1,0,1
1472,2016,2,2016-09-10,East Carolina,,North Carolina State,W (33-30),33,43,76.7,297,1,33,148,4.5,3,76,445,5.9,12,9,2,23,4,36,1,1,2
1473,2016,3,2016-09-17,East Carolina,@,South Carolina,L (15-20),44,58,75.9,400,1,33,119,3.6,0,91,519,5.7,24,6,4,34,8,75,2,2,4
1474,2016,4,2016-09-24,East Carolina,@,Virginia Tech,L (17-54),17,34,50.0,362,2,35,81,2.3,0,69,443,6.4,10,6,0,16,5,43,1,0,1
1475,2016,5,2016-10-01,East Carolina,,Central Florida,L (29-47),38,70,54.3,488,3,32,33,1.0,1,102,521,5.1,22,3,5,30,2,15,2,3,5
1476,2016,6,2016-10-08,East Carolina,@,South Florida,L (22-38),33,56,58.9,308,1,35,168,4.8,1,91,476,5.2,15,8,1,24,2,19,0,1,1
1477,2016,7,2016-10-22,East Carolina,@,Cincinnati,L (19-31),28,43,65.1,283,2,44,221,5.0,0,87,504,5.8,13,13,2,28,4,34,1,2,3
1478,2016,8,2016-10-29,East Carolina,,Connecticut,W (41-3),33,47,70.2,294,4,40,136,3.4,1,87,430,4.9,16,8,1,25,5,35,0,0,0
1479,2016,9,2016-11-05,East Carolina,@,Tulsa,L (24-45),38,62,61.3,436,2,30,38,1.3,1,92,474,5.2,20,6,1,27,13,117,0,0,0
1480,2016,10,2016-11-12,East Carolina,,Southern Methodist,L (31-55),29,49,59.2,314,1,32,152,4.8,3,81,466,5.8,13,12,2,27,9,84,2,3,5
1481,2016,11,2016-11-19,East Carolina,,Navy,L (31-66),16,25,64.0,238,3,25,176,7.0,1,50,414,8.3,6,6,0,12,1,5,1,0,1
1482,2016,12,2016-11-26,East Carolina,@,Temple,L (10-37),21,34,61.8,183,1,27,42,1.6,0,61,225,3.7,9,4,0,13,4,33,1,0,1
1483,2016,,12 Games,East Carolina,,,,359,554,64.8,4016,26,404,1589,3.9,13,958,5605,5.9,177,92,18,287,60,521,12,12,24
1484,2017,1,2017-09-02,East Carolina,,James Madison,L (14-34),28,53,52.8,292,0,28,75,2.7,2,81,367,4.5,17,3,8,28,8,61,1,3,4
1485,2017,2,2017-09-09,East Carolina,@,West Virginia,L (20-56),23,47,48.9,328,2,32,142,4.4,0,79,470,5.9,13,6,2,21,8,103,0,2,2
1486,2017,3,2017-09-16,East Carolina,,Virginia Tech,L (17-64),11,30,36.7,241,2,31,40,1.3,0,61,281,4.6,6,3,3,12,6,40,2,1,3
1487,2017,4,2017-09-24,East Carolina,@,Connecticut,W (41-38),30,39,76.9,426,3,47,170,3.6,2,86,596,6.9,19,10,1,30,8,78,0,0,0
1488,2017,5,2017-09-30,East Carolina,,South Florida,L (31-61),21,46,45.7,306,2,36,108,3.0,2,82,414,5.0,13,7,3,23,6,58,0,2,2
1489,2017,6,2017-10-07,East Carolina,,Temple,L (10-34),20,38,52.6,253,1,22,34,1.5,0,60,287,4.8,11,3,1,15,8,96,0,1,1
1490,2017,7,2017-10-14,East Carolina,@,Central Florida,L (21-63),15,33,45.5,160,3,37,187,5.1,0,70,347,5.0,8,5,3,16,10,50,0,1,1
1491,2017,8,2017-10-21,East Carolina,,Brigham Young,W (33-17),20,30,66.7,298,2,35,115,3.3,1,65,413,6.4,12,8,2,22,2,15,1,0,1
1492,2017,9,2017-11-04,East Carolina,@,Houston,L (27-52),54,74,73.0,468,3,24,36,1.5,0,98,504,5.1,27,4,2,33,7,51,1,2,3
1493,2017,10,2017-11-11,East Carolina,,Tulane,L (24-31),25,53,47.2,228,1,32,161,5.0,2,85,389,4.6,12,9,3,24,2,20,0,1,1
1494,2017,11,2017-11-18,East Carolina,,Cincinnati,W (48-20),32,46,69.6,464,5,33,114,3.5,1,79,578,7.3,19,6,3,28,7,54,0,0,0
1495,2017,12,2017-11-25,East Carolina,@,Memphis,L (13-70),28,54,51.9,351,2,37,115,3.1,0,91,466,5.1,15,8,4,27,8,74,0,3,3
1496,2017,,12 Games,East Carolina,,,,307,543,56.5,3815,26,394,1297,3.3,10,937,5112,5.5,172,72,35,279,80,700,5,16,21
1497,2014,1,2014-08-30,Eastern Michigan,,Morgan State,W (31-28),18,30,60.0,99,0,56,292,5.2,3,86,391,4.5,8,20,2,30,4,30,0,0,0
1498,2014,2,2014-09-06,Eastern Michigan,@,Florida,L (0-65),9,21,42.9,45,0,34,80,2.4,0,55,125,2.3,2,3,2,7,4,40,4,1,5
1499,2014,3,2014-09-13,Eastern Michigan,@,Old Dominion,L (3-17),12,24,50.0,72,0,48,143,3.0,0,72,215,3.0,4,10,0,14,5,47,2,0,2
1500,2014,4,2014-09-20,Eastern Michigan,@,Michigan State,L (14-73),10,29,34.5,115,2,19,20,1.1,0,48,135,2.8,3,2,0,5,4,38,5,1,6
1501,2014,5,2014-10-04,Eastern Michigan,@,Akron,L (6-31),17,30,56.7,185,1,37,94,2.5,0,67,279,4.2,8,8,2,18,7,60,2,2,4
1502,2014,6,2014-10-11,Eastern Michigan,,Buffalo,W (37-27),10,18,55.6,147,1,49,337,6.9,4,67,484,7.2,7,11,0,18,7,62,1,0,1
1503,2014,7,2014-10-18,Eastern Michigan,N,Massachusetts,L (14-36),10,21,47.6,147,2,32,133,4.2,0,53,280,5.3,5,6,0,11,10,92,0,1,1
1504,2014,8,2014-10-25,Eastern Michigan,,Northern Illinois,L (17-28),16,34,47.1,124,0,48,257,5.4,2,82,381,4.6,8,15,2,25,8,80,0,1,1
1505,2014,9,2014-11-01,Eastern Michigan,,Central Michigan,L (7-38),7,19,36.8,76,1,29,21,0.7,0,48,97,2.0,2,2,1,5,4,19,1,1,2
1506,2014,10,2014-11-15,Eastern Michigan,@,Western Michigan,L (7-51),14,22,63.6,283,1,37,87,2.4,0,59,370,6.3,10,4,0,14,8,70,1,2,3
1507,2014,11,2014-11-22,Eastern Michigan,@,Ball State,L (30-45),36,49,73.5,409,3,36,94,2.6,0,85,503,5.9,16,13,1,30,6,46,3,0,3
1508,2014,12,2014-11-28,Eastern Michigan,,Toledo,L (16-52),8,23,34.8,119,2,34,96,2.8,0,57,215,3.8,6,4,2,12,2,14,0,2,2
1509,2014,,12 Games,Eastern Michigan,,,,167,320,52.2,1821,13,459,1654,3.6,9,779,3475,4.5,79,98,12,189,69,598,19,11,30
1510,2015,1,2015-09-05,Eastern Michigan,,Old Dominion,L (34-38),22,36,61.1,192,2,47,252,5.4,2,83,444,5.3,11,13,3,27,7,78,1,2,3
1511,2015,2,2015-09-12,Eastern Michigan,@,Wyoming,W (48-29),18,25,72.0,330,3,37,176,4.8,3,62,506,8.2,12,8,1,21,4,45,0,0,0
1512,2015,3,2015-09-19,Eastern Michigan,,Ball State,L (17-28),19,39,48.7,196,0,22,123,5.6,2,61,319,5.2,8,4,0,12,4,45,0,2,2
1513,2015,4,2015-09-26,Eastern Michigan,,Army,L (36-58),27,39,69.2,280,2,25,193,7.7,3,64,473,7.4,16,7,1,24,10,77,1,1,2
1514,2015,5,2015-10-03,Eastern Michigan,@,Louisiana State,L (22-44),17,24,70.8,161,1,33,94,2.8,2,57,255,4.5,8,7,1,16,7,70,0,3,3
1515,2015,6,2015-10-10,Eastern Michigan,,Akron,L (21-47),24,35,68.6,252,3,31,161,5.2,0,66,413,6.3,9,9,2,20,9,90,2,1,3
1516,2015,7,2015-10-17,Eastern Michigan,@,Toledo,L (20-63),23,37,62.2,176,0,48,282,5.9,2,85,458,5.4,8,14,1,23,6,45,1,1,2
1517,2015,8,2015-10-24,Eastern Michigan,@,Northern Illinois,L (21-49),26,43,60.5,219,0,44,157,3.6,3,87,376,4.3,11,14,1,26,7,75,0,1,1
1518,2015,9,2015-10-29,Eastern Michigan,,Western Michigan,L (28-58),18,30,60.0,263,3,39,226,5.8,1,69,489,7.1,13,12,1,26,3,20,2,2,4
1519,2015,10,2015-11-07,Eastern Michigan,@,Miami (OH),L (13-28),7,20,35.0,89,0,39,103,2.6,1,59,192,3.3,5,5,0,10,9,54,1,1,2
1520,2015,11,2015-11-14,Eastern Michigan,,Massachusetts,L (17-28),27,43,62.8,256,2,26,59,2.3,0,69,315,4.6,16,4,3,23,6,47,1,0,1
1521,2015,12,2015-11-27,Eastern Michigan,@,Central Michigan,L (28-35),19,36,52.8,217,2,32,113,3.5,1,68,330,4.9,7,5,2,14,9,55,2,0,2
1522,2015,,12 Games,Eastern Michigan,,,,247,407,60.7,2631,18,423,1939,4.6,20,830,4570,5.5,124,102,16,242,81,701,11,14,25
1523,2016,1,2016-09-02,Eastern Michigan,,Mississippi Valley State,W (61-14),17,24,70.8,198,3,44,281,6.4,5,68,479,7.0,9,14,1,24,6,68,0,1,1
1524,2016,2,2016-09-10,Eastern Michigan,@,Missouri,L (21-61),23,45,51.1,287,1,46,141,3.1,2,91,428,4.7,12,7,2,21,8,61,0,2,2
1525,2016,3,2016-09-17,Eastern Michigan,@,UNC Charlotte,W (37-19),24,31,77.4,285,2,30,72,2.4,1,61,357,5.9,13,4,0,17,7,90,0,1,1
1526,2016,4,2016-09-23,Eastern Michigan,,Wyoming,W (27-24),17,34,50.0,261,1,47,239,5.1,2,81,500,6.2,10,13,1,24,5,55,0,4,4
1527,2016,5,2016-10-01,Eastern Michigan,@,Bowling Green State,W (28-25),21,30,70.0,262,3,45,212,4.7,1,75,474,6.3,8,13,3,24,5,56,1,1,2
1528,2016,6,2016-10-08,Eastern Michigan,,Toledo,L (20-35),20,38,52.6,255,1,20,62,3.1,1,58,317,5.5,11,4,1,16,5,51,1,1,2
1529,2016,7,2016-10-15,Eastern Michigan,@,Ohio,W (27-20),29,39,74.4,347,3,32,88,2.8,0,71,435,6.1,12,8,0,20,5,55,1,0,1
1530,2016,8,2016-10-22,Eastern Michigan,@,Western Michigan,L (31-45),29,45,64.4,319,1,30,142,4.7,3,75,461,6.1,17,5,1,23,7,50,1,1,2
1531,2016,9,2016-10-29,Eastern Michigan,,Miami (OH),L (15-28),23,39,59.0,328,2,23,33,1.4,0,62,361,5.8,13,3,0,16,7,67,0,1,1
1532,2016,10,2016-11-08,Eastern Michigan,@,Ball State,W (48-41),37,72,51.4,468,3,37,154,4.2,3,109,622,5.7,23,10,2,35,4,30,2,1,3
1533,2016,11,2016-11-16,Eastern Michigan,,Northern Illinois,L (24-31),17,38,44.7,184,1,56,291,5.2,2,94,475,5.1,9,18,5,32,7,68,0,2,2
1534,2016,12,2016-11-22,Eastern Michigan,,Central Michigan,W (26-21),26,37,70.3,355,2,32,183,5.7,1,69,538,7.8,14,8,1,23,7,75,0,1,1
1535,2016,13,2016-12-23,Eastern Michigan,N,Old Dominion*,L (20-24),26,47,55.3,300,2,38,170,4.5,0,85,470,5.5,16,8,4,28,3,15,0,1,1
1536,2016,,13 Games,Eastern Michigan,,,,309,519,59.5,3849,25,480,2068,4.3,21,999,5917,5.9,167,115,21,303,76,741,6,17,23
1537,2017,1,2017-09-01,Eastern Michigan,,UNC Charlotte,W (24-7),22,31,71.0,267,0,41,126,3.1,2,72,393,5.5,10,8,1,19,10,70,1,1,2
1538,2017,2,2017-09-09,Eastern Michigan,@,Rutgers,W (16-13),19,37,51.4,260,1,35,114,3.3,0,72,374,5.2,13,4,2,19,9,93,1,0,1
1539,2017,3,2017-09-23,Eastern Michigan,,Ohio,L (20-27),29,49,59.2,305,1,27,45,1.7,1,76,350,4.6,12,3,0,15,8,85,0,1,1
1540,2017,4,2017-09-30,Eastern Michigan,@,Kentucky,L (20-24),27,47,57.4,299,2,27,13,0.5,1,74,312,4.2,17,2,1,20,5,50,1,2,3
1541,2017,5,2017-10-07,Eastern Michigan,@,Toledo,L (15-20),24,40,60.0,253,2,23,73,3.2,0,63,326,5.2,13,6,2,21,7,86,0,2,2
1542,2017,6,2017-10-14,Eastern Michigan,@,Army,L (27-28),19,27,70.4,229,4,26,135,5.2,0,53,364,6.9,13,7,1,21,6,34,0,1,1
1543,2017,7,2017-10-21,Eastern Michigan,,Western Michigan,L (17-20),28,44,63.6,308,1,38,153,4.0,1,82,461,5.6,14,10,3,27,8,65,2,1,3
1544,2017,8,2017-10-26,Eastern Michigan,@,Northern Illinois,L (27-30),23,45,51.1,307,2,33,96,2.9,0,78,403,5.2,11,2,2,15,6,69,0,0,0
1545,2017,9,2017-11-02,Eastern Michigan,,Ball State,W (56-14),15,22,68.2,263,3,40,225,5.6,4,62,488,7.9,12,10,2,24,3,30,1,0,1
1546,2017,10,2017-11-08,Eastern Michigan,@,Central Michigan,L (30-42),23,39,59.0,204,2,36,124,3.4,1,75,328,4.4,9,10,3,22,4,25,0,5,5
1547,2017,11,2017-11-15,Eastern Michigan,@,Miami (OH),W (27-24),15,27,55.6,269,2,40,196,4.9,1,67,465,6.9,9,7,2,18,4,28,1,1,2
1548,2017,12,2017-11-21,Eastern Michigan,,Bowling Green State,W (34-31),13,27,48.1,124,1,53,266,5.0,3,80,390,4.9,7,15,0,22,4,55,0,1,1
1549,2017,,12 Games,Eastern Michigan,,,,257,435,59.1,3088,21,419,1566,3.7,14,854,4654,5.4,140,84,19,243,74,690,7,15,22
1550,2014,1,2014-09-06,Florida,,Eastern Michigan,W (65-0),33,47,70.2,396,3,39,259,6.6,4,86,655,7.6,12,13,2,27,10,100,0,0,0
1551,2014,2,2014-09-13,Florida,,Kentucky,W (36-30),25,44,56.8,295,3,50,237,4.7,1,94,532,5.7,13,14,1,28,8,78,0,1,1
1552,2014,3,2014-09-20,Florida,@,Alabama,L (21-42),9,28,32.1,93,1,27,107,4.0,1,55,200,3.6,5,5,1,11,5,36,1,2,3
1553,2014,4,2014-10-04,Florida,@,Tennessee,W (10-9),13,27,48.1,76,0,48,156,3.3,1,75,232,3.1,5,11,0,16,5,45,0,3,3
1554,2014,5,2014-10-11,Florida,,Louisiana State,L (27-30),14,25,56.0,183,1,32,123,3.8,1,57,306,5.4,4,8,1,13,4,34,1,2,3
1555,2014,6,2014-10-18,Florida,,Missouri,L (13-42),15,31,48.4,148,1,48,135,2.8,1,79,283,3.6,7,8,2,17,3,39,3,3,6
1556,2014,7,2014-11-01,Florida,N,Georgia,W (38-20),3,6,50.0,27,0,60,418,7.0,5,66,445,6.7,2,16,1,19,4,31,1,0,1
1557,2014,8,2014-11-08,Florida,@,Vanderbilt,W (34-10),13,22,59.1,215,0,50,214,4.3,4,72,429,6.0,10,9,0,19,10,82,0,0,0
1558,2014,9,2014-11-15,Florida,,South Carolina,L (20-23),5,11,45.5,60,1,49,218,4.4,1,60,278,4.6,2,10,3,15,10,75,1,0,1
1559,2014,10,2014-11-22,Florida,,Eastern Kentucky,W (52-3),13,23,56.5,326,5,38,104,2.7,2,61,430,7.0,11,6,0,17,5,45,1,0,1
1560,2014,11,2014-11-29,Florida,@,Florida State,L (19-24),13,32,40.6,169,1,33,113,3.4,0,65,282,4.3,9,3,1,13,10,105,0,2,2
1561,2014,12,2015-01-03,Florida,N,East Carolina*,W (28-20),13,28,46.4,171,2,43,168,3.9,1,71,339,4.8,6,8,1,15,6,40,2,1,3
1562,2014,,12 Games,Florida,,,,169,324,52.2,2159,18,517,2252,4.4,22,841,4411,5.2,86,111,13,210,80,710,10,14,24
1563,2015,1,2015-09-05,Florida,,New Mexico State,W (61-13),30,37,81.1,382,4,42,224,5.3,4,79,606,7.7,18,10,0,28,1,10,1,0,1
1564,2015,2,2015-09-12,Florida,,East Carolina,W (31-24),15,25,60.0,205,2,38,168,4.4,1,63,373,5.9,8,8,1,17,12,105,1,1,2
1565,2015,3,2015-09-19,Florida,@,Kentucky,W (14-9),13,22,59.1,125,0,37,120,3.2,2,59,245,4.2,7,8,1,16,10,61,0,1,1
1566,2015,4,2015-09-26,Florida,,Tennessee,W (28-27),23,43,53.5,283,2,28,109,3.9,2,71,392,5.5,13,4,0,17,4,25,0,1,1
1567,2015,5,2015-10-03,Florida,,Mississippi,W (38-10),24,29,82.8,271,4,34,84,2.5,1,63,355,5.6,13,4,1,18,6,51,0,0,0
1568,2015,6,2015-10-10,Florida,@,Missouri,W (21-3),20,33,60.6,208,0,44,129,2.9,2,77,337,4.4,13,7,3,23,4,30,0,0,0
1569,2015,7,2015-10-17,Florida,@,Louisiana State,L (28-35),17,32,53.1,271,2,31,55,1.8,1,63,326,5.2,10,5,0,15,6,45,0,0,0
1570,2015,8,2015-10-31,Florida,N,Georgia,W (27-3),8,19,42.1,155,1,48,258,5.4,2,67,413,6.2,4,11,0,15,8,74,1,0,1
1571,2015,9,2015-11-07,Florida,,Vanderbilt,W (9-7),13,26,50.0,165,0,34,93,2.7,1,60,258,4.3,7,5,0,12,8,61,3,1,4
1572,2015,10,2015-11-14,Florida,@,South Carolina,W (24-14),19,33,57.6,256,1,43,148,3.4,2,76,404,5.3,12,7,1,20,8,55,0,2,2
1573,2015,11,2015-11-21,Florida,,Florida Atlantic,W (20-14),8,17,47.1,122,2,43,143,3.3,1,60,265,4.4,6,6,1,13,5,43,1,1,2
1574,2015,12,2015-11-28,Florida,,Florida State,L (2-27),19,39,48.7,134,0,40,128,3.2,0,79,262,3.3,5,13,1,19,7,60,0,0,0
1575,2015,13,2015-12-05,Florida,N,Alabama,L (15-29),9,24,37.5,165,1,21,15,0.7,0,45,180,4.0,6,1,0,7,5,51,0,1,1
1576,2015,14,2016-01-01,Florida,N,Michigan*,L (7-41),10,25,40.0,155,1,27,118,4.4,0,52,273,5.3,7,7,0,14,7,66,0,2,2
1577,2015,,14 Games,Florida,,,,228,404,56.4,2897,20,510,1792,3.5,19,914,4689,5.1,129,96,9,234,91,737,7,10,17
1578,2016,1,2016-09-03,Florida,,Massachusetts,W (24-7),29,44,65.9,256,2,29,107,3.7,0,73,363,5.0,14,7,0,21,8,80,0,0,0
1579,2016,2,2016-09-10,Florida,,Kentucky,W (45-7),19,33,57.6,320,4,50,244,4.9,2,83,564,6.8,15,13,0,28,6,75,0,1,1
1580,2016,3,2016-09-17,Florida,,North Texas,W (32-0),16,29,55.2,216,0,43,255,5.9,4,72,471,6.5,10,11,5,26,11,97,0,1,1
1581,2016,4,2016-09-24,Florida,@,Tennessee,L (28-38),23,39,59.0,296,3,31,106,3.4,1,70,402,5.7,10,6,1,17,9,75,1,1,2
1582,2016,5,2016-10-01,Florida,@,Vanderbilt,W (13-6),19,28,67.9,144,0,35,92,2.6,1,63,236,3.7,7,6,2,15,4,45,1,0,1
1583,2016,6,2016-10-15,Florida,,Missouri,W (40-14),18,38,47.4,236,1,39,287,7.4,1,77,523,6.8,12,10,0,22,11,65,1,3,4
1584,2016,7,2016-10-29,Florida,N,Georgia,W (24-10),15,25,60.0,131,1,48,100,2.1,2,73,231,3.2,8,9,3,20,6,45,0,1,1
1585,2016,8,2016-11-05,Florida,@,Arkansas,L (10-31),19,37,51.4,229,0,14,12,0.9,0,51,241,4.7,11,1,1,13,3,34,0,2,2
1586,2016,9,2016-11-12,Florida,,South Carolina,W (20-7),17,21,81.0,201,2,37,171,4.6,0,58,372,6.4,11,7,0,18,10,80,2,1,3
1587,2016,10,2016-11-19,Florida,@,Louisiana State,W (16-10),7,17,41.2,144,1,35,126,3.6,0,52,270,5.2,3,10,1,14,1,5,0,0,0
1588,2016,11,2016-11-26,Florida,@,Florida State,L (13-31),19,35,54.3,149,0,29,58,2.0,0,64,207,3.2,6,7,1,14,4,44,2,0,2
1589,2016,12,2016-12-03,Florida,N,Alabama,L (16-54),26,39,66.7,261,2,30,0,0.0,0,69,261,3.8,13,2,1,16,7,53,0,3,3
1590,2016,13,2017-01-02,Florida,N,Iowa*,W (30-3),14,25,56.0,222,2,32,109,3.4,0,57,331,5.8,5,6,0,11,8,60,0,2,2
1591,2016,,13 Games,Florida,,,,241,410,58.8,2805,18,452,1667,3.7,11,862,4472,5.2,125,95,15,235,88,758,7,15,22
1592,2017,1,2017-09-02,Florida,N,Michigan,L (17-33),14,26,53.8,181,0,27,11,0.4,0,53,192,3.6,6,2,1,9,5,45,3,0,3
1593,2017,2,2017-09-16,Florida,,Tennessee,W (26-20),18,28,64.3,212,2,29,168,5.8,0,57,380,6.7,8,6,0,14,8,38,2,1,3
1594,2017,3,2017-09-23,Florida,@,Kentucky,W (28-27),17,27,63.0,209,2,36,186,5.2,2,63,395,6.3,10,9,1,20,8,72,0,1,1
1595,2017,4,2017-09-30,Florida,,Vanderbilt,W (38-24),17,26,65.4,249,0,51,218,4.3,5,77,467,6.1,9,11,3,23,9,64,0,0,0
1596,2017,5,2017-10-07,Florida,,Louisiana State,L (16-17),10,16,62.5,108,0,38,194,5.1,2,54,302,5.6,6,8,2,16,6,48,0,0,0
1597,2017,6,2017-10-14,Florida,,Texas A&M,L (17-19),18,27,66.7,135,1,41,236,5.8,1,68,371,5.5,6,11,0,17,6,44,0,2,2
1598,2017,7,2017-10-28,Florida,N,Georgia,L (7-42),10,25,40.0,66,0,41,183,4.5,1,66,249,3.8,6,9,0,15,14,85,1,1,2
1599,2017,8,2017-11-04,Florida,@,Missouri,L (16-45),20,29,69.0,256,1,31,93,3.0,0,60,349,5.8,12,3,2,17,11,84,1,1,2
1600,2017,9,2017-11-11,Florida,@,South Carolina,L (20-28),17,39,43.6,223,0,22,78,3.5,2,61,301,4.9,8,3,1,12,10,56,2,1,3
1601,2017,10,2017-11-18,Florida,,Alabama-Birmingham,W (36-7),15,30,50.0,152,2,50,257,5.1,1,80,409,5.1,11,14,0,25,6,60,0,0,0
1602,2017,11,2017-11-25,Florida,,Florida State,L (22-38),18,39,46.2,184,2,34,96,2.8,1,73,280,3.8,10,7,0,17,4,50,1,3,4
1603,2017,,11 Games,Florida,,,,174,312,55.8,1975,10,400,1720,4.3,15,712,3695,5.2,92,83,10,185,87,646,10,10,20
1604,2016,1,2016-09-03,Florida A&M,@,Miami (FL),L (3-70),15,27,55.6,175,0,42,22,0.5,0,69,197,2.9,8,3,2,13,9,84,0,2,2
1605,2017,1,2017-08-31,Florida A&M,N,Arkansas,L (7-49),14,29,48.3,95,1,31,80,2.6,0,60,175,2.9,3,6,0,9,7,55,1,0,1
1606,2014,1,2014-08-30,Florida Atlantic,@,Nebraska,L (7-55),11,30,36.7,95,1,30,105,3.5,0,60,200,3.3,5,7,1,13,3,22,0,0,0
1607,2014,2,2014-09-06,Florida Atlantic,@,Alabama,L (0-41),12,19,63.2,88,0,24,57,2.4,0,43,145,3.4,4,3,2,9,3,23,1,0,1
1608,2014,3,2014-09-13,Florida Atlantic,,Tulsa,W (50-21),18,23,78.3,341,4,42,177,4.2,1,65,518,8.0,11,7,0,18,4,37,0,0,0
1609,2014,4,2014-09-20,Florida Atlantic,@,Wyoming,L (19-20),15,29,51.7,108,0,39,188,4.8,1,68,296,4.4,5,10,1,16,4,23,3,0,3
1610,2014,5,2014-09-27,Florida Atlantic,,Texas-San Antonio,W (41-37),24,34,70.6,295,3,33,114,3.5,2,67,409,6.1,14,9,2,25,5,52,2,0,2
1611,2014,6,2014-10-02,Florida Atlantic,@,Florida International,L (10-38),19,42,45.2,225,0,30,158,5.3,1,72,383,5.3,13,7,2,22,4,40,3,1,4
1612,2014,7,2014-10-18,Florida Atlantic,,Western Kentucky,W (45-38),24,35,68.6,341,3,54,278,5.1,3,89,619,7.0,18,10,1,29,6,59,1,0,1
1613,2014,8,2014-10-25,Florida Atlantic,@,Marshall,L (16-35),19,37,51.4,179,1,53,209,3.9,0,90,388,4.3,10,15,1,26,3,45,0,0,0
1614,2014,9,2014-11-01,Florida Atlantic,,Alabama-Birmingham,L (28-31),18,31,58.1,177,3,29,145,5.0,1,60,322,5.4,8,7,1,16,3,30,1,1,2
1615,2014,10,2014-11-08,Florida Atlantic,@,North Texas,L (10-31),15,31,48.4,102,1,32,95,3.0,0,63,197,3.1,4,7,1,12,7,55,1,1,2
1616,2014,11,2014-11-22,Florida Atlantic,@,Middle Tennessee State,L (34-35),22,35,62.9,310,2,41,230,5.6,2,76,540,7.1,11,9,0,20,2,19,0,2,2
1617,2014,12,2014-11-29,Florida Atlantic,,Old Dominion,L (28-31),9,19,47.4,133,0,36,207,5.8,3,55,340,6.2,5,9,0,14,7,69,1,0,1
1618,2014,,12 Games,Florida Atlantic,,,,206,365,56.4,2394,18,443,1963,4.4,14,808,4357,5.4,108,100,12,220,51,474,13,5,18
1619,2015,1,2015-09-05,Florida Atlantic,@,Tulsa,L (44-47),23,35,65.7,263,2,61,300,4.9,3,96,563,5.9,11,19,0,30,13,130,0,0,0
1620,2015,2,2015-09-11,Florida Atlantic,,Miami (FL),L (20-44),19,34,55.9,166,1,33,223,6.8,1,67,389,5.8,8,12,2,22,8,71,3,2,5
1621,2015,3,2015-09-19,Florida Atlantic,,Buffalo,L (15-33),26,56,46.4,385,2,34,105,3.1,0,90,490,5.4,15,9,3,27,5,35,3,2,5
1622,2015,4,2015-09-26,Florida Atlantic,@,UNC Charlotte,W (17-7),14,25,56.0,144,0,48,40,0.8,1,73,184,2.5,8,3,2,13,6,44,3,2,5
1623,2015,5,2015-10-10,Florida Atlantic,,Rice,L (26-27),15,29,51.7,249,2,32,142,4.4,1,61,391,6.4,9,5,5,19,5,50,0,0,0
1624,2015,6,2015-10-17,Florida Atlantic,,Marshall,L (17-33),14,31,45.2,203,0,34,131,3.9,1,65,334,5.1,8,9,0,17,5,30,0,1,1
1625,2015,7,2015-10-24,Florida Atlantic,@,Texas-El Paso,L (17-27),14,23,60.9,219,0,30,146,4.9,2,53,365,6.9,10,2,3,15,5,60,2,1,3
1626,2015,8,2015-10-31,Florida Atlantic,,Florida International,W (31-17),16,25,64.0,168,0,49,229,4.7,3,74,397,5.4,9,17,1,27,6,60,0,0,0
1627,2015,9,2015-11-07,Florida Atlantic,@,Western Kentucky,L (19-35),14,33,42.4,185,2,43,174,4.0,0,76,359,4.7,9,11,3,23,3,24,0,0,0
1628,2015,10,2015-11-14,Florida Atlantic,,Middle Tennessee State,L (17-24),13,27,48.1,222,2,34,75,2.2,0,61,297,4.9,8,5,1,14,6,63,0,1,1
1629,2015,11,2015-11-21,Florida Atlantic,@,Florida,L (14-20),20,39,51.3,159,1,45,140,3.1,0,84,299,3.6,6,11,1,18,7,55,2,1,3
1630,2015,12,2015-11-28,Florida Atlantic,@,Old Dominion,W (33-31),17,35,48.6,188,0,54,248,4.6,3,89,436,4.9,11,11,1,23,6,64,0,2,2
1631,2015,,12 Games,Florida Atlantic,,,,205,392,52.3,2551,12,497,1953,3.9,15,889,4504,5.1,112,114,22,248,75,686,13,12,25
1632,2016,1,2016-09-03,Florida Atlantic,,Southern Illinois,W (38-30),23,31,74.2,282,2,45,170,3.8,3,76,452,5.9,9,8,2,19,5,45,0,0,0
1633,2016,2,2016-09-10,Florida Atlantic,@,Miami (FL),L (10-38),18,37,48.6,167,0,34,47,1.4,1,71,214,3.0,7,4,2,13,6,45,0,1,1
1634,2016,3,2016-09-17,Florida Atlantic,@,Kansas State,L (7-63),15,28,53.6,129,0,37,82,2.2,1,65,211,3.2,4,8,1,13,10,93,2,2,4
1635,2016,4,2016-09-24,Florida Atlantic,,Ball State,L (27-31),25,37,67.6,324,1,36,121,3.4,2,73,445,6.1,12,8,0,20,2,20,1,1,2
1636,2016,5,2016-10-01,Florida Atlantic,@,Florida International,L (31-33),9,21,42.9,92,1,36,236,6.6,2,57,328,5.8,5,12,0,17,4,35,1,0,1
1637,2016,6,2016-10-09,Florida Atlantic,,UNC Charlotte,L (23-28),22,42,52.4,212,0,41,174,4.2,3,83,386,4.7,13,11,2,26,3,25,0,1,1
1638,2016,7,2016-10-15,Florida Atlantic,@,Marshall,L (21-27),11,20,55.0,175,0,45,281,6.2,3,65,456,7.0,7,16,1,24,5,65,1,1,2
1639,2016,8,2016-10-29,Florida Atlantic,,Western Kentucky,L (3-52),15,34,44.1,77,0,33,125,3.8,0,67,202,3.0,4,6,2,12,1,10,1,1,2
1640,2016,9,2016-11-05,Florida Atlantic,@,Rice,W (42-25),16,26,61.5,321,2,40,340,8.5,4,66,661,10.0,10,15,1,26,13,122,0,0,0
1641,2016,10,2016-11-12,Florida Atlantic,,Texas-El Paso,W (35-31),20,27,74.1,233,1,36,243,6.8,3,63,476,7.6,11,13,2,26,5,45,1,2,3
1642,2016,11,2016-11-19,Florida Atlantic,,Old Dominion,L (24-42),15,28,53.6,219,0,34,144,4.2,3,62,363,5.9,10,6,0,16,8,62,0,0,0
1643,2016,12,2016-11-26,Florida Atlantic,@,Middle Tennessee State,L (56-77),26,35,74.3,290,2,53,299,5.6,6,88,589,6.7,17,17,1,35,1,10,0,4,4
1644,2016,,12 Games,Florida Atlantic,,,,215,366,58.7,2521,9,470,2262,4.8,31,836,4783,5.7,109,124,14,247,63,577,7,13,20
1645,2017,1,2017-09-01,Florida Atlantic,,Navy,L (19-42),21,33,63.6,286,2,24,40,1.7,0,57,326,5.7,8,7,1,16,4,20,0,2,2
1646,2017,2,2017-09-09,Florida Atlantic,@,Wisconsin,L (14-31),9,19,47.4,142,1,35,106,3.0,1,54,248,4.6,4,5,0,9,8,73,0,0,0
1647,2017,3,2017-09-16,Florida Atlantic,,Bethune-Cookman,W (45-0),19,32,59.4,180,1,58,439,7.6,4,90,619,6.9,6,22,4,32,8,83,1,1,2
1648,2017,4,2017-09-23,Florida Atlantic,@,Buffalo,L (31-34),17,29,58.6,150,0,37,262,7.1,4,66,412,6.2,7,15,0,22,8,65,0,1,1
1649,2017,5,2017-09-30,Florida Atlantic,,Middle Tennessee State,W (38-20),22,29,75.9,187,1,50,252,5.0,4,79,439,5.6,10,17,2,29,4,27,0,0,0
1650,2017,6,2017-10-07,Florida Atlantic,@,Old Dominion,W (58-28),13,22,59.1,97,0,69,453,6.6,8,91,550,6.0,5,23,1,29,5,65,1,1,2
1651,2017,7,2017-10-21,Florida Atlantic,,North Texas,W (69-31),24,35,68.6,357,2,48,447,9.3,7,83,804,9.7,16,18,3,37,5,39,0,0,0
1652,2017,8,2017-10-28,Florida Atlantic,@,Western Kentucky,W (42-28),10,24,41.7,93,1,55,368,6.7,4,79,461,5.8,3,17,1,21,9,75,0,1,1
1653,2017,9,2017-11-03,Florida Atlantic,,Marshall,W (30-25),12,18,66.7,164,1,45,189,4.2,3,63,353,5.6,6,11,0,17,5,60,0,0,0
1654,2017,10,2017-11-11,Florida Atlantic,@,Louisiana Tech,W (48-23),14,17,82.4,221,2,33,194,5.9,4,50,415,8.3,7,11,1,19,2,22,1,0,1
1655,2017,11,2017-11-18,Florida Atlantic,,Florida International,W (52-24),18,25,72.0,239,4,46,333,7.2,3,71,572,8.1,9,16,2,27,8,64,0,1,1
1656,2017,12,2017-11-25,Florida Atlantic,@,UNC Charlotte,W (31-12),18,22,81.8,245,2,63,316,5.0,2,85,561,6.6,11,19,1,31,1,15,2,0,2
1657,2017,13,2017-12-02,Florida Atlantic,,North Texas,W (41-17),18,30,60.0,352,2,42,281,6.7,3,72,633,8.8,11,9,2,22,9,73,1,0,1
1658,2017,14,2017-12-19,Florida Atlantic,,Akron*,W (50-3),19,26,73.1,270,2,60,312,5.2,5,86,582,6.8,8,19,2,29,6,52,0,0,0
1659,2017,,14 Games,Florida Atlantic,,,,234,361,64.8,2983,21,665,3992,6.0,52,1026,6975,6.8,111,209,20,340,82,733,6,7,13
1660,2014,1,2014-08-30,Florida International,,Bethune-Cookman,L (12-14),16,33,48.5,143,1,32,43,1.3,0,65,186,2.9,5,4,3,12,8,47,0,0,0
1661,2014,2,2014-09-06,Florida International,,Wagner,W (34-3),23,33,69.7,229,2,34,148,4.4,1,67,377,5.6,9,7,3,19,9,70,3,0,3
1662,2014,3,2014-09-13,Florida International,,Pittsburgh,L (25-42),17,35,48.6,236,2,33,57,1.7,1,68,293,4.3,9,7,1,17,8,68,1,0,1
1663,2014,4,2014-09-20,Florida International,,Louisville,L (3-34),13,26,50.0,117,0,40,88,2.2,0,66,205,3.1,4,7,1,12,6,60,1,2,3
1664,2014,5,2014-09-27,Florida International,@,Alabama-Birmingham,W (34-20),9,24,37.5,204,2,37,93,2.5,0,61,297,4.9,5,4,0,9,10,65,0,0,0
1665,2014,6,2014-10-02,Florida International,,Florida Atlantic,W (38-10),18,29,62.1,160,0,41,185,4.5,4,70,345,4.9,7,13,0,20,8,51,1,0,1
1666,2014,7,2014-10-11,Florida International,@,Texas-San Antonio,L (13-16),11,26,42.3,141,1,47,118,2.5,0,73,259,3.5,8,9,3,20,6,30,3,2,5
1667,2014,8,2014-10-18,Florida International,,Marshall,L (13-45),18,32,56.3,208,1,53,177,3.3,1,85,385,4.5,12,10,1,23,8,88,0,2,2
1668,2014,9,2014-11-01,Florida International,,Rice,L (17-31),10,23,43.5,159,1,46,102,2.2,1,69,261,3.8,5,9,0,14,5,30,2,0,2
1669,2014,10,2014-11-08,Florida International,@,Old Dominion,L (35-38),8,13,61.5,132,2,55,256,4.7,2,68,388,5.7,4,17,0,21,6,59,0,1,1
1670,2014,11,2014-11-15,Florida International,,Middle Tennessee State,W (38-28),17,24,70.8,231,3,40,144,3.6,1,64,375,5.9,9,7,1,17,3,25,1,0,1
1671,2014,12,2014-11-22,Florida International,@,North Texas,L (14-17),11,25,44.0,56,0,30,91,3.0,0,55,147,2.7,5,6,1,12,7,80,0,3,3
1672,2014,,12 Games,Florida International,,,,171,323,52.9,2016,15,488,1502,3.1,11,811,3518,4.3,82,100,14,196,84,673,12,10,22
1673,2015,1,2015-09-03,Florida International,@,Central Florida,W (15-14),29,38,76.3,260,1,31,131,4.2,1,69,391,5.7,11,6,0,17,7,45,1,0,1
1674,2015,2,2015-09-12,Florida International,@,Indiana,L (22-36),24,47,51.1,283,3,33,123,3.7,0,80,406,5.1,12,7,5,24,8,54,2,1,3
1675,2015,3,2015-09-19,Florida International,,North Carolina Central,W (39-14),22,36,61.1,242,3,46,248,5.4,2,82,490,6.0,8,13,0,21,6,60,1,1,2
1676,2015,4,2015-09-26,Florida International,@,Louisiana Tech,L (17-27),29,44,65.9,263,1,23,45,2.0,0,67,308,4.6,14,4,0,18,7,55,0,0,0
1677,2015,5,2015-10-03,Florida International,@,Massachusetts,L (14-24),22,34,64.7,115,1,29,73,2.5,1,63,188,3.0,6,5,2,13,10,111,0,0,0
1678,2015,6,2015-10-10,Florida International,,Texas-El Paso,W (52-12),15,22,68.2,368,3,31,150,4.8,3,53,518,9.8,14,7,1,22,5,38,0,0,0
1679,2015,7,2015-10-17,Florida International,@,Middle Tennessee State,L (34-42),29,51,56.9,260,2,30,86,2.9,2,81,346,4.3,16,5,4,25,3,20,0,1,1
1680,2015,8,2015-10-24,Florida International,,Old Dominion,W (41-12),31,39,79.5,390,3,33,58,1.8,2,72,448,6.2,13,6,1,20,3,30,1,0,1
1681,2015,9,2015-10-31,Florida International,@,Florida Atlantic,L (17-31),19,27,70.4,196,1,32,66,2.1,1,59,262,4.4,8,9,3,20,5,38,1,1,2
1682,2015,10,2015-11-07,Florida International,,UNC Charlotte,W (48-31),27,42,64.3,284,3,32,155,4.8,2,74,439,5.9,13,9,2,24,6,55,0,1,1
1683,2015,11,2015-11-14,Florida International,@,Marshall,L (0-52),11,27,40.7,98,0,36,111,3.1,0,63,209,3.3,3,9,1,13,5,55,0,1,1
1684,2015,12,2015-11-21,Florida International,,Western Kentucky,L (7-63),17,33,51.5,95,0,29,73,2.5,1,62,168,2.7,2,5,3,10,4,33,1,2,3
1685,2015,,12 Games,Florida International,,,,275,440,62.5,2854,21,385,1319,3.4,15,825,4173,5.1,120,85,22,227,69,594,7,8,15
1686,2016,1,2016-09-01,Florida International,,Indiana,L (13-34),24,47,51.1,268,0,21,63,3.0,1,68,331,4.9,12,2,2,16,6,36,0,3,3
1687,2016,2,2016-09-09,Florida International,,Maryland,L (14-41),14,28,50.0,170,1,40,202,5.1,1,68,372,5.5,7,7,2,16,9,90,0,1,1
1688,2016,3,2016-09-17,Florida International,@,Massachusetts,L (13-21),20,34,58.8,178,0,34,137,4.0,1,68,315,4.6,8,7,4,19,10,95,2,0,2
1689,2016,4,2016-09-24,Florida International,,Central Florida,L (14-53),11,24,45.8,109,1,34,80,2.4,1,58,189,3.3,5,5,1,11,5,55,0,1,1
1690,2016,5,2016-10-01,Florida International,,Florida Atlantic,W (33-31),15,30,50.0,199,1,49,270,5.5,3,79,469,5.9,9,14,2,25,1,5,0,2,2
1691,2016,6,2016-10-08,Florida International,@,Texas-El Paso,W (35-21),21,31,67.7,241,3,44,258,5.9,1,75,499,6.7,10,12,1,23,6,57,0,1,1
1692,2016,7,2016-10-15,Florida International,@,UNC Charlotte,W (27-26),26,42,61.9,315,2,21,39,1.9,1,63,354,5.6,15,1,3,19,5,55,1,2,3
1693,2016,8,2016-10-22,Florida International,,Louisiana Tech,L (24-44),29,49,59.2,331,3,29,67,2.3,0,78,398,5.1,18,5,1,24,7,49,0,1,1
1694,2016,9,2016-10-29,Florida International,,Middle Tennessee State,L (35-42),27,40,67.5,307,3,44,210,4.8,2,84,517,6.2,15,11,0,26,3,25,2,1,3
1695,2016,10,2016-11-05,Florida International,@,Western Kentucky,L (21-49),22,34,64.7,210,2,30,101,3.4,1,64,311,4.9,13,4,0,17,4,30,1,2,3
1696,2016,11,2016-11-19,Florida International,,Marshall,W (31-14),18,25,72.0,257,1,41,259,6.3,3,66,516,7.8,12,13,1,26,5,45,0,2,2
1697,2016,12,2016-11-26,Florida International,@,Old Dominion,L (28-42),11,23,47.8,135,2,36,97,2.7,1,59,232,3.9,5,10,1,16,3,42,0,1,1
1698,2016,,12 Games,Florida International,,,,238,407,58.5,2720,19,423,1783,4.2,16,830,4503,5.4,129,91,18,238,64,584,6,17,23
1699,2017,1,2017-08-31,Florida International,@,Central Florida,L (17-61),18,31,58.1,201,1,26,134,5.2,1,57,335,5.9,8,5,0,13,14,163,3,1,4
1700,2017,2,2017-09-08,Florida International,N,Alcorn State,W (17-10),21,33,63.6,328,0,40,137,3.4,2,73,465,6.4,15,9,2,26,5,30,1,0,1
1701,2017,3,2017-09-23,Florida International,@,Rice,W (13-7),17,28,60.7,172,1,33,99,3.0,0,61,271,4.4,10,7,1,18,5,57,0,1,1
1702,2017,4,2017-09-30,Florida International,,UNC Charlotte,W (30-29),15,27,55.6,241,2,41,234,5.7,2,68,475,7.0,10,10,0,20,5,42,0,1,1
1703,2017,5,2017-10-07,Florida International,@,Middle Tennessee State,L (17-37),22,34,64.7,221,1,36,85,2.4,1,70,306,4.4,10,8,3,21,4,45,1,1,2
1704,2017,6,2017-10-14,Florida International,,Tulane,W (23-10),17,31,54.8,220,1,44,218,5.0,1,75,438,5.8,11,11,1,23,11,105,0,2,2
1705,2017,7,2017-10-28,Florida International,@,Marshall,W (41-30),14,18,77.8,177,2,48,224,4.7,2,66,401,6.1,10,9,2,21,6,60,0,0,0
1706,2017,8,2017-11-04,Florida International,,Texas-San Antonio,W (14-7),18,25,72.0,215,2,37,100,2.7,0,62,315,5.1,11,6,1,18,6,75,2,1,3
1707,2017,9,2017-11-11,Florida International,,Old Dominion,L (30-37),35,50,70.0,323,2,35,164,4.7,2,85,487,5.7,20,6,1,27,9,84,2,0,2
1708,2017,10,2017-11-18,Florida International,@,Florida Atlantic,L (24-52),20,33,60.6,218,2,31,85,2.7,1,64,303,4.7,10,7,1,18,6,55,0,0,0
1709,2017,11,2017-11-24,Florida International,,Western Kentucky,W (41-17),18,27,66.7,251,2,34,122,3.6,2,61,373,6.1,13,5,0,18,2,19,0,0,0
1710,2017,12,2017-12-02,Florida International,,Massachusetts,W (63-45),20,25,80.0,295,3,49,379,7.7,6,74,674,9.1,12,11,3,26,5,50,1,1,2
1711,2017,13,2017-12-21,Florida International,N,Temple*,L (3-28),17,34,50.0,169,0,40,88,2.2,0,74,257,3.5,11,5,4,20,6,59,1,2,3
1712,2017,,13 Games,Florida International,,,,252,396,63.6,3031,19,494,2069,4.2,20,890,5100,5.7,151,99,19,269,84,844,11,10,21
1713,2014,1,2014-08-30,Florida State,N,Oklahoma State,W (37-31),25,40,62.5,370,1,31,106,3.4,2,71,476,6.7,12,7,4,23,8,71,0,2,2
1714,2014,2,2014-09-06,Florida State,,Citadel,W (37-12),25,32,78.1,284,2,35,210,6.0,2,67,494,7.4,13,15,0,28,3,20,0,0,0
1715,2014,3,2014-09-20,Florida State,,Clemson,W (23-17),21,39,53.8,304,1,27,13,0.5,2,66,317,4.8,11,5,1,17,8,41,0,2,2
1716,2014,4,2014-09-27,Florida State,@,North Carolina State,W (56-41),26,38,68.4,365,4,33,166,5.0,4,71,531,7.5,18,7,3,28,9,58,2,2,4
1717,2014,5,2014-10-04,Florida State,,Wake Forest,W (43-3),24,41,58.5,304,1,33,171,5.2,2,74,475,6.4,12,9,2,23,5,48,1,1,2
1718,2014,6,2014-10-11,Florida State,@,Syracuse,W (38-20),30,36,83.3,317,3,36,165,4.6,2,72,482,6.7,16,9,4,29,6,36,2,0,2
1719,2014,7,2014-10-18,Florida State,,Notre Dame,W (31-27),23,31,74.2,273,2,26,50,1.9,2,57,323,5.7,12,4,2,18,9,84,0,1,1
1720,2014,8,2014-10-30,Florida State,@,Louisville,W (42-31),25,48,52.1,401,3,30,173,5.8,3,78,574,7.4,18,7,0,25,7,53,0,3,3
1721,2014,9,2014-11-08,Florida State,,Virginia,W (34-20),22,35,62.9,261,1,39,115,2.9,3,74,376,5.1,13,5,2,20,6,46,1,2,3
1722,2014,10,2014-11-15,Florida State,@,Miami (FL),W (30-26),25,42,59.5,304,1,19,114,6.0,2,61,418,6.9,13,6,1,20,2,15,2,1,3
1723,2014,11,2014-11-22,Florida State,,Boston College,W (20-17),22,32,68.8,281,1,29,110,3.8,1,61,391,6.4,15,7,0,22,5,40,0,1,1
1724,2014,12,2014-11-29,Florida State,,Florida,W (24-19),12,24,50.0,125,2,41,181,4.4,0,65,306,4.7,6,8,3,17,8,63,0,4,4
1725,2014,13,2014-12-06,Florida State,N,Georgia Tech,W (37-35),21,30,70.0,309,3,33,179,5.4,1,63,488,7.7,11,12,1,24,5,45,0,0,0
1726,2014,14,2015-01-01,Florida State,N,Oregon*,L (20-59),29,48,60.4,348,1,39,180,4.6,1,87,528,6.1,17,10,1,28,6,48,4,1,5
1727,2014,,14 Games,Florida State,,,,330,516,64.0,4246,26,451,1933,4.3,27,967,6179,6.4,187,111,24,322,87,668,12,20,32
1728,2015,1,2015-09-05,Florida State,,Texas State,W (59-16),25,32,78.1,370,5,41,266,6.5,3,73,636,8.7,16,14,0,30,5,35,1,0,1
1729,2015,2,2015-09-12,Florida State,,South Florida,W (34-14),14,26,53.8,163,1,46,278,6.0,3,72,441,6.1,10,10,1,21,7,50,0,0,0
1730,2015,3,2015-09-18,Florida State,@,Boston College,W (14-0),15,24,62.5,119,1,33,98,3.0,0,57,217,3.8,7,5,3,15,4,26,0,0,0
1731,2015,4,2015-10-03,Florida State,@,Wake Forest,W (24-16),20,31,64.5,202,1,21,127,6.0,2,52,329,6.3,7,6,1,14,10,100,0,0,0
1732,2015,5,2015-10-10,Florida State,,Miami (FL),W (29-24),25,33,75.8,291,1,36,248,6.9,2,69,539,7.8,13,10,2,25,7,43,0,0,0
1733,2015,6,2015-10-17,Florida State,,Louisville,W (41-21),27,39,69.2,377,3,32,133,4.2,2,71,510,7.2,13,7,4,24,10,75,0,0,0
1734,2015,7,2015-10-24,Florida State,@,Georgia Tech,L (16-22),20,31,64.5,210,0,24,70,2.9,1,55,280,5.1,11,4,2,17,6,45,0,1,1
1735,2015,8,2015-10-31,Florida State,,Syracuse,W (45-21),25,38,65.8,354,3,34,221,6.5,3,72,575,8.0,11,12,0,23,9,77,0,0,0
1736,2015,9,2015-11-07,Florida State,@,Clemson,L (13-23),16,29,55.2,164,0,30,197,6.6,1,59,361,6.1,6,7,1,14,9,65,1,1,2
1737,2015,10,2015-11-14,Florida State,,North Carolina State,W (34-17),23,37,62.2,283,2,38,196,5.2,2,75,479,6.4,15,11,2,28,6,38,2,3,5
1738,2015,11,2015-11-21,Florida State,,Chattanooga,W (52-13),17,23,73.9,235,2,37,193,5.2,5,60,428,7.1,11,11,3,25,3,30,1,0,1
1739,2015,12,2015-11-28,Florida State,@,Florida,W (27-2),14,28,50.0,160,1,30,144,4.8,2,58,304,5.2,5,9,1,15,7,52,0,0,0
1740,2015,13,2015-12-31,Florida State,N,Houston*,L (24-38),23,48,47.9,397,2,23,16,0.7,1,71,413,5.8,16,1,0,17,6,66,1,4,5
1741,2015,,13 Games,Florida State,,,,264,419,63.0,3325,22,425,2187,5.1,27,844,5512,6.5,141,107,20,268,89,702,6,9,15
1742,2016,1,2016-09-05,Florida State,N,Mississippi,W (45-34),33,52,63.5,419,2,41,161,3.9,2,93,580,6.2,17,12,3,32,15,127,0,0,0
1743,2016,2,2016-09-10,Florida State,,Charleston Southern,W (52-8),26,35,74.3,269,3,36,169,4.7,3,71,438,6.2,11,13,2,26,6,60,0,1,1
1744,2016,3,2016-09-17,Florida State,@,Louisville,L (20-63),8,24,33.3,113,2,43,171,4.0,0,67,284,4.2,6,12,2,20,8,84,1,1,2
1745,2016,4,2016-09-24,Florida State,@,South Florida,W (55-35),11,19,57.9,169,1,63,478,7.6,6,82,647,7.9,8,20,3,31,4,50,1,0,1
1746,2016,5,2016-10-01,Florida State,,North Carolina,L (35-37),20,32,62.5,372,0,43,223,5.2,5,75,595,7.9,15,12,3,30,13,120,0,0,0
1747,2016,6,2016-10-08,Florida State,@,Miami (FL),W (20-19),21,33,63.6,240,2,43,167,3.9,0,76,407,5.4,10,10,2,22,8,77,0,1,1
1748,2016,7,2016-10-15,Florida State,,Wake Forest,W (17-6),22,37,59.5,319,1,38,123,3.2,1,75,442,5.9,13,13,1,27,4,42,3,1,4
1749,2016,8,2016-10-29,Florida State,,Clemson,L (34-37),17,35,48.6,286,1,28,163,5.8,4,63,449,7.1,13,6,4,23,13,111,0,1,1
1750,2016,9,2016-11-05,Florida State,@,North Carolina State,W (24-20),22,39,56.4,330,1,24,63,2.6,2,63,393,6.2,12,7,1,20,6,59,1,0,1
1751,2016,10,2016-11-11,Florida State,,Boston College,W (45-7),21,31,67.7,236,5,39,180,4.6,1,70,416,5.9,11,11,2,24,4,33,0,0,0
1752,2016,11,2016-11-19,Florida State,@,Syracuse,W (45-14),19,31,61.3,320,2,45,334,7.4,4,76,654,8.6,16,16,1,33,9,85,3,1,4
1753,2016,12,2016-11-26,Florida State,,Florida,W (31-13),15,26,57.7,138,1,40,249,6.2,3,66,387,5.9,6,10,2,18,3,35,2,1,3
1754,2016,13,2016-12-30,Florida State,N,Michigan*,W (33-32),9,27,33.3,222,2,35,149,4.3,2,62,371,6.0,5,7,3,15,7,65,1,1,2
1755,2016,,13 Games,Florida State,,,,244,421,58.0,3433,23,518,2630,5.1,33,939,6063,6.5,143,149,29,321,100,948,12,8,20
1756,2017,1,2017-09-02,Florida State,N,Alabama,L (7-24),19,33,57.6,210,1,27,40,1.5,0,60,250,4.2,10,4,1,15,4,30,1,2,3
1757,2017,2,2017-09-23,Florida State,,North Carolina State,L (21-27),22,39,56.4,278,1,26,104,4.0,0,65,382,5.9,9,6,0,15,11,93,1,0,1
1758,2017,3,2017-09-30,Florida State,@,Wake Forest,W (26-19),11,21,52.4,121,1,43,149,3.5,1,64,270,4.2,4,8,3,15,8,70,1,0,1
1759,2017,4,2017-10-07,Florida State,,Miami (FL),L (20-24),17,28,60.7,203,2,43,203,4.7,0,71,406,5.7,9,12,1,22,7,65,0,2,2
1760,2017,5,2017-10-14,Florida State,@,Duke,W (17-10),18,21,85.7,197,1,40,228,5.7,1,61,425,7.0,10,12,1,23,7,51,0,2,2
1761,2017,6,2017-10-21,Florida State,,Louisville,L (28-31),16,28,57.1,248,2,38,155,4.1,0,66,403,6.1,12,10,1,23,4,40,1,2,3
1762,2017,7,2017-10-27,Florida State,@,Boston College,L (3-35),12,27,44.4,149,0,29,64,2.2,0,56,213,3.8,7,3,0,10,7,71,2,1,3
1763,2017,8,2017-11-04,Florida State,,Syracuse,W (27-24),12,19,63.2,136,1,37,207,5.6,2,56,343,6.1,5,7,1,13,4,34,1,0,1
1764,2017,9,2017-11-11,Florida State,@,Clemson,L (14-31),13,32,40.6,208,1,24,21,0.9,1,56,229,4.1,6,3,3,12,4,55,1,1,2
1765,2017,10,2017-11-18,Florida State,,Delaware State,W (77-6),18,24,75.0,236,4,32,246,7.7,5,56,482,8.6,9,14,0,23,5,45,0,0,0
1766,2017,11,2017-11-25,Florida State,@,Florida,W (38-22),10,21,47.6,128,2,34,88,2.6,1,55,216,3.9,5,5,2,12,7,55,0,1,1
1767,2017,12,2017-12-02,Florida State,,Louisiana-Monroe,W (42-10),15,23,65.2,199,1,45,305,6.8,5,68,504,7.4,10,16,0,26,4,30,0,2,2
1768,2017,13,2017-12-27,Florida State,N,Southern Mississippi*,W (42-13),19,29,65.5,238,4,45,214,4.8,1,74,452,6.1,14,10,1,25,6,60,0,0,0
1769,2017,,13 Games,Florida State,,,,202,345,58.6,2551,21,463,2024,4.4,17,808,4575,5.7,110,110,14,234,78,699,8,13,21
1770,2016,1,2016-09-03,Fordham,@,Navy,L (16-52),26,45,57.8,302,1,36,162,4.5,0,81,464,5.7,13,9,2,24,5,35,1,0,1
1771,2017,1,2017-09-01,Fordham,@,Army,L (6-64),28,41,68.3,240,0,32,78,2.4,1,73,318,4.4,14,5,1,20,5,25,0,1,1
1772,2014,1,2014-08-30,Fresno State,@,Southern California,L (13-52),18,36,50.0,160,0,33,157,4.8,2,69,317,4.6,8,6,3,17,5,47,0,4,4
1773,2014,2,2014-09-06,Fresno State,@,Utah,L (27-59),24,40,60.0,283,3,40,55,1.4,1,80,338,4.2,11,6,7,24,6,55,1,0,1
1774,2014,3,2014-09-13,Fresno State,,Nebraska,L (19-55),30,59,50.8,241,1,28,105,3.8,1,87,346,4.0,13,5,2,20,5,55,0,0,0
1775,2014,4,2014-09-20,Fresno State,,Southern Utah,W (56-16),22,38,57.9,291,4,54,389,7.2,3,92,680,7.4,10,18,1,29,6,38,0,1,1
1776,2014,5,2014-09-26,Fresno State,@,New Mexico,W (35-24),28,42,66.7,321,3,45,272,6.0,2,87,593,6.8,13,14,3,30,4,27,1,1,2
1777,2014,6,2014-10-03,Fresno State,,San Diego State,W (24-13),14,28,50.0,143,0,43,172,4.0,3,71,315,4.4,5,7,4,16,4,37,1,1,2
1778,2014,7,2014-10-10,Fresno State,@,Nevada-Las Vegas,L (27-30),25,44,56.8,310,3,33,177,5.4,1,77,487,6.3,12,7,2,21,6,80,1,2,3
1779,2014,8,2014-10-17,Fresno State,@,Boise State,L (27-37),13,25,52.0,127,1,34,186,5.5,2,59,313,5.3,6,6,0,12,2,20,0,1,1
1780,2014,9,2014-11-01,Fresno State,,Wyoming,L (17-45),14,29,48.3,149,1,31,167,5.4,1,60,316,5.3,7,8,1,16,3,20,0,2,2
1781,2014,10,2014-11-08,Fresno State,,San Jose State,W (38-24),20,26,76.9,207,3,53,232,4.4,1,79,439,5.6,10,13,0,23,2,20,1,1,2
1782,2014,11,2014-11-22,Fresno State,@,Nevada,W (40-20),25,47,53.2,313,4,52,238,4.6,1,99,551,5.6,13,14,2,29,2,20,1,1,2
1783,2014,12,2014-11-29,Fresno State,,Hawaii,W (28-21),19,32,59.4,162,1,37,171,4.6,3,69,333,4.8,8,12,3,23,9,69,0,2,2
1784,2014,13,2014-12-06,Fresno State,@,Boise State,L (14-28),30,46,65.2,332,1,41,70,1.7,1,87,402,4.6,17,3,1,21,4,43,0,3,3
1785,2014,14,2014-12-24,Fresno State,N,Rice*,L (6-30),17,38,44.7,93,0,42,162,3.9,0,80,255,3.2,6,7,2,15,1,15,0,2,2
1786,2014,,14 Games,Fresno State,,,,299,530,56.4,3132,25,566,2553,4.5,22,1096,5685,5.2,139,126,31,296,59,546,6,21,27
1787,2015,1,2015-09-03,Fresno State,,Abilene Christian,W (34-13),22,45,48.9,217,4,39,225,5.8,0,84,442,5.3,10,14,2,26,2,20,1,2,3
1788,2015,2,2015-09-12,Fresno State,@,Mississippi,L (21-73),15,24,62.5,153,2,52,163,3.1,0,76,316,4.2,5,8,4,17,6,45,1,3,4
1789,2015,3,2015-09-19,Fresno State,,Utah,L (24-45),17,35,48.6,241,3,29,124,4.3,0,64,365,5.7,9,7,0,16,4,45,2,0,2
1790,2015,4,2015-09-26,Fresno State,@,San Jose State,L (23-49),19,33,57.6,159,2,29,88,3.0,1,62,247,4.0,8,5,0,13,3,30,0,1,1
1791,2015,5,2015-10-03,Fresno State,@,San Diego State,L (7-21),12,25,48.0,77,1,22,12,0.5,0,47,89,1.9,2,3,1,6,6,47,0,0,0
1792,2015,6,2015-10-10,Fresno State,,Utah State,L (14-56),10,20,50.0,112,1,42,82,2.0,1,62,194,3.1,5,5,0,10,5,30,0,3,3
1793,2015,7,2015-10-16,Fresno State,,Nevada-Las Vegas,W (31-28),19,31,61.3,193,0,38,217,5.7,4,69,410,5.9,11,11,1,23,4,47,1,0,1
1794,2015,8,2015-10-24,Fresno State,@,Air Force,L (14-42),14,39,35.9,177,0,17,134,7.9,2,56,311,5.6,9,3,0,12,5,39,0,1,1
1795,2015,9,2015-11-05,Fresno State,,Nevada,L (16-30),17,35,48.6,154,1,29,126,4.3,1,64,280,4.4,9,6,3,18,9,58,1,3,4
1796,2015,10,2015-11-14,Fresno State,@,Hawaii,W (42-14),20,35,57.1,285,6,51,170,3.3,0,86,455,5.3,11,11,7,29,6,50,0,0,0
1797,2015,11,2015-11-21,Fresno State,@,Brigham Young,L (10-52),18,48,37.5,190,0,30,85,2.8,1,78,275,3.5,10,5,2,17,4,35,0,3,3
1798,2015,12,2015-11-28,Fresno State,,Colorado State,L (31-34),19,33,57.6,182,0,45,216,4.8,4,78,398,5.1,8,12,0,20,5,25,0,0,0
1799,2015,,12 Games,Fresno State,,,,202,403,50.1,2140,20,423,1642,3.9,14,826,3782,4.6,97,90,20,207,59,471,6,16,22
1800,2016,1,2016-09-03,Fresno State,@,Nebraska,L (10-43),24,43,55.8,243,1,26,31,1.2,0,69,274,4.0,12,2,3,17,6,29,0,2,2
1801,2016,2,2016-09-10,Fresno State,,Sacramento State,W (31-3),22,42,52.4,274,2,43,200,4.7,2,85,474,5.6,14,13,0,27,6,55,1,1,2
1802,2016,3,2016-09-17,Fresno State,@,Toledo,L (17-52),13,26,50.0,203,2,27,51,1.9,0,53,254,4.8,5,2,0,7,12,138,0,0,0
1803,2016,4,2016-09-24,Fresno State,,Tulsa,L (41-48),21,45,46.7,276,1,44,177,4.0,4,89,453,5.1,11,8,1,20,5,40,1,1,2
1804,2016,5,2016-10-01,Fresno State,@,Nevada-Las Vegas,L (20-45),16,45,35.6,296,2,32,64,2.0,0,77,360,4.7,10,3,2,15,6,50,0,1,1
1805,2016,6,2016-10-08,Fresno State,@,Nevada,L (22-27),16,28,57.1,197,1,48,255,5.3,1,76,452,5.9,9,15,1,25,5,57,2,0,2
1806,2016,7,2016-10-14,Fresno State,,San Diego State,L (3-17),16,27,59.3,139,0,24,78,3.3,0,51,217,4.3,4,4,2,10,5,36,0,3,3
1807,2016,8,2016-10-22,Fresno State,@,Utah State,L (20-38),27,44,61.4,205,1,39,114,2.9,1,83,319,3.8,10,9,4,23,10,80,0,0,0
1808,2016,9,2016-10-28,Fresno State,,Air Force,L (21-31),19,38,50.0,312,3,30,37,1.2,0,68,349,5.1,10,4,4,18,8,55,0,4,4
1809,2016,10,2016-11-05,Fresno State,@,Colorado State,L (0-37),12,25,48.0,155,0,34,77,2.3,0,59,232,3.9,7,3,2,12,4,35,0,1,1
1810,2016,11,2016-11-19,Fresno State,,Hawaii,L (13-14),13,23,56.5,108,0,52,214,4.1,1,75,322,4.3,5,14,1,20,7,64,0,0,0
1811,2016,12,2016-11-26,Fresno State,,San Jose State,L (14-16),11,19,57.9,149,0,41,96,2.3,2,60,245,4.1,5,6,1,12,2,30,1,0,1
1812,2016,,12 Games,Fresno State,,,,210,405,51.9,2557,13,440,1394,3.2,11,845,3951,4.7,102,83,21,206,76,669,5,13,18
1813,2017,1,2017-09-02,Fresno State,,Incarnate Word,W (66-0),23,37,62.2,414,4,40,199,5.0,4,77,613,8.0,13,12,1,26,3,15,0,0,0
1814,2017,2,2017-09-09,Fresno State,@,Alabama,L (10-41),26,41,63.4,216,1,21,71,3.4,0,62,287,4.6,11,5,2,18,1,6,0,1,1
1815,2017,3,2017-09-16,Fresno State,@,Washington,L (16-48),21,36,58.3,194,1,31,119,3.8,0,67,313,4.7,8,8,2,18,6,54,0,1,1
1816,2017,4,2017-09-30,Fresno State,,Nevada,W (41-21),25,33,75.8,312,3,36,192,5.3,1,69,504,7.3,13,8,1,22,8,61,2,1,3
1817,2017,5,2017-10-07,Fresno State,@,San Jose State,W (27-10),15,26,57.7,136,0,51,212,4.2,3,77,348,4.5,4,11,2,17,10,99,0,0,0
1818,2017,6,2017-10-14,Fresno State,,New Mexico,W (38-0),13,23,56.5,299,3,36,227,6.3,2,59,526,8.9,7,9,1,17,2,25,1,0,1
1819,2017,7,2017-10-21,Fresno State,@,San Diego State,W (27-3),10,16,62.5,176,0,38,199,5.2,3,54,375,6.9,6,9,0,15,5,40,0,0,0
1820,2017,8,2017-10-28,Fresno State,,Nevada-Las Vegas,L (16-26),16,27,59.3,152,0,34,140,4.1,2,61,292,4.8,7,12,0,19,5,40,1,0,1
1821,2017,9,2017-11-04,Fresno State,,Brigham Young,W (20-13),14,20,70.0,174,0,40,136,3.4,2,60,310,5.2,8,7,1,16,5,40,0,0,0
1822,2017,10,2017-11-11,Fresno State,@,Hawaii,W (31-21),19,36,52.8,226,4,36,175,4.9,0,72,401,5.6,11,12,1,24,6,46,0,2,2
1823,2017,11,2017-11-18,Fresno State,@,Wyoming,W (13-7),14,23,60.9,186,1,45,147,3.3,0,68,333,4.9,6,9,0,15,5,35,1,0,1
1824,2017,12,2017-11-25,Fresno State,,Boise State,W (28-17),23,36,63.9,332,2,30,99,3.3,1,66,431,6.5,13,5,0,18,3,40,0,0,0
1825,2017,13,2017-12-02,Fresno State,@,Boise State,L (14-17),16,34,47.1,172,0,35,137,3.9,2,69,309,4.5,9,8,2,19,8,57,0,1,1
1826,2017,14,2017-12-24,Fresno State,N,Houston*,W (33-27),33,49,67.3,342,0,39,131,3.4,2,88,473,5.4,15,8,3,26,7,52,1,1,2
1827,2017,,14 Games,Fresno State,,,,268,437,61.3,3331,19,512,2184,4.3,22,949,5515,5.8,131,123,16,270,74,610,6,7,13
1828,2016,1,2016-09-02,Furman,@,Michigan State,L (13-28),16,31,51.6,139,0,33,87,2.6,1,64,226,3.5,8,6,4,18,4,34,0,1,1
1829,2017,1,2017-09-16,Furman,@,North Carolina State,L (16-49),11,19,57.9,196,1,47,133,2.8,0,66,329,5.0,8,7,1,16,1,5,2,1,3
1830,2014,1,2014-08-30,Georgia,,Clemson,W (45-21),18,26,69.2,131,0,41,328,8.0,5,67,459,6.9,7,13,2,22,8,65,1,0,1
1831,2014,2,2014-09-13,Georgia,@,South Carolina,L (35-38),16,22,72.7,191,2,38,217,5.7,2,60,408,6.8,8,9,1,18,7,44,0,0,0
1832,2014,3,2014-09-20,Georgia,,Troy,W (66-0),14,22,63.6,180,3,39,367,9.4,5,61,547,9.0,8,13,2,23,5,35,0,0,0
1833,2014,4,2014-09-27,Georgia,,Tennessee,W (35-32),16,25,64.0,147,1,53,289,5.5,3,78,436,5.6,9,16,0,25,7,57,0,2,2
1834,2014,5,2014-10-04,Georgia,,Vanderbilt,W (44-17),14,22,63.6,202,2,35,243,6.9,3,57,445,7.8,7,12,1,20,2,12,0,1,1
1835,2014,6,2014-10-11,Georgia,@,Missouri,W (34-0),23,29,79.3,169,1,58,210,3.6,3,87,379,4.4,9,16,0,25,4,30,0,0,0
1836,2014,7,2014-10-18,Georgia,N,Arkansas,W (45-32),10,17,58.8,179,2,39,207,5.3,3,56,386,6.9,6,10,2,18,9,101,0,0,0
1837,2014,8,2014-11-01,Georgia,N,Florida,L (20-38),26,41,63.4,319,1,32,141,4.4,2,73,460,6.3,15,5,1,21,4,30,1,0,1
1838,2014,9,2014-11-08,Georgia,@,Kentucky,W (63-31),18,21,85.7,254,5,39,305,7.8,2,60,559,9.3,13,15,0,28,4,33,1,0,1
1839,2014,10,2014-11-15,Georgia,,Auburn,W (34-7),10,19,52.6,123,1,52,289,5.6,3,71,412,5.8,5,19,3,27,6,51,0,0,0
1840,2014,11,2014-11-22,Georgia,,Charleston Southern,W (55-9),20,26,76.9,310,4,37,270,7.3,3,63,580,9.2,16,9,3,28,3,30,1,1,2
1841,2014,12,2014-11-29,Georgia,,Georgia Tech,L (24-30),18,28,64.3,194,1,39,194,5.0,1,67,388,5.8,12,8,1,21,2,20,2,1,3
1842,2014,13,2014-12-30,Georgia,N,Louisville*,W (37-14),14,24,58.3,200,1,52,305,5.9,3,76,505,6.6,11,9,2,22,4,32,1,1,2
1843,2014,,13 Games,Georgia,,,,217,322,67.4,2599,24,554,3365,6.1,38,876,5964,6.8,126,154,18,298,65,540,7,6,13
1844,2015,1,2015-09-05,Georgia,,Louisiana-Monroe,W (51-14),10,14,71.4,192,3,38,243,6.4,4,52,435,8.4,8,11,0,19,4,30,0,0,0
1845,2015,2,2015-09-12,Georgia,@,Vanderbilt,W (31-14),13,25,52.0,141,0,41,282,6.9,2,66,423,6.4,9,9,1,19,10,92,0,0,0
1846,2015,3,2015-09-19,Georgia,,South Carolina,W (52-20),24,25,96.0,330,3,38,246,6.5,4,63,576,9.1,17,12,3,32,7,74,1,0,1
1847,2015,4,2015-09-26,Georgia,,Southern,W (48-6),20,24,83.3,271,2,33,261,7.9,4,57,532,9.3,13,13,1,27,2,10,1,0,1
1848,2015,5,2015-10-03,Georgia,,Alabama,L (10-38),11,31,35.5,106,0,38,193,5.1,1,69,299,4.3,4,7,1,12,8,82,1,3,4
1849,2015,6,2015-10-10,Georgia,@,Tennessee,L (31-38),15,33,45.5,279,2,29,165,5.7,0,62,444,7.2,11,4,0,15,7,51,1,0,1
1850,2015,7,2015-10-17,Georgia,,Missouri,W (9-6),23,32,71.9,178,0,45,120,2.7,0,77,298,3.9,9,9,1,19,3,30,0,1,1
1851,2015,8,2015-10-31,Georgia,N,Florida,L (3-27),15,34,44.1,154,0,22,69,3.1,0,56,223,4.0,8,3,1,12,3,20,1,4,5
1852,2015,9,2015-11-07,Georgia,,Kentucky,W (27-3),10,19,52.6,90,1,52,300,5.8,2,71,390,5.5,6,15,0,21,6,60,2,0,2
1853,2015,10,2015-11-14,Georgia,@,Auburn,W (20-13),12,17,70.6,97,0,45,146,3.2,1,62,243,3.9,6,8,1,15,5,48,0,0,0
1854,2015,11,2015-11-21,Georgia,,Georgia Southern,W (23-17),16,25,64.0,183,1,28,106,3.8,2,53,289,5.5,8,8,0,16,2,15,2,0,2
1855,2015,12,2015-11-28,Georgia,@,Georgia Tech,W (13-7),18,25,72.0,224,0,34,178,5.2,1,59,402,6.8,8,7,1,16,5,35,0,0,0
1856,2015,13,2016-01-02,Georgia,N,Penn State*,W (24-17),12,23,52.2,161,2,41,166,4.0,1,64,327,5.1,7,9,1,17,5,45,0,0,0
1857,2015,,13 Games,Georgia,,,,199,327,60.9,2406,14,484,2475,5.1,22,811,4881,6.0,114,115,11,240,67,592,9,8,17
1858,2016,1,2016-09-03,Georgia,N,North Carolina,W (33-24),13,20,65.0,185,1,52,289,5.6,3,72,474,6.6,8,13,4,25,9,70,1,0,1
1859,2016,2,2016-09-10,Georgia,,Nicholls State,W (26-24),13,23,56.5,206,1,39,167,4.3,1,62,373,6.0,9,8,0,17,3,34,2,1,3
1860,2016,3,2016-09-17,Georgia,@,Missouri,W (28-27),29,55,52.7,308,3,38,101,2.7,1,93,409,4.4,18,5,2,25,3,42,0,1,1
1861,2016,4,2016-09-24,Georgia,@,Mississippi,L (14-45),17,37,45.9,166,0,44,230,5.2,2,81,396,4.9,9,12,0,21,8,52,1,1,2
1862,2016,5,2016-10-01,Georgia,,Tennessee,L (31-34),17,28,60.7,211,2,46,181,3.9,2,74,392,5.3,11,11,2,24,8,44,1,1,2
1863,2016,6,2016-10-09,Georgia,@,South Carolina,W (28-14),5,17,29.4,29,1,50,326,6.5,2,67,355,5.3,1,17,1,19,8,56,0,1,1
1864,2016,7,2016-10-15,Georgia,,Vanderbilt,L (16-17),27,40,67.5,346,1,35,75,2.1,0,75,421,5.6,17,4,2,23,8,53,0,0,0
1865,2016,8,2016-10-29,Georgia,N,Florida,L (10-24),15,33,45.5,143,1,19,21,1.1,0,52,164,3.2,7,0,1,8,5,49,0,0,0
1866,2016,9,2016-11-05,Georgia,@,Kentucky,W (27-24),17,31,54.8,245,1,42,215,5.1,1,73,460,6.3,10,12,1,23,6,54,3,0,3
1867,2016,10,2016-11-12,Georgia,,Auburn,W (13-7),20,33,60.6,208,0,43,135,3.1,0,76,343,4.5,8,11,2,21,5,30,0,1,1
1868,2016,11,2016-11-19,Georgia,,Louisiana,W (35-21),13,20,65.0,165,2,39,235,6.0,2,59,400,6.8,7,9,0,16,2,15,1,1,2
1869,2016,12,2016-11-26,Georgia,,Georgia Tech,L (27-28),14,28,50.0,139,1,42,263,6.3,2,70,402,5.7,7,13,2,22,2,15,0,2,2
1870,2016,13,2016-12-30,Georgia,N,Texas Christian*,W (31-23),12,21,57.1,164,2,42,251,6.0,2,63,415,6.6,5,11,1,17,7,45,1,0,1
1871,2016,,13 Games,Georgia,,,,212,386,54.9,2515,16,531,2489,4.7,18,917,5004,5.5,117,126,18,261,74,559,10,9,19
1872,2017,1,2017-09-02,Georgia,,Appalachian State,W (31-10),11,20,55.0,147,1,44,221,5.0,3,64,368,5.8,6,9,3,18,8,46,0,2,2
1873,2017,2,2017-09-09,Georgia,@,Notre Dame,W (20-19),16,29,55.2,141,1,43,185,4.3,1,72,326,4.5,3,9,4,16,12,127,1,1,2
1874,2017,3,2017-09-16,Georgia,,Samford,W (42-14),9,15,60.0,175,3,54,284,5.3,3,69,459,6.7,5,22,0,27,3,25,1,0,1
1875,2017,4,2017-09-23,Georgia,,Mississippi State,W (31-3),9,12,75.0,201,2,42,203,4.8,2,54,404,7.5,7,7,1,15,4,35,1,0,1
1876,2017,5,2017-09-30,Georgia,@,Tennessee,W (41-0),7,17,41.2,84,1,55,294,5.3,4,72,378,5.3,5,13,2,20,6,65,0,1,1
1877,2017,6,2017-10-07,Georgia,@,Vanderbilt,W (45-14),10,14,71.4,126,2,54,423,7.8,4,68,549,8.1,6,21,0,27,7,46,1,0,1
1878,2017,7,2017-10-14,Georgia,,Missouri,W (53-28),18,26,69.2,326,2,54,370,6.9,4,80,696,8.7,11,13,0,24,8,42,0,1,1
1879,2017,8,2017-10-28,Georgia,N,Florida,W (42-7),4,7,57.1,101,1,35,292,8.3,4,42,393,9.4,4,10,0,14,7,40,0,1,1
1880,2017,9,2017-11-04,Georgia,,South Carolina,W (24-10),16,22,72.7,196,2,53,242,4.6,1,75,438,5.8,12,13,1,26,5,55,1,0,1
1881,2017,10,2017-11-11,Georgia,@,Auburn,L (17-40),13,29,44.8,184,1,32,46,1.4,1,61,230,3.8,8,4,1,13,7,75,1,0,1
1882,2017,11,2017-11-18,Georgia,,Kentucky,W (42-13),9,14,64.3,123,1,44,381,8.7,5,58,504,8.7,7,17,1,25,7,59,0,1,1
1883,2017,12,2017-11-25,Georgia,@,Georgia Tech,W (38-7),12,17,70.6,224,2,43,247,5.7,3,60,471,7.9,9,13,1,23,2,25,0,0,0
1884,2017,13,2017-12-02,Georgia,N,Auburn,W (28-7),16,22,72.7,183,2,41,238,5.8,1,63,421,6.7,6,11,3,20,7,91,0,0,0
1885,2017,14,2018-01-01,Georgia,N,Oklahoma*,W (54-48),20,29,69.0,210,2,34,317,9.3,5,63,527,8.4,12,8,1,21,6,39,1,0,1
1886,2017,15,2018-01-08,Georgia,N,Alabama*,L (23-26),16,32,50.0,232,1,45,133,3.0,1,77,365,4.7,11,8,3,22,6,65,0,2,2
1887,2017,,15 Games,Georgia,,,,186,305,61.0,2653,24,673,3876,5.8,42,978,6529,6.7,112,178,21,311,95,835,7,9,16
1888,2014,1,2014-08-30,Georgia Southern,@,North Carolina State,L (23-24),10,17,58.8,192,1,47,246,5.2,1,64,438,6.8,6,12,0,18,3,35,1,0,1
1889,2014,2,2014-09-13,Georgia Southern,@,Georgia Tech,L (38-42),13,22,59.1,245,1,38,283,7.4,4,60,528,8.8,9,12,1,22,5,60,1,0,1
1890,2014,3,2014-09-20,Georgia Southern,@,South Alabama,W (28-6),6,11,54.5,85,0,52,335,6.4,4,63,420,6.7,4,14,0,18,1,10,1,1,2
1891,2014,4,2014-10-04,Georgia Southern,@,New Mexico State,W (36-28),3,13,23.1,18,0,61,405,6.6,4,74,423,5.7,0,21,1,22,4,39,1,0,1
1892,2014,5,2014-10-11,Georgia Southern,,Idaho,W (47-24),11,15,73.3,201,2,58,349,6.0,4,73,550,7.5,7,18,1,26,6,48,1,0,1
1893,2014,6,2014-10-25,Georgia Southern,@,Georgia State,W (69-31),5,6,83.3,47,0,63,613,9.7,10,69,660,9.6,2,28,0,30,5,39,0,0,0
1894,2014,7,2014-10-30,Georgia Southern,,Troy,W (42-10),6,10,60.0,40,0,63,421,6.7,6,73,461,6.3,2,24,2,28,3,25,2,0,2
1895,2014,8,2014-11-08,Georgia Southern,@,Texas State,W (28-25),6,9,66.7,41,0,40,227,5.7,3,49,268,5.5,2,6,1,9,7,74,0,0,0
1896,2014,9,2014-11-15,Georgia Southern,@,Navy,L (19-52),10,16,62.5,73,0,47,375,8.0,3,63,448,7.1,4,15,0,19,7,65,1,2,3
1897,2014,10,2014-11-29,Georgia Southern,,Louisiana-Monroe,W (22-16),8,19,42.1,136,0,59,333,5.6,3,78,469,6.0,4,14,1,19,6,65,0,0,0
1898,2014,,10 Games,Georgia Southern,,,,78,138,56.5,1078,4,528,3587,6.8,42,666,4665,7.0,40,164,7,211,47,460,8,3,11
1899,2015,1,2015-09-05,Georgia Southern,@,West Virginia,L (0-44),2,13,15.4,29,0,57,195,3.4,0,70,224,3.2,2,11,1,14,1,15,1,4,5
1900,2015,2,2015-09-12,Georgia Southern,,Western Michigan,W (43-17),1,4,25.0,7,0,52,413,7.9,5,56,420,7.5,1,12,1,14,4,35,0,0,0
1901,2015,3,2015-09-19,Georgia Southern,,Citadel,W (48-13),12,19,63.2,101,0,49,383,7.8,6,68,484,7.1,5,13,0,18,5,40,1,0,1
1902,2015,4,2015-09-26,Georgia Southern,@,Idaho,W (44-20),7,16,43.8,127,0,52,441,8.5,5,68,568,8.4,6,17,0,23,4,38,1,1,2
1903,2015,5,2015-10-03,Georgia Southern,@,Louisiana-Monroe,W (51-31),3,10,30.0,48,0,67,455,6.8,6,77,503,6.5,3,21,2,26,12,109,0,1,1
1904,2015,6,2015-10-17,Georgia Southern,,New Mexico State,W (56-26),4,8,50.0,85,1,59,507,8.6,7,67,592,8.8,2,21,1,24,7,86,1,0,1
1905,2015,7,2015-10-22,Georgia Southern,@,Appalachian State,L (13-31),5,13,38.5,64,0,38,188,4.9,2,51,252,4.9,2,11,0,13,4,26,0,2,2
1906,2015,8,2015-10-29,Georgia Southern,,Texas State,W (37-13),3,6,50.0,31,0,67,503,7.5,4,73,534,7.3,2,19,1,22,2,30,3,0,3
1907,2015,9,2015-11-14,Georgia Southern,@,Troy,W (45-10),4,7,57.1,85,1,66,325,4.9,4,73,410,5.6,3,19,3,25,7,70,1,0,1
1908,2015,10,2015-11-21,Georgia Southern,@,Georgia,L (17-23),4,7,57.1,44,0,49,227,4.6,1,56,271,4.8,2,9,0,11,3,25,1,0,1
1909,2015,11,2015-11-28,Georgia Southern,,South Alabama,W (55-17),4,7,57.1,53,1,56,489,8.7,6,63,542,8.6,2,18,0,20,7,67,2,0,2
1910,2015,12,2015-12-05,Georgia Southern,,Georgia State,L (7-34),6,19,31.6,68,0,44,135,3.1,1,63,203,3.2,4,6,4,14,6,38,0,2,2
1911,2015,13,2015-12-23,Georgia Southern,N,Bowling Green State*,W (58-27),4,8,50.0,82,1,68,452,6.6,7,76,534,7.0,4,20,2,26,5,45,0,0,0
1912,2015,,13 Games,Georgia Southern,,,,59,137,43.1,824,4,724,4713,6.5,54,861,5537,6.4,38,197,15,250,67,624,11,10,21
1913,2016,1,2016-09-03,Georgia Southern,,Savannah State,W (54-0),12,15,80.0,185,2,69,420,6.1,6,84,605,7.2,8,23,3,34,8,58,1,1,2
1914,2016,2,2016-09-10,Georgia Southern,@,South Alabama,W (24-9),7,10,70.0,137,0,63,304,4.8,3,73,441,6.0,6,15,2,23,10,65,1,0,1
1915,2016,3,2016-09-17,Georgia Southern,,Louisiana-Monroe,W (23-21),5,17,29.4,71,0,71,345,4.9,2,88,416,4.7,5,18,4,27,14,136,1,0,1
1916,2016,4,2016-09-24,Georgia Southern,@,Western Michigan,L (31-49),9,16,56.3,168,3,50,202,4.0,1,66,370,5.6,6,12,2,20,5,39,2,2,4
1917,2016,5,2016-10-05,Georgia Southern,@,Arkansas State,L (26-27),14,23,60.9,203,1,45,162,3.6,1,68,365,5.4,10,6,0,16,7,52,0,0,0
1918,2016,6,2016-10-15,Georgia Southern,@,Georgia Tech,L (24-35),18,33,54.5,168,1,50,167,3.3,2,83,335,4.0,8,14,3,25,7,66,0,0,0
1919,2016,7,2016-10-22,Georgia Southern,@,New Mexico State,W (22-19),11,20,55.0,157,2,53,254,4.8,0,73,411,5.6,8,11,1,20,8,79,1,2,3
1920,2016,8,2016-10-27,Georgia Southern,,Appalachian State,L (10-34),12,29,41.4,94,0,26,65,2.5,0,55,159,2.9,5,3,1,9,4,45,0,3,3
1921,2016,9,2016-11-05,Georgia Southern,@,Mississippi,L (27-37),7,17,41.2,134,1,59,267,4.5,2,76,401,5.3,4,12,3,19,6,54,0,1,1
1922,2016,10,2016-11-10,Georgia Southern,,Louisiana,L (26-33),22,37,59.5,254,1,28,52,1.9,2,65,306,4.7,14,1,1,16,6,61,0,0,0
1923,2016,11,2016-11-19,Georgia Southern,@,Georgia State,L (24-30),14,26,53.8,122,0,46,241,5.2,3,72,363,5.0,7,11,1,19,11,78,2,0,2
1924,2016,12,2016-12-03,Georgia Southern,,Troy,W (28-24),16,21,76.2,175,2,42,218,5.2,2,63,393,6.2,6,13,1,20,5,45,1,0,1
1925,2016,,12 Games,Georgia Southern,,,,147,264,55.7,1868,13,602,2697,4.5,24,866,4565,5.3,87,139,22,248,91,778,9,9,18
1926,2017,1,2017-09-02,Georgia Southern,@,Auburn,L (7-41),4,9,44.4,8,0,47,70,1.5,0,56,78,1.4,0,5,3,8,3,15,0,1,1
1927,2017,2,2017-09-09,Georgia Southern,N,New Hampshire,L (12-22),11,22,50.0,93,0,57,226,4.0,1,79,319,4.0,5,15,1,21,5,50,1,1,2
1928,2017,3,2017-09-23,Georgia Southern,@,Indiana,L (17-52),7,16,43.8,133,2,54,242,4.5,0,70,375,5.4,2,11,2,15,13,108,3,0,3
1929,2017,4,2017-10-04,Georgia Southern,,Arkansas State,L (25-43),10,18,55.6,160,1,63,333,5.3,2,81,493,6.1,5,16,3,24,7,63,2,2,4
1930,2017,5,2017-10-14,Georgia Southern,,New Mexico State,L (27-35),6,9,66.7,73,0,50,192,3.8,2,59,265,4.5,3,10,0,13,6,61,0,0,0
1931,2017,6,2017-10-21,Georgia Southern,@,Massachusetts,L (20-55),5,18,27.8,155,0,41,136,3.3,2,59,291,4.9,3,8,1,12,11,114,3,1,4
1932,2017,7,2017-10-28,Georgia Southern,@,Troy,L (16-38),6,12,50.0,82,0,62,227,3.7,2,74,309,4.2,3,16,0,19,4,30,0,1,1
1933,2017,8,2017-11-04,Georgia Southern,,Georgia State,L (17-21),22,28,78.6,147,1,50,189,3.8,1,78,336,4.3,8,10,1,19,8,60,3,0,3
1934,2017,9,2017-11-09,Georgia Southern,@,Appalachian State,L (6-27),10,18,55.6,80,0,38,111,2.9,0,56,191,3.4,6,8,1,15,5,42,0,0,0
1935,2017,10,2017-11-18,Georgia Southern,,South Alabama,W (52-0),11,17,64.7,227,2,68,356,5.2,5,85,583,6.9,7,18,1,26,5,45,0,0,0
1936,2017,11,2017-11-25,Georgia Southern,@,Louisiana,W (34-24),6,11,54.5,75,1,63,389,6.2,3,74,464,6.3,2,19,2,23,5,40,0,0,0
1937,2017,12,2017-12-02,Georgia Southern,@,Coastal Carolina,L (17-28),7,17,41.2,87,1,51,197,3.9,1,68,284,4.2,5,11,0,16,5,25,1,1,2
1938,2017,,12 Games,Georgia Southern,,,,105,195,53.8,1320,8,644,2668,4.1,19,839,3988,4.8,49,147,15,211,77,653,13,7,20
1939,2014,1,2014-08-27,Georgia State,,Abilene Christian,W (38-37),31,49,63.3,413,4,33,153,4.6,1,82,566,6.9,20,10,3,33,12,99,1,2,3
1940,2014,2,2014-09-06,Georgia State,,New Mexico State,L (31-34),21,37,56.8,294,1,39,162,4.2,3,76,456,6.0,10,10,3,23,7,59,2,2,4
1941,2014,3,2014-09-13,Georgia State,,Air Force,L (38-48),26,42,61.9,414,2,25,135,5.4,3,67,549,8.2,18,7,1,26,7,79,0,1,1
1942,2014,4,2014-09-20,Georgia State,@,Washington,L (14-45),22,34,64.7,205,2,41,68,1.7,0,75,273,3.6,10,5,2,17,4,25,1,3,4
1943,2014,5,2014-10-04,Georgia State,@,Louisiana,L (31-34),20,31,64.5,287,0,37,138,3.7,4,68,425,6.3,12,6,6,24,10,79,0,0,0
1944,2014,6,2014-10-11,Georgia State,,Arkansas State,L (10-52),20,39,51.3,198,0,34,71,2.1,1,73,269,3.7,9,8,1,18,1,5,1,1,2
1945,2014,7,2014-10-18,Georgia State,@,South Alabama,L (27-30),23,40,57.5,311,3,37,90,2.4,1,77,401,5.2,10,8,3,21,4,30,1,0,1
1946,2014,8,2014-10-25,Georgia State,,Georgia Southern,L (31-69),24,38,63.2,408,4,23,47,2.0,0,61,455,7.5,15,4,2,21,6,40,2,1,3
1947,2014,9,2014-11-01,Georgia State,@,Appalachian State,L (0-44),9,19,47.4,54,0,26,8,0.3,0,45,62,1.4,2,4,0,6,0,0,2,1,3
1948,2014,10,2014-11-08,Georgia State,@,Troy,L (21-45),23,37,62.2,293,3,34,101,3.0,0,71,394,5.5,13,8,0,21,3,25,1,2,3
1949,2014,11,2014-11-22,Georgia State,@,Clemson,L (0-28),13,33,39.4,115,0,33,40,1.2,0,66,155,2.3,6,4,0,10,5,40,0,3,3
1950,2014,12,2014-11-29,Georgia State,,Texas State,L (31-54),32,47,68.1,356,4,27,160,5.9,0,74,516,7.0,13,10,1,24,5,40,1,2,3
1951,2014,,12 Games,Georgia State,,,,264,446,59.2,3348,23,389,1173,3.0,13,835,4521,5.4,138,84,22,244,64,521,12,18,30
1952,2015,1,2015-09-04,Georgia State,,UNC Charlotte,L (20-23),25,43,58.1,299,2,26,93,3.6,0,69,392,5.7,9,6,1,16,10,79,2,1,3
1953,2015,2,2015-09-12,Georgia State,@,New Mexico State,W (34-32),32,43,74.4,372,2,46,210,4.6,2,89,582,6.5,17,11,0,28,9,75,2,1,3
1954,2015,3,2015-09-19,Georgia State,@,Oregon,L (28-61),25,40,62.5,318,3,36,113,3.1,1,76,431,5.7,11,8,3,22,4,23,2,2,4
1955,2015,4,2015-10-03,Georgia State,,Liberty,L (33-41),18,29,62.1,394,3,14,11,0.8,1,43,405,9.4,10,2,2,14,5,46,0,1,1
1956,2015,5,2015-10-10,Georgia State,,Appalachian State,L (3-37),21,39,53.8,166,0,21,59,2.8,0,60,225,3.8,8,5,1,14,7,60,1,1,2
1957,2015,6,2015-10-17,Georgia State,@,Ball State,W (31-19),28,39,71.8,412,1,32,33,1.0,3,71,445,6.3,16,3,2,21,7,65,1,0,1
1958,2015,7,2015-10-31,Georgia State,@,Arkansas State,L (34-48),23,43,53.5,390,2,32,101,3.2,1,75,491,6.5,13,5,3,21,10,73,1,1,2
1959,2015,8,2015-11-07,Georgia State,,Louisiana,L (21-23),23,39,59.0,312,3,29,78,2.7,0,68,390,5.7,13,3,5,21,4,50,0,1,1
1960,2015,9,2015-11-14,Georgia State,@,Texas State,W (41-19),23,35,65.7,471,4,37,172,4.6,1,72,643,8.9,18,8,1,27,5,35,0,2,2
1961,2015,10,2015-11-21,Georgia State,,South Alabama,W (24-10),27,44,61.4,311,1,34,73,2.1,2,78,384,4.9,17,3,0,20,10,112,0,0,0
1962,2015,11,2015-11-27,Georgia State,,Troy,W (31-21),29,41,70.7,368,2,43,151,3.5,2,84,519,6.2,14,7,2,23,7,56,2,0,2
1963,2015,12,2015-12-05,Georgia State,@,Georgia Southern,W (34-7),20,32,62.5,346,3,37,143,3.9,2,69,489,7.1,14,8,1,23,8,103,0,1,1
1964,2015,13,2015-12-19,Georgia State,N,San Jose State*,L (16-27),14,29,48.3,208,2,20,23,1.2,0,49,231,4.7,9,1,1,11,6,73,0,1,1
1965,2015,,13 Games,Georgia State,,,,308,496,62.1,4367,28,407,1260,3.1,15,903,5627,6.2,169,70,22,261,92,850,11,12,23
1966,2016,1,2016-09-02,Georgia State,,Ball State,L (21-31),25,40,62.5,195,1,25,77,3.1,1,65,272,4.2,11,6,2,19,6,52,1,1,2
1967,2016,2,2016-09-10,Georgia State,@,Air Force,L (14-48),9,27,33.3,142,1,14,27,1.9,1,41,169,4.1,6,0,0,6,5,25,0,0,0
1968,2016,3,2016-09-17,Georgia State,@,Wisconsin,L (17-23),20,30,66.7,269,1,24,33,1.4,1,54,302,5.6,10,2,0,12,5,45,0,0,0
1969,2016,4,2016-10-01,Georgia State,@,Appalachian State,L (3-17),19,44,43.2,153,0,25,88,3.5,0,69,241,3.5,10,4,2,16,7,70,0,4,4
1970,2016,5,2016-10-08,Georgia State,,Texas State,W (41-21),27,40,67.5,340,2,37,196,5.3,3,77,536,7.0,12,9,2,23,6,59,3,0,3
1971,2016,6,2016-10-15,Georgia State,@,Troy,L (21-31),28,52,53.8,381,3,24,37,1.5,0,76,418,5.5,16,5,3,24,10,48,1,2,3
1972,2016,7,2016-10-22,Georgia State,,Tennessee-Martin,W (31-6),8,16,50.0,119,1,39,166,4.3,1,55,285,5.2,4,9,0,13,7,54,0,2,2
1973,2016,8,2016-10-29,Georgia State,@,South Alabama,L (10-13),11,18,61.1,113,0,40,127,3.2,1,58,240,4.1,5,8,1,14,5,37,1,0,1
1974,2016,9,2016-11-03,Georgia State,,Arkansas State,L (16-31),22,46,47.8,237,1,31,94,3.0,0,77,331,4.3,10,7,2,19,7,65,0,2,2
1975,2016,10,2016-11-12,Georgia State,,Louisiana-Monroe,L (23-37),19,30,63.3,422,3,26,42,1.6,0,56,464,8.3,11,5,0,16,6,47,0,0,0
1976,2016,11,2016-11-19,Georgia State,,Georgia Southern,W (30-24),21,39,53.8,318,2,27,73,2.7,2,66,391,5.9,13,4,3,20,5,49,0,0,0
1977,2016,12,2016-12-03,Georgia State,@,Idaho,L (12-37),22,37,59.5,266,2,24,92,3.8,0,61,358,5.9,12,4,3,19,4,30,2,4,6
1978,2016,,12 Games,Georgia State,,,,231,419,55.1,2955,17,336,1052,3.1,10,755,4007,5.3,120,63,18,201,73,581,8,15,23
1979,2017,1,2017-08-31,Georgia State,,Tennessee State,L (10-17),18,23,78.3,224,1,28,51,1.8,0,51,275,5.4,8,2,4,14,6,51,3,1,4
1980,2017,2,2017-09-16,Georgia State,@,Penn State,L (0-56),18,32,56.3,170,0,49,150,3.1,0,81,320,4.0,9,10,2,21,3,25,2,3,5
1981,2017,3,2017-09-23,Georgia State,@,UNC Charlotte,W (28-0),26,37,70.3,250,1,40,119,3.0,2,77,369,4.8,13,9,0,22,1,5,0,0,0
1982,2017,4,2017-10-07,Georgia State,@,Coastal Carolina,W (27-21),18,30,60.0,273,1,40,91,2.3,2,70,364,5.2,12,7,3,22,6,45,0,1,1
1983,2017,5,2017-10-14,Georgia State,@,Louisiana-Monroe,W (47-37),26,35,74.3,446,4,41,224,5.5,2,76,670,8.8,18,13,0,31,8,72,0,0,0
1984,2017,6,2017-10-21,Georgia State,,Troy,L (10-34),25,40,62.5,255,1,33,52,1.6,0,73,307,4.2,10,6,0,16,2,20,0,1,1
1985,2017,7,2017-10-26,Georgia State,,South Alabama,W (21-13),17,31,54.8,195,2,32,118,3.7,1,63,313,5.0,10,4,2,16,7,63,1,0,1
1986,2017,8,2017-11-04,Georgia State,@,Georgia Southern,W (21-17),22,37,59.5,319,2,24,49,2.0,0,61,368,6.0,12,2,1,15,10,99,0,1,1
1987,2017,9,2017-11-11,Georgia State,@,Texas State,W (33-30),26,40,65.0,368,2,41,162,4.0,1,81,530,6.5,11,10,0,21,7,64,2,0,2
1988,2017,10,2017-11-25,Georgia State,,Appalachian State,L (10-31),22,35,62.9,201,0,26,91,3.5,1,61,292,4.8,8,4,2,14,6,75,0,1,1
1989,2017,11,2017-12-02,Georgia State,,Idaho,L (10-24),27,45,60.0,271,0,39,164,4.2,1,84,435,5.2,16,9,1,26,2,20,3,1,4
1990,2017,12,2017-12-16,Georgia State,N,Western Kentucky*,W (27-17),20,28,71.4,276,1,43,143,3.3,2,71,419,5.9,9,10,2,21,4,30,1,0,1
1991,2017,,12 Games,Georgia State,,,,265,413,64.2,3248,15,436,1414,3.2,12,849,4662,5.5,136,86,17,239,62,569,12,9,21
1992,2014,1,2014-08-30,Georgia Tech,,Wofford,W (38-19),11,16,68.8,282,2,43,226,5.3,3,59,508,8.6,9,12,0,21,5,50,0,0,0
1993,2014,2,2014-09-06,Georgia Tech,@,Tulane,W (38-21),3,8,37.5,15,0,57,344,6.0,4,65,359,5.5,2,20,2,24,4,35,2,1,3
1994,2014,3,2014-09-13,Georgia Tech,,Georgia Southern,W (42-38),11,24,45.8,188,4,53,348,6.6,2,77,536,7.0,7,19,2,28,4,55,0,0,0
1995,2014,4,2014-09-20,Georgia Tech,@,Virginia Tech,W (27-24),7,18,38.9,125,1,44,250,5.7,1,62,375,6.0,6,12,1,19,8,60,1,0,1
1996,2014,5,2014-10-04,Georgia Tech,,Miami (FL),W (28-17),4,7,57.1,53,0,65,318,4.9,4,72,371,5.2,2,18,1,21,7,69,0,0,0
1997,2014,6,2014-10-11,Georgia Tech,,Duke,L (25-31),14,26,53.8,201,0,46,282,6.1,3,72,483,6.7,9,17,0,26,8,69,1,2,3
1998,2014,7,2014-10-18,Georgia Tech,@,North Carolina,L (43-48),8,18,44.4,235,3,51,376,7.4,3,69,611,8.9,7,22,0,29,5,32,1,0,1
1999,2014,8,2014-10-25,Georgia Tech,@,Pittsburgh,W (56-28),5,12,41.7,147,1,64,465,7.3,7,76,612,8.1,4,23,0,27,3,15,1,0,1
2000,2014,9,2014-11-01,Georgia Tech,,Virginia,W (35-10),7,13,53.8,141,3,63,268,4.3,2,76,409,5.4,6,15,2,23,4,30,0,1,1
2001,2014,10,2014-11-08,Georgia Tech,@,North Carolina State,W (56-23),7,8,87.5,70,1,64,479,7.5,5,72,549,7.6,4,24,2,30,8,62,2,0,2
2002,2014,11,2014-11-15,Georgia Tech,,Clemson,W (28-6),8,11,72.7,102,1,50,251,5.0,0,61,353,5.8,6,9,1,16,2,10,2,0,2
2003,2014,12,2014-11-29,Georgia Tech,@,Georgia,W (30-24),6,16,37.5,64,1,70,399,5.7,3,86,463,5.4,4,27,1,32,5,24,2,0,2
2004,2014,13,2014-12-06,Georgia Tech,N,Florida State,L (35-37),8,14,57.1,134,1,59,331,5.6,4,73,465,6.4,8,19,1,28,3,20,0,1,1
2005,2014,14,2014-12-31,Georgia Tech,N,Mississippi State*,W (49-34),7,12,58.3,125,1,61,452,7.4,6,73,577,7.9,4,22,0,26,3,45,0,1,1
2006,2014,,14 Games,Georgia Tech,,,,106,203,52.2,1882,19,790,4789,6.1,47,993,6671,6.7,78,259,13,350,69,576,12,6,18
2007,2015,1,2015-09-03,Georgia Tech,,Alcorn State,W (69-6),4,5,80.0,77,1,52,476,9.2,9,57,553,9.7,4,20,2,26,0,0,1,0,1
2008,2015,2,2015-09-12,Georgia Tech,,Tulane,W (65-10),8,10,80.0,132,3,56,439,7.8,6,66,571,8.7,7,21,0,28,2,24,1,0,1
2009,2015,3,2015-09-19,Georgia Tech,@,Notre Dame,L (22-30),8,24,33.3,121,2,47,216,4.6,1,71,337,4.7,6,12,3,21,4,30,1,0,1
2010,2015,4,2015-09-26,Georgia Tech,@,Duke,L (20-34),6,22,27.3,143,1,60,173,2.9,1,82,316,3.9,5,11,0,16,1,5,1,1,2
2011,2015,5,2015-10-03,Georgia Tech,,North Carolina,L (31-38),12,21,57.1,162,1,59,255,4.3,3,80,417,5.2,8,17,2,27,4,39,1,1,2
2012,2015,6,2015-10-10,Georgia Tech,@,Clemson,L (24-43),6,14,42.9,159,2,42,71,1.7,0,56,230,4.1,5,6,1,12,5,50,0,1,1
2013,2015,7,2015-10-17,Georgia Tech,,Pittsburgh,L (28-31),6,15,40.0,106,1,40,376,9.4,3,55,482,8.8,3,15,1,19,5,54,1,1,2
2014,2015,8,2015-10-24,Georgia Tech,,Florida State,W (22-16),4,10,40.0,67,0,49,261,5.3,1,59,328,5.6,2,12,1,15,5,41,0,2,2
2015,2015,9,2015-10-31,Georgia Tech,@,Virginia,L (21-27),13,31,41.9,251,2,33,144,4.4,1,64,395,6.2,12,6,0,18,6,42,2,0,2
2016,2015,10,2015-11-12,Georgia Tech,,Virginia Tech,L (21-23),4,13,30.8,97,0,47,161,3.4,2,60,258,4.3,4,6,5,15,3,26,3,0,3
2017,2015,11,2015-11-21,Georgia Tech,@,Miami (FL),L (21-38),4,9,44.4,59,0,57,314,5.5,3,66,373,5.7,3,16,0,19,1,5,2,2,4
2018,2015,12,2015-11-28,Georgia Tech,,Georgia,L (7-13),6,18,33.3,82,1,41,194,4.7,0,59,276,4.7,4,11,2,17,2,13,1,2,3
2019,2015,,12 Games,Georgia Tech,,,,81,192,42.2,1456,14,583,3080,5.3,30,775,4536,5.9,63,153,17,233,38,329,14,10,24
2020,2016,1,2016-09-03,Georgia Tech,N,Boston College,W (17-14),8,15,53.3,119,0,44,119,2.7,2,59,238,4.0,4,7,1,12,3,28,1,0,1
2021,2016,2,2016-09-10,Georgia Tech,,Mercer,W (35-10),5,10,50.0,80,0,52,364,7.0,5,62,444,7.2,3,20,2,25,1,10,2,0,2
2022,2016,3,2016-09-17,Georgia Tech,,Vanderbilt,W (38-7),8,16,50.0,222,2,46,289,6.3,3,62,511,8.2,5,14,2,21,4,55,0,1,1
2023,2016,4,2016-09-22,Georgia Tech,,Clemson,L (7-26),4,14,28.6,29,0,38,95,2.5,1,52,124,2.4,1,7,3,11,2,15,0,1,1
2024,2016,5,2016-10-01,Georgia Tech,,Miami (FL),L (21-35),11,19,57.9,94,1,54,267,4.9,2,73,361,4.9,5,17,0,22,4,41,2,1,3
2025,2016,6,2016-10-08,Georgia Tech,@,Pittsburgh,L (34-37),7,10,70.0,130,1,45,241,5.4,2,55,371,6.7,5,13,0,18,5,46,0,0,0
2026,2016,7,2016-10-15,Georgia Tech,,Georgia Southern,W (35-24),7,11,63.6,172,1,44,265,6.0,4,55,437,7.9,7,11,1,19,3,30,0,0,0
2027,2016,8,2016-10-29,Georgia Tech,,Duke,W (38-35),10,14,71.4,264,2,47,341,7.3,3,61,605,9.9,9,11,0,20,8,46,2,0,2
2028,2016,9,2016-11-05,Georgia Tech,@,North Carolina,L (20-48),4,9,44.4,144,1,59,374,6.3,1,68,518,7.6,4,19,1,24,4,26,2,0,2
2029,2016,10,2016-11-12,Georgia Tech,@,Virginia Tech,W (30-20),2,7,28.6,34,0,58,309,5.3,3,65,343,5.3,1,12,2,15,7,35,1,0,1
2030,2016,11,2016-11-19,Georgia Tech,,Virginia,W (31-17),5,10,50.0,122,1,31,199,6.4,2,41,321,7.8,4,4,0,8,4,50,0,0,0
2031,2016,12,2016-11-26,Georgia Tech,@,Georgia,W (28-27),6,10,60.0,164,0,42,226,5.4,4,52,390,7.5,5,10,0,15,4,45,1,1,2
2032,2016,13,2016-12-31,Georgia Tech,N,Kentucky*,W (33-18),6,14,42.9,105,0,51,266,5.2,2,65,371,5.7,4,15,2,21,8,74,0,0,0
2033,2016,,13 Games,Georgia Tech,,,,83,159,52.2,1679,9,611,3355,5.5,34,770,5034,6.5,57,160,14,231,57,501,11,4,15
2034,2017,1,2017-09-04,Georgia Tech,N,Tennessee,L (41-42),5,10,50.0,120,0,86,535,6.2,6,96,655,6.8,4,29,0,33,4,37,2,0,2
2035,2017,2,2017-09-09,Georgia Tech,,Jacksonville State,W (37-10),5,7,71.4,112,3,49,210,4.3,2,56,322,5.8,5,8,4,17,8,70,0,0,0
2036,2017,3,2017-09-23,Georgia Tech,,Pittsburgh,W (35-17),4,7,57.1,48,0,67,436,6.5,5,74,484,6.5,2,21,2,25,4,18,4,0,4
2037,2017,4,2017-09-30,Georgia Tech,,North Carolina,W (33-7),5,10,50.0,53,1,66,403,6.1,3,76,456,6.0,3,18,1,22,1,5,2,0,2
2038,2017,5,2017-10-14,Georgia Tech,@,Miami (FL),L (24-25),3,7,42.9,55,1,53,226,4.3,1,60,281,4.7,1,14,1,16,1,6,1,0,1
2039,2017,6,2017-10-21,Georgia Tech,,Wake Forest,W (38-24),5,11,45.5,68,0,66,427,6.5,5,77,495,6.4,5,21,3,29,5,45,0,0,0
2040,2017,7,2017-10-28,Georgia Tech,@,Clemson,L (10-24),3,13,23.1,32,0,43,198,4.6,1,56,230,4.1,2,7,1,10,2,20,1,0,1
2041,2017,8,2017-11-04,Georgia Tech,@,Virginia,L (36-40),6,22,27.3,179,1,52,220,4.2,3,74,399,5.4,5,11,0,16,6,45,0,2,2
2042,2017,9,2017-11-11,Georgia Tech,,Virginia Tech,W (28-22),2,8,25.0,140,2,57,261,4.6,2,65,401,6.2,2,15,2,19,5,45,0,1,1
2043,2017,10,2017-11-18,Georgia Tech,@,Duke,L (20-43),3,14,21.4,82,1,47,277,5.9,2,61,359,5.9,2,13,0,15,5,63,0,1,1
2044,2017,11,2017-11-25,Georgia Tech,,Georgia,L (7-38),2,9,22.2,38,1,46,188,4.1,0,55,226,4.1,1,11,0,12,3,40,0,1,1
2045,2017,,11 Games,Georgia Tech,,,,43,118,36.4,927,10,632,3381,5.3,30,750,4308,5.7,32,168,14,214,44,394,10,5,15
2046,2016,1,2016-09-10,Grambling State,@,Arizona,L (21-31),31,44,70.5,402,2,36,60,1.7,1,80,462,5.8,19,7,2,28,12,86,3,3,6
2047,2017,1,2017-09-02,Grambling State,@,Tulane,L (14-43),15,27,55.6,148,0,22,77,3.5,2,49,225,4.6,6,3,1,10,11,80,0,1,1
2048,2014,1,2014-08-30,Hawaii,,Washington,L (16-17),23,43,53.5,207,0,54,217,4.0,1,97,424,4.4,11,13,2,26,5,36,0,0,0
2049,2014,2,2014-09-06,Hawaii,,Oregon State,L (30-38),20,51,39.2,236,0,33,100,3.0,4,84,336,4.0,8,7,5,20,12,108,1,1,2
2050,2014,3,2014-09-13,Hawaii,,Northern Iowa,W (27-24),17,36,47.2,225,1,50,148,3.0,1,86,373,4.3,10,6,1,17,5,45,1,0,1
2051,2014,4,2014-09-20,Hawaii,@,Colorado,L (12-21),17,46,37.0,155,0,32,131,4.1,0,78,286,3.7,7,8,5,20,2,15,1,1,2
2052,2014,5,2014-10-04,Hawaii,@,Rice,L (14-28),12,27,44.4,117,2,45,144,3.2,0,72,261,3.6,4,11,2,17,5,40,1,1,2
2053,2014,6,2014-10-11,Hawaii,,Wyoming,W (38-28),17,26,65.4,281,3,50,232,4.6,2,76,513,6.8,14,10,1,25,3,40,3,0,3
2054,2014,7,2014-10-18,Hawaii,@,San Diego State,L (10-20),17,31,54.8,174,1,25,90,3.6,0,56,264,4.7,7,5,0,12,7,40,1,2,3
2055,2014,8,2014-10-25,Hawaii,,Nevada,L (18-26),18,32,56.3,201,1,29,102,3.5,1,61,303,5.0,8,7,1,16,3,25,1,1,2
2056,2014,9,2014-11-01,Hawaii,,Utah State,L (14-35),26,48,54.2,356,1,31,98,3.2,1,79,454,5.7,14,9,0,23,13,100,1,2,3
2057,2014,10,2014-11-08,Hawaii,@,Colorado State,L (22-49),17,49,34.7,211,1,36,141,3.9,1,85,352,4.1,12,7,2,21,2,30,1,2,3
2058,2014,11,2014-11-15,Hawaii,@,San Jose State,W (13-0),9,16,56.3,150,0,40,90,2.3,1,56,240,4.3,5,6,0,11,6,45,0,1,1
2059,2014,12,2014-11-22,Hawaii,,Nevada-Las Vegas,W (37-35),14,23,60.9,230,2,56,348,6.2,3,79,578,7.3,8,14,1,23,7,50,2,1,3
2060,2014,13,2014-11-29,Hawaii,@,Fresno State,L (21-28),22,39,56.4,247,3,46,106,2.3,0,85,353,4.2,11,7,4,22,10,76,0,2,2
2061,2014,,13 Games,Hawaii,,,,229,467,49.0,2790,15,527,1947,3.7,15,994,4737,4.8,119,110,24,253,80,650,13,14,27
2062,2015,1,2015-09-03,Hawaii,,Colorado,W (28-20),19,38,50.0,202,3,34,100,2.9,0,72,302,4.2,8,4,2,14,9,50,0,2,2
2063,2015,2,2015-09-12,Hawaii,@,Ohio State,L (0-38),8,26,30.8,85,0,35,80,2.3,0,61,165,2.7,4,6,2,12,6,36,2,2,4
2064,2015,3,2015-09-19,Hawaii,,California-Davis,W (47-27),17,24,70.8,272,2,31,193,6.2,3,55,465,8.5,13,5,4,22,7,42,1,0,1
2065,2015,4,2015-09-26,Hawaii,@,Wisconsin,L (0-28),16,34,47.1,240,0,18,15,0.8,0,52,255,4.9,9,1,1,11,11,100,0,0,0
2066,2015,5,2015-10-03,Hawaii,@,Boise State,L (0-55),11,38,28.9,88,0,30,82,2.7,0,68,170,2.5,5,4,3,12,7,61,1,3,4
2067,2015,6,2015-10-10,Hawaii,,San Diego State,L (14-28),19,39,48.7,198,0,28,53,1.9,2,67,251,3.7,6,4,4,14,4,30,1,2,3
2068,2015,7,2015-10-17,Hawaii,@,New Mexico,L (27-28),13,25,52.0,195,1,50,220,4.4,2,75,415,5.5,12,10,1,23,11,94,0,2,2
2069,2015,8,2015-10-24,Hawaii,@,Nevada,L (20-30),27,40,67.5,291,2,24,34,1.4,0,64,325,5.1,16,2,1,19,10,79,1,3,4
2070,2015,9,2015-10-31,Hawaii,,Air Force,L (7-58),15,35,42.9,180,0,12,-2,-0.2,0,47,178,3.8,7,0,0,7,9,86,2,2,4
2071,2015,10,2015-11-07,Hawaii,@,Nevada-Las Vegas,L (21-41),16,33,48.5,187,0,31,191,6.2,3,64,378,5.9,8,6,2,16,5,52,2,1,3
2072,2015,11,2015-11-14,Hawaii,,Fresno State,L (14-42),20,49,40.8,245,1,39,192,4.9,1,88,437,5.0,13,11,1,25,11,132,1,3,4
2073,2015,12,2015-11-21,Hawaii,,San Jose State,L (23-42),13,25,52.0,202,2,38,213,5.6,1,63,415,6.6,7,10,1,18,9,61,1,1,2
2074,2015,13,2015-11-28,Hawaii,,Louisiana-Monroe,W (28-26),8,16,50.0,116,1,54,240,4.4,3,70,356,5.1,5,14,3,22,8,74,1,0,1
2075,2015,,13 Games,Hawaii,,,,202,422,47.9,2501,12,424,1611,3.8,15,846,4112,4.9,113,77,25,215,107,897,13,21,34
2076,2016,1,2016-08-26,Hawaii,N,California,L (31-51),17,34,50.0,234,1,38,248,6.5,3,72,482,6.7,11,13,2,26,6,52,2,1,3
2077,2016,2,2016-09-03,Hawaii,@,Michigan,L (3-63),12,23,52.2,151,0,37,81,2.2,0,60,232,3.9,7,7,2,16,8,60,0,2,2
2078,2016,3,2016-09-10,Hawaii,,Tennessee-Martin,W (41-36),10,20,50.0,203,4,37,175,4.7,2,57,378,6.6,6,9,0,15,7,52,0,3,3
2079,2016,4,2016-09-17,Hawaii,@,Arizona,L (28-47),21,43,48.8,261,1,38,168,4.4,3,81,429,5.3,13,9,3,25,12,95,1,1,2
2080,2016,5,2016-10-01,Hawaii,,Nevada,W (38-17),15,18,83.3,222,2,40,344,8.6,3,58,566,9.8,9,13,2,24,10,90,1,0,1
2081,2016,6,2016-10-08,Hawaii,@,San Jose State,W (34-17),24,33,72.7,287,2,31,144,4.6,2,64,431,6.7,13,6,1,20,9,85,2,0,2
2082,2016,7,2016-10-15,Hawaii,,Nevada-Las Vegas,L (38-41),17,32,53.1,217,2,33,229,6.9,3,65,446,6.9,9,8,3,20,7,61,1,0,1
2083,2016,8,2016-10-22,Hawaii,@,Air Force,W (34-27),21,37,56.8,312,3,26,75,2.9,1,63,387,6.1,16,3,0,19,4,46,0,2,2
2084,2016,9,2016-10-29,Hawaii,,New Mexico,L (21-28),16,28,57.1,173,0,40,125,3.1,3,68,298,4.4,9,6,1,16,1,10,1,0,1
2085,2016,10,2016-11-05,Hawaii,@,San Diego State,L (0-55),25,45,55.6,167,0,27,48,1.8,0,72,215,3.0,12,3,0,15,8,69,0,4,4
2086,2016,11,2016-11-12,Hawaii,,Boise State,L (16-52),16,32,50.0,125,1,32,234,7.3,0,64,359,5.6,6,9,0,15,10,79,1,1,2
2087,2016,12,2016-11-19,Hawaii,@,Fresno State,W (14-13),20,31,64.5,227,0,23,49,2.1,2,54,276,5.1,7,3,1,11,11,89,0,1,1
2088,2016,13,2016-11-26,Hawaii,,Massachusetts,W (46-40),22,31,71.0,311,5,33,168,5.1,1,64,479,7.5,9,10,4,23,12,101,1,0,1
2089,2016,14,2016-12-24,Hawaii,N,Middle Tennessee State*,W (52-35),21,31,67.7,295,4,42,205,4.9,2,73,500,6.8,10,8,0,18,11,114,0,0,0
2090,2016,,14 Games,Hawaii,,,,257,438,58.7,3185,25,477,2293,4.8,25,915,5478,6.0,137,107,19,263,116,1003,10,15,25
2091,2017,1,2017-08-26,Hawaii,@,Massachusetts,W (38-35),25,38,65.8,391,3,35,112,3.2,2,73,503,6.9,12,6,0,18,9,88,0,1,1
2092,2017,2,2017-09-02,Hawaii,,Western Carolina,W (41-18),12,24,50.0,154,2,49,299,6.1,3,73,453,6.2,7,15,1,23,11,104,0,2,2
2093,2017,3,2017-09-09,Hawaii,@,UCLA,L (23-56),24,39,61.5,234,2,42,281,6.7,1,81,515,6.4,12,9,4,25,8,80,0,1,1
2094,2017,4,2017-09-23,Hawaii,@,Wyoming,L (21-28),29,40,72.5,280,1,38,170,4.5,2,78,450,5.8,13,9,2,24,10,96,0,2,2
2095,2017,5,2017-09-30,Hawaii,,Colorado State,L (21-51),31,47,66.0,362,2,21,150,7.1,1,68,512,7.5,15,6,0,21,7,41,1,0,1
2096,2017,6,2017-10-07,Hawaii,@,Nevada,L (21-35),18,27,66.7,229,2,35,248,7.1,1,62,477,7.7,8,11,1,20,11,114,1,1,2
2097,2017,7,2017-10-14,Hawaii,,San Jose State,W (37-26),13,24,54.2,177,2,50,274,5.5,3,74,451,6.1,9,13,1,23,7,41,1,0,1
2098,2017,8,2017-10-28,Hawaii,,San Diego State,L (7-28),19,33,57.6,160,0,23,35,1.5,1,56,195,3.5,7,1,4,12,6,46,0,0,0
2099,2017,9,2017-11-04,Hawaii,@,Nevada-Las Vegas,L (23-31),24,47,51.1,269,1,28,131,4.7,1,75,400,5.3,12,9,2,23,6,65,0,0,0
2100,2017,10,2017-11-11,Hawaii,,Fresno State,L (21-31),18,31,58.1,154,2,37,118,3.2,0,68,272,4.0,7,8,1,16,4,36,1,1,2
2101,2017,11,2017-11-18,Hawaii,@,Utah State,L (0-38),19,35,54.3,146,0,47,172,3.7,0,82,318,3.9,7,12,1,20,8,60,1,0,1
2102,2017,12,2017-11-25,Hawaii,,Brigham Young,L (20-30),28,38,73.7,258,2,15,28,1.9,0,53,286,5.4,11,2,0,13,6,55,1,0,1
2103,2017,,12 Games,Hawaii,,,,260,423,61.5,2814,19,420,2018,4.8,15,843,4832,5.7,120,101,17,238,93,826,6,8,14
2104,2017,1,2017-08-31,Holy Cross,@,Connecticut,L (20-27),33,56,58.9,358,1,26,89,3.4,1,82,447,5.5,18,4,2,24,10,65,1,0,1
2105,2014,1,2014-08-29,Houston,,Texas-San Antonio,L (7-27),25,50,50.0,234,0,23,-26,-1.1,1,73,208,2.8,10,4,4,18,9,47,2,4,6
2106,2014,2,2014-09-06,Houston,,Grambling State,W (47-0),15,26,57.7,202,1,40,275,6.9,3,66,477,7.2,8,8,4,20,5,30,2,0,2
2107,2014,3,2014-09-11,Houston,@,Brigham Young,L (25-33),31,53,58.5,315,3,13,10,0.8,0,66,325,4.9,14,1,3,18,8,83,0,0,0
2108,2014,4,2014-09-20,Houston,,Nevada-Las Vegas,W (47-14),12,29,41.4,135,2,52,399,7.7,4,81,534,6.6,6,19,5,30,9,110,0,2,2
2109,2014,5,2014-10-02,Houston,,Central Florida,L (12-17),22,43,51.2,214,0,33,117,3.5,0,76,331,4.4,7,9,4,20,11,99,1,2,3
2110,2014,6,2014-10-11,Houston,@,Memphis,W (28-24),17,28,60.7,188,1,40,166,4.2,3,68,354,5.2,8,6,1,15,3,32,2,1,3
2111,2014,7,2014-10-17,Houston,,Temple,W (31-10),29,33,87.9,268,2,49,171,3.5,1,82,439,5.4,10,11,2,23,10,102,0,0,0
2112,2014,8,2014-11-01,Houston,@,South Florida,W (27-3),15,19,78.9,89,1,47,217,4.6,3,66,306,4.6,5,14,2,21,1,5,0,0,0
2113,2014,9,2014-11-08,Houston,,Tulane,L (24-31),30,49,61.2,336,2,32,90,2.8,0,81,426,5.3,13,8,4,25,6,51,0,4,4
2114,2014,10,2014-11-22,Houston,,Tulsa,W (38-28),16,21,76.2,227,1,43,244,5.7,4,64,471,7.4,9,12,0,21,5,47,0,0,0
2115,2014,11,2014-11-28,Houston,@,Southern Methodist,W (35-9),18,29,62.1,151,0,48,282,5.9,5,77,433,5.6,11,12,2,25,4,28,0,1,1
2116,2014,12,2014-12-06,Houston,N,Cincinnati,L (31-38),27,45,60.0,360,2,35,234,6.7,2,80,594,7.4,12,14,1,27,4,37,0,1,1
2117,2014,13,2015-01-02,Houston,N,Pittsburgh*,W (35-34),15,25,60.0,274,3,40,212,5.3,2,65,486,7.5,10,12,1,23,9,100,0,0,0
2118,2014,,13 Games,Houston,,,,272,450,60.4,2993,18,495,2391,4.8,28,945,5384,5.7,123,130,33,286,84,771,7,15,22
2119,2015,1,2015-09-05,Houston,,Tennessee Tech,W (52-24),27,38,71.1,355,1,44,272,6.2,6,82,627,7.6,13,14,0,27,9,59,1,0,1
2120,2015,2,2015-09-12,Houston,@,Louisville,W (34-31),23,35,65.7,236,3,57,226,4.0,0,92,462,5.0,11,12,2,25,7,78,0,1,1
2121,2015,3,2015-09-26,Houston,,Texas State,W (59-14),18,24,75.0,323,4,54,366,6.8,3,78,689,8.8,10,19,0,29,10,69,0,0,0
2122,2015,4,2015-10-03,Houston,@,Tulsa,W (38-24),22,38,57.9,273,0,56,365,6.5,5,94,638,6.8,12,13,3,28,3,44,1,0,1
2123,2015,5,2015-10-08,Houston,,Southern Methodist,W (49-28),16,18,88.9,243,0,48,214,4.5,7,66,457,6.9,9,13,1,23,6,55,1,0,1
2124,2015,6,2015-10-16,Houston,@,Tulane,W (42-7),17,25,68.0,222,1,47,239,5.1,4,72,461,6.4,8,12,4,24,10,99,0,1,1
2125,2015,7,2015-10-24,Houston,@,Central Florida,W (59-10),20,28,71.4,234,2,48,366,7.6,5,76,600,7.9,10,17,3,30,7,87,0,0,0
2126,2015,8,2015-10-31,Houston,,Vanderbilt,W (34-0),15,23,65.2,221,1,51,150,2.9,2,74,371,5.0,11,6,2,19,6,55,2,0,2
2127,2015,9,2015-11-07,Houston,,Cincinnati,W (33-30),16,24,66.7,161,2,63,266,4.2,1,87,427,4.9,10,8,6,24,4,40,0,2,2
2128,2015,10,2015-11-14,Houston,,Memphis,W (35-34),26,44,59.1,296,1,31,96,3.1,4,75,392,5.2,14,5,1,20,4,40,0,0,0
2129,2015,11,2015-11-21,Houston,@,Connecticut,L (17-20),17,31,54.8,208,1,33,110,3.3,0,64,318,5.0,8,4,1,13,7,69,2,2,4
2130,2015,12,2015-11-27,Houston,,Navy,W (52-31),27,36,75.0,337,4,44,218,5.0,3,80,555,6.9,14,13,0,27,3,29,0,0,0
2131,2015,13,2015-12-05,Houston,,Temple,W (24-13),12,22,54.5,106,0,40,233,5.8,3,62,339,5.5,5,11,0,16,5,40,0,0,0
2132,2015,14,2015-12-31,Houston,N,Florida State*,W (38-24),28,46,60.9,261,2,53,187,3.5,3,99,448,4.5,14,10,3,27,4,30,0,1,1
2133,2015,,14 Games,Houston,,,,284,432,65.7,3476,22,669,3308,4.9,46,1101,6784,6.2,149,157,26,332,85,794,7,7,14
2134,2016,1,2016-09-03,Houston,N,Oklahoma,W (33-23),23,40,57.5,321,2,40,89,2.2,0,80,410,5.1,16,5,4,25,7,75,1,0,1
2135,2016,2,2016-09-10,Houston,,Lamar,W (42-0),15,26,57.7,130,0,71,381,5.4,6,97,511,5.3,7,17,1,25,2,15,0,1,1
2136,2016,3,2016-09-15,Houston,@,Cincinnati,W (40-16),24,36,66.7,326,1,57,180,3.2,2,93,506,5.4,14,14,0,28,4,45,1,2,3
2137,2016,4,2016-09-24,Houston,@,Texas State,W (64-3),25,32,78.1,320,3,50,243,4.9,5,82,563,6.9,14,14,4,32,0,0,0,0,0
2138,2016,5,2016-09-29,Houston,,Connecticut,W (42-14),40,49,81.6,426,3,30,114,3.8,3,79,540,6.8,20,6,1,27,2,20,0,0,0
2139,2016,6,2016-10-08,Houston,@,Navy,L (40-46),32,50,64.0,359,3,33,125,3.8,2,83,484,5.8,20,8,0,28,4,30,1,2,3
2140,2016,7,2016-10-15,Houston,,Tulsa,W (38-31),26,34,76.5,254,0,55,268,4.9,4,89,522,5.9,15,15,0,30,10,104,2,1,3
2141,2016,8,2016-10-22,Houston,@,Southern Methodist,L (16-38),21,33,63.6,241,2,35,62,1.8,0,68,303,4.5,8,5,0,13,4,55,2,0,2
2142,2016,9,2016-10-29,Houston,,Central Florida,W (31-24),26,37,70.3,240,1,49,158,3.2,3,86,398,4.6,12,10,0,22,6,71,1,3,4
2143,2016,10,2016-11-12,Houston,,Tulane,W (30-18),21,37,56.8,221,2,35,66,1.9,1,72,287,4.0,8,5,1,14,7,55,1,1,2
2144,2016,11,2016-11-17,Houston,,Louisville,W (36-10),27,46,58.7,298,3,33,64,1.9,1,79,362,4.6,15,5,1,21,1,5,0,0,0
2145,2016,12,2016-11-25,Houston,@,Memphis,L (44-48),47,69,68.1,487,4,32,137,4.3,1,101,624,6.2,20,10,3,33,9,69,1,1,2
2146,2016,13,2016-12-17,Houston,N,San Diego State*,L (10-34),25,34,73.5,229,0,41,25,0.6,1,75,254,3.4,9,7,0,16,2,10,0,4,4
2147,2016,,13 Games,Houston,,,,352,523,67.3,3852,24,561,1912,3.4,29,1084,5764,5.3,178,121,15,314,58,554,10,15,25
2148,2017,1,2017-09-09,Houston,@,Arizona,W (19-16),25,32,78.1,225,1,37,158,4.3,1,69,383,5.6,11,6,1,18,10,110,0,2,2
2149,2017,2,2017-09-16,Houston,,Rice,W (38-3),34,38,89.5,354,2,37,130,3.5,3,75,484,6.5,16,6,0,22,2,10,0,0,0
2150,2017,3,2017-09-23,Houston,,Texas Tech,L (24-27),32,52,61.5,317,2,31,110,3.5,1,83,427,5.1,14,8,3,25,6,50,3,2,5
2151,2017,4,2017-09-30,Houston,@,Temple,W (20-13),25,36,69.4,226,1,31,162,5.2,1,67,388,5.8,10,9,4,23,12,108,0,1,1
2152,2017,5,2017-10-07,Houston,,Southern Methodist,W (35-22),20,28,71.4,198,3,40,265,6.6,2,68,463,6.8,10,14,3,27,4,48,0,2,2
2153,2017,6,2017-10-14,Houston,@,Tulsa,L (17-45),25,41,61.0,258,0,47,146,3.1,2,88,404,4.6,13,11,1,25,6,36,1,2,3
2154,2017,7,2017-10-19,Houston,,Memphis,L (38-42),29,41,70.7,315,1,54,239,4.4,4,95,554,5.8,16,9,0,25,8,72,2,1,3
2155,2017,8,2017-10-28,Houston,@,South Florida,W (28-24),14,25,56.0,142,1,48,255,5.3,3,73,397,5.4,5,11,0,16,5,45,1,0,1
2156,2017,9,2017-11-04,Houston,,East Carolina,W (52-27),15,22,68.2,330,3,26,142,5.5,3,48,472,9.8,8,7,1,16,4,34,0,0,0
2157,2017,10,2017-11-18,Houston,@,Tulane,L (17-20),18,26,69.2,225,0,33,220,6.7,2,59,445,7.5,13,8,1,22,5,46,1,1,2
2158,2017,11,2017-11-24,Houston,,Navy,W (24-14),21,27,77.8,277,1,32,103,3.2,2,59,380,6.4,10,5,1,16,4,43,2,0,2
2159,2017,12,2017-12-24,Houston,N,Fresno State*,L (27-33),23,43,53.5,269,1,30,72,2.4,1,73,341,4.7,13,3,1,17,6,44,1,1,2
2160,2017,,12 Games,Houston,,,,281,411,68.4,3136,16,446,2002,4.5,25,857,5138,6.0,139,97,16,252,72,646,11,12,23
2161,2014,1,2014-09-06,Idaho,@,Louisiana-Monroe,L (31-38),26,47,55.3,324,3,36,118,3.3,1,83,442,5.3,15,8,2,25,12,119,1,2,3
2162,2014,2,2014-09-13,Idaho,,Western Michigan,L (33-45),27,41,65.9,362,3,31,45,1.5,1,72,407,5.7,14,4,5,23,8,79,0,1,1
2163,2014,3,2014-09-20,Idaho,@,Ohio,L (24-36),33,56,58.9,353,2,28,64,2.3,1,84,417,5.0,15,7,1,23,4,32,0,3,3
2164,2014,4,2014-09-27,Idaho,,South Alabama,L (10-34),25,40,62.5,239,1,33,30,0.9,0,73,269,3.7,10,4,4,18,7,59,0,2,2
2165,2014,5,2014-10-04,Idaho,@,Texas State,L (30-35),33,52,63.5,347,0,53,176,3.3,4,105,523,5.0,18,13,2,33,4,35,0,2,2
2166,2014,6,2014-10-11,Idaho,@,Georgia Southern,L (24-47),20,32,62.5,271,0,40,94,2.4,3,72,365,5.1,11,6,0,17,3,23,0,1,1
2167,2014,7,2014-10-18,Idaho,,New Mexico State,W (29-17),23,37,62.2,226,1,52,310,6.0,2,89,536,6.0,11,17,2,30,6,57,1,1,2
2168,2014,8,2014-11-01,Idaho,,Arkansas State,L (28-44),17,31,54.8,206,0,46,243,5.3,4,77,449,5.8,11,12,2,25,9,93,4,4,8
2169,2014,9,2014-11-08,Idaho,@,San Diego State,L (21-35),17,33,51.5,186,1,49,193,3.9,2,82,379,4.6,9,13,4,26,4,30,1,0,1
2170,2014,10,2014-11-15,Idaho,,Troy,L (17-34),14,36,38.9,269,1,27,117,4.3,1,63,386,6.1,8,8,3,19,5,40,0,3,3
2171,2014,11,2014-11-29,Idaho,@,Appalachian State,L (28-45),21,37,56.8,208,1,42,157,3.7,3,79,365,4.6,11,6,1,18,12,145,0,1,1
2172,2014,,11 Games,Idaho,,,,256,442,57.9,2991,13,437,1547,3.5,22,879,4538,5.2,133,98,26,257,74,712,7,20,27
2173,2015,1,2015-09-03,Idaho,,Ohio,L (28-45),36,48,75.0,297,1,28,100,3.6,2,76,397,5.2,18,4,3,25,3,31,1,2,3
2174,2015,2,2015-09-12,Idaho,@,Southern California,L (9-59),28,45,62.2,240,1,32,71,2.2,0,77,311,4.0,12,6,1,19,2,23,0,0,0
2175,2015,3,2015-09-19,Idaho,,Wofford,W (41-38),25,34,73.5,334,1,43,198,4.6,3,77,532,6.9,11,11,0,22,6,75,0,2,2
2176,2015,4,2015-09-26,Idaho,,Georgia Southern,L (20-44),20,36,55.6,284,2,34,111,3.3,0,70,395,5.6,10,8,2,20,2,15,0,2,2
2177,2015,5,2015-10-03,Idaho,@,Arkansas State,L (35-49),24,42,57.1,166,0,29,172,5.9,4,71,338,4.8,6,6,7,19,11,105,0,3,3
2178,2015,6,2015-10-17,Idaho,@,Troy,W (19-16),20,37,54.1,207,0,37,123,3.3,1,74,330,4.5,11,6,3,20,6,59,0,0,0
2179,2015,7,2015-10-24,Idaho,,Louisiana-Monroe,W (27-13),23,39,59.0,315,3,52,174,3.3,0,91,489,5.4,15,12,1,28,5,65,2,1,3
2180,2015,8,2015-10-31,Idaho,@,New Mexico State,L (48-55),25,42,59.5,307,2,50,262,5.2,3,92,569,6.2,14,14,2,30,4,30,0,2,2
2181,2015,9,2015-11-07,Idaho,@,South Alabama,L (45-52),26,39,66.7,317,2,45,177,3.9,4,84,494,5.9,15,9,3,27,3,24,2,1,3
2182,2015,10,2015-11-14,Idaho,,Appalachian State,L (20-47),20,32,62.5,243,2,28,56,2.0,0,60,299,5.0,11,5,1,17,5,44,0,0,0
2183,2015,11,2015-11-21,Idaho,@,Auburn,L (34-56),29,48,60.4,356,1,37,123,3.3,3,85,479,5.6,11,10,5,26,4,38,1,2,3
2184,2015,12,2015-11-28,Idaho,,Texas State,W (38-31),21,31,67.7,309,2,43,199,4.6,3,74,508,6.9,12,10,1,23,3,15,2,0,2
2185,2015,,12 Games,Idaho,,,,297,473,62.8,3375,17,458,1766,3.9,23,931,5141,5.5,146,101,29,276,54,524,8,15,23
2186,2016,1,2016-09-01,Idaho,,Montana State,W (20-17),8,22,36.4,128,0,35,225,6.4,2,57,353,6.2,6,9,0,15,5,85,1,1,2
2187,2016,2,2016-09-10,Idaho,@,Washington,L (14-59),23,38,60.5,218,1,38,104,2.7,1,76,322,4.2,9,8,0,17,4,35,2,1,3
2188,2016,3,2016-09-17,Idaho,@,Washington State,L (6-56),20,37,54.1,179,0,31,78,2.5,0,68,257,3.8,10,2,3,15,6,80,2,0,2
2189,2016,4,2016-09-24,Idaho,@,Nevada-Las Vegas,W (33-30),17,35,48.6,249,1,36,129,3.6,2,71,378,5.3,11,7,3,21,5,40,1,0,1
2190,2016,5,2016-10-01,Idaho,,Troy,L (13-34),19,34,55.9,166,1,36,89,2.5,0,70,255,3.6,10,7,2,19,4,40,0,2,2
2191,2016,6,2016-10-08,Idaho,@,Louisiana-Monroe,W (34-31),21,38,55.3,211,1,33,203,6.2,1,71,414,5.8,10,7,1,18,7,61,0,0,0
2192,2016,7,2016-10-15,Idaho,,New Mexico State,W (55-23),31,39,79.5,482,4,42,169,4.0,3,81,651,8.0,24,7,3,34,5,40,0,1,1
2193,2016,8,2016-10-22,Idaho,@,Appalachian State,L (19-37),26,41,63.4,294,1,26,63,2.4,0,67,357,5.3,16,5,3,24,3,37,0,3,3
2194,2016,9,2016-11-05,Idaho,@,Louisiana,W (23-13),20,30,66.7,227,0,40,157,3.9,2,70,384,5.5,14,7,1,22,4,45,0,0,0
2195,2016,10,2016-11-12,Idaho,@,Texas State,W (47-14),26,33,78.8,336,1,40,154,3.9,5,73,490,6.7,14,7,2,23,14,103,0,0,0
2196,2016,11,2016-11-26,Idaho,,South Alabama,W (38-31),17,34,50.0,231,2,35,176,5.0,3,69,407,5.9,11,11,5,27,4,45,0,3,3
2197,2016,12,2016-12-03,Idaho,,Georgia State,W (37-12),16,20,80.0,138,3,45,149,3.3,0,65,287,4.4,7,8,1,16,5,45,0,0,0
2198,2016,13,2016-12-22,Idaho,N,Colorado State*,W (61-50),21,31,67.7,381,4,51,225,4.4,5,82,606,7.4,16,13,1,30,7,69,0,0,0
2199,2016,,13 Games,Idaho,,,,265,432,61.3,3240,19,488,1921,3.9,24,920,5161,5.6,158,98,25,281,73,725,6,11,17
2200,2017,1,2017-08-31,Idaho,,Sacramento State,W (28-6),14,19,73.7,163,2,44,197,4.5,2,63,360,5.7,4,11,0,15,3,20,1,2,3
2201,2017,2,2017-09-09,Idaho,,Nevada-Las Vegas,L (16-44),22,34,64.7,261,1,36,123,3.4,1,70,384,5.5,11,6,1,18,4,40,0,1,1
2202,2017,3,2017-09-16,Idaho,@,Western Michigan,L (28-37),16,26,61.5,229,3,34,170,5.0,1,60,399,6.7,5,8,2,15,6,44,2,1,3
2203,2017,4,2017-09-23,Idaho,@,South Alabama,W (29-23),23,39,59.0,273,1,37,146,3.9,2,76,419,5.5,13,5,6,24,5,51,2,0,2
2204,2017,5,2017-10-07,Idaho,,Louisiana,L (16-21),13,28,46.4,149,0,39,130,3.3,1,67,279,4.2,7,6,0,13,6,60,0,0,0
2205,2017,6,2017-10-14,Idaho,,Appalachian State,L (20-23),15,28,53.6,200,2,36,112,3.1,0,64,312,4.9,6,8,0,14,7,60,2,0,2
2206,2017,7,2017-10-21,Idaho,@,Missouri,L (21-68),22,36,61.1,197,3,38,81,2.1,0,74,278,3.8,8,6,1,15,6,50,1,0,1
2207,2017,8,2017-10-28,Idaho,,Louisiana-Monroe,W (31-23),28,42,66.7,360,3,39,158,4.1,1,81,518,6.4,17,9,1,27,5,56,0,0,0
2208,2017,9,2017-11-02,Idaho,@,Troy,L (21-24),24,35,68.6,288,3,32,90,2.8,0,67,378,5.6,13,6,3,22,5,45,0,0,0
2209,2017,10,2017-11-18,Idaho,,Coastal Carolina,L (7-13),18,26,69.2,177,1,33,100,3.0,0,59,277,4.7,9,5,0,14,8,84,0,1,1
2210,2017,11,2017-11-25,Idaho,@,New Mexico State,L (10-17),19,35,54.3,174,1,38,41,1.1,0,73,215,2.9,8,6,2,16,4,20,1,2,3
2211,2017,12,2017-12-02,Idaho,@,Georgia State,W (24-10),16,30,53.3,228,1,40,147,3.7,2,70,375,5.4,11,6,1,18,5,37,0,0,0
2212,2017,,12 Games,Idaho,,,,230,378,60.8,2699,21,446,1495,3.4,10,824,4194,5.1,112,82,17,211,64,567,9,7,16
2213,2016,1,2016-09-10,Idaho State,@,Colorado,L (7-56),19,41,46.3,61,0,14,35,2.5,1,55,96,1.7,4,1,2,7,8,78,0,1,1
2214,2016,2,2016-09-17,Idaho State,@,Oregon State,L (7-37),28,48,58.3,227,0,23,136,5.9,1,71,363,5.1,11,3,3,17,6,43,1,4,5
2215,2016,,2 Games,Idaho State,,,,47,89,52.8,288,0,37,171,4.6,2,126,459,3.6,15,4,5,24,14,121,1,5,6
2216,2017,1,2017-09-07,Idaho State,@,Utah State,L (13-51),17,31,54.8,190,1,38,113,3.0,1,69,303,4.4,8,6,1,15,6,46,0,2,2
2217,2017,2,2017-09-16,Idaho State,@,Nevada,W (30-28),19,38,50.0,269,2,35,114,3.3,1,73,383,5.2,9,6,3,18,9,80,0,0,0
2218,2017,,2 Games,Idaho State,,,,36,69,52.2,459,3,73,227,3.1,2,142,686,4.8,17,12,4,33,15,126,0,2,2
2219,2014,1,2014-08-30,Illinois,,Youngstown State,W (28-17),24,38,63.2,285,4,22,78,3.5,0,60,363,6.1,12,2,0,14,7,55,1,0,1
2220,2014,2,2014-09-06,Illinois,,Western Kentucky,W (42-34),35,50,70.0,456,3,35,64,1.8,2,85,520,6.1,19,6,3,28,9,69,2,1,3
2221,2014,3,2014-09-13,Illinois,@,Washington,L (19-44),20,30,66.7,279,2,26,72,2.8,0,56,351,6.3,9,5,1,15,11,110,2,1,3
2222,2014,4,2014-09-20,Illinois,,Texas State,W (42-35),25,39,64.1,266,2,27,219,8.1,3,66,485,7.3,12,7,2,21,4,19,0,1,1
2223,2014,5,2014-09-27,Illinois,@,Nebraska,L (14-45),17,38,44.7,261,1,24,78,3.3,1,62,339,5.5,10,4,2,16,7,53,0,3,3
2224,2014,6,2014-10-04,Illinois,,Purdue,L (27-38),36,53,67.9,450,2,25,65,2.6,2,78,515,6.6,16,6,4,26,2,20,1,1,2
2225,2014,7,2014-10-11,Illinois,@,Wisconsin,L (28-38),14,24,58.3,135,2,39,153,3.9,2,63,288,4.6,5,11,4,20,4,50,0,1,1
2226,2014,8,2014-10-25,Illinois,,Minnesota,W (28-24),15,23,65.2,140,1,41,123,3.0,2,64,263,4.1,7,8,1,16,4,36,1,0,1
2227,2014,9,2014-11-01,Illinois,@,Ohio State,L (14-55),13,27,48.1,137,1,42,106,2.5,1,69,243,3.5,5,6,4,15,5,50,2,2,4
2228,2014,10,2014-11-15,Illinois,,Iowa,L (14-30),17,31,54.8,147,2,25,88,3.5,0,56,235,4.2,8,4,0,12,8,59,0,0,0
2229,2014,11,2014-11-22,Illinois,,Penn State,W (16-14),26,42,61.9,215,1,27,68,2.5,0,69,283,4.1,8,5,3,16,3,30,0,0,0
2230,2014,12,2014-11-29,Illinois,@,Northwestern,W (47-33),17,28,60.7,147,3,47,291,6.2,2,75,438,5.8,6,14,3,23,6,50,0,1,1
2231,2014,13,2014-12-26,Illinois,N,Louisiana Tech*,L (18-35),28,47,59.6,329,1,33,122,3.7,1,80,451,5.6,18,6,2,26,9,68,1,1,2
2232,2014,,13 Games,Illinois,,,,287,470,61.1,3247,25,413,1527,3.7,16,883,4774,5.4,135,84,29,248,79,669,10,12,22
2233,2015,1,2015-09-05,Illinois,,Kent State,W (52-3),14,29,48.3,208,5,36,134,3.7,2,65,342,5.3,9,7,3,19,8,80,0,1,1
2234,2015,2,2015-09-12,Illinois,,Western Illinois,W (44-0),38,54,70.4,353,2,40,147,3.7,2,94,500,5.3,19,7,1,27,3,25,3,1,4
2235,2015,3,2015-09-19,Illinois,@,North Carolina,L (14-48),19,38,50.0,172,0,45,227,5.0,2,83,399,4.8,10,10,2,22,8,75,0,1,1
2236,2015,4,2015-09-26,Illinois,,Middle Tennessee State,W (27-25),29,49,59.2,238,1,39,140,3.6,1,88,378,4.3,11,11,3,25,6,55,0,0,0
2237,2015,5,2015-10-03,Illinois,,Nebraska,W (14-13),23,45,51.1,251,2,32,131,4.1,0,77,382,5.0,11,4,2,17,3,35,0,0,0
2238,2015,6,2015-10-10,Illinois,@,Iowa,L (20-29),25,43,58.1,317,1,24,46,1.9,1,67,363,5.4,14,2,4,20,5,45,1,1,2
2239,2015,7,2015-10-24,Illinois,,Wisconsin,L (13-24),22,43,51.2,278,0,13,55,4.2,1,56,333,5.9,13,1,1,15,7,50,1,1,2
2240,2015,8,2015-10-31,Illinois,@,Penn State,L (0-39),17,44,38.6,130,0,27,37,1.4,0,71,167,2.4,8,4,0,12,8,60,0,1,1
2241,2015,9,2015-11-07,Illinois,@,Purdue,W (48-14),21,38,55.3,213,3,41,382,9.3,3,79,595,7.5,10,17,2,29,8,69,0,0,0
2242,2015,10,2015-11-14,Illinois,,Ohio State,L (3-28),23,47,48.9,241,0,25,20,0.8,0,72,261,3.6,10,4,1,15,2,10,2,0,2
2243,2015,11,2015-11-21,Illinois,@,Minnesota,L (23-32),34,48,70.8,279,2,35,154,4.4,0,83,433,5.2,15,11,2,28,3,30,2,1,3
2244,2015,12,2015-11-28,Illinois,N,Northwestern,L (14-24),20,41,48.8,241,0,31,78,2.5,1,72,319,4.4,11,5,0,16,5,55,0,1,1
2245,2015,,12 Games,Illinois,,,,285,519,54.9,2921,16,388,1551,4.0,13,907,4472,4.9,141,83,21,245,66,589,9,8,17
2246,2016,1,2016-09-03,Illinois,,Murray State,W (52-3),16,24,66.7,228,3,40,287,7.2,4,64,515,8.0,9,10,2,21,7,55,0,0,0
2247,2016,2,2016-09-10,Illinois,,North Carolina,L (23-48),17,35,48.6,127,2,36,182,5.1,1,71,309,4.4,5,8,2,15,13,99,1,0,1
2248,2016,3,2016-09-17,Illinois,,Western Michigan,L (10-34),29,42,69.0,312,1,15,3,0.2,0,57,315,5.5,14,1,0,15,7,48,1,1,2
2249,2016,4,2016-10-01,Illinois,@,Nebraska,L (16-31),14,23,60.9,146,0,21,124,5.9,1,44,270,6.1,7,4,1,12,7,48,0,0,0
2250,2016,5,2016-10-08,Illinois,,Purdue,L (31-34),14,23,60.9,184,0,46,315,6.8,3,69,499,7.2,9,12,3,24,12,125,1,0,1
2251,2016,6,2016-10-15,Illinois,@,Rutgers,W (24-7),6,14,42.9,92,1,43,228,5.3,1,57,320,5.6,1,9,0,10,6,60,0,1,1
2252,2016,7,2016-10-22,Illinois,@,Michigan,L (8-41),4,15,26.7,95,1,23,77,3.3,0,38,172,4.5,2,3,1,6,5,45,1,1,2
2253,2016,8,2016-10-29,Illinois,,Minnesota,L (17-40),16,34,47.1,156,1,34,89,2.6,1,68,245,3.6,7,7,3,17,3,33,3,0,3
2254,2016,9,2016-11-05,Illinois,,Michigan State,W (31-27),13,29,44.8,140,2,24,164,6.8,2,53,304,5.7,7,5,2,14,2,10,0,0,0
2255,2016,10,2016-11-12,Illinois,@,Wisconsin,L (3-48),7,24,29.2,101,0,21,99,4.7,0,45,200,4.4,5,5,1,11,5,46,0,4,4
2256,2016,11,2016-11-19,Illinois,,Iowa,L (0-28),19,41,46.3,137,0,24,61,2.5,0,65,198,3.0,7,3,0,10,2,10,1,1,2
2257,2016,12,2016-11-26,Illinois,@,Northwestern,L (21-42),28,54,51.9,377,2,26,57,2.2,1,80,434,5.4,18,6,1,25,6,60,3,1,4
2258,2016,,12 Games,Illinois,,,,183,358,51.1,2095,13,353,1686,4.8,14,711,3781,5.3,91,73,16,180,75,639,11,9,20
2259,2017,1,2017-09-02,Illinois,,Ball State,W (24-21),10,19,52.6,145,1,30,71,2.4,2,49,216,4.4,8,5,1,14,3,30,0,1,1
2260,2017,2,2017-09-09,Illinois,,Western Kentucky,W (20-7),14,25,56.0,107,0,50,193,3.9,1,75,300,4.0,5,12,2,19,9,95,0,1,1
2261,2017,3,2017-09-15,Illinois,@,South Florida,L (23-47),20,40,50.0,287,1,15,67,4.5,2,55,354,6.4,8,3,4,15,15,138,0,3,3
2262,2017,4,2017-09-29,Illinois,,Nebraska,L (6-28),10,16,62.5,106,0,37,93,2.5,0,53,199,3.8,7,6,2,15,5,49,0,1,1
2263,2017,5,2017-10-07,Illinois,@,Iowa,L (16-45),22,45,48.9,246,0,30,200,6.7,1,75,446,5.9,9,10,1,20,5,50,1,3,4
2264,2017,6,2017-10-14,Illinois,,Rutgers,L (24-35),20,38,52.6,308,2,29,86,3.0,1,67,394,5.9,13,4,1,18,8,68,1,2,3
2265,2017,7,2017-10-21,Illinois,@,Minnesota,L (17-24),20,27,74.1,161,1,36,121,3.4,1,63,282,4.5,8,7,0,15,5,45,1,1,2
2266,2017,8,2017-10-28,Illinois,,Wisconsin,L (10-24),9,31,29.0,152,0,33,134,4.1,1,64,286,4.5,6,8,3,17,5,40,1,2,3
2267,2017,9,2017-11-04,Illinois,@,Purdue,L (10-29),12,27,44.4,170,1,35,80,2.3,0,62,250,4.0,4,8,3,15,9,66,0,1,1
2268,2017,10,2017-11-11,Illinois,,Indiana,L (14-24),13,26,50.0,261,2,30,33,1.1,0,56,294,5.3,8,1,1,10,8,73,1,2,3
2269,2017,11,2017-11-18,Illinois,@,Ohio State,L (14-52),4,14,28.6,16,0,28,89,3.2,1,42,105,2.5,1,3,1,5,7,55,1,0,1
2270,2017,12,2017-11-25,Illinois,,Northwestern,L (7-42),14,31,45.2,139,0,33,100,3.0,1,64,239,3.7,6,5,0,11,6,59,1,2,3
2271,2017,,12 Games,Illinois,,,,168,339,49.6,2098,8,386,1267,3.3,11,725,3365,4.6,83,72,19,174,85,768,7,19,26
2272,2016,1,2016-09-10,Illinois State,@,Northwestern,W (9-7),30,41,73.2,287,0,30,85,2.8,1,71,372,5.2,15,8,2,25,9,89,0,2,2
2273,2014,1,2014-08-30,Indiana,,Indiana State,W (28-10),11,18,61.1,111,0,69,455,6.6,4,87,566,6.5,4,24,1,29,4,30,1,1,2
2274,2014,2,2014-09-13,Indiana,@,Bowling Green State,L (42-45),31,41,75.6,347,1,37,235,6.4,5,78,582,7.5,16,11,3,30,11,143,1,0,1
2275,2014,3,2014-09-20,Indiana,@,Missouri,W (31-27),18,33,54.5,252,1,50,241,4.8,3,83,493,5.9,13,11,3,27,5,50,0,0,0
2276,2014,4,2014-09-27,Indiana,,Maryland,L (15-37),14,37,37.8,126,0,47,206,4.4,1,84,332,4.0,6,11,5,22,9,55,0,1,1
2277,2014,5,2014-10-04,Indiana,,North Texas,W (49-24),23,29,79.3,230,3,44,363,8.3,4,73,593,8.1,6,16,0,22,6,55,1,0,1
2278,2014,6,2014-10-11,Indiana,@,Iowa,L (29-45),7,21,33.3,116,1,39,316,8.1,3,60,432,7.2,5,8,0,13,9,110,0,3,3
2279,2014,7,2014-10-18,Indiana,,Michigan State,L (17-56),5,16,31.3,11,0,33,213,6.5,2,49,224,4.6,1,4,2,7,4,25,1,0,1
2280,2014,8,2014-11-01,Indiana,@,Michigan,L (10-34),5,8,62.5,24,0,45,167,3.7,1,53,191,3.6,0,10,0,10,3,25,2,0,2
2281,2014,9,2014-11-08,Indiana,,Penn State,L (7-13),13,28,46.4,68,0,40,153,3.8,0,68,221,3.3,2,9,2,13,10,82,0,2,2
2282,2014,10,2014-11-15,Indiana,@,Rutgers,L (23-45),15,31,48.4,179,1,53,294,5.5,1,84,473,5.6,6,15,1,22,9,82,2,1,3
2283,2014,11,2014-11-22,Indiana,@,Ohio State,L (27-42),11,27,40.7,114,0,36,281,7.8,3,63,395,6.3,6,6,1,13,2,10,0,1,1
2284,2014,12,2014-11-29,Indiana,,Purdue,W (23-16),15,24,62.5,119,0,46,239,5.2,2,70,358,5.1,8,9,1,18,6,61,2,0,2
2285,2014,,12 Games,Indiana,,,,168,313,53.7,1697,7,539,3163,5.9,29,852,4860,5.7,73,134,19,226,78,728,10,9,19
2286,2015,1,2015-09-05,Indiana,,Southern Illinois,W (48-47),19,32,59.4,349,1,42,246,5.9,5,74,595,8.0,13,9,1,23,6,43,0,0,0
2287,2015,2,2015-09-12,Indiana,,Florida International,W (36-22),19,33,57.6,234,1,52,205,3.9,2,85,439,5.2,10,14,1,25,11,110,0,1,1
2288,2015,3,2015-09-19,Indiana,,Western Kentucky,W (38-35),20,27,74.1,355,3,59,284,4.8,1,86,639,7.4,13,18,3,34,5,50,1,0,1
2289,2015,4,2015-09-26,Indiana,@,Wake Forest,W (31-24),19,34,55.9,205,2,52,211,4.1,1,86,416,4.8,12,13,1,26,11,119,0,0,0
2290,2015,5,2015-10-03,Indiana,,Ohio State,L (27-34),17,36,47.2,226,0,55,176,3.2,3,91,402,4.4,11,5,5,21,7,50,0,0,0
2291,2015,6,2015-10-10,Indiana,@,Penn State,L (7-29),15,33,45.5,155,0,33,79,2.4,1,66,234,3.5,7,7,0,14,8,65,0,1,1
2292,2015,7,2015-10-17,Indiana,,Rutgers,L (52-55),32,42,76.2,464,4,34,163,4.8,3,76,627,8.3,21,7,0,28,4,19,1,2,3
2293,2015,8,2015-10-24,Indiana,@,Michigan State,L (26-52),23,37,62.2,308,3,23,81,3.5,1,60,389,6.5,15,3,2,20,6,45,1,1,2
2294,2015,9,2015-11-07,Indiana,,Iowa,L (27-35),16,37,43.2,180,1,39,227,5.8,2,76,407,5.4,13,11,2,26,3,35,0,1,1
2295,2015,10,2015-11-14,Indiana,,Michigan,L (41-48),20,34,58.8,220,1,55,307,5.6,2,89,527,5.9,9,20,3,32,9,79,0,0,0
2296,2015,11,2015-11-21,Indiana,@,Maryland,W (47-28),23,35,65.7,385,4,45,170,3.8,1,80,555,6.9,15,6,3,24,7,55,1,0,1
2297,2015,12,2015-11-28,Indiana,@,Purdue,W (54-36),18,29,62.1,350,4,56,309,5.5,3,85,659,7.8,13,14,4,31,7,54,1,0,1
2298,2015,13,2015-12-26,Indiana,N,Duke*,L (41-44),28,52,53.8,389,3,47,278,5.9,2,99,667,6.7,16,14,3,33,7,54,1,2,3
2299,2015,,13 Games,Indiana,,,,269,461,58.4,3820,27,592,2736,4.6,27,1053,6556,6.2,168,141,28,337,91,778,6,8,14
2300,2016,1,2016-09-01,Indiana,@,Florida International,W (34-13),18,28,64.3,240,1,52,246,4.7,1,80,486,6.1,10,15,1,26,9,74,1,0,1
2301,2016,2,2016-09-10,Indiana,,Ball State,W (30-20),17,27,63.0,266,3,45,187,4.2,0,72,453,6.3,8,11,0,19,8,69,0,0,0
2302,2016,3,2016-09-24,Indiana,,Wake Forest,L (28-33),28,47,59.6,496,3,32,115,3.6,1,79,611,7.7,18,5,2,25,9,84,0,5,5
2303,2016,4,2016-10-01,Indiana,,Michigan State,W (24-21),17,28,60.7,281,3,39,156,4.0,0,67,437,6.5,12,6,1,19,7,60,0,1,1
2304,2016,5,2016-10-08,Indiana,@,Ohio State,L (17-38),14,28,50.0,182,2,40,99,2.5,0,68,281,4.1,6,7,1,14,5,40,1,1,2
2305,2016,6,2016-10-15,Indiana,,Nebraska,L (22-27),24,39,61.5,245,1,30,88,2.9,1,69,333,4.8,12,4,2,18,1,10,0,2,2
2306,2016,7,2016-10-22,Indiana,@,Northwestern,L (14-24),35,59,59.3,317,0,27,84,3.1,1,86,401,4.7,14,6,3,23,5,53,0,2,2
2307,2016,8,2016-10-29,Indiana,,Maryland,W (42-36),17,26,65.4,236,0,57,414,7.3,6,83,650,7.8,14,18,2,34,6,65,0,0,0
2308,2016,9,2016-11-05,Indiana,@,Rutgers,W (33-27),29,41,70.7,420,3,44,147,3.3,2,85,567,6.7,17,6,4,27,4,22,2,2,4
2309,2016,10,2016-11-12,Indiana,,Penn State,L (31-45),24,41,58.5,344,2,41,110,2.7,2,82,454,5.5,15,5,0,20,8,80,5,0,5
2310,2016,11,2016-11-19,Indiana,@,Michigan,L (10-20),14,30,46.7,191,0,36,64,1.8,1,66,255,3.9,9,4,2,15,4,35,0,0,0
2311,2016,12,2016-11-26,Indiana,,Purdue,W (26-24),11,22,50.0,117,1,54,152,2.8,2,76,269,3.5,6,10,1,17,9,70,0,4,4
2312,2016,13,2016-12-28,Indiana,N,Utah*,L (24-26),15,40,37.5,224,2,37,117,3.2,1,77,341,4.4,11,8,3,22,4,24,2,1,3
2313,2016,,13 Games,Indiana,,,,263,456,57.7,3559,21,534,1979,3.7,18,990,5538,5.6,152,105,22,279,79,686,11,18,29
2314,2017,1,2017-08-31,Indiana,,Ohio State,L (21-49),42,68,61.8,420,3,27,17,0.6,0,95,437,4.6,22,1,2,25,5,33,1,2,3
2315,2017,2,2017-09-09,Indiana,@,Virginia,W (34-17),19,30,63.3,197,2,41,111,2.7,1,71,308,4.3,11,7,1,19,7,78,0,1,1
2316,2017,3,2017-09-23,Indiana,,Georgia Southern,W (52-17),11,22,50.0,185,2,47,282,6.0,3,69,467,6.8,5,12,3,20,5,30,0,0,0
2317,2017,4,2017-09-30,Indiana,@,Penn State,L (14-45),15,32,46.9,175,1,47,177,3.8,1,79,352,4.5,8,10,1,19,2,20,3,1,4
2318,2017,5,2017-10-07,Indiana,,Charleston Southern,W (27-0),32,41,78.0,321,2,45,157,3.5,1,86,478,5.6,15,9,1,25,7,60,2,1,3
2319,2017,6,2017-10-14,Indiana,,Michigan,L (20-27),21,43,48.8,198,1,29,80,2.8,1,72,278,3.9,8,3,3,14,5,55,0,2,2
2320,2017,7,2017-10-21,Indiana,@,Michigan State,L (9-17),22,34,64.7,158,0,35,94,2.7,0,69,252,3.7,8,3,3,14,10,115,0,0,0
2321,2017,8,2017-10-28,Indiana,@,Maryland,L (39-42),43,62,69.4,410,5,35,73,2.1,0,97,483,5.0,21,7,7,35,7,70,0,1,1
2322,2017,9,2017-11-04,Indiana,,Wisconsin,L (17-45),20,34,58.8,226,2,21,40,1.9,0,55,266,4.8,9,5,2,16,10,98,1,2,3
2323,2017,10,2017-11-11,Indiana,@,Illinois,W (24-14),32,48,66.7,289,2,42,139,3.3,1,90,428,4.8,13,7,2,22,5,49,0,1,1
2324,2017,11,2017-11-18,Indiana,,Rutgers,W (41-0),17,28,60.7,236,2,48,267,5.6,3,76,503,6.6,11,11,1,23,1,15,0,1,1
2325,2017,12,2017-11-25,Indiana,@,Purdue,L (24-31),32,60,53.3,373,3,32,124,3.9,0,92,497,5.4,13,5,2,20,7,84,0,1,1
2326,2017,,12 Games,Indiana,,,,306,502,61.0,3188,25,449,1561,3.5,11,951,4749,5.0,144,80,28,252,71,707,7,13,20
2327,2016,1,2016-09-10,Indiana State,@,Minnesota,L (28-58),21,37,56.8,247,4,33,109,3.3,0,70,356,5.1,11,7,2,20,4,30,1,0,1
2328,2017,1,2017-09-09,Indiana State,@,Tennessee,L (7-42),9,19,47.4,93,1,38,122,3.2,0,57,215,3.8,6,6,1,13,5,45,0,0,0
2329,2014,1,2014-08-30,Iowa,,Northern Iowa,W (31-23),31,41,75.6,250,2,36,151,4.2,2,77,401,5.2,11,9,6,26,4,35,1,0,1
2330,2014,2,2014-09-06,Iowa,,Ball State,W (17-13),35,55,63.6,342,2,29,113,3.9,0,84,455,5.4,17,9,1,27,3,30,2,0,2
2331,2014,3,2014-09-13,Iowa,,Iowa State,L (17-20),16,24,66.7,146,0,44,129,2.9,2,68,275,4.0,5,12,1,18,6,50,1,1,2
2332,2014,4,2014-09-20,Iowa,@,Pittsburgh,W (24-20),12,18,66.7,178,1,35,133,3.8,2,53,311,5.9,7,8,2,17,2,20,0,1,1
2333,2014,5,2014-09-27,Iowa,@,Purdue,W (24-10),17,37,45.9,245,1,51,175,3.4,2,88,420,4.8,10,11,1,22,3,14,0,1,1
2334,2014,6,2014-10-11,Iowa,,Indiana,W (45-29),21,32,65.6,219,2,44,207,4.7,3,76,426,5.6,6,12,4,22,4,30,0,0,0
2335,2014,7,2014-10-18,Iowa,@,Maryland,L (31-38),32,56,57.1,317,2,31,116,3.7,2,87,433,5.0,11,8,0,19,7,65,2,1,3
2336,2014,8,2014-11-01,Iowa,,Northwestern,W (48-7),17,25,68.0,262,1,46,221,4.8,4,71,483,6.8,12,11,1,24,5,35,1,0,1
2337,2014,9,2014-11-08,Iowa,@,Minnesota,L (14-51),13,26,50.0,121,1,30,84,2.8,1,56,205,3.7,6,6,1,13,1,15,2,1,3
2338,2014,10,2014-11-15,Iowa,@,Illinois,W (30-14),17,24,70.8,283,3,55,304,5.5,1,79,587,7.4,12,13,1,26,1,10,1,0,1
2339,2014,11,2014-11-22,Iowa,,Wisconsin,L (24-26),20,30,66.7,311,2,28,101,3.6,1,58,412,7.1,12,4,3,19,3,22,1,0,1
2340,2014,12,2014-11-28,Iowa,,Nebraska,L (34-37),19,38,50.0,230,2,50,142,2.8,0,88,372,4.2,11,11,2,24,3,21,3,1,4
2341,2014,13,2015-01-02,Iowa,N,Tennessee*,L (28-45),15,31,48.4,177,2,35,244,7.0,2,66,421,6.4,10,9,4,23,4,37,1,1,2
2342,2014,,13 Games,Iowa,,,,265,437,60.6,3081,21,514,2120,4.1,22,951,5201,5.5,130,123,27,280,46,384,15,7,22
2343,2015,1,2015-09-05,Iowa,,Illinois State,W (31-14),16,25,64.0,221,1,44,210,4.8,3,69,431,6.2,10,12,0,22,5,51,1,0,1
2344,2015,2,2015-09-12,Iowa,@,Iowa State,W (31-17),15,25,60.0,215,3,45,260,5.8,1,70,475,6.8,9,13,0,22,6,50,1,0,1
2345,2015,3,2015-09-19,Iowa,,Pittsburgh,W (27-24),27,40,67.5,258,0,29,105,3.6,3,69,363,5.3,11,9,2,22,5,50,0,1,1
2346,2015,4,2015-09-26,Iowa,,North Texas,W (62-16),19,22,86.4,278,2,43,210,4.9,5,65,488,7.5,11,11,1,23,4,24,2,0,2
2347,2015,5,2015-10-03,Iowa,@,Wisconsin,W (10-6),9,21,42.9,77,1,40,144,3.6,0,61,221,3.6,3,8,3,14,6,54,1,1,2
2348,2015,6,2015-10-10,Iowa,,Illinois,W (29-20),15,31,48.4,200,2,51,278,5.5,1,82,478,5.8,6,15,2,23,6,80,0,0,0
2349,2015,7,2015-10-17,Iowa,@,Northwestern,W (40-10),16,27,59.3,198,0,51,294,5.8,5,78,492,6.3,9,14,1,24,5,47,0,1,1
2350,2015,8,2015-10-31,Iowa,,Maryland,W (31-15),12,24,50.0,183,0,44,110,2.5,3,68,293,4.3,9,6,3,18,7,53,1,0,1
2351,2015,9,2015-11-07,Iowa,@,Indiana,W (35-27),19,31,61.3,233,1,44,234,5.3,4,75,467,6.2,13,11,2,26,5,55,0,0,0
2352,2015,10,2015-11-14,Iowa,,Minnesota,W (40-35),19,27,70.4,234,0,48,272,5.7,5,75,506,6.7,12,12,3,27,4,50,0,0,0
2353,2015,11,2015-11-21,Iowa,,Purdue,W (40-20),12,20,60.0,213,3,39,174,4.5,3,59,387,6.6,10,9,2,21,2,20,1,0,1
2354,2015,12,2015-11-27,Iowa,@,Nebraska,W (28-20),9,16,56.3,97,1,28,153,5.5,2,44,250,5.7,3,4,4,11,6,54,1,0,1
2355,2015,13,2015-12-05,Iowa,N,Michigan State,L (13-16),18,27,66.7,216,1,24,52,2.2,0,51,268,5.3,6,5,2,13,5,45,2,1,3
2356,2015,14,2016-01-01,Iowa,N,Stanford*,L (16-45),21,33,63.6,239,2,38,48,1.3,0,71,287,4.0,11,6,1,18,7,50,1,1,2
2357,2015,,14 Games,Iowa,,,,227,369,61.5,2862,17,568,2544,4.5,35,937,5406,5.8,123,135,26,284,73,683,11,5,16
2358,2016,1,2016-09-03,Iowa,,Miami (OH),W (45-21),13,21,61.9,192,1,29,212,7.3,5,50,404,8.1,6,11,0,17,3,35,0,0,0
2359,2016,2,2016-09-10,Iowa,,Iowa State,W (42-3),20,30,66.7,237,3,36,198,5.5,3,66,435,6.6,12,10,3,25,5,35,0,0,0
2360,2016,3,2016-09-17,Iowa,,North Dakota State,L (21-23),13,24,54.2,197,3,25,34,1.4,0,49,231,4.7,5,6,1,12,3,16,0,1,1
2361,2016,4,2016-09-24,Iowa,@,Rutgers,W (14-7),12,23,52.2,162,1,38,193,5.1,1,61,355,5.8,8,11,0,19,7,57,0,0,0
2362,2016,5,2016-10-01,Iowa,,Northwestern,L (31-38),19,27,70.4,204,1,41,79,1.9,3,68,283,4.2,9,6,0,15,6,70,0,1,1
2363,2016,6,2016-10-08,Iowa,@,Minnesota,W (14-7),17,31,54.8,142,0,41,179,4.4,1,72,321,4.5,7,9,1,17,4,32,1,2,3
2364,2016,7,2016-10-15,Iowa,@,Purdue,W (49-35),12,20,60.0,155,2,53,365,6.9,4,73,520,7.1,5,17,2,24,12,94,0,0,0
2365,2016,8,2016-10-22,Iowa,,Wisconsin,L (9-17),17,33,51.5,153,0,27,83,3.1,0,60,236,3.9,9,5,0,14,5,30,0,0,0
2366,2016,9,2016-11-05,Iowa,@,Penn State,L (14-41),18,26,69.2,204,2,26,30,1.2,0,52,234,4.5,8,2,4,14,4,24,0,1,1
2367,2016,10,2016-11-12,Iowa,,Michigan,W (14-13),8,19,42.1,66,1,49,164,3.3,0,68,230,3.4,2,13,2,17,3,24,0,1,1
2368,2016,11,2016-11-19,Iowa,@,Illinois,W (28-0),9,17,52.9,80,0,49,262,5.3,3,66,342,5.2,5,11,0,16,5,40,1,1,2
2369,2016,12,2016-11-25,Iowa,,Nebraska,W (40-10),10,15,66.7,144,3,47,264,5.6,3,62,408,6.6,5,7,1,13,7,70,0,0,0
2370,2016,13,2017-01-02,Iowa,N,Florida*,L (3-30),7,24,29.2,55,0,41,171,4.2,0,65,226,3.5,3,9,2,14,1,10,0,3,3
2371,2016,,13 Games,Iowa,,,,175,310,56.5,1991,17,502,2234,4.5,23,812,4225,5.2,84,117,16,217,65,537,2,10,12
2372,2017,1,2017-09-02,Iowa,,Wyoming,W (24-3),8,15,53.3,125,3,41,138,3.4,0,56,263,4.7,5,9,2,16,3,25,3,1,4
2373,2017,2,2017-09-09,Iowa,@,Iowa State,W (44-41),27,41,65.9,333,5,41,164,4.0,1,82,497,6.1,16,12,1,29,10,84,0,0,0
2374,2017,3,2017-09-16,Iowa,,North Texas,W (31-14),16,27,59.3,197,2,59,238,4.0,2,86,435,5.1,10,15,3,28,6,63,2,0,2
2375,2017,4,2017-09-23,Iowa,,Penn State,L (19-21),13,22,59.1,191,2,23,82,3.6,1,45,273,6.1,6,3,2,11,3,25,1,0,1
2376,2017,5,2017-09-30,Iowa,@,Michigan State,L (10-17),17,32,53.1,207,0,25,19,0.8,1,57,226,4.0,9,2,0,11,7,47,2,0,2
2377,2017,6,2017-10-07,Iowa,,Illinois,W (45-16),18,34,52.9,250,4,38,191,5.0,1,72,441,6.1,10,10,0,20,3,18,1,1,2
2378,2017,7,2017-10-21,Iowa,@,Northwestern,L (10-17),19,33,57.6,223,1,33,89,2.7,0,66,312,4.7,9,5,0,14,6,50,0,1,1
2379,2017,8,2017-10-28,Iowa,,Minnesota,W (17-10),15,27,55.6,190,1,33,125,3.8,1,60,315,5.3,7,6,2,15,6,50,1,1,2
2380,2017,9,2017-11-04,Iowa,,Ohio State,W (55-24),21,32,65.6,244,5,38,243,6.4,1,70,487,7.0,13,8,3,24,5,34,0,0,0
2381,2017,10,2017-11-11,Iowa,@,Wisconsin,L (14-38),8,24,33.3,41,0,26,25,1.0,0,50,66,1.3,2,3,0,5,5,32,2,1,3
2382,2017,11,2017-11-18,Iowa,,Purdue,L (15-24),16,33,48.5,176,1,38,82,2.2,1,71,258,3.6,10,6,1,17,6,56,1,1,2
2383,2017,12,2017-11-24,Iowa,@,Nebraska,W (56-14),13,20,65.0,192,2,47,313,6.7,6,67,505,7.5,4,18,1,23,3,30,0,0,0
2384,2017,13,2017-12-27,Iowa,N,Boston College*,W (27-20),8,15,53.3,99,1,39,101,2.6,2,54,200,3.7,5,6,2,13,3,20,0,0,0
2385,2017,,13 Games,Iowa,,,,199,355,56.1,2468,27,481,1810,3.8,17,836,4278,5.1,106,103,17,226,66,534,13,6,19
2386,2014,1,2014-08-30,Iowa State,,North Dakota State,L (14-34),20,31,64.5,151,0,26,102,3.9,2,57,253,4.4,5,10,1,16,5,31,0,2,2
2387,2014,2,2014-09-06,Iowa State,,Kansas State,L (28-32),22,33,66.7,214,2,37,105,2.8,1,70,319,4.6,13,6,2,21,5,55,0,1,1
2388,2014,3,2014-09-13,Iowa State,@,Iowa,W (20-17),25,36,69.4,255,2,26,82,3.2,0,62,337,5.4,13,4,2,19,4,50,1,0,1
2389,2014,4,2014-09-27,Iowa State,,Baylor,L (28-49),17,39,43.6,212,2,34,127,3.7,2,73,339,4.6,9,6,3,18,7,45,0,1,1
2390,2014,5,2014-10-04,Iowa State,@,Oklahoma State,L (20-37),17,39,43.6,200,2,33,122,3.7,0,72,322,4.5,8,8,1,17,3,45,0,0,0
2391,2014,6,2014-10-11,Iowa State,,Toledo,W (37-30),37,53,69.8,351,3,34,103,3.0,1,87,454,5.2,23,7,4,34,5,50,0,0,0
2392,2014,7,2014-10-18,Iowa State,@,Texas,L (45-48),36,55,65.5,345,3,38,179,4.7,2,93,524,5.6,18,11,1,30,5,59,1,2,3
2393,2014,8,2014-11-01,Iowa State,,Oklahoma,L (14-59),17,45,37.8,247,1,31,87,2.8,1,76,334,4.4,9,5,3,17,4,40,1,0,1
2394,2014,9,2014-11-08,Iowa State,@,Kansas,L (14-34),25,50,50.0,275,2,25,98,3.9,0,75,373,5.0,11,9,2,22,4,26,1,1,2
2395,2014,10,2014-11-22,Iowa State,,Texas Tech,L (31-34),24,38,63.2,304,2,46,265,5.8,2,84,569,6.8,12,14,1,27,3,35,1,0,1
2396,2014,11,2014-11-29,Iowa State,,West Virginia,L (24-37),26,50,52.0,275,2,40,135,3.4,1,90,410,4.6,12,8,2,22,4,35,0,2,2
2397,2014,12,2014-12-06,Iowa State,@,Texas Christian,L (3-55),16,41,39.0,152,0,32,84,2.6,0,73,236,3.2,8,4,1,13,2,19,0,2,2
2398,2014,,12 Games,Iowa State,,,,282,510,55.3,2981,21,402,1489,3.7,12,912,4470,4.9,141,92,23,256,51,490,5,11,16
2399,2015,1,2015-09-05,Iowa State,,Northern Iowa,W (31-7),21,29,72.4,233,2,32,77,2.4,1,61,310,5.1,10,3,2,15,5,48,2,0,2
2400,2015,2,2015-09-12,Iowa State,,Iowa,L (17-31),19,35,54.3,247,2,27,63,2.3,0,62,310,5.0,8,5,5,18,4,45,0,1,1
2401,2015,3,2015-09-19,Iowa State,@,Toledo,L (23-30),26,43,60.5,274,1,49,207,4.2,1,92,481,5.2,13,13,1,27,14,113,1,0,1
2402,2015,4,2015-10-03,Iowa State,,Kansas,W (38-13),27,37,73.0,269,2,37,243,6.6,3,74,512,6.9,12,11,1,24,2,10,0,2,2
2403,2015,5,2015-10-10,Iowa State,@,Texas Tech,L (31-66),15,30,50.0,180,1,45,315,7.0,3,75,495,6.6,6,13,0,19,4,45,0,3,3
2404,2015,6,2015-10-17,Iowa State,,Texas Christian,L (21-45),24,38,63.2,346,1,38,115,3.0,2,76,461,6.1,12,8,4,24,8,55,2,0,2
2405,2015,7,2015-10-24,Iowa State,@,Baylor,L (27-45),15,29,51.7,156,3,55,232,4.2,1,84,388,4.6,7,15,1,23,4,30,2,2,4
2406,2015,8,2015-10-31,Iowa State,,Texas,W (24-0),19,38,50.0,188,1,54,238,4.4,2,92,426,4.6,12,13,3,28,4,45,0,0,0
2407,2015,9,2015-11-07,Iowa State,@,Oklahoma,L (16-52),26,51,51.0,260,1,38,114,3.0,0,89,374,4.2,11,11,0,22,5,23,0,1,1
2408,2015,10,2015-11-14,Iowa State,,Oklahoma State,L (31-35),11,22,50.0,162,1,38,249,6.6,3,60,411,6.9,6,12,1,19,3,30,0,1,1
2409,2015,11,2015-11-21,Iowa State,@,Kansas State,L (35-38),15,20,75.0,210,3,44,238,5.4,2,64,448,7.0,11,10,0,21,2,15,4,0,4
2410,2015,12,2015-11-28,Iowa State,@,West Virginia,L (6-30),19,39,48.7,191,0,41,93,2.3,0,80,284,3.6,10,6,1,17,4,30,1,2,3
2411,2015,,12 Games,Iowa State,,,,237,411,57.7,2716,18,498,2184,4.4,18,909,4900,5.4,118,120,19,257,59,489,12,12,24
2412,2016,1,2016-09-03,Iowa State,,Northern Iowa,L (20-25),18,28,64.3,256,3,25,51,2.0,0,53,307,5.8,10,3,3,16,9,89,2,2,4
2413,2016,2,2016-09-10,Iowa State,@,Iowa,L (3-42),14,35,40.0,165,0,35,126,3.6,0,70,291,4.2,8,7,1,16,10,73,0,1,1
2414,2016,3,2016-09-17,Iowa State,@,Texas Christian,L (20-41),19,36,52.8,217,0,47,138,2.9,2,83,355,4.3,7,10,1,18,7,44,0,0,0
2415,2016,4,2016-09-24,Iowa State,,San Jose State,W (44-10),22,29,75.9,316,5,32,187,5.8,1,61,503,8.2,13,9,1,23,3,25,1,0,1
2416,2016,5,2016-10-01,Iowa State,,Baylor,L (42-45),17,23,73.9,261,2,54,204,3.8,4,77,465,6.0,12,12,2,26,9,80,0,0,0
2417,2016,6,2016-10-08,Iowa State,@,Oklahoma State,L (31-38),25,44,56.8,283,3,42,165,3.9,1,86,448,5.2,14,9,3,26,7,41,1,2,3
2418,2016,7,2016-10-15,Iowa State,@,Texas,L (6-27),19,34,55.9,182,0,43,98,2.3,0,77,280,3.6,7,9,3,19,6,64,1,0,1
2419,2016,8,2016-10-29,Iowa State,,Kansas State,L (26-31),24,43,55.8,339,2,31,154,5.0,1,74,493,6.7,16,8,1,25,6,51,0,1,1
2420,2016,9,2016-11-03,Iowa State,,Oklahoma,L (24-34),16,30,53.3,160,2,26,130,5.0,1,56,290,5.2,8,6,1,15,5,45,0,0,0
2421,2016,10,2016-11-12,Iowa State,@,Kansas,W (31-24),21,30,70.0,220,2,46,238,5.2,2,76,458,6.0,12,11,1,24,5,59,0,1,1
2422,2016,11,2016-11-19,Iowa State,,Texas Tech,W (66-10),17,22,77.3,336,2,43,272,6.3,6,65,608,9.4,14,10,0,24,2,25,0,0,0
2423,2016,12,2016-11-26,Iowa State,,West Virginia,L (19-49),23,44,52.3,371,0,34,190,5.6,0,78,561,7.2,12,9,0,21,7,85,3,1,4
2424,2016,,12 Games,Iowa State,,,,235,398,59.0,3106,21,458,1953,4.3,18,856,5059,5.9,133,103,17,253,76,681,8,8,16
2425,2017,1,2017-09-02,Iowa State,,Northern Iowa,W (42-24),27,36,75.0,271,2,35,134,3.8,2,71,405,5.7,16,7,1,24,7,74,0,1,1
2426,2017,2,2017-09-09,Iowa State,,Iowa,L (41-44),25,46,54.3,347,4,26,120,4.6,1,72,467,6.5,14,5,3,22,2,15,0,1,1
2427,2017,3,2017-09-16,Iowa State,@,Akron,W (41-14),24,33,72.7,317,2,37,191,5.2,3,70,508,7.3,12,7,4,23,7,72,0,0,0
2428,2017,4,2017-09-28,Iowa State,,Texas,L (7-17),24,49,49.0,246,1,15,10,0.7,0,64,256,4.0,15,2,1,18,4,40,0,3,3
2429,2017,5,2017-10-07,Iowa State,@,Oklahoma,W (38-31),20,27,74.1,368,3,32,81,2.5,1,59,449,7.6,10,6,5,21,3,17,0,0,0
2430,2017,6,2017-10-14,Iowa State,,Kansas,W (45-0),18,30,60.0,212,1,43,106,2.5,4,73,318,4.4,8,5,2,15,4,38,0,0,0
2431,2017,7,2017-10-21,Iowa State,@,Texas Tech,W (31-13),22,32,68.8,192,3,36,208,5.8,0,68,400,5.9,11,8,1,20,0,0,0,1,1
2432,2017,8,2017-10-28,Iowa State,,Texas Christian,W (14-7),21,35,60.0,202,2,33,53,1.6,0,68,255,3.8,11,2,4,17,4,35,0,1,1
2433,2017,9,2017-11-04,Iowa State,@,West Virginia,L (16-20),27,40,67.5,249,1,29,101,3.5,0,69,350,5.1,13,5,5,23,3,30,0,1,1
2434,2017,10,2017-11-11,Iowa State,,Oklahoma State,L (42-49),30,47,63.8,386,2,29,105,3.6,4,76,491,6.5,18,5,7,30,7,40,0,1,1
2435,2017,11,2017-11-18,Iowa State,@,Baylor,W (23-13),14,28,50.0,180,2,40,214,5.4,0,68,394,5.8,7,13,1,21,4,50,0,0,0
2436,2017,12,2017-11-25,Iowa State,@,Kansas State,L (19-20),24,36,66.7,264,2,30,115,3.8,0,66,379,5.7,10,7,1,18,9,85,0,0,0
2437,2017,13,2017-12-30,Iowa State,@,Memphis*,W (21-20),24,38,63.2,314,2,42,32,0.8,1,80,346,4.3,15,5,2,22,3,20,1,0,1
2438,2017,,13 Games,Iowa State,,,,300,477,62.9,3548,27,427,1470,3.4,16,904,5018,5.6,160,77,37,274,57,516,1,9,10
2439,2016,1,2016-09-01,Jackson State,@,Nevada-Las Vegas,L (13-63),17,43,39.5,144,1,35,108,3.1,0,78,252,3.2,8,6,3,17,2,10,1,2,3
2440,2017,1,2017-09-02,Jackson State,@,Texas Christian,L (0-63),7,14,50.0,41,0,42,24,0.6,0,56,65,1.2,2,3,2,7,3,10,1,1,2
2441,2014,1,2014-09-06,Kansas,,Southeast Missouri State,W (34-28),12,24,50.0,196,3,49,261,5.3,1,73,457,6.3,8,11,1,20,9,80,0,0,0
2442,2014,2,2014-09-13,Kansas,@,Duke,L (3-41),12,29,41.4,95,0,47,202,4.3,0,76,297,3.9,2,13,2,17,7,74,0,2,2
2443,2014,3,2014-09-20,Kansas,,Central Michigan,W (24-10),24,34,70.6,231,2,35,138,3.9,1,69,369,5.3,10,5,0,15,8,65,0,1,1
2444,2014,4,2014-09-27,Kansas,,Texas,L (0-23),12,31,38.7,140,0,51,173,3.4,0,82,313,3.8,6,12,1,19,7,52,0,4,4
2445,2014,5,2014-10-04,Kansas,@,West Virginia,L (14-33),13,28,46.4,111,0,34,65,1.9,1,62,176,2.8,4,4,1,9,11,101,0,0,0
2446,2014,6,2014-10-11,Kansas,,Oklahoma State,L (20-27),20,37,54.1,288,0,41,91,2.2,2,78,379,4.9,12,5,1,18,8,65,0,1,1
2447,2014,7,2014-10-18,Kansas,@,Texas Tech,L (21-34),20,32,62.5,235,2,40,128,3.2,1,72,363,5.0,11,8,0,19,4,37,1,1,2
2448,2014,8,2014-11-01,Kansas,@,Baylor,L (14-60),21,30,70.0,288,2,27,16,0.6,0,57,304,5.3,8,1,3,12,6,60,3,0,3
2449,2014,9,2014-11-08,Kansas,,Iowa State,W (34-14),26,43,60.5,286,1,48,228,4.8,3,91,514,5.6,18,11,0,29,4,32,0,0,0
2450,2014,10,2014-11-15,Kansas,,Texas Christian,L (30-34),20,38,52.6,342,2,36,76,2.1,2,74,418,5.6,13,5,1,19,7,55,0,1,1
2451,2014,11,2014-11-22,Kansas,@,Oklahoma,L (7-44),8,23,34.8,84,0,36,19,0.5,0,59,103,1.7,4,2,1,7,2,20,1,1,2
2452,2014,12,2014-11-29,Kansas,@,Kansas State,L (13-51),16,27,59.3,139,2,22,57,2.6,0,49,196,4.0,8,4,1,13,3,28,0,2,2
2453,2014,,12 Games,Kansas,,,,204,376,54.3,2435,14,466,1454,3.1,11,842,3889,4.6,104,81,12,197,76,669,5,13,18
2454,2015,1,2015-09-05,Kansas,,South Dakota State,L (38-41),25,40,62.5,291,1,51,285,5.6,3,91,576,6.3,15,14,0,29,7,75,1,1,2
2455,2015,2,2015-09-12,Kansas,,Memphis,L (23-55),18,38,47.4,165,0,46,194,4.2,2,84,359,4.3,0,0,0,23,7,68,0,0,0
2456,2015,3,2015-09-26,Kansas,@,Rutgers,L (14-27),19,32,59.4,278,0,29,64,2.2,2,61,342,5.6,15,1,2,18,4,46,0,1,1
2457,2015,4,2015-10-03,Kansas,@,Iowa State,L (13-38),23,37,62.2,250,1,33,38,1.2,0,70,288,4.1,11,4,0,15,5,37,1,0,1
2458,2015,5,2015-10-10,Kansas,,Baylor,L (7-66),20,36,55.6,158,1,39,69,1.8,0,75,227,3.0,7,5,2,14,4,50,2,1,3
2459,2015,6,2015-10-17,Kansas,,Texas Tech,L (20-30),35,50,70.0,330,2,40,145,3.6,1,90,475,5.3,17,7,2,26,5,41,2,1,3
2460,2015,7,2015-10-24,Kansas,@,Oklahoma State,L (10-58),12,31,38.7,191,1,27,30,1.1,0,58,221,3.8,7,2,0,9,10,102,0,2,2
2461,2015,8,2015-10-31,Kansas,,Oklahoma,L (7-62),20,34,58.8,181,1,36,35,1.0,0,70,216,3.1,10,3,2,15,6,81,2,0,2
2462,2015,9,2015-11-07,Kansas,@,Texas,L (20-59),19,41,46.3,234,1,48,192,4.0,1,89,426,4.8,10,13,0,23,3,15,1,3,4
2463,2015,10,2015-11-14,Kansas,@,Texas Christian,L (17-23),20,41,48.8,203,1,30,121,4.0,1,71,324,4.6,7,5,1,13,8,53,0,1,1
2464,2015,11,2015-11-21,Kansas,,West Virginia,L (0-49),13,37,35.1,127,0,30,82,2.7,0,67,209,3.1,3,5,2,10,5,46,1,3,4
2465,2015,12,2015-11-28,Kansas,,Kansas State,L (14-45),19,35,54.3,215,2,35,100,2.9,0,70,315,4.5,10,7,0,17,6,50,0,1,1
2466,2015,,12 Games,Kansas,,,,243,452,53.8,2623,11,444,1355,3.1,10,896,3978,4.4,112,66,11,212,70,664,10,14,24
2467,2016,1,2016-09-03,Kansas,,Rhode Island,W (55-6),28,38,73.7,399,6,35,171,4.9,2,73,570,7.8,16,12,0,28,4,37,1,1,2
2468,2016,2,2016-09-10,Kansas,,Ohio,L (21-37),18,29,62.1,206,2,15,26,1.7,0,44,232,5.3,7,1,1,9,4,50,2,1,3
2469,2016,3,2016-09-17,Kansas,@,Memphis,L (7-43),26,41,63.4,193,0,31,121,3.9,1,72,314,4.4,6,5,3,14,8,41,4,2,6
2470,2016,4,2016-09-29,Kansas,@,Texas Tech,L (19-55),25,48,52.1,250,2,28,46,1.6,0,76,296,3.9,13,4,0,17,7,55,1,1,2
2471,2016,5,2016-10-08,Kansas,,Texas Christian,L (23-24),31,45,68.9,348,0,44,122,2.8,2,89,470,5.3,13,8,2,23,5,61,1,3,4
2472,2016,6,2016-10-15,Kansas,@,Baylor,L (7-49),13,27,48.1,134,0,48,83,1.7,1,75,217,2.9,4,9,2,15,4,35,1,4,5
2473,2016,7,2016-10-22,Kansas,,Oklahoma State,L (20-44),24,40,60.0,250,1,33,204,6.2,1,73,454,6.2,11,8,1,20,5,46,1,2,3
2474,2016,8,2016-10-29,Kansas,@,Oklahoma,L (3-56),21,37,56.8,121,0,28,49,1.8,0,65,170,2.6,4,5,2,11,6,40,0,2,2
2475,2016,9,2016-11-05,Kansas,@,West Virginia,L (21-48),21,36,58.3,291,2,37,150,4.1,1,73,441,6.0,10,6,2,18,9,104,0,2,2
2476,2016,10,2016-11-12,Kansas,,Iowa State,L (24-31),26,38,68.4,171,1,40,244,6.1,2,78,415,5.3,7,16,2,25,1,15,1,1,2
2477,2016,11,2016-11-19,Kansas,,Texas,W (24-21),21,42,50.0,220,0,39,112,2.9,1,81,332,4.1,7,6,2,15,9,85,1,1,2
2478,2016,12,2016-11-26,Kansas,@,Kansas State,L (19-34),24,44,54.5,302,2,27,101,3.7,0,71,403,5.7,8,9,1,18,9,85,1,2,3
2479,2016,,12 Games,Kansas,,,,278,465,59.8,2885,16,405,1429,3.5,11,870,4314,5.0,106,89,18,213,71,654,14,22,36
2480,2017,1,2017-09-02,Kansas,,Southeast Missouri State,W (38-16),23,37,62.2,364,4,25,73,2.9,1,62,437,7.0,12,4,1,17,5,49,1,2,3
2481,2017,2,2017-09-09,Kansas,,Central Michigan,L (27-45),32,62,51.6,323,0,34,147,4.3,3,96,470,4.9,20,7,2,29,9,65,0,2,2
2482,2017,3,2017-09-16,Kansas,@,Ohio,L (30-42),30,47,63.8,343,2,32,108,3.4,2,79,451,5.7,17,5,1,23,7,50,0,1,1
2483,2017,4,2017-09-23,Kansas,,West Virginia,L (34-56),17,34,50.0,197,1,50,367,7.3,3,84,564,6.7,8,13,3,24,8,43,1,2,3
2484,2017,5,2017-10-07,Kansas,,Texas Tech,L (19-65),23,43,53.5,256,1,33,112,3.4,1,76,368,4.8,9,7,1,17,4,35,2,2,4
2485,2017,6,2017-10-14,Kansas,@,Iowa State,L (0-45),11,26,42.3,44,0,33,62,1.9,0,59,106,1.8,1,3,1,5,8,75,1,1,2
2486,2017,7,2017-10-21,Kansas,@,Texas Christian,L (0-43),8,18,44.4,46,0,31,-25,-0.8,0,49,21,0.4,1,1,2,4,4,40,0,0,0
2487,2017,8,2017-10-28,Kansas,,Kansas State,L (20-30),23,48,47.9,418,1,28,64,2.3,1,76,482,6.3,14,6,0,20,4,42,1,1,2
2488,2017,9,2017-11-04,Kansas,,Baylor,L (9-38),19,36,52.8,163,0,33,126,3.8,0,69,289,4.2,6,8,1,15,4,30,1,1,2
2489,2017,10,2017-11-11,Kansas,@,Texas,L (27-42),27,43,62.8,268,3,35,96,2.7,0,78,364,4.7,11,7,1,19,5,45,1,3,4
2490,2017,11,2017-11-18,Kansas,,Oklahoma,L (3-41),19,34,55.9,123,0,27,32,1.2,0,61,155,2.5,6,2,2,10,5,60,1,1,2
2491,2017,12,2017-11-25,Kansas,@,Oklahoma State,L (17-58),17,32,53.1,172,2,30,69,2.3,0,62,241,3.9,8,3,0,11,3,19,0,1,1
2492,2017,,12 Games,Kansas,,,,249,460,54.1,2717,14,391,1231,3.1,11,851,3948,4.6,113,66,15,194,66,553,9,17,26
2493,2014,1,2014-08-30,Kansas State,,Stephen F. Austin,W (55-16),20,30,66.7,238,3,51,240,4.7,4,81,478,5.9,13,16,0,29,3,15,0,1,1
2494,2014,2,2014-09-06,Kansas State,@,Iowa State,W (32-28),16,29,55.2,239,0,41,232,5.7,4,70,471,6.7,9,12,3,24,10,77,0,0,0
2495,2014,3,2014-09-18,Kansas State,,Auburn,L (14-20),24,40,60.0,245,0,30,40,1.3,2,70,285,4.1,13,4,3,20,0,0,1,2,3
2496,2014,4,2014-09-27,Kansas State,,Texas-El Paso,W (58-28),13,19,68.4,263,1,37,188,5.1,6,56,451,8.1,9,7,0,16,6,55,1,0,1
2497,2014,5,2014-10-04,Kansas State,,Texas Tech,W (45-13),24,31,77.4,290,4,50,245,4.9,2,81,535,6.6,13,12,4,29,1,15,1,0,1
2498,2014,6,2014-10-18,Kansas State,@,Oklahoma,W (31-30),15,23,65.2,225,2,32,160,5.0,1,55,385,7.0,8,9,0,17,2,20,0,0,0
2499,2014,7,2014-10-25,Kansas State,,Texas,W (23-0),19,30,63.3,224,0,43,143,3.3,2,73,367,5.0,9,10,3,22,3,25,0,0,0
2500,2014,8,2014-11-01,Kansas State,,Oklahoma State,W (48-14),20,33,60.6,287,2,33,134,4.1,3,66,421,6.4,11,7,3,21,2,15,0,1,1
2501,2014,9,2014-11-08,Kansas State,@,Texas Christian,L (20-41),22,40,55.0,376,2,19,34,1.8,1,59,410,6.9,13,2,1,16,5,68,0,1,1
2502,2014,10,2014-11-20,Kansas State,@,West Virginia,W (26-20),22,34,64.7,400,1,29,1,0.0,0,63,401,6.4,16,0,2,18,10,102,1,1,2
2503,2014,11,2014-11-29,Kansas State,,Kansas,W (51-13),23,30,76.7,311,4,39,194,5.0,2,69,505,7.3,17,10,1,28,6,50,0,0,0
2504,2014,12,2014-12-06,Kansas State,@,Baylor,L (27-38),22,27,81.5,300,2,40,103,2.6,1,67,403,6.0,14,10,3,27,3,30,0,1,1
2505,2014,13,2015-01-02,Kansas State,N,UCLA*,L (35-40),31,49,63.3,338,2,32,31,1.0,2,81,369,4.6,17,5,5,27,6,39,1,1,2
2506,2014,,13 Games,Kansas State,,,,271,415,65.3,3736,23,476,1745,3.7,30,891,5481,6.2,162,104,28,294,57,511,5,8,13
2507,2015,1,2015-09-05,Kansas State,,South Dakota,W (34-0),9,18,50.0,147,1,40,185,4.6,2,58,332,5.7,6,10,0,16,8,66,1,0,1
2508,2015,2,2015-09-12,Kansas State,@,Texas-San Antonio,W (30-3),12,23,52.2,243,0,44,175,4.0,3,67,418,6.2,10,9,3,22,9,85,0,0,0
2509,2015,3,2015-09-19,Kansas State,,Louisiana Tech,W (39-33),15,26,57.7,195,3,45,160,3.6,1,71,355,5.0,8,8,1,17,4,35,1,0,1
2510,2015,4,2015-10-03,Kansas State,@,Oklahoma State,L (34-36),13,25,52.0,207,2,42,144,3.4,3,67,351,5.2,8,9,5,22,9,54,0,1,1
2511,2015,5,2015-10-10,Kansas State,,Texas Christian,L (45-52),13,33,39.4,157,0,48,228,4.8,6,81,385,4.8,8,14,6,28,3,35,1,1,2
2512,2015,6,2015-10-17,Kansas State,,Oklahoma,L (0-55),5,22,22.7,45,0,31,65,2.1,0,53,110,2.1,2,5,0,7,1,5,0,3,3
2513,2015,7,2015-10-24,Kansas State,@,Texas,L (9-23),11,24,45.8,107,1,37,135,3.6,0,61,242,4.0,5,9,1,15,5,27,0,1,1
2514,2015,8,2015-11-05,Kansas State,,Baylor,L (24-31),13,23,56.5,172,1,48,258,5.4,2,71,430,6.1,6,15,1,22,7,39,1,2,3
2515,2015,9,2015-11-14,Kansas State,@,Texas Tech,L (44-59),19,42,45.2,289,2,34,123,3.6,3,76,412,5.4,11,6,2,19,7,55,1,1,2
2516,2015,10,2015-11-21,Kansas State,,Iowa State,W (38-35),19,33,57.6,220,2,41,165,4.0,2,74,385,5.2,11,11,0,22,5,35,1,0,1
2517,2015,11,2015-11-28,Kansas State,@,Kansas,W (45-14),11,20,55.0,137,0,49,226,4.6,5,69,363,5.3,7,12,3,22,1,5,0,1,1
2518,2015,12,2015-12-05,Kansas State,,West Virginia,W (24-23),10,31,32.3,206,1,49,98,2.0,1,80,304,3.8,7,6,2,15,3,35,0,2,2
2519,2015,13,2016-01-02,Kansas State,N,Arkansas*,L (23-45),12,25,48.0,163,1,22,79,3.6,1,47,242,5.1,10,2,1,13,4,25,0,1,1
2520,2015,,13 Games,Kansas State,,,,162,345,47.0,2288,14,530,2041,3.9,29,875,4329,4.9,99,116,25,240,66,501,6,13,19
2521,2016,1,2016-09-02,Kansas State,@,Stanford,L (13-26),19,41,46.3,243,1,32,92,2.9,0,73,335,4.6,11,6,1,18,8,44,0,2,2
2522,2016,2,2016-09-17,Kansas State,,Florida Atlantic,W (63-7),13,18,72.2,159,1,54,336,6.2,7,72,495,6.9,7,15,2,24,13,131,1,0,1
2523,2016,3,2016-09-24,Kansas State,,Missouri State,W (35-0),10,13,76.9,105,2,22,165,7.5,3,35,270,7.7,5,8,0,13,2,24,0,0,0
2524,2016,4,2016-10-01,Kansas State,@,West Virginia,L (16-17),10,30,33.3,166,0,42,120,2.9,1,72,286,4.0,8,7,2,17,6,25,0,1,1
2525,2016,5,2016-10-08,Kansas State,,Texas Tech,W (44-38),10,20,50.0,104,1,39,231,5.9,2,59,335,5.7,7,13,1,21,6,50,0,0,0
2526,2016,6,2016-10-15,Kansas State,@,Oklahoma,L (17-38),20,37,54.1,225,1,32,110,3.4,1,69,335,4.9,12,6,1,19,7,35,0,0,0
2527,2016,7,2016-10-22,Kansas State,,Texas,W (24-21),20,27,74.1,171,1,49,240,4.9,2,76,411,5.4,4,18,5,27,8,75,2,1,3
2528,2016,8,2016-10-29,Kansas State,@,Iowa State,W (31-26),18,28,64.3,151,1,43,247,5.7,3,71,398,5.6,11,14,2,27,4,35,0,0,0
2529,2016,9,2016-11-05,Kansas State,,Oklahoma State,L (37-43),12,18,66.7,87,0,56,345,6.2,4,74,432,5.8,5,16,3,24,4,31,0,1,1
2530,2016,10,2016-11-19,Kansas State,@,Baylor,W (42-21),16,25,64.0,177,0,51,237,4.6,6,76,414,5.4,9,14,2,25,8,85,2,0,2
2531,2016,11,2016-11-26,Kansas State,,Kansas,W (34-19),6,11,54.5,99,0,58,342,5.9,4,69,441,6.4,4,17,4,25,5,60,1,0,1
2532,2016,12,2016-12-03,Kansas State,@,Texas Christian,W (30-6),9,21,42.9,159,1,51,336,6.6,3,72,495,6.9,6,15,0,21,6,61,1,0,1
2533,2016,13,2016-12-28,Kansas State,N,Texas A&M*,W (33-28),14,20,70.0,195,1,41,218,5.3,3,61,413,6.8,6,9,2,17,12,80,0,0,0
2534,2016,,13 Games,Kansas State,,,,177,309,57.3,2041,10,570,3019,5.3,39,879,5060,5.8,95,158,25,278,89,736,7,5,12
2535,2017,1,2017-09-02,Kansas State,,Central Arkansas,W (55-19),10,16,62.5,333,4,31,186,6.0,2,47,519,11.0,8,8,0,16,6,58,0,0,0
2536,2017,2,2017-09-09,Kansas State,,UNC Charlotte,W (55-7),17,23,73.9,189,0,51,304,6.0,5,74,493,6.7,12,15,1,28,5,44,0,0,0
2537,2017,3,2017-09-16,Kansas State,@,Vanderbilt,L (7-14),10,28,35.7,76,0,35,201,5.7,1,63,277,4.4,3,10,0,13,7,68,0,2,2
2538,2017,4,2017-09-30,Kansas State,,Baylor,W (33-20),7,17,41.2,119,1,43,225,5.2,2,60,344,5.7,6,13,0,19,6,45,1,0,1
2539,2017,5,2017-10-07,Kansas State,@,Texas,L (34-40),14,23,60.9,254,2,39,140,3.6,2,62,394,6.4,8,7,1,16,7,70,0,1,1
2540,2017,6,2017-10-14,Kansas State,,Texas Christian,L (6-26),11,30,36.7,146,0,29,70,2.4,0,59,216,3.7,6,3,1,10,5,38,1,0,1
2541,2017,7,2017-10-21,Kansas State,,Oklahoma,L (35-42),12,14,85.7,144,1,42,268,6.4,4,56,412,7.4,4,13,1,18,2,25,1,1,2
2542,2017,8,2017-10-28,Kansas State,@,Kansas,W (30-20),8,13,61.5,138,0,43,202,4.7,2,56,340,6.1,4,11,0,15,6,35,1,0,1
2543,2017,9,2017-11-04,Kansas State,@,Texas Tech,W (42-35),18,28,64.3,263,2,36,145,4.0,2,64,408,6.4,14,6,4,24,6,46,0,1,1
2544,2017,10,2017-11-11,Kansas State,,West Virginia,L (23-28),13,26,50.0,159,0,42,173,4.1,2,68,332,4.9,6,7,1,14,5,61,0,2,2
2545,2017,11,2017-11-18,Kansas State,@,Oklahoma State,W (45-40),10,13,76.9,204,3,49,217,4.4,2,62,421,6.8,7,10,1,18,6,41,1,0,1
2546,2017,12,2017-11-25,Kansas State,,Iowa State,W (20-19),16,22,72.7,155,2,30,109,3.6,1,52,264,5.1,7,4,1,12,4,45,0,0,0
2547,2017,13,2017-12-26,Kansas State,N,UCLA*,W (35-17),10,17,58.8,79,1,49,344,7.0,4,66,423,6.4,4,14,3,21,2,20,0,1,1
2548,2017,,13 Games,Kansas State,,,,156,270,57.8,2259,16,519,2584,5.0,29,789,4843,6.1,89,121,14,224,67,596,5,8,13
2549,2014,1,2014-08-30,Kent State,,Ohio,L (14-17),30,41,73.2,264,2,22,31,1.4,0,63,295,4.7,16,1,0,17,8,44,0,0,0
2550,2014,2,2014-09-06,Kent State,,South Alabama,L (13-23),17,40,42.5,213,2,28,64,2.3,0,68,277,4.1,10,4,1,15,6,45,0,1,1
2551,2014,3,2014-09-13,Kent State,@,Ohio State,L (0-66),15,34,44.1,79,0,23,47,2.0,0,57,126,2.2,3,3,4,10,8,62,0,3,3
2552,2014,4,2014-09-27,Kent State,@,Virginia,L (13-45),17,35,48.6,246,1,33,34,1.0,0,68,280,4.1,13,2,3,18,7,60,2,3,5
2553,2014,5,2014-10-04,Kent State,@,Northern Illinois,L (14-17),20,38,52.6,244,0,37,83,2.2,1,75,327,4.4,12,7,3,22,3,27,0,0,0
2554,2014,6,2014-10-11,Kent State,,Massachusetts,L (17-40),22,42,52.4,191,1,27,150,5.6,1,69,341,4.9,8,8,3,19,6,80,0,1,1
2555,2014,7,2014-10-18,Kent State,,Army,W (39-17),27,40,67.5,360,3,24,107,4.5,1,64,467,7.3,15,5,1,21,5,53,0,1,1
2556,2014,8,2014-10-25,Kent State,@,Miami (OH),L (3-10),22,40,55.0,206,0,27,79,2.9,0,67,285,4.3,12,5,1,18,3,17,0,1,1
2557,2014,9,2014-11-04,Kent State,,Toledo,L (20-30),19,41,46.3,163,2,19,171,9.0,1,60,334,5.6,9,6,2,17,7,74,1,2,3
2558,2014,10,2014-11-12,Kent State,@,Bowling Green State,L (20-30),27,47,57.4,306,3,14,22,1.6,0,61,328,5.4,15,3,3,21,6,62,1,4,5
2559,2014,11,2014-11-28,Kent State,,Akron,W (27-24),28,45,62.2,298,2,23,112,4.9,2,68,410,6.0,13,5,2,20,6,50,0,1,1
2560,2014,,11 Games,Kent State,,,,244,443,55.1,2570,16,277,900,3.2,6,720,3470,4.8,126,49,23,198,65,574,4,17,21
2561,2015,1,2015-09-05,Kent State,@,Illinois,L (3-52),19,40,47.5,186,0,39,59,1.5,0,79,245,3.1,8,6,1,15,11,82,1,3,4
2562,2015,2,2015-09-12,Kent State,,Delaware State,W (45-13),18,26,69.2,214,3,65,278,4.3,2,91,492,5.4,9,15,1,25,12,114,3,0,3
2563,2015,3,2015-09-19,Kent State,@,Minnesota,L (7-10),10,28,35.7,63,0,31,79,2.5,0,59,142,2.4,3,3,2,8,7,89,0,0,0
2564,2015,4,2015-09-26,Kent State,,Marshall,L (29-36),13,34,38.2,189,2,55,247,4.5,2,89,436,4.9,7,10,3,20,11,82,1,0,1
2565,2015,5,2015-10-03,Kent State,,Miami (OH),W (20-14),12,21,57.1,136,1,41,214,5.2,1,62,350,5.6,6,7,0,13,7,57,1,0,1
2566,2015,6,2015-10-10,Kent State,@,Toledo,L (7-38),14,32,43.8,134,0,32,123,3.8,0,64,257,4.0,4,8,1,13,9,83,0,1,1
2567,2015,7,2015-10-17,Kent State,@,Massachusetts,W (15-10),20,25,80.0,135,1,50,192,3.8,0,75,327,4.4,8,9,1,18,9,103,0,1,1
2568,2015,8,2015-10-24,Kent State,,Bowling Green State,L (0-48),12,25,48.0,111,0,26,55,2.1,0,51,166,3.3,4,4,2,10,8,69,0,2,2
2569,2015,9,2015-11-05,Kent State,,Buffalo,L (17-18),19,31,61.3,155,1,31,106,3.4,0,62,261,4.2,7,8,2,17,3,45,0,1,1
2570,2015,10,2015-11-10,Kent State,@,Ohio,L (0-27),16,31,51.6,111,0,25,80,3.2,0,56,191,3.4,5,22,1,8,7,63,0,2,2
2571,2015,11,2015-11-18,Kent State,,Central Michigan,L (14-27),9,26,34.6,98,1,32,180,5.6,1,58,278,4.8,6,9,0,15,2,20,2,0,2
2572,2015,12,2015-11-27,Kent State,@,Akron,L (0-20),13,24,54.2,125,0,20,10,0.5,0,44,135,3.1,4,2,1,7,7,65,3,0,3
2573,2015,,12 Games,Kent State,,,,175,343,51.0,1657,9,447,1623,3.6,6,790,3280,4.2,71,103,15,169,93,872,11,10,21
2574,2016,1,2016-09-03,Kent State,@,Penn State,L (13-33),14,28,50.0,129,0,41,150,3.7,0,69,279,4.0,6,8,2,16,6,47,1,2,3
2575,2016,2,2016-09-10,Kent State,,North Carolina A&T,L (36-39),17,32,53.1,182,3,46,93,2.0,1,78,275,3.5,11,4,0,15,10,82,1,1,2
2576,2016,3,2016-09-17,Kent State,,Monmouth,W (27-7),15,20,75.0,108,2,46,235,5.1,1,66,343,5.2,4,12,1,17,6,55,1,0,1
2577,2016,4,2016-09-24,Kent State,@,Alabama,L (0-48),7,16,43.8,84,0,30,82,2.7,0,46,166,3.6,2,2,1,5,0,0,1,0,1
2578,2016,5,2016-10-01,Kent State,,Akron,L (27-31),19,36,52.8,285,2,41,138,3.4,1,77,423,5.5,11,8,1,20,8,75,0,0,0
2579,2016,6,2016-10-08,Kent State,@,Buffalo,W (44-20),7,13,53.8,89,0,45,341,7.6,4,58,430,7.4,4,12,1,17,2,12,0,0,0
2580,2016,7,2016-10-15,Kent State,@,Miami (OH),L (14-18),8,14,57.1,99,0,48,163,3.4,2,62,262,4.2,2,11,1,14,5,39,0,2,2
2581,2016,8,2016-10-22,Kent State,,Ohio,L (10-14),12,29,41.4,101,0,49,163,3.3,1,78,264,3.4,6,9,3,18,2,20,0,0,0
2582,2016,9,2016-10-29,Kent State,@,Central Michigan,W (27-24),10,18,55.6,102,1,42,228,5.4,2,60,330,5.5,6,8,0,14,5,44,1,1,2
2583,2016,10,2016-11-08,Kent State,,Western Michigan,L (21-37),9,21,42.9,73,0,34,220,6.5,2,55,293,5.3,5,12,0,17,5,50,0,1,1
2584,2016,11,2016-11-15,Kent State,@,Bowling Green State,L (7-42),15,28,53.6,245,1,22,9,0.4,0,50,254,5.1,8,2,0,10,8,58,0,0,0
2585,2016,12,2016-11-25,Kent State,,Northern Illinois,L (21-31),14,37,37.8,203,2,29,188,6.5,1,66,391,5.9,8,5,2,15,6,57,0,1,1
2586,2016,,12 Games,Kent State,,,,147,292,50.3,1700,11,473,2010,4.2,15,765,3710,4.8,73,93,12,178,63,539,5,8,13
2587,2017,1,2017-09-02,Kent State,@,Clemson,L (3-56),1,5,20.0,1,0,44,119,2.7,0,49,120,2.4,0,4,1,5,11,79,0,0,0
2588,2017,2,2017-09-09,Kent State,,Howard,W (38-31),8,16,50.0,105,2,53,294,5.5,3,69,399,5.8,5,12,0,17,13,132,2,0,2
2589,2017,3,2017-09-16,Kent State,@,Marshall,L (0-21),7,17,41.2,117,0,44,142,3.2,0,61,259,4.2,5,8,1,14,8,80,0,1,1
2590,2017,4,2017-09-23,Kent State,@,Louisville,L (3-42),2,5,40.0,11,0,54,139,2.6,0,59,150,2.5,0,10,1,11,5,45,2,1,3
2591,2017,5,2017-09-30,Kent State,,Buffalo,L (13-27),19,31,61.3,320,1,40,124,3.1,0,71,444,6.3,12,9,3,24,10,99,0,1,1
2592,2017,6,2017-10-07,Kent State,@,Northern Illinois,L (3-24),6,17,35.3,29,0,43,102,2.4,0,60,131,2.2,1,7,1,9,5,43,1,3,4
2593,2017,7,2017-10-14,Kent State,,Miami (OH),W (17-14),10,18,55.6,161,2,44,167,3.8,0,62,328,5.3,5,7,0,12,3,39,0,0,0
2594,2017,8,2017-10-21,Kent State,@,Ohio,L (3-48),7,17,41.2,64,0,35,102,2.9,0,52,166,3.2,1,5,1,7,9,74,1,1,2
2595,2017,9,2017-10-31,Kent State,,Bowling Green State,L (16-44),16,35,45.7,140,0,32,144,4.5,2,67,284,4.2,7,10,3,20,5,55,1,3,4
2596,2017,10,2017-11-08,Kent State,@,Western Michigan,L (20-48),13,24,54.2,119,0,37,162,4.4,3,61,281,4.6,5,7,0,12,6,56,2,2,4
2597,2017,11,2017-11-14,Kent State,,Central Michigan,L (23-42),16,30,53.3,320,2,47,174,3.7,1,77,494,6.4,12,12,1,25,10,109,1,1,2
2598,2017,12,2017-11-21,Kent State,@,Akron,L (14-24),9,19,47.4,85,1,45,161,3.6,1,64,246,3.8,4,8,1,13,9,84,1,2,3
2599,2017,,12 Games,Kent State,,,,114,234,48.7,1472,8,518,1830,3.5,10,752,3302,4.4,57,99,13,169,94,895,11,15,26
2600,2014,1,2014-08-30,Kentucky,,Tennessee-Martin,W (59-14),22,33,66.7,422,1,28,234,8.4,6,61,656,10.8,13,8,3,24,6,59,0,0,0
2601,2014,2,2014-09-06,Kentucky,,Ohio,W (20-3),17,31,54.8,170,1,52,232,4.5,1,83,402,4.8,8,15,1,24,4,45,0,0,0
2602,2014,3,2014-09-13,Kentucky,@,Florida,L (30-36),24,45,53.3,369,3,33,81,2.5,0,78,450,5.8,14,6,3,23,8,61,0,3,3
2603,2014,4,2014-09-27,Kentucky,,Vanderbilt,W (17-7),23,30,76.7,201,1,50,183,3.7,1,80,384,4.8,10,13,0,23,5,55,2,1,3
2604,2014,5,2014-10-04,Kentucky,,South Carolina,W (45-38),20,30,66.7,208,1,36,239,6.6,4,66,447,6.8,9,12,1,22,8,80,1,0,1
2605,2014,6,2014-10-11,Kentucky,,Louisiana-Monroe,W (48-14),16,30,53.3,216,3,29,136,4.7,1,59,352,6.0,7,6,2,15,6,54,0,1,1
2606,2014,7,2014-10-18,Kentucky,@,Louisiana State,L (3-41),19,36,52.8,146,0,27,71,2.6,0,63,217,3.4,6,5,1,12,5,55,0,0,0
2607,2014,8,2014-10-25,Kentucky,,Mississippi State,L (31-45),25,44,56.8,401,2,32,103,3.2,2,76,504,6.6,16,7,0,23,3,25,1,0,1
2608,2014,9,2014-11-01,Kentucky,@,Missouri,L (10-20),19,37,51.4,158,1,35,100,2.9,0,72,258,3.6,5,6,3,14,9,65,0,1,1
2609,2014,10,2014-11-08,Kentucky,,Georgia,L (31-63),16,31,51.6,139,1,47,214,4.6,3,78,353,4.5,8,12,2,22,3,25,0,1,1
2610,2014,11,2014-11-15,Kentucky,@,Tennessee,L (16-50),13,29,44.8,168,0,34,94,2.8,1,63,262,4.2,7,6,2,15,5,35,0,2,2
2611,2014,12,2014-11-29,Kentucky,@,Louisville,L (40-44),14,29,48.3,176,0,41,151,3.7,2,70,327,4.7,5,9,0,14,4,45,0,2,2
2612,2014,,12 Games,Kentucky,,,,228,405,56.3,2774,14,444,1838,4.1,21,849,4612,5.4,108,105,18,231,66,604,4,11,15
2613,2015,1,2015-09-05,Kentucky,,Louisiana,W (40-33),16,34,47.1,257,3,26,178,6.8,2,60,435,7.3,8,7,3,18,4,54,0,1,1
2614,2015,2,2015-09-12,Kentucky,@,South Carolina,W (26-22),21,29,72.4,192,0,38,207,5.4,3,67,399,6.0,7,12,0,19,7,74,0,1,1
2615,2015,3,2015-09-19,Kentucky,,Florida,L (9-14),8,24,33.3,126,0,41,115,2.8,0,65,241,3.7,5,8,1,14,5,37,0,2,2
2616,2015,4,2015-09-26,Kentucky,,Missouri,W (21-13),22,27,81.5,249,2,38,120,3.2,1,65,369,5.7,8,9,1,18,8,91,0,0,0
2617,2015,5,2015-10-03,Kentucky,,Eastern Kentucky,W (34-27),29,42,69.0,329,3,36,55,1.5,2,78,384,4.9,16,5,3,24,6,46,1,2,3
2618,2015,6,2015-10-15,Kentucky,,Auburn,L (27-30),27,44,61.4,359,0,33,138,4.2,3,77,497,6.5,17,6,2,25,5,37,0,1,1
2619,2015,7,2015-10-24,Kentucky,@,Mississippi State,L (16-42),30,52,57.7,260,0,33,163,4.9,1,85,423,5.0,14,12,4,30,3,30,0,3,3
2620,2015,8,2015-10-31,Kentucky,,Tennessee,L (21-52),16,33,48.5,184,1,32,165,5.2,1,65,349,5.4,8,7,3,18,9,93,1,1,2
2621,2015,9,2015-11-07,Kentucky,@,Georgia,L (3-27),9,23,39.1,101,0,24,79,3.3,0,47,180,3.8,4,4,0,8,7,58,1,2,3
2622,2015,10,2015-11-14,Kentucky,@,Vanderbilt,L (17-21),15,34,44.1,127,1,37,225,6.1,1,71,352,5.0,3,9,0,12,4,31,1,2,3
2623,2015,11,2015-11-21,Kentucky,,UNC Charlotte,W (58-10),16,29,55.2,129,0,44,415,9.4,6,73,544,7.5,7,15,0,22,2,30,1,0,1
2624,2015,12,2015-11-28,Kentucky,,Louisville,L (24-38),9,26,34.6,199,0,37,92,2.5,2,63,291,4.6,6,6,2,14,9,95,1,1,2
2625,2015,,12 Games,Kentucky,,,,218,397,54.9,2512,10,419,1952,4.7,22,816,4464,5.5,103,100,19,222,69,676,6,16,22
2626,2016,1,2016-09-03,Kentucky,,Southern Mississippi,L (35-44),16,25,64.0,313,4,25,96,3.8,1,50,409,8.2,8,5,1,14,6,75,2,1,3
2627,2016,2,2016-09-10,Kentucky,@,Florida,L (7-45),3,14,21.4,55,0,34,94,2.8,1,48,149,3.1,1,6,2,9,2,25,1,3,4
2628,2016,3,2016-09-17,Kentucky,,New Mexico State,W (62-42),18,24,75.0,311,3,51,381,7.5,5,75,692,9.2,12,16,0,28,11,87,2,1,3
2629,2016,4,2016-09-24,Kentucky,,South Carolina,W (17-10),11,19,57.9,135,0,50,216,4.3,2,69,351,5.1,7,14,2,23,4,30,1,1,2
2630,2016,5,2016-10-01,Kentucky,@,Alabama,L (6-34),13,22,59.1,89,0,36,72,2.0,0,58,161,2.8,4,7,1,12,2,15,2,0,2
2631,2016,6,2016-10-08,Kentucky,,Vanderbilt,W (20-13),10,24,41.7,49,0,52,258,5.0,2,76,307,4.0,2,18,0,20,5,42,1,1,2
2632,2016,7,2016-10-22,Kentucky,,Mississippi State,W (40-38),17,33,51.5,292,2,44,262,6.0,1,77,554,7.2,13,12,1,26,2,20,2,0,2
2633,2016,8,2016-10-29,Kentucky,@,Missouri,W (35-21),15,24,62.5,205,2,59,377,6.4,3,83,582,7.0,9,14,2,25,3,25,1,1,2
2634,2016,9,2016-11-05,Kentucky,,Georgia,L (24-27),11,21,52.4,122,0,40,186,4.7,3,61,308,5.0,5,8,3,16,5,40,1,1,2
2635,2016,10,2016-11-12,Kentucky,@,Tennessee,L (36-49),12,29,41.4,192,0,55,443,8.1,4,84,635,7.6,10,16,3,29,6,59,1,1,2
2636,2016,11,2016-11-19,Kentucky,,Austin Peay,W (49-13),8,14,57.1,129,2,35,281,8.0,5,49,410,8.4,4,10,0,14,10,85,0,1,1
2637,2016,12,2016-11-26,Kentucky,@,Louisville,W (41-38),17,29,58.6,352,3,43,229,5.3,2,72,581,8.1,11,10,3,24,4,41,1,1,2
2638,2016,13,2016-12-31,Kentucky,N,Georgia Tech*,L (18-33),19,34,55.9,175,1,36,149,4.1,1,70,324,4.6,10,9,1,20,6,61,1,0,1
2639,2016,,13 Games,Kentucky,,,,170,312,54.5,2419,17,560,3044,5.4,30,872,5463,6.3,96,145,19,260,66,605,16,12,28
2640,2017,1,2017-09-02,Kentucky,@,Southern Mississippi,W (24-17),11,20,55.0,176,1,35,78,2.2,1,55,254,4.6,5,5,2,12,8,60,1,0,1
2641,2017,2,2017-09-09,Kentucky,,Eastern Kentucky,W (27-16),16,24,66.7,229,1,39,207,5.3,2,63,436,6.9,10,9,3,22,6,60,0,0,0
2642,2017,3,2017-09-16,Kentucky,@,South Carolina,W (23-13),16,26,61.5,169,0,47,184,3.9,2,73,353,4.8,11,7,2,20,4,10,1,1,2
2643,2017,4,2017-09-23,Kentucky,,Florida,L (27-28),18,27,66.7,220,3,32,120,3.8,0,59,340,5.8,11,7,3,21,7,55,0,0,0
2644,2017,5,2017-09-30,Kentucky,,Eastern Michigan,W (24-20),18,27,66.7,175,2,37,53,1.4,1,64,228,3.6,9,4,3,16,5,40,1,0,1
2645,2017,6,2017-10-07,Kentucky,,Missouri,W (40-34),22,37,59.5,298,2,39,188,4.8,2,76,486,6.4,14,7,1,22,6,34,0,1,1
2646,2017,7,2017-10-21,Kentucky,@,Mississippi State,L (7-45),14,30,46.7,145,0,29,115,4.0,1,59,260,4.4,8,5,1,14,4,41,0,2,2
2647,2017,8,2017-10-28,Kentucky,,Tennessee,W (29-26),7,16,43.8,82,0,36,289,8.0,4,52,371,7.1,3,13,1,17,4,44,4,0,4
2648,2017,9,2017-11-04,Kentucky,,Mississippi,L (34-37),20,25,80.0,236,1,45,219,4.9,3,70,455,6.5,10,12,1,23,4,40,0,0,0
2649,2017,10,2017-11-11,Kentucky,@,Vanderbilt,W (44-21),13,17,76.5,195,0,47,232,4.9,5,64,427,6.7,8,10,3,21,9,61,1,0,1
2650,2017,11,2017-11-18,Kentucky,@,Georgia,L (13-42),12,23,52.2,138,0,37,124,3.4,1,60,262,4.4,5,10,2,17,2,30,0,1,1
2651,2017,12,2017-11-25,Kentucky,,Louisville,L (17-44),8,19,42.1,110,0,43,228,5.3,2,62,338,5.5,6,13,1,20,7,86,0,0,0
2652,2017,13,2017-12-29,Kentucky,N,Northwestern*,L (23-24),21,39,53.8,273,0,22,65,3.0,3,61,338,5.5,12,3,2,17,5,65,0,2,2
2653,2017,,13 Games,Kentucky,,,,196,330,59.4,2446,10,488,2102,4.3,27,818,4548,5.6,112,105,25,242,71,626,8,7,15
2654,2016,1,2016-10-15,Lafayette,@,Army,L (7-62),23,38,60.5,213,0,17,10,0.6,1,55,223,4.1,9,1,0,10,5,45,0,2,2
2655,2016,1,2016-09-10,Lamar,@,Houston,L (0-42),7,13,53.8,58,0,28,15,0.5,0,41,73,1.8,2,2,0,4,6,43,1,0,1
2656,2017,1,2017-09-02,Lamar,@,North Texas,L (14-59),20,41,48.8,180,2,33,86,2.6,0,74,266,3.6,9,6,1,15,3,15,1,1,2
2657,2016,1,2016-09-03,Liberty,@,Virginia Tech,L (13-36),9,27,33.3,70,0,35,90,2.6,1,62,160,2.6,4,4,3,11,13,75,1,3,4
2658,2016,2,2016-09-17,Liberty,@,Southern Methodist,L (14-29),18,36,50.0,183,1,36,97,2.7,1,72,280,3.9,8,6,2,16,7,88,0,4,4
2659,2016,,2 Games,Liberty,,,,27,63,42.9,253,1,71,187,2.6,2,134,440,3.3,12,10,5,27,20,163,1,7,8
2660,2017,1,2017-09-02,Liberty,@,Baylor,W (48-45),44,60,73.3,447,3,43,138,3.2,1,103,585,5.7,21,9,1,31,8,95,0,0,0
2661,2014,1,2014-08-30,Louisiana,,Southern,W (45-6),24,36,66.7,264,4,41,248,6.0,2,77,512,6.6,13,14,1,28,4,30,0,2,2
2662,2014,2,2014-09-06,Louisiana,,Louisiana Tech,L (20-48),29,44,65.9,237,2,34,178,5.2,1,78,415,5.3,10,10,0,20,4,36,2,1,3
2663,2014,3,2014-09-13,Louisiana,@,Mississippi,L (15-56),15,31,48.4,129,0,37,193,5.2,1,68,322,4.7,6,11,1,18,0,0,1,3,4
2664,2014,4,2014-09-20,Louisiana,@,Boise State,L (9-34),21,39,53.8,174,0,23,67,2.9,1,62,241,3.9,8,3,3,14,7,40,0,1,1
2665,2014,5,2014-10-04,Louisiana,,Georgia State,W (34-31),24,31,77.4,266,2,32,195,6.1,3,63,461,7.3,12,9,0,21,13,130,0,0,0
2666,2014,6,2014-10-14,Louisiana,@,Texas State,W (34-10),16,23,69.6,240,1,58,288,5.0,2,81,528,6.5,8,17,0,25,7,35,0,1,1
2667,2014,7,2014-10-21,Louisiana,,Arkansas State,W (55-40),9,17,52.9,102,0,56,419,7.5,8,73,521,7.1,5,19,1,25,9,83,0,0,0
2668,2014,8,2014-11-01,Louisiana,,South Alabama,W (19-9),16,28,57.1,216,0,39,196,5.0,1,67,412,6.1,10,10,2,22,5,39,1,0,1
2669,2014,9,2014-11-08,Louisiana,@,New Mexico State,W (44-16),12,23,52.2,158,3,54,244,4.5,3,77,402,5.2,6,16,0,22,1,5,0,0,0
2670,2014,10,2014-11-15,Louisiana,@,Louisiana-Monroe,W (34-27),11,14,78.6,174,2,47,282,6.0,2,61,456,7.5,7,13,0,20,5,32,0,1,1
2671,2014,11,2014-11-22,Louisiana,,Appalachian State,L (16-35),21,34,61.8,160,0,35,99,2.8,1,69,259,3.8,7,9,1,17,3,27,0,0,0
2672,2014,12,2014-11-29,Louisiana,@,Troy,W (42-23),14,19,73.7,142,0,49,344,7.0,6,68,486,7.1,9,16,0,25,6,57,0,0,0
2673,2014,13,2014-12-20,Louisiana,N,Nevada*,W (16-3),26,31,83.9,227,1,43,184,4.3,0,74,411,5.6,11,15,0,26,1,15,1,0,1
2674,2014,,13 Games,Louisiana,,,,238,370,64.3,2489,15,548,2937,5.4,31,918,5426,5.9,112,162,9,283,65,529,5,9,14
2675,2015,1,2015-09-05,Louisiana,@,Kentucky,L (33-40),26,41,63.4,232,0,47,247,5.3,4,88,479,5.4,9,15,4,28,7,70,2,2,4
2676,2015,2,2015-09-12,Louisiana,,Northwestern State,W (44-17),7,9,77.8,187,0,42,360,8.6,6,51,547,10.7,6,13,2,21,5,35,0,0,0
2677,2015,3,2015-09-26,Louisiana,,Akron,L (14-35),19,37,51.4,173,1,28,112,4.0,1,65,285,4.4,9,6,3,18,11,126,2,2,4
2678,2015,4,2015-10-03,Louisiana,@,Louisiana Tech,L (14-43),19,37,51.4,182,1,27,149,5.5,1,64,331,5.2,6,11,1,18,8,91,1,2,3
2679,2015,5,2015-10-10,Louisiana,,Texas State,W (49-27),22,30,73.3,238,3,52,288,5.5,3,82,526,6.4,12,14,1,27,6,50,0,0,0
2680,2015,6,2015-10-20,Louisiana,@,Arkansas State,L (27-37),17,44,38.6,253,2,34,232,6.8,2,78,485,6.2,11,10,1,22,3,32,0,2,2
2681,2015,7,2015-10-31,Louisiana,,Louisiana-Monroe,W (30-24),9,21,42.9,109,1,44,152,3.5,2,65,261,4.0,2,12,1,15,3,27,0,0,0
2682,2015,8,2015-11-07,Louisiana,@,Georgia State,W (23-21),18,27,66.7,162,1,41,145,3.5,0,68,307,4.5,9,7,3,19,12,126,0,1,1
2683,2015,9,2015-11-12,Louisiana,@,South Alabama,L (25-32),21,34,61.8,270,1,24,43,1.8,2,58,313,5.4,11,4,3,18,8,57,0,1,1
2684,2015,10,2015-11-21,Louisiana,,New Mexico State,L (34-37),25,38,65.8,285,2,36,190,5.3,2,74,475,6.4,13,9,1,23,6,79,0,1,1
2685,2015,11,2015-11-28,Louisiana,@,Appalachian State,L (7-28),21,30,70.0,204,0,36,42,1.2,1,66,246,3.7,9,7,1,17,7,75,0,0,0
2686,2015,12,2015-12-05,Louisiana,,Troy,L (17-41),22,39,56.4,207,1,39,103,2.6,1,78,310,4.0,11,8,2,21,9,85,3,1,4
2687,2015,,12 Games,Louisiana,,,,226,387,58.4,2502,13,450,2063,4.6,25,837,4565,5.5,108,116,23,247,85,853,8,12,20
2688,2016,1,2016-09-03,Louisiana,,Boise State,L (10-45),21,33,63.6,186,1,40,81,2.0,0,73,267,3.7,9,5,4,18,10,71,0,0,0
2689,2016,2,2016-09-10,Louisiana,,McNeese State,W (30-22),15,21,71.4,170,1,40,220,5.5,3,61,390,6.4,6,12,2,20,11,94,0,0,0
2690,2016,3,2016-09-17,Louisiana,,South Alabama,W (28-23),18,26,69.2,256,3,36,256,7.1,1,62,512,8.3,10,10,0,20,4,30,0,2,2
2691,2016,4,2016-09-24,Louisiana,@,Tulane,L (39-41),19,38,50.0,240,2,63,137,2.2,2,101,377,3.7,13,7,0,20,5,30,2,2,4
2692,2016,5,2016-10-01,Louisiana,@,New Mexico State,L (31-37),20,36,55.6,227,1,49,205,4.2,2,85,432,5.1,10,10,1,21,8,95,0,2,2
2693,2016,6,2016-10-12,Louisiana,,Appalachian State,L (0-24),21,35,60.0,128,0,41,139,3.4,0,76,267,3.5,5,9,2,16,7,65,0,0,0
2694,2016,7,2016-10-22,Louisiana,@,Texas State,W (27-3),18,22,81.8,165,1,48,236,4.9,2,70,401,5.7,8,13,1,22,13,93,0,1,1
2695,2016,8,2016-11-05,Louisiana,,Idaho,L (13-23),17,30,56.7,161,0,40,105,2.6,1,70,266,3.8,6,10,2,18,6,29,0,0,0
2696,2016,9,2016-11-10,Louisiana,@,Georgia Southern,W (33-26),18,27,66.7,258,1,40,230,5.8,3,67,488,7.3,9,14,3,26,8,64,1,0,1
2697,2016,10,2016-11-19,Louisiana,@,Georgia,L (21-35),14,24,58.3,189,0,46,276,6.0,3,70,465,6.6,9,12,0,21,5,35,1,3,4
2698,2016,11,2016-11-26,Louisiana,,Arkansas State,W (24-19),13,24,54.2,242,2,33,50,1.5,0,57,292,5.1,9,3,3,15,5,50,0,0,0
2699,2016,12,2016-12-03,Louisiana,@,Louisiana-Monroe,W (30-3),2,5,40.0,0,0,61,240,3.9,1,66,240,3.6,0,16,1,17,6,43,0,2,2
2700,2016,13,2016-12-17,Louisiana,N,Southern Mississippi*,L (21-28),8,22,36.4,95,0,47,157,3.3,3,69,252,3.7,5,13,3,21,6,57,0,1,1
2701,2016,,13 Games,Louisiana,,,,204,343,59.5,2317,12,584,2332,4.0,21,927,4649,5.0,99,134,22,255,94,756,4,13,17
2702,2017,1,2017-09-02,Louisiana,,Southeastern Louisiana,W (51-48),12,23,52.2,162,1,36,201,5.6,4,59,363,6.2,6,9,0,16,4,16,0,0,0
2703,2017,2,2017-09-09,Louisiana,@,Tulsa,L (42-66),21,34,61.8,309,2,41,287,7.0,4,75,596,7.9,16,11,0,27,7,64,0,2,2
2704,2017,3,2017-09-16,Louisiana,@,Texas A&M,L (21-45),28,44,63.6,216,2,29,93,3.2,1,73,309,4.2,10,7,0,17,4,25,2,3,5
2705,2017,4,2017-09-23,Louisiana,,Louisiana-Monroe,L (50-56),24,43,55.8,295,2,47,231,4.9,5,90,526,5.8,15,14,3,32,5,35,0,0,0
2706,2017,5,2017-10-07,Louisiana,@,Idaho,W (21-16),19,28,67.9,213,1,39,84,2.2,2,67,297,4.4,12,8,2,22,6,32,0,1,1
2707,2017,6,2017-10-12,Louisiana,,Texas State,W (24-7),17,27,63.0,232,1,38,135,3.6,2,65,367,5.6,12,7,0,19,5,34,0,0,0
2708,2017,7,2017-10-19,Louisiana,@,Arkansas State,L (3-47),15,36,41.7,179,0,41,91,2.2,0,77,270,3.5,10,6,1,17,6,74,1,1,2
2709,2017,8,2017-11-04,Louisiana,@,South Alabama,W (19-14),8,15,53.3,110,2,50,264,5.3,0,65,374,5.8,5,11,0,16,4,35,0,0,0
2710,2017,9,2017-11-11,Louisiana,@,Mississippi,L (22-50),18,35,51.4,199,0,31,228,7.4,3,66,427,6.5,10,10,1,21,6,50,0,0,0
2711,2017,10,2017-11-18,Louisiana,,New Mexico State,W (47-34),21,35,60.0,226,2,47,279,5.9,4,82,505,6.2,10,17,2,29,6,60,0,0,0
2712,2017,11,2017-11-25,Louisiana,,Georgia Southern,L (24-34),16,30,53.3,230,2,18,149,8.3,1,48,379,7.9,8,4,1,13,4,47,0,3,3
2713,2017,12,2017-12-02,Louisiana,@,Appalachian State,L (14-63),15,26,57.7,207,1,35,162,4.6,1,61,369,6.0,7,11,0,18,1,15,1,2,3
2714,2017,,12 Games,Louisiana,,,,214,376,56.9,2578,16,452,2204,4.9,27,828,4782,5.8,121,115,10,247,58,487,4,12,16
2715,2014,1,2014-08-30,Louisiana Tech,@,Oklahoma,L (16-48),22,36,61.1,191,2,29,54,1.9,0,65,245,3.8,10,3,2,15,5,32,0,1,1
2716,2014,2,2014-09-06,Louisiana Tech,@,Louisiana,W (48-20),22,33,66.7,295,2,35,238,6.8,3,68,533,7.8,9,9,2,20,5,35,0,0,0
2717,2014,3,2014-09-11,Louisiana Tech,@,North Texas,W (42-21),23,36,63.9,260,5,30,98,3.3,1,66,358,5.4,14,5,2,21,7,73,0,1,1
2718,2014,4,2014-09-20,Louisiana Tech,,Northwestern State,L (27-30),20,34,58.8,280,1,33,133,4.0,2,67,413,6.2,13,8,1,22,8,74,2,3,5
2719,2014,5,2014-09-27,Louisiana Tech,@,Auburn,L (17-45),20,35,57.1,216,0,33,105,3.2,2,68,321,4.7,7,5,2,14,5,40,1,1,2
2720,2014,6,2014-10-04,Louisiana Tech,,Texas-El Paso,W (55-3),7,17,41.2,187,3,43,256,6.0,3,60,443,7.4,7,12,0,19,4,35,1,1,2
2721,2014,7,2014-10-18,Louisiana Tech,,Texas-San Antonio,W (27-20),14,33,42.4,157,1,35,121,3.5,1,68,278,4.1,7,6,3,16,10,85,0,1,1
2722,2014,8,2014-10-25,Louisiana Tech,@,Southern Mississippi,W (31-20),27,46,58.7,423,3,26,30,1.2,1,72,453,6.3,17,3,3,23,4,40,2,0,2
2723,2014,9,2014-11-01,Louisiana Tech,,Western Kentucky,W (59-10),34,49,69.4,378,5,34,129,3.8,2,83,507,6.1,17,10,4,31,2,15,2,1,3
2724,2014,10,2014-11-08,Louisiana Tech,@,Alabama-Birmingham,W (40-24),19,34,55.9,200,2,46,228,5.0,3,80,428,5.4,11,11,2,24,2,15,2,1,3
2725,2014,11,2014-11-22,Louisiana Tech,@,Old Dominion,L (27-30),19,31,61.3,217,1,34,109,3.2,2,65,326,5.0,11,7,1,19,4,25,1,1,2
2726,2014,12,2014-11-29,Louisiana Tech,,Rice,W (76-31),22,35,62.9,408,4,36,269,7.5,6,71,677,9.5,14,10,2,26,3,15,0,1,1
2727,2014,13,2014-12-06,Louisiana Tech,@,Marshall,L (23-26),7,20,35.0,72,0,45,196,4.4,3,65,268,4.1,2,9,3,14,4,26,1,1,2
2728,2014,14,2014-12-26,Louisiana Tech,N,Illinois*,W (35-18),14,28,50.0,247,1,31,114,3.7,3,59,361,6.1,7,8,3,16,6,45,1,0,1
2729,2014,,14 Games,Louisiana Tech,,,,270,467,57.8,3531,30,490,2080,4.2,32,957,5611,5.9,146,106,30,280,69,555,13,13,26
2730,2015,1,2015-09-05,Louisiana Tech,,Southern,W (62-15),21,29,72.4,380,5,32,207,6.5,2,61,587,9.6,13,7,1,21,3,35,0,2,2
2731,2015,2,2015-09-10,Louisiana Tech,@,Western Kentucky,L (38-41),28,49,57.1,357,2,31,223,7.2,3,80,580,7.3,19,6,3,28,5,40,1,1,2
2732,2015,3,2015-09-19,Louisiana Tech,@,Kansas State,L (33-39),30,51,58.8,314,1,38,137,3.6,2,89,451,5.1,11,12,0,23,6,41,2,0,2
2733,2015,4,2015-09-26,Louisiana Tech,,Florida International,W (27-17),18,32,56.3,226,1,42,246,5.9,2,74,472,6.4,11,15,3,29,7,45,0,0,0
2734,2015,5,2015-10-03,Louisiana Tech,,Louisiana,W (43-14),20,33,60.6,290,2,35,138,3.9,2,68,428,6.3,13,9,5,27,8,76,1,0,1
2735,2015,6,2015-10-10,Louisiana Tech,@,Texas-San Antonio,W (34-31),28,44,63.6,351,1,31,93,3.0,2,75,444,5.9,17,5,2,24,5,40,0,2,2
2736,2015,7,2015-10-17,Louisiana Tech,@,Mississippi State,L (20-45),25,41,61.0,303,2,32,110,3.4,0,73,413,5.7,14,8,2,24,7,60,0,1,1
2737,2015,8,2015-10-24,Louisiana Tech,,Middle Tennessee State,W (45-16),19,33,57.6,301,2,35,169,4.8,3,68,470,6.9,10,10,2,22,5,46,0,0,0
2738,2015,9,2015-10-30,Louisiana Tech,@,Rice,W (42-17),17,27,63.0,320,4,33,135,4.1,2,60,455,7.6,12,7,2,21,2,20,0,0,0
2739,2015,10,2015-11-07,Louisiana Tech,,North Texas,W (56-13),18,27,66.7,299,0,36,274,7.6,7,63,573,9.1,10,14,1,25,3,32,2,1,3
2740,2015,11,2015-11-21,Louisiana Tech,@,Texas-El Paso,W (17-15),13,22,59.1,188,2,28,119,4.3,0,50,307,6.1,7,5,0,12,6,68,1,0,1
2741,2015,12,2015-11-28,Louisiana Tech,,Southern Mississippi,L (24-58),32,51,62.7,407,3,23,-2,-0.1,0,74,405,5.5,23,2,2,27,2,6,3,4,7
2742,2015,13,2015-12-19,Louisiana Tech,N,Arkansas State*,W (47-28),26,38,68.4,458,3,36,229,6.4,2,74,687,9.3,14,9,3,26,13,154,0,0,0
2743,2015,,13 Games,Louisiana Tech,,,,295,477,61.8,4194,28,432,2078,4.8,27,909,6272,6.9,174,109,26,309,72,663,10,11,21
2744,2016,1,2016-09-03,Louisiana Tech,@,Arkansas,L (20-21),19,31,61.3,212,0,23,79,3.4,2,54,291,5.4,10,5,1,16,3,20,0,1,1
2745,2016,2,2016-09-10,Louisiana Tech,,South Carolina State,W (53-24),41,60,68.3,518,5,30,209,7.0,1,90,727,8.1,24,10,0,34,6,62,2,2,4
2746,2016,3,2016-09-17,Louisiana Tech,@,Texas Tech,L (45-59),20,32,62.5,311,3,36,261,7.3,3,68,572,8.4,10,16,1,27,8,89,0,0,0
2747,2016,4,2016-09-24,Louisiana Tech,@,Middle Tennessee State,L (34-38),36,59,61.0,504,3,37,118,3.2,1,96,622,6.5,24,8,3,35,3,28,1,0,1
2748,2016,5,2016-10-01,Louisiana Tech,,Texas-El Paso,W (28-7),19,28,67.9,191,2,22,196,8.9,2,50,387,7.7,8,11,0,19,2,12,0,0,0
2749,2016,6,2016-10-06,Louisiana Tech,,Western Kentucky,W (55-52),33,45,73.3,454,5,27,107,4.0,2,72,561,7.8,15,7,4,26,5,64,0,0,0
2750,2016,7,2016-10-15,Louisiana Tech,@,Massachusetts,W (56-28),27,34,79.4,491,5,35,199,5.7,2,69,690,10.0,21,7,1,29,5,41,3,1,4
2751,2016,8,2016-10-22,Louisiana Tech,@,Florida International,W (44-24),22,30,73.3,269,2,25,145,5.8,2,55,414,7.5,10,8,0,18,8,60,0,0,0
2752,2016,9,2016-10-29,Louisiana Tech,,Rice,W (61-16),24,31,77.4,434,3,39,301,7.7,5,70,735,10.5,15,13,0,28,3,25,1,0,1
2753,2016,10,2016-11-05,Louisiana Tech,@,North Texas,W (45-24),18,30,60.0,253,4,40,226,5.7,2,70,479,6.8,11,12,7,30,3,30,0,1,1
2754,2016,11,2016-11-12,Louisiana Tech,,Texas-San Antonio,W (63-35),17,27,63.0,293,4,30,180,6.0,3,57,473,8.3,11,8,4,23,6,80,0,0,0
2755,2016,12,2016-11-25,Louisiana Tech,@,Southern Mississippi,L (24-39),22,39,56.4,246,0,16,8,0.5,2,55,254,4.6,12,2,2,16,7,50,0,3,3
2756,2016,13,2016-12-03,Louisiana Tech,@,Western Kentucky,L (44-58),35,57,61.4,502,3,22,5,0.2,1,79,507,6.4,20,5,1,26,8,64,0,1,1
2757,2016,14,2016-12-23,Louisiana Tech,N,Navy*,W (48-45),29,40,72.5,409,4,33,88,2.7,2,73,497,6.8,19,7,5,31,4,50,1,0,1
2758,2016,,14 Games,Louisiana Tech,,,,362,543,66.7,5087,43,415,2122,5.1,30,958,7209,7.5,210,119,29,358,71,675,8,9,17
2759,2017,1,2017-09-02,Louisiana Tech,,Northwestern State,W (52-24),18,35,51.4,276,2,37,221,6.0,3,72,497,6.9,12,9,1,22,5,50,3,0,3
2760,2017,2,2017-09-09,Louisiana Tech,,Mississippi State,L (21-57),13,30,43.3,163,1,50,152,3.0,1,80,315,3.9,5,12,3,20,3,28,2,1,3
2761,2017,3,2017-09-16,Louisiana Tech,@,Western Kentucky,W (23-22),22,39,56.4,306,1,30,122,4.1,1,69,428,6.2,14,4,2,20,3,25,0,1,1
2762,2017,4,2017-09-23,Louisiana Tech,@,South Carolina,L (16-17),23,33,69.7,281,1,28,80,2.9,0,61,361,5.9,12,4,1,17,3,18,0,1,1
2763,2017,5,2017-09-30,Louisiana Tech,,South Alabama,W (34-16),24,39,61.5,317,3,33,162,4.9,1,72,479,6.7,13,12,1,26,3,11,1,0,1
2764,2017,6,2017-10-07,Louisiana Tech,@,Alabama-Birmingham,L (22-23),17,29,58.6,209,2,34,154,4.5,1,63,363,5.8,10,9,2,21,10,95,0,0,0
2765,2017,7,2017-10-21,Louisiana Tech,,Southern Mississippi,L (27-34),11,28,39.3,194,0,34,161,4.7,2,62,355,5.7,6,8,0,15,4,30,1,1,2
2766,2017,8,2017-10-28,Louisiana Tech,@,Rice,W (42-28),21,32,65.6,237,1,39,180,4.6,4,71,417,5.9,13,10,1,24,4,25,0,0,0
2767,2017,9,2017-11-04,Louisiana Tech,,North Texas,L (23-24),16,28,57.1,168,0,41,147,3.6,2,69,315,4.6,9,7,3,19,5,37,0,0,0
2768,2017,10,2017-11-11,Louisiana Tech,,Florida Atlantic,L (23-48),30,51,58.8,326,1,45,186,4.1,1,96,512,5.3,20,10,2,32,5,58,0,0,0
2769,2017,11,2017-11-18,Louisiana Tech,@,Texas-El Paso,W (42-21),15,28,53.6,203,2,49,343,7.0,3,77,546,7.1,7,19,2,28,8,70,2,0,2
2770,2017,12,2017-11-25,Louisiana Tech,,Texas-San Antonio,W (20-6),7,21,33.3,101,0,37,193,5.2,2,58,294,5.1,6,10,3,19,3,30,1,1,2
2771,2017,13,2017-12-20,Louisiana Tech,N,Southern Methodist*,W (51-10),16,27,59.3,216,3,38,141,3.7,1,65,357,5.5,8,7,3,18,5,50,0,0,0
2772,2017,,13 Games,Louisiana Tech,,,,233,420,55.5,2997,17,495,2242,4.5,22,915,5239,5.7,135,121,24,281,61,527,10,5,15
2773,2014,1,2014-08-28,Louisiana-Monroe,,Wake Forest,W (17-10),23,41,56.1,189,0,44,163,3.7,1,85,352,4.1,9,11,1,21,5,25,1,0,1
2774,2014,2,2014-09-06,Louisiana-Monroe,,Idaho,W (38-31),24,45,53.3,384,2,37,150,4.1,3,82,534,6.5,15,10,4,29,5,40,0,1,1
2775,2014,3,2014-09-13,Louisiana-Monroe,@,Louisiana State,L (0-31),16,30,53.3,77,0,18,16,0.9,0,48,93,1.9,5,0,1,6,5,45,1,0,1
2776,2014,4,2014-09-27,Louisiana-Monroe,,Troy,W (22-20),28,43,65.1,328,2,33,29,0.9,0,76,357,4.7,14,4,1,19,0,0,0,1,1
2777,2014,5,2014-10-04,Louisiana-Monroe,@,Arkansas State,L (14-28),27,47,57.4,276,2,25,72,2.9,0,72,348,4.8,12,4,0,16,8,69,2,0,2
2778,2014,6,2014-10-11,Louisiana-Monroe,@,Kentucky,L (14-48),22,39,56.4,187,2,40,77,1.9,0,79,264,3.3,8,6,1,15,5,41,1,2,3
2779,2014,7,2014-10-25,Louisiana-Monroe,,Texas State,L (18-22),25,40,62.5,250,0,42,144,3.4,1,82,394,4.8,12,7,1,20,5,34,0,1,1
2780,2014,8,2014-11-01,Louisiana-Monroe,@,Texas A&M,L (16-21),28,49,57.1,269,0,30,78,2.6,1,79,347,4.4,14,4,1,19,4,20,0,1,1
2781,2014,9,2014-11-08,Louisiana-Monroe,@,Appalachian State,L (29-31),20,41,48.8,244,2,30,55,1.8,1,71,299,4.2,13,5,2,20,8,78,0,0,0
2782,2014,10,2014-11-15,Louisiana-Monroe,,Louisiana,L (27-34),39,56,69.6,483,2,21,-39,-1.9,1,77,444,5.8,18,1,2,21,0,0,3,0,3
2783,2014,11,2014-11-22,Louisiana-Monroe,@,New Mexico State,W (30-17),35,50,70.0,350,1,27,70,2.6,1,77,420,5.5,14,4,1,19,4,40,1,1,2
2784,2014,12,2014-11-29,Louisiana-Monroe,@,Georgia Southern,L (16-22),30,48,62.5,322,2,16,19,1.2,0,64,341,5.3,13,2,1,16,4,33,1,0,1
2785,2014,,12 Games,Louisiana-Monroe,,,,317,529,59.9,3359,15,363,834,2.3,9,892,4193,4.7,147,58,16,221,53,425,10,7,17
2786,2015,1,2015-09-05,Louisiana-Monroe,@,Georgia,L (14-51),23,29,79.3,206,2,26,45,1.7,0,55,251,4.6,9,3,0,12,5,30,0,1,1
2787,2015,2,2015-09-12,Louisiana-Monroe,,Nicholls State,W (47-0),28,38,73.7,391,3,38,202,5.3,3,76,593,7.8,15,10,2,27,18,158,0,0,0
2788,2015,3,2015-09-26,Louisiana-Monroe,@,Alabama,L (0-34),20,43,46.5,83,0,31,9,0.3,0,74,92,1.2,5,1,4,10,10,90,0,2,2
2789,2015,4,2015-10-03,Louisiana-Monroe,,Georgia Southern,L (31-51),21,36,58.3,232,3,26,47,1.8,0,62,279,4.5,11,3,2,16,10,72,0,3,3
2790,2015,5,2015-10-10,Louisiana-Monroe,@,Tulsa,L (24-34),25,48,52.1,231,1,29,173,6.0,2,77,404,5.2,13,6,2,21,8,73,2,1,3
2791,2015,6,2015-10-17,Louisiana-Monroe,,Appalachian State,L (14-59),18,35,51.4,191,2,39,159,4.1,0,74,350,4.7,11,7,3,21,3,15,0,2,2
2792,2015,7,2015-10-24,Louisiana-Monroe,@,Idaho,L (13-27),19,37,51.4,186,1,23,57,2.5,0,60,243,4.1,9,3,3,15,6,42,0,0,0
2793,2015,8,2015-10-31,Louisiana-Monroe,@,Louisiana,L (24-30),16,35,45.7,265,3,34,76,2.2,0,69,341,4.9,11,4,0,15,5,45,2,0,2
2794,2015,9,2015-11-07,Louisiana-Monroe,@,Troy,L (14-51),24,42,57.1,262,2,35,114,3.3,0,77,376,4.9,13,7,0,20,11,84,3,3,6
2795,2015,10,2015-11-14,Louisiana-Monroe,,Arkansas State,L (21-59),10,31,32.3,100,1,44,152,3.5,2,75,252,3.4,3,5,2,10,6,43,1,4,5
2796,2015,11,2015-11-19,Louisiana-Monroe,@,Texas State,L (3-16),16,33,48.5,83,0,24,98,4.1,0,57,181,3.2,4,5,1,10,3,28,1,1,2
2797,2015,12,2015-11-28,Louisiana-Monroe,@,Hawaii,L (26-28),27,44,61.4,234,2,33,142,4.3,0,77,376,4.9,16,6,4,26,8,54,1,0,1
2798,2015,13,2015-12-05,Louisiana-Monroe,,New Mexico State,W (42-35),9,26,34.6,239,5,43,64,1.5,0,69,303,4.4,7,5,1,13,2,20,1,2,3
2799,2015,,13 Games,Louisiana-Monroe,,,,256,477,53.7,2703,25,425,1338,3.1,7,902,4041,4.5,127,65,24,216,95,754,11,19,30
2800,2016,1,2016-09-03,Louisiana-Monroe,,Southern,W (38-21),20,33,60.6,208,2,46,325,7.1,3,79,533,6.7,10,16,0,26,7,73,0,2,2
2801,2016,2,2016-09-10,Louisiana-Monroe,@,Oklahoma,L (17-59),23,37,62.2,272,2,29,78,2.7,0,66,350,5.3,11,4,0,15,4,36,1,0,1
2802,2016,3,2016-09-17,Louisiana-Monroe,@,Georgia Southern,L (21-23),17,33,51.5,283,2,29,67,2.3,1,62,350,5.6,10,4,1,15,5,70,1,1,2
2803,2016,4,2016-10-01,Louisiana-Monroe,@,Auburn,L (7-58),19,33,57.6,139,1,32,112,3.5,0,65,251,3.9,7,8,1,16,2,30,1,1,2
2804,2016,5,2016-10-08,Louisiana-Monroe,,Idaho,L (31-34),20,38,52.6,302,2,38,221,5.8,2,76,523,6.9,13,12,2,27,2,15,1,3,4
2805,2016,6,2016-10-15,Louisiana-Monroe,,Texas State,W (40-34),14,23,60.9,179,2,73,298,4.1,3,96,477,5.0,10,18,3,31,2,30,1,1,2
2806,2016,7,2016-10-22,Louisiana-Monroe,@,New Mexico,L (17-59),12,22,54.5,120,1,41,115,2.8,1,63,235,3.7,6,6,0,12,6,52,0,2,2
2807,2016,8,2016-10-29,Louisiana-Monroe,@,Arkansas State,L (10-51),14,29,48.3,162,0,42,174,4.1,1,71,336,4.7,8,7,2,17,7,51,0,2,2
2808,2016,9,2016-11-05,Louisiana-Monroe,,South Alabama,W (42-35),26,39,66.7,279,3,46,181,3.9,3,85,460,5.4,14,10,3,27,4,40,0,1,1
2809,2016,10,2016-11-12,Louisiana-Monroe,@,Georgia State,W (37-23),17,31,54.8,193,0,54,264,4.9,5,85,457,5.4,11,18,2,31,3,25,0,0,0
2810,2016,11,2016-11-19,Louisiana-Monroe,@,Appalachian State,L (17-42),13,32,40.6,136,0,44,225,5.1,2,76,361,4.8,7,13,2,22,5,50,0,1,1
2811,2016,12,2016-12-03,Louisiana-Monroe,,Louisiana,L (3-30),3,14,21.4,31,0,38,116,3.1,0,52,147,2.8,2,6,0,8,3,35,3,2,5
2812,2016,,12 Games,Louisiana-Monroe,,,,198,364,54.4,2304,15,512,2176,4.3,21,876,4480,5.1,109,122,16,247,50,507,8,16,24
2813,2017,1,2017-08-31,Louisiana-Monroe,@,Memphis,L (29-37),21,37,56.8,279,2,49,146,3.0,2,86,425,4.9,13,10,2,25,8,53,3,1,4
2814,2017,2,2017-09-16,Louisiana-Monroe,,Southern Mississippi,L (17-28),11,27,40.7,112,0,37,218,5.9,2,64,330,5.2,5,9,1,15,5,54,1,0,1
2815,2017,3,2017-09-23,Louisiana-Monroe,@,Louisiana,W (56-50),28,34,82.4,343,1,45,250,5.6,7,79,593,7.5,14,12,1,27,9,87,0,0,0
2816,2017,4,2017-09-30,Louisiana-Monroe,,Coastal Carolina,W (51-43),12,20,60.0,101,1,40,243,6.1,4,60,344,5.7,5,9,2,16,4,35,0,0,0
2817,2017,5,2017-10-07,Louisiana-Monroe,@,Texas State,W (45-27),24,37,64.9,433,3,41,156,3.8,2,78,589,7.6,15,9,0,24,6,57,0,0,0
2818,2017,6,2017-10-14,Louisiana-Monroe,,Georgia State,L (37-47),23,37,62.2,314,3,37,117,3.2,1,74,431,5.8,10,8,1,19,4,25,1,0,1
2819,2017,7,2017-10-21,Louisiana-Monroe,@,South Alabama,L (23-33),14,23,60.9,179,0,41,309,7.5,3,64,488,7.6,6,13,1,20,4,18,1,1,2
2820,2017,8,2017-10-28,Louisiana-Monroe,@,Idaho,L (23-31),24,37,64.9,415,3,29,98,3.4,0,66,513,7.8,20,4,1,25,1,5,1,1,2
2821,2017,9,2017-11-04,Louisiana-Monroe,,Appalachian State,W (52-45),24,32,75.0,356,3,38,213,5.6,3,70,569,8.1,15,11,2,28,6,55,0,1,1
2822,2017,10,2017-11-18,Louisiana-Monroe,@,Auburn,L (14-42),16,36,44.4,217,1,41,116,2.8,1,77,333,4.3,11,3,2,16,3,14,1,2,3
2823,2017,11,2017-11-25,Louisiana-Monroe,,Arkansas State,L (50-67),21,37,56.8,454,4,39,136,3.5,2,76,590,7.8,15,9,3,27,8,80,1,3,4
2824,2017,12,2017-12-02,Louisiana-Monroe,@,Florida State,L (10-42),28,47,59.6,262,1,22,38,1.7,0,69,300,4.3,14,3,0,17,5,38,0,0,0
2825,2017,,12 Games,Louisiana-Monroe,,,,246,404,60.9,3465,22,459,2040,4.4,27,863,5505,6.4,143,100,16,259,63,521,9,9,18
2826,2014,1,2014-09-01,Louisville,,Miami (FL),W (31-13),20,28,71.4,206,2,43,130,3.0,1,71,336,4.7,10,11,0,21,7,57,2,0,2
2827,2014,2,2014-09-06,Louisville,,Murray State,W (66-21),25,39,64.1,278,3,49,325,6.6,6,88,603,6.9,13,15,3,31,3,19,0,0,0
2828,2014,3,2014-09-13,Louisville,@,Virginia,L (21-23),20,43,46.5,203,2,27,79,2.9,1,70,282,4.0,9,6,2,17,7,50,2,2,4
2829,2014,4,2014-09-20,Louisville,@,Florida International,W (34-3),20,36,55.6,324,2,35,12,0.3,1,71,336,4.7,9,6,1,16,7,36,2,0,2
2830,2014,5,2014-09-27,Louisville,,Wake Forest,W (20-10),16,32,50.0,206,0,49,215,4.4,2,81,421,5.2,9,11,1,21,11,89,3,0,3
2831,2014,6,2014-10-03,Louisville,@,Syracuse,W (28-6),12,22,54.5,174,1,48,178,3.7,2,70,352,5.0,6,11,1,18,9,75,1,1,2
2832,2014,7,2014-10-11,Louisville,@,Clemson,L (17-23),15,30,50.0,212,1,38,52,1.4,1,68,264,3.9,6,3,1,10,11,65,2,0,2
2833,2014,8,2014-10-18,Louisville,,North Carolina State,W (30-18),21,36,58.3,203,2,33,166,5.0,1,69,369,5.3,10,11,0,21,4,33,0,0,0
2834,2014,9,2014-10-30,Louisville,,Florida State,L (31-42),20,38,52.6,330,1,33,158,4.8,3,71,488,6.9,14,9,1,24,3,14,1,1,2
2835,2014,10,2014-11-08,Louisville,@,Boston College,W (38-19),17,24,70.8,257,2,40,166,4.2,3,64,423,6.6,10,9,2,21,10,87,1,0,1
2836,2014,11,2014-11-22,Louisville,@,Notre Dame,W (31-28),8,21,38.1,180,1,50,229,4.6,3,71,409,5.8,7,14,2,23,8,57,0,1,1
2837,2014,12,2014-11-29,Louisville,,Kentucky,W (44-40),22,35,62.9,389,3,39,83,2.1,3,74,472,6.4,16,4,2,22,3,15,2,2,4
2838,2014,13,2014-12-30,Louisville,N,Georgia*,L (14-37),21,44,47.7,314,1,27,62,2.3,1,71,376,5.3,14,6,0,20,7,44,0,3,3
2839,2014,,13 Games,Louisville,,,,237,428,55.4,3276,21,511,1855,3.6,28,939,5131,5.5,133,116,16,265,90,641,16,10,26
2840,2015,1,2015-09-05,Louisville,N,Auburn,L (24-31),17,33,51.5,167,0,48,238,5.0,3,81,405,5.0,9,17,1,27,5,35,1,1,2
2841,2015,2,2015-09-12,Louisville,,Houston,L (31-34),27,45,60.0,325,2,26,70,2.7,2,71,395,5.6,15,7,3,25,9,80,2,2,4
2842,2015,3,2015-09-17,Louisville,,Clemson,L (17-20),20,35,57.1,253,0,28,19,0.7,1,63,272,4.3,10,3,3,16,2,15,0,2,2
2843,2015,4,2015-09-26,Louisville,,Samford,W (45-3),18,28,64.3,274,2,46,288,6.3,4,74,562,7.6,13,12,0,25,9,89,0,2,2
2844,2015,5,2015-10-03,Louisville,@,North Carolina State,W (20-13),10,27,37.0,103,1,45,203,4.5,1,72,306,4.3,7,10,3,20,6,50,0,0,0
2845,2015,6,2015-10-17,Louisville,@,Florida State,L (21-41),20,35,57.1,307,3,30,99,3.3,0,65,406,6.2,13,6,1,20,9,84,1,1,2
2846,2015,7,2015-10-24,Louisville,,Boston College,W (17-14),15,26,57.7,230,0,48,135,2.8,1,74,365,4.9,10,8,0,18,8,49,2,2,4
2847,2015,8,2015-10-30,Louisville,@,Wake Forest,W (20-19),23,32,71.9,249,2,42,68,1.6,0,74,317,4.3,12,3,2,17,10,89,1,0,1
2848,2015,9,2015-11-07,Louisville,,Syracuse,W (41-17),24,36,66.7,362,3,31,217,7.0,1,67,579,8.6,12,11,0,23,9,84,3,1,4
2849,2015,10,2015-11-14,Louisville,,Virginia,W (38-31),11,22,50.0,159,2,37,266,7.2,3,59,425,7.2,9,11,3,23,5,53,2,0,2
2850,2015,11,2015-11-21,Louisville,@,Pittsburgh,L (34-45),20,38,52.6,355,3,24,-1,0.0,1,62,354,5.7,13,2,2,17,8,50,0,1,1
2851,2015,12,2015-11-28,Louisville,@,Kentucky,W (38-24),10,26,38.5,175,1,40,314,7.9,4,66,489,7.4,6,13,1,20,7,46,0,3,3
2852,2015,13,2015-12-30,Louisville,N,Texas A&M*,W (27-21),12,26,46.2,227,2,46,307,6.7,2,72,534,7.4,7,12,2,21,10,90,0,0,0
2853,2015,,13 Games,Louisville,,,,227,409,55.5,3186,21,491,2223,4.5,23,900,5409,6.0,136,115,21,272,97,814,12,15,27
2854,2016,1,2016-09-01,Louisville,,UNC Charlotte,W (70-14),26,35,74.3,391,8,35,272,7.8,2,70,663,9.5,20,14,4,38,10,49,2,1,3
2855,2016,2,2016-09-09,Louisville,@,Syracuse,W (62-28),21,40,52.5,431,1,41,414,10.1,7,81,845,10.4,16,13,1,30,9,100,2,1,3
2856,2016,3,2016-09-17,Louisville,,Florida State,W (63-20),13,20,65.0,216,1,46,314,6.8,7,66,530,8.0,8,13,3,24,5,56,0,1,1
2857,2016,4,2016-09-24,Louisville,@,Marshall,W (59-28),24,44,54.5,417,5,41,273,6.7,3,85,690,8.1,14,15,4,33,12,143,2,1,3
2858,2016,5,2016-10-01,Louisville,@,Clemson,L (36-42),27,44,61.4,295,1,55,273,5.0,3,99,568,5.7,12,16,3,31,11,104,2,1,3
2859,2016,6,2016-10-14,Louisville,,Duke,W (24-14),13,26,50.0,181,1,35,288,8.2,2,61,469,7.7,6,14,1,21,4,32,1,0,1
2860,2016,7,2016-10-22,Louisville,,North Carolina State,W (54-13),21,36,58.3,390,3,44,163,3.7,3,80,553,6.9,12,10,2,24,12,94,2,0,2
2861,2016,8,2016-10-29,Louisville,@,Virginia,W (32-25),24,41,58.5,361,4,34,147,4.3,0,75,508,6.8,16,10,1,27,7,68,1,1,2
2862,2016,9,2016-11-05,Louisville,@,Boston College,W (52-7),19,29,65.5,305,4,36,210,5.8,3,65,515,7.9,13,6,3,22,0,0,2,1,3
2863,2016,10,2016-11-12,Louisville,,Wake Forest,W (44-12),14,26,53.8,145,1,37,346,9.4,4,63,491,7.8,7,13,0,20,4,55,3,0,3
2864,2016,11,2016-11-17,Louisville,@,Houston,L (10-36),20,43,46.5,211,1,40,101,2.5,0,83,312,3.8,8,10,0,18,15,114,3,0,3
2865,2016,12,2016-11-26,Louisville,,Kentucky,L (38-41),16,25,64.0,281,2,46,280,6.1,3,71,561,7.9,12,14,0,26,4,48,1,3,4
2866,2016,13,2016-12-31,Louisville,N,Louisiana State*,L (9-29),10,27,37.0,153,0,35,67,1.9,0,62,220,3.5,6,4,1,11,8,56,1,0,1
2867,2016,,13 Games,Louisville,,,,248,436,56.9,3777,32,525,3148,6.0,37,961,6925,7.2,150,152,23,325,101,919,22,10,32
2868,2017,1,2017-09-02,Louisville,N,Purdue,W (35-28),30,46,65.2,378,2,33,146,4.4,1,79,524,6.6,16,8,3,27,16,110,3,0,3
2869,2017,2,2017-09-09,Louisville,@,North Carolina,W (47-35),25,39,64.1,393,3,44,312,7.1,3,83,705,8.5,18,15,2,35,6,61,0,0,0
2870,2017,3,2017-09-16,Louisville,,Clemson,L (21-47),21,42,50.0,317,3,27,116,4.3,0,69,433,6.3,13,7,1,21,4,35,0,1,1
2871,2017,4,2017-09-23,Louisville,,Kent State,W (42-3),23,30,76.7,374,2,27,165,6.1,3,57,539,9.5,12,9,2,23,4,30,2,2,4
2872,2017,5,2017-09-30,Louisville,,Murray State,W (55-10),32,45,71.1,364,4,46,312,6.8,3,91,676,7.4,18,16,4,38,7,69,2,0,2
2873,2017,6,2017-10-05,Louisville,@,North Carolina State,L (25-39),26,48,54.2,354,1,29,116,4.0,2,77,470,6.1,12,12,1,25,10,69,0,1,1
2874,2017,7,2017-10-14,Louisville,,Boston College,L (42-45),19,39,48.7,332,2,36,293,8.1,4,75,625,8.3,12,13,0,25,4,30,1,1,2
2875,2017,8,2017-10-21,Louisville,@,Florida State,W (31-28),13,21,61.9,156,1,44,293,6.7,3,65,449,6.9,7,14,1,22,2,13,1,0,1
2876,2017,9,2017-10-28,Louisville,@,Wake Forest,L (32-42),28,46,60.9,332,1,42,191,4.5,3,88,523,5.9,19,10,1,30,0,0,0,1,1
2877,2017,10,2017-11-11,Louisville,,Virginia,W (38-21),15,26,57.7,195,3,43,298,6.9,2,69,493,7.1,9,15,3,27,6,65,2,0,2
2878,2017,11,2017-11-18,Louisville,,Syracuse,W (56-10),17,30,56.7,316,3,42,411,9.8,5,72,727,10.1,12,15,0,27,11,85,0,0,0
2879,2017,12,2017-11-25,Louisville,@,Kentucky,W (44-17),15,21,71.4,216,2,43,346,8.0,3,64,562,8.8,11,16,5,32,6,55,0,0,0
2880,2017,13,2017-12-30,Louisville,N,Mississippi State*,L (27-31),13,31,41.9,171,2,39,187,4.8,1,70,358,5.1,9,7,4,20,6,42,0,4,4
2881,2017,,13 Games,Louisville,,,,277,464,59.7,3898,29,495,3186,6.4,33,959,7084,7.4,168,157,27,352,82,664,11,10,21
2882,2014,1,2014-08-30,LSU,N,Wisconsin,W (28-24),9,21,42.9,239,2,47,126,2.7,1,68,365,5.4,8,8,1,17,7,50,1,0,1
2883,2014,2,2014-09-06,LSU,,Sam Houston State,W (56-0),11,18,61.1,250,4,58,334,5.8,4,76,584,7.7,10,15,2,27,6,60,1,0,1
2884,2014,3,2014-09-13,LSU,,Louisiana-Monroe,W (31-0),12,20,60.0,153,0,52,219,4.2,4,72,372,5.2,7,14,1,22,6,54,0,1,1
2885,2014,4,2014-09-20,LSU,,Mississippi State,L (29-34),20,36,55.6,341,2,36,89,2.5,1,72,430,6.0,13,6,1,20,3,28,0,1,1
2886,2014,5,2014-09-27,LSU,,New Mexico State,W (63-7),14,20,70.0,200,3,54,363,6.7,5,74,563,7.6,8,20,1,29,5,35,2,2,4
2887,2014,6,2014-10-04,LSU,@,Auburn,L (7-41),8,24,33.3,142,0,36,138,3.8,1,60,280,4.7,3,6,4,13,5,31,0,0,0
2888,2014,7,2014-10-11,LSU,@,Florida,W (30-27),10,22,45.5,110,1,50,195,3.9,3,72,305,4.2,7,11,3,21,8,80,0,0,0
2889,2014,8,2014-10-18,LSU,,Kentucky,W (41-3),7,15,46.7,120,1,51,303,5.9,3,66,423,6.4,5,13,2,20,10,80,0,1,1
2890,2014,9,2014-10-25,LSU,,Mississippi,W (10-7),8,16,50.0,142,1,55,264,4.8,0,71,406,5.7,6,15,1,22,5,45,2,2,4
2891,2014,10,2014-11-08,LSU,,Alabama,L (13-20),8,26,30.8,76,1,56,183,3.3,0,82,259,3.2,5,12,0,17,2,20,0,1,1
2892,2014,11,2014-11-15,LSU,@,Arkansas,L (0-17),12,22,54.5,87,0,32,36,1.1,0,54,123,2.3,4,6,2,12,3,20,1,0,1
2893,2014,12,2014-11-27,LSU,@,Texas A&M,W (23-17),12,21,57.1,107,1,57,384,6.7,1,78,491,6.3,5,19,1,25,9,85,0,1,1
2894,2014,13,2014-12-30,LSU,N,Notre Dame*,L (28-31),7,14,50.0,151,1,38,285,7.5,2,52,436,8.4,4,13,0,17,2,7,1,0,1
2895,2014,,13 Games,LSU,,,,138,275,50.2,2118,17,622,2919,4.7,25,897,5037,5.6,85,158,19,262,71,595,8,9,17
2896,2015,1,2015-09-12,LSU,@,Mississippi State,W (21-19),9,14,64.3,71,0,47,266,5.7,3,61,337,5.5,0,0,0,16,9,95,0,0,0
2897,2015,2,2015-09-19,LSU,,Auburn,W (45-21),12,17,70.6,74,1,48,411,8.6,5,65,485,7.5,5,14,1,20,5,43,0,0,0
2898,2015,3,2015-09-26,LSU,@,Syracuse,W (34-24),8,16,50.0,157,1,42,268,6.4,2,58,425,7.3,6,10,1,17,14,120,0,0,0
2899,2015,4,2015-10-03,LSU,,Eastern Michigan,W (44-22),4,14,28.6,80,0,50,391,7.8,4,64,471,7.4,3,22,3,28,7,51,1,0,1
2900,2015,5,2015-10-10,LSU,@,South Carolina,W (45-24),18,29,62.1,228,2,54,396,7.3,4,83,624,7.5,9,19,1,29,7,50,0,0,0
2901,2015,6,2015-10-17,LSU,,Florida,W (35-28),13,19,68.4,202,2,41,221,5.4,3,60,423,7.1,8,10,0,18,3,20,1,0,1
2902,2015,7,2015-10-24,LSU,,Western Kentucky,W (48-20),11,20,55.0,286,3,43,211,4.9,3,63,497,7.9,7,11,3,21,7,65,0,0,0
2903,2015,8,2015-11-07,LSU,@,Alabama,L (16-30),6,19,31.6,128,1,26,54,2.1,1,45,182,4.0,5,3,4,12,7,48,0,1,1
2904,2015,9,2015-11-14,LSU,,Arkansas,L (14-31),21,35,60.0,271,1,30,59,2.0,1,65,330,5.1,11,8,1,20,7,46,1,1,2
2905,2015,10,2015-11-21,LSU,@,Mississippi,L (17-38),26,51,51.0,324,1,38,184,4.8,0,89,508,5.7,15,10,0,25,13,95,1,2,3
2906,2015,11,2015-11-28,LSU,,Texas A&M,W (19-7),7,21,33.3,83,0,47,244,5.2,2,68,327,4.8,5,10,2,17,8,65,0,1,1
2907,2015,12,2015-12-29,LSU,N,Texas Tech*,W (56-27),14,23,60.9,261,1,39,377,9.7,7,62,638,10.3,8,12,3,23,9,76,0,1,1
2908,2015,,12 Games,LSU,,,,149,278,53.6,2165,13,505,3082,6.1,35,783,5247,6.7,82,129,19,246,96,774,4,6,10
2909,2016,1,2016-09-03,LSU,N,Wisconsin,L (14-16),12,21,57.1,131,1,29,126,4.3,0,50,257,5.1,8,5,1,14,5,57,1,2,3
2910,2016,2,2016-09-10,LSU,,Jacksonville State,W (34-13),8,19,42.1,127,1,37,244,6.6,3,56,371,6.6,6,11,1,18,5,35,1,1,2
2911,2016,3,2016-09-17,LSU,,Mississippi State,W (23-20),19,32,59.4,215,1,39,177,4.5,2,71,392,5.5,11,9,2,22,7,56,1,0,1
2912,2016,4,2016-09-24,LSU,@,Auburn,L (13-18),15,27,55.6,118,1,32,220,6.9,0,59,338,5.7,5,8,1,14,5,50,1,0,1
2913,2016,5,2016-10-01,LSU,,Missouri,W (42-7),19,30,63.3,216,0,52,418,8.0,6,82,634,7.7,9,19,2,30,5,35,0,0,0
2914,2016,6,2016-10-15,LSU,,Southern Mississippi,W (45-10),11,18,61.1,276,3,24,183,7.6,3,42,459,10.9,9,8,0,17,6,55,0,1,1
2915,2016,7,2016-10-22,LSU,,Mississippi,W (38-21),19,28,67.9,204,1,35,312,8.9,4,63,516,8.2,10,10,0,20,6,43,2,1,3
2916,2016,8,2016-11-05,LSU,,Alabama,L (0-10),11,24,45.8,92,0,27,33,1.2,0,51,125,2.5,2,4,0,6,3,20,0,1,1
2917,2016,9,2016-11-12,LSU,@,Arkansas,W (38-10),10,16,62.5,157,0,51,390,7.6,5,67,547,8.2,6,15,2,23,5,44,2,0,2
2918,2016,10,2016-11-19,LSU,,Florida,L (10-16),14,26,53.8,204,0,45,219,4.9,1,71,423,6.0,10,13,0,23,2,20,2,0,2
2919,2016,11,2016-11-24,LSU,@,Texas A&M,W (54-39),20,28,71.4,324,2,46,298,6.5,5,74,622,8.4,13,13,2,28,5,29,0,0,0
2920,2016,12,2016-12-31,LSU,N,Louisville*,W (29-9),16,29,55.2,217,2,41,177,4.3,1,70,394,5.6,11,5,4,20,4,48,0,1,1
2921,2016,,12 Games,LSU,,,,174,298,58.4,2281,12,458,2797,6.1,30,756,5078,6.7,100,120,15,235,58,492,10,7,17
2922,2017,1,2017-09-02,LSU,N,Brigham Young,W (27-0),15,18,83.3,183,0,57,296,5.2,3,75,479,6.4,8,16,2,26,10,86,0,0,0
2923,2017,2,2017-09-09,LSU,,Chattanooga,W (45-10),9,18,50.0,232,1,46,222,4.8,4,64,454,7.1,8,14,0,22,11,74,0,0,0
2924,2017,3,2017-09-16,LSU,@,Mississippi State,L (7-37),13,29,44.8,137,0,29,133,4.6,1,58,270,4.7,6,5,2,13,9,112,0,0,0
2925,2017,4,2017-09-23,LSU,,Syracuse,W (35-26),14,23,60.9,263,2,38,151,4.0,3,61,414,6.8,7,10,1,18,3,25,0,1,1
2926,2017,5,2017-09-30,LSU,,Troy,L (21-24),21,32,65.6,266,3,29,162,5.6,0,61,428,7.0,11,10,0,21,4,29,2,2,4
2927,2017,6,2017-10-07,LSU,@,Florida,W (17-16),9,16,56.3,125,1,48,216,4.5,1,64,341,5.3,4,11,3,18,5,46,0,0,0
2928,2017,7,2017-10-14,LSU,,Auburn,W (27-23),13,25,52.0,206,1,39,157,4.0,1,64,363,5.7,8,6,0,14,7,61,1,0,1
2929,2017,8,2017-10-21,LSU,@,Mississippi,W (40-24),9,13,69.2,200,2,55,393,7.1,2,68,593,8.7,8,15,3,26,8,89,0,0,0
2930,2017,9,2017-11-04,LSU,@,Alabama,L (10-24),15,31,48.4,155,0,42,151,3.6,1,73,306,4.2,8,8,0,16,5,30,0,1,1
2931,2017,10,2017-11-11,LSU,,Arkansas,W (33-10),11,16,68.8,217,2,39,198,5.1,3,55,415,7.5,9,11,1,21,5,40,0,0,0
2932,2017,11,2017-11-18,LSU,@,Tennessee,W (30-10),11,15,73.3,81,0,43,200,4.7,4,58,281,4.8,5,11,1,17,1,9,0,0,0
2933,2017,12,2017-11-25,LSU,,Texas A&M,W (45-21),20,31,64.5,351,3,56,250,4.5,2,87,601,6.9,15,9,3,27,2,30,1,0,1
2934,2017,13,2018-01-01,LSU,N,Notre Dame*,L (17-21),19,33,57.6,229,2,42,170,4.0,0,75,399,5.3,12,10,0,22,5,27,0,0,0
2935,2017,,13 Games,LSU,,,,179,300,59.7,2645,17,563,2699,4.8,25,863,5344,6.2,109,136,16,261,75,658,4,4,8
2936,2016,1,2016-09-01,Maine,@,Connecticut,L (21-24),19,33,57.6,269,2,19,40,2.1,0,52,309,5.9,12,2,2,16,4,46,0,0,0
2937,2016,2,2016-09-10,Maine,@,Toledo,L (3-45),9,25,36.0,65,0,42,170,4.0,0,67,235,3.5,4,6,2,12,8,65,0,0,0
2938,2016,,2 Games,Maine,,,,28,58,48.3,334,2,61,210,3.4,0,119,544,4.6,16,8,4,28,12,111,0,0,0
2939,2017,1,2017-11-11,Maine,N,Massachusetts,L (31-44),16,41,39.0,232,0,29,148,5.1,3,70,380,5.4,7,6,4,17,12,124,0,2,2
2940,2014,1,2014-08-30,Marshall,@,Miami (OH),W (42-27),20,32,62.5,261,3,36,171,4.8,3,68,432,6.4,13,4,3,20,9,98,1,0,1
2941,2014,2,2014-09-06,Marshall,,Rhode Island,W (48-7),18,35,51.4,292,2,46,432,9.4,4,81,724,8.9,11,18,0,29,8,64,3,0,3
2942,2014,3,2014-09-13,Marshall,,Ohio,W (44-14),20,33,60.6,448,4,46,257,5.6,1,79,705,8.9,14,16,1,31,7,60,0,1,1
2943,2014,4,2014-09-20,Marshall,@,Akron,W (48-17),20,38,52.6,242,1,38,284,7.5,5,76,526,6.9,11,13,4,28,20,188,0,1,1
2944,2014,5,2014-10-04,Marshall,@,Old Dominion,W (56-14),21,27,77.8,237,2,50,354,7.1,5,77,591,7.7,13,15,0,28,6,54,1,2,3
2945,2014,6,2014-10-11,Marshall,,Middle Tennessee State,W (49-24),17,33,51.5,337,3,52,252,4.8,4,85,589,6.9,12,12,4,28,8,101,1,1,2
2946,2014,7,2014-10-18,Marshall,@,Florida International,W (45-13),15,27,55.6,214,4,26,243,9.3,1,53,457,8.6,10,6,2,18,9,65,0,1,1
2947,2014,8,2014-10-25,Marshall,,Florida Atlantic,W (35-16),13,24,54.2,218,1,35,328,9.4,4,59,546,9.3,9,9,2,20,6,60,0,0,0
2948,2014,9,2014-11-08,Marshall,@,Southern Mississippi,W (63-17),13,19,68.4,186,2,38,335,8.8,7,57,521,9.1,10,13,2,25,7,80,0,0,0
2949,2014,10,2014-11-15,Marshall,,Rice,W (41-14),23,37,62.2,297,4,44,284,6.5,1,81,581,7.2,17,13,0,30,7,70,1,1,2
2950,2014,11,2014-11-22,Marshall,@,Alabama-Birmingham,W (23-18),20,39,51.3,284,2,39,231,5.9,0,78,515,6.6,13,9,2,24,11,90,1,1,2
2951,2014,12,2014-11-28,Marshall,,Western Kentucky,L (66-67),29,46,63.0,417,7,36,291,8.1,2,82,708,8.6,19,17,1,37,6,59,0,4,4
2952,2014,13,2014-12-06,Marshall,,Louisiana Tech,W (26-23),25,46,54.3,308,2,35,121,3.5,0,81,429,5.3,16,4,0,20,9,75,3,1,4
2953,2014,14,2014-12-23,Marshall,N,Northern Illinois*,W (52-23),25,37,67.6,281,3,38,224,5.9,3,75,505,6.7,15,12,1,28,6,60,0,0,0
2954,2014,,14 Games,Marshall,,,,279,473,59.0,4022,40,559,3807,6.8,40,1032,7829,7.6,183,161,22,366,119,1124,11,13,24
2955,2015,1,2015-09-06,Marshall,,Purdue,W (41-31),23,36,63.9,234,2,29,163,5.6,1,65,397,6.1,11,5,4,20,6,57,2,1,3
2956,2015,2,2015-09-12,Marshall,@,Ohio,L (10-21),16,33,48.5,106,0,25,157,6.3,1,58,263,4.5,5,4,1,10,16,150,2,2,4
2957,2015,3,2015-09-19,Marshall,,Norfolk State,W (45-7),25,34,73.5,279,4,43,216,5.0,2,77,495,6.4,15,14,0,29,5,60,1,1,2
2958,2015,4,2015-09-26,Marshall,@,Kent State,W (36-29),14,36,38.9,151,2,44,126,2.9,2,80,277,3.5,9,5,3,17,4,45,1,2,3
2959,2015,5,2015-10-03,Marshall,,Old Dominion,W (27-7),21,35,60.0,212,2,40,112,2.8,1,75,324,4.3,9,7,1,17,7,77,2,0,2
2960,2015,6,2015-10-09,Marshall,,Southern Mississippi,W (31-10),11,21,52.4,163,2,35,114,3.3,1,56,277,4.9,6,7,1,14,8,96,0,1,1
2961,2015,7,2015-10-17,Marshall,@,Florida Atlantic,W (33-17),17,28,60.7,174,1,47,326,6.9,3,75,500,6.7,11,13,2,26,3,15,0,1,1
2962,2015,8,2015-10-24,Marshall,,North Texas,W (30-13),19,34,55.9,189,1,43,213,5.0,2,77,402,5.2,7,11,3,21,4,50,0,0,0
2963,2015,9,2015-10-31,Marshall,@,UNC Charlotte,W (34-10),35,53,66.0,494,2,39,136,3.5,2,92,630,6.8,21,8,2,31,14,100,0,0,0
2964,2015,10,2015-11-07,Marshall,@,Middle Tennessee State,L (24-27),35,58,60.3,376,3,45,139,3.1,0,103,515,5.0,18,9,3,30,11,86,0,1,1
2965,2015,11,2015-11-14,Marshall,,Florida International,W (52-0),17,26,65.4,174,3,39,289,7.4,3,65,463,7.1,8,16,2,26,3,14,1,1,2
2966,2015,12,2015-11-27,Marshall,@,Western Kentucky,L (28-49),20,41,48.8,242,2,25,31,1.2,1,66,273,4.1,11,3,2,16,6,65,2,2,4
2967,2015,13,2015-12-26,Marshall,N,Connecticut*,W (16-10),23,36,63.9,218,1,41,171,4.2,0,77,389,5.1,13,10,1,24,4,45,0,1,1
2968,2015,,13 Games,Marshall,,,,276,471,58.6,3012,25,495,2193,4.4,19,966,5205,5.4,144,112,25,281,91,860,11,13,24
2969,2016,1,2016-09-10,Marshall,,Morgan State,W (62-0),14,22,63.6,313,6,40,217,5.4,1,62,530,8.5,10,10,1,21,8,70,1,0,1
2970,2016,2,2016-09-17,Marshall,,Akron,L (38-65),33,59,55.9,446,4,38,114,3.0,1,97,560,5.8,17,8,6,31,17,180,1,3,4
2971,2016,3,2016-09-24,Marshall,,Louisville,L (28-59),9,21,42.9,59,2,43,148,3.4,1,64,207,3.2,2,10,4,16,9,95,1,1,2
2972,2016,4,2016-10-01,Marshall,@,Pittsburgh,L (27-43),20,32,62.5,240,2,30,104,3.5,2,62,344,5.5,7,9,2,18,5,67,0,1,1
2973,2016,5,2016-10-08,Marshall,@,North Texas,L (21-38),20,42,47.6,258,1,28,13,0.5,1,70,271,3.9,12,2,2,16,6,70,0,1,1
2974,2016,6,2016-10-15,Marshall,,Florida Atlantic,W (27-21),27,39,69.2,330,1,42,106,2.5,2,81,436,5.4,16,6,3,25,4,40,0,1,1
2975,2016,7,2016-10-22,Marshall,,UNC Charlotte,L (24-27),32,46,69.6,262,2,24,88,3.7,1,70,350,5.0,13,5,4,22,12,115,1,1,2
2976,2016,8,2016-10-29,Marshall,@,Southern Mississippi,L (14-24),20,34,58.8,166,1,25,60,2.4,1,59,226,3.8,8,2,1,11,5,65,0,0,0
2977,2016,9,2016-11-05,Marshall,@,Old Dominion,L (14-38),20,29,69.0,138,2,20,76,3.8,0,49,214,4.4,5,5,0,10,5,39,0,0,0
2978,2016,10,2016-11-12,Marshall,,Middle Tennessee State,W (42-17),21,37,56.8,246,4,41,207,5.0,2,78,453,5.8,13,13,3,29,3,35,0,0,0
2979,2016,11,2016-11-19,Marshall,@,Florida International,L (14-31),29,42,69.0,301,2,26,78,3.0,0,68,379,5.6,18,5,1,24,5,55,0,2,2
2980,2016,12,2016-11-26,Marshall,,Western Kentucky,L (6-60),19,35,54.3,143,1,39,87,2.2,0,74,230,3.1,4,10,4,18,11,90,0,2,2
2981,2016,,12 Games,Marshall,,,,264,438,60.3,2902,28,396,1298,3.3,12,834,4200,5.0,125,85,31,241,90,921,4,12,16
2982,2017,1,2017-09-02,Marshall,,Miami (OH),W (31-26),20,30,66.7,208,1,25,59,2.4,0,55,267,4.9,8,5,2,15,6,43,1,1,2
2983,2017,2,2017-09-09,Marshall,@,North Carolina State,L (20-37),26,43,60.5,350,2,25,101,4.0,0,68,451,6.6,13,5,0,18,9,86,1,1,2
2984,2017,3,2017-09-16,Marshall,,Kent State,W (21-0),23,43,53.5,223,1,33,158,4.8,2,76,381,5.0,11,10,2,23,8,75,0,1,1
2985,2017,4,2017-09-30,Marshall,@,Cincinnati,W (38-21),21,34,61.8,233,4,44,133,3.0,1,78,366,4.7,12,5,5,22,6,85,1,0,1
2986,2017,5,2017-10-07,Marshall,@,UNC Charlotte,W (14-3),19,28,67.9,192,2,42,212,5.0,0,70,404,5.8,11,10,2,23,5,30,2,0,2
2987,2017,6,2017-10-14,Marshall,,Old Dominion,W (35-3),12,23,52.2,176,3,40,195,4.9,1,63,371,5.9,7,8,3,18,3,25,0,0,0
2988,2017,7,2017-10-20,Marshall,@,Middle Tennessee State,W (38-10),16,24,66.7,168,0,43,202,4.7,4,67,370,5.5,9,10,2,21,7,63,0,0,0
2989,2017,8,2017-10-28,Marshall,,Florida International,L (30-41),33,52,63.5,363,3,29,142,4.9,1,81,505,6.2,19,8,2,29,3,35,1,2,3
2990,2017,9,2017-11-03,Marshall,@,Florida Atlantic,L (25-30),20,39,51.3,253,2,41,128,3.1,1,80,381,4.8,11,6,4,21,7,37,0,4,4
2991,2017,10,2017-11-11,Marshall,,Western Kentucky,W (30-23),17,28,60.7,190,0,49,144,2.9,2,77,334,4.3,10,11,1,22,7,69,0,1,1
2992,2017,11,2017-11-18,Marshall,@,Texas-San Antonio,L (7-9),16,23,69.6,189,1,23,40,1.7,0,46,229,5.0,9,2,1,12,7,70,1,1,2
2993,2017,12,2017-11-25,Marshall,,Southern Mississippi,L (27-28),26,44,59.1,308,4,26,74,2.8,0,70,382,5.5,12,6,5,23,6,52,2,1,3
2994,2017,13,2017-12-16,Marshall,N,Colorado State*,W (31-28),17,32,53.1,262,2,33,239,7.2,2,65,501,7.7,10,8,0,18,11,107,0,2,2
2995,2017,,13 Games,Marshall,,,,266,443,60.0,3115,25,453,1827,4.0,14,896,4942,5.5,142,94,29,265,85,777,9,14,23
2996,2014,1,2014-08-30,Maryland,,James Madison,W (52-7),18,35,51.4,186,2,50,285,5.7,5,85,471,5.5,11,16,3,30,5,35,0,1,1
2997,2014,2,2014-09-06,Maryland,@,South Florida,W (24-17),17,28,60.7,201,2,40,116,2.9,0,68,317,4.7,9,8,0,17,4,35,4,2,6
2998,2014,3,2014-09-13,Maryland,,West Virginia,L (37-40),21,38,55.3,284,2,27,163,6.0,1,65,447,6.9,11,5,0,16,7,71,0,1,1
2999,2014,4,2014-09-20,Maryland,@,Syracuse,W (34-20),16,26,61.5,280,2,32,89,2.8,1,58,369,6.4,10,6,1,17,8,75,0,0,0
3000,2014,5,2014-09-27,Maryland,@,Indiana,W (37-15),22,33,66.7,361,3,36,123,3.4,1,69,484,7.0,14,8,1,23,8,83,0,0,0
3001,2014,6,2014-10-04,Maryland,,Ohio State,L (24-52),24,40,60.0,244,1,24,66,2.8,2,64,310,4.8,8,6,3,17,2,23,0,4,4
3002,2014,7,2014-10-18,Maryland,,Iowa,W (38-31),17,33,51.5,206,1,46,212,4.6,3,79,418,5.3,8,11,3,22,6,50,0,2,2
3003,2014,8,2014-10-25,Maryland,@,Wisconsin,L (7-52),13,29,44.8,129,1,28,46,1.6,0,57,175,3.1,6,3,1,10,7,45,1,0,1
3004,2014,9,2014-11-01,Maryland,@,Penn State,W (20-19),18,38,47.4,161,1,30,33,1.1,1,68,194,2.9,7,5,3,15,6,89,2,0,2
3005,2014,10,2014-11-15,Maryland,,Michigan State,L (15-37),20,43,46.5,246,2,17,6,0.4,0,60,252,4.2,9,0,2,11,5,30,1,3,4
3006,2014,11,2014-11-22,Maryland,@,Michigan,W (23-16),13,24,54.2,165,0,35,147,4.2,2,59,312,5.3,8,8,1,17,4,30,0,0,0
3007,2014,12,2014-11-29,Maryland,,Rutgers,L (38-41),14,24,58.3,195,2,36,281,7.8,3,60,476,7.9,8,11,1,20,10,72,0,0,0
3008,2014,13,2014-12-30,Maryland,N,Stanford*,L (21-45),15,27,55.6,205,0,27,17,0.6,2,54,222,4.1,10,1,1,12,5,39,0,1,1
3009,2014,,13 Games,Maryland,,,,228,418,54.5,2863,19,428,1584,3.7,21,846,4447,5.3,119,88,20,227,77,677,8,14,22
3010,2015,1,2015-09-05,Maryland,,Richmond,W (50-21),12,22,54.5,138,2,45,341,7.6,3,67,479,7.1,6,18,0,24,5,39,0,1,1
3011,2015,2,2015-09-12,Maryland,,Bowling Green State,L (27-48),16,33,48.5,185,2,26,156,6.0,0,59,341,5.8,8,7,1,16,6,57,1,3,4
3012,2015,3,2015-09-19,Maryland,,South Florida,W (35-17),21,34,61.8,297,4,34,114,3.4,1,68,411,6.0,12,4,2,18,12,120,0,3,3
3013,2015,4,2015-09-26,Maryland,@,West Virginia,L (6-45),14,36,38.9,153,1,29,173,6.0,0,65,326,5.0,7,4,3,14,10,100,1,5,6
3014,2015,5,2015-10-03,Maryland,,Michigan,L (0-28),10,36,27.8,76,0,26,29,1.1,0,62,105,1.7,5,1,1,7,5,66,0,3,3
3015,2015,6,2015-10-10,Maryland,@,Ohio State,L (28-49),10,27,37.0,133,1,42,253,6.0,3,69,386,5.6,6,13,1,20,9,63,0,2,2
3016,2015,7,2015-10-24,Maryland,N,Penn State,L (30-31),19,28,67.9,225,1,48,241,5.0,2,76,466,6.1,9,11,1,21,6,55,2,3,5
3017,2015,8,2015-10-31,Maryland,@,Iowa,L (15-31),11,23,47.8,74,1,34,167,4.9,0,57,241,4.2,3,10,2,15,8,72,1,3,4
3018,2015,9,2015-11-07,Maryland,,Wisconsin,L (24-31),13,34,38.2,204,2,32,112,3.5,1,66,316,4.8,9,6,1,16,11,79,0,2,2
3019,2015,10,2015-11-14,Maryland,@,Michigan State,L (7-24),17,36,47.2,182,0,37,107,2.9,1,73,289,4.0,8,7,1,16,1,8,2,3,5
3020,2015,11,2015-11-21,Maryland,,Indiana,L (28-47),21,41,51.2,170,1,46,314,6.8,3,87,484,5.6,11,11,1,23,8,52,0,0,0
3021,2015,12,2015-11-28,Maryland,@,Rutgers,W (46-41),19,38,50.0,255,0,42,401,9.5,6,80,656,8.2,12,13,2,27,3,31,0,1,1
3022,2015,,12 Games,Maryland,,,,183,388,47.2,2092,15,441,2408,5.5,20,829,4500,5.4,96,105,16,217,84,742,7,29,36
3023,2016,1,2016-09-03,Maryland,,Howard,W (52-13),20,29,69.0,204,0,44,315,7.2,6,73,519,7.1,10,14,1,25,2,25,0,0,0
3024,2016,2,2016-09-09,Maryland,@,Florida International,W (41-14),15,21,71.4,238,3,45,239,5.3,1,66,477,7.2,11,11,0,22,8,85,0,0,0
3025,2016,3,2016-09-17,Maryland,@,Central Florida,W (30-24),10,23,43.5,127,0,50,246,4.9,4,73,373,5.1,4,16,0,20,6,47,0,0,0
3026,2016,4,2016-10-01,Maryland,,Purdue,W (50-7),9,17,52.9,96,3,46,400,8.7,4,63,496,7.9,5,13,1,19,11,92,1,1,2
3027,2016,5,2016-10-08,Maryland,@,Penn State,L (14-38),10,16,62.5,100,1,38,170,4.5,1,54,270,5.0,3,8,0,11,5,49,1,1,2
3028,2016,6,2016-10-15,Maryland,,Minnesota,L (10-31),18,37,48.6,161,1,36,130,3.6,0,73,291,4.0,8,8,0,16,9,75,2,2,4
3029,2016,7,2016-10-22,Maryland,,Michigan State,W (28-17),21,28,75.0,200,2,42,247,5.9,2,70,447,6.4,8,10,4,22,3,25,1,0,1
3030,2016,8,2016-10-29,Maryland,@,Indiana,L (36-42),22,34,64.7,248,2,50,269,5.4,3,84,517,6.2,14,13,2,29,6,60,1,1,2
3031,2016,9,2016-11-05,Maryland,@,Michigan,L (3-59),17,28,60.7,289,0,38,78,2.1,0,66,367,5.6,12,6,1,19,6,46,0,2,2
3032,2016,10,2016-11-12,Maryland,,Ohio State,L (3-62),15,27,55.6,133,0,40,43,1.1,0,67,176,2.6,7,3,0,10,7,74,1,1,2
3033,2016,11,2016-11-19,Maryland,@,Nebraska,L (7-28),15,31,48.4,196,1,25,11,0.4,0,56,207,3.7,7,2,0,9,5,65,0,0,0
3034,2016,12,2016-11-26,Maryland,,Rutgers,W (31-13),9,16,56.3,96,0,45,318,7.1,3,61,414,6.8,4,12,1,17,9,60,0,0,0
3035,2016,13,2016-12-26,Maryland,N,Boston College*,L (30-36),15,35,42.9,229,2,34,128,3.8,2,69,357,5.2,9,7,1,17,11,86,3,1,4
3036,2016,,13 Games,Maryland,,,,196,342,57.3,2317,15,533,2594,4.9,26,875,4911,5.6,102,123,11,236,88,789,10,9,19
3037,2017,1,2017-09-02,Maryland,@,Texas,W (51-41),12,15,80.0,219,2,43,263,6.1,4,58,482,8.3,7,10,1,18,10,53,0,1,1
3038,2017,2,2017-09-09,Maryland,,Towson,W (63-17),14,18,77.8,167,2,36,367,10.2,6,54,534,9.9,7,14,2,23,5,55,0,0,0
3039,2017,3,2017-09-23,Maryland,,Central Florida,L (10-38),17,28,60.7,155,1,37,42,1.1,0,65,197,3.0,7,5,6,18,7,53,0,2,2
3040,2017,4,2017-09-30,Maryland,@,Minnesota,W (31-24),18,28,64.3,154,2,47,262,5.6,2,75,416,5.5,9,13,1,23,6,70,0,0,0
3041,2017,5,2017-10-07,Maryland,@,Ohio State,L (14-62),3,13,23.1,16,0,42,50,1.2,1,55,66,1.2,0,3,3,6,6,66,2,0,2
3042,2017,6,2017-10-14,Maryland,,Northwestern,L (21-37),17,38,44.7,255,3,31,85,2.7,0,69,340,4.9,9,7,3,19,2,30,0,0,0
3043,2017,7,2017-10-21,Maryland,@,Wisconsin,L (13-38),13,30,43.3,125,1,35,143,4.1,0,65,268,4.1,6,10,2,18,4,54,1,1,2
3044,2017,8,2017-10-28,Maryland,,Indiana,W (42-39),10,16,62.5,171,2,40,174,4.4,3,56,345,6.2,6,8,4,18,12,133,0,1,1
3045,2017,9,2017-11-04,Maryland,N,Rutgers,L (24-31),19,32,59.4,218,1,37,167,4.5,2,69,385,5.6,11,6,3,20,10,65,0,1,1
3046,2017,10,2017-11-11,Maryland,,Michigan,L (10-35),18,38,47.4,160,1,32,180,5.6,0,70,340,4.9,7,8,0,15,7,59,0,2,2
3047,2017,11,2017-11-18,Maryland,@,Michigan State,L (7-17),13,25,52.0,121,0,31,83,2.7,1,56,204,3.6,6,5,1,12,6,45,1,0,1
3048,2017,12,2017-11-25,Maryland,,Penn State,L (3-66),21,37,56.8,179,0,25,124,5.0,0,62,303,4.9,7,3,1,11,8,91,2,0,2
3049,2017,,12 Games,Maryland,,,,175,318,55.0,1940,15,436,1940,4.4,19,754,3880,5.1,82,92,27,201,83,774,6,8,14
3050,2014,1,2014-08-30,Massachusetts,N,Boston College,L (7-30),9,22,40.9,147,1,22,55,2.5,0,44,202,4.6,4,4,1,9,4,23,0,1,1
3051,2014,2,2014-09-06,Massachusetts,N,Colorado,L (38-41),20,38,52.6,267,3,30,104,3.5,2,68,371,5.5,11,7,5,23,7,85,0,1,1
3052,2014,3,2014-09-13,Massachusetts,@,Vanderbilt,L (31-34),18,35,51.4,258,2,39,88,2.3,2,74,346,4.7,13,4,3,20,2,10,1,0,1
3053,2014,4,2014-09-20,Massachusetts,@,Penn State,L (7-48),17,33,51.5,263,1,28,3,0.1,0,61,266,4.4,7,5,1,13,4,30,1,0,1
3054,2014,5,2014-09-27,Massachusetts,,Bowling Green State,L (42-47),36,61,59.0,589,5,31,49,1.6,1,92,638,6.9,23,3,3,29,4,30,3,1,4
3055,2014,6,2014-10-04,Massachusetts,@,Miami (OH),L (41-42),35,62,56.5,389,4,34,165,4.9,1,96,554,5.8,17,9,6,32,7,60,2,2,4
3056,2014,7,2014-10-11,Massachusetts,@,Kent State,W (40-17),23,38,60.5,286,3,35,196,5.6,1,73,482,6.6,12,9,3,24,10,105,0,0,0
3057,2014,8,2014-10-18,Massachusetts,N,Eastern Michigan,W (36-14),28,51,54.9,337,0,43,225,5.2,5,94,562,6.0,19,11,4,34,9,55,2,1,3
3058,2014,9,2014-10-25,Massachusetts,@,Toledo,L (35-42),29,58,50.0,445,5,20,52,2.6,0,78,497,6.4,18,6,2,26,9,75,0,2,2
3059,2014,10,2014-11-12,Massachusetts,,Ball State,W (24-10),28,44,63.6,424,0,40,145,3.6,3,84,569,6.8,16,8,3,27,7,49,0,2,2
3060,2014,11,2014-11-18,Massachusetts,@,Akron,L (6-30),13,21,61.9,168,1,30,67,2.2,0,51,235,4.6,6,5,0,11,5,45,1,3,4
3061,2014,12,2014-11-28,Massachusetts,,Buffalo,L (21-41),13,29,44.8,168,2,35,162,4.6,1,64,330,5.2,9,8,1,18,5,50,0,0,0
3062,2014,,12 Games,Massachusetts,,,,269,492,54.7,3741,27,387,1311,3.4,16,879,5052,5.7,155,79,32,266,73,617,10,13,23
3063,2015,1,2015-09-12,Massachusetts,@,Colorado,L (14-48),24,42,57.1,250,1,29,147,5.1,1,71,397,5.6,11,6,3,20,4,50,1,1,2
3064,2015,2,2015-09-19,Massachusetts,,Temple,L (23-25),29,55,52.7,393,3,25,45,1.8,0,80,438,5.5,14,2,4,20,12,106,1,1,2
3065,2015,3,2015-09-26,Massachusetts,@,Notre Dame,L (27-62),28,48,58.3,302,1,29,148,5.1,3,77,450,5.8,13,4,5,22,4,35,0,1,1
3066,2015,4,2015-10-03,Massachusetts,,Florida International,W (24-14),32,43,74.4,363,3,39,132,3.4,0,82,495,6.0,16,9,4,29,10,72,2,0,2
3067,2015,5,2015-10-10,Massachusetts,@,Bowling Green State,L (38-62),37,61,60.7,486,4,15,30,2.0,0,76,516,6.8,25,1,4,30,7,78,1,1,2
3068,2015,6,2015-10-17,Massachusetts,,Kent State,L (10-15),17,33,51.5,171,0,27,86,3.2,1,60,257,4.3,6,6,4,16,9,76,0,1,1
3069,2015,7,2015-10-24,Massachusetts,,Toledo,L (35-51),27,49,55.1,240,4,24,148,6.2,1,73,388,5.3,12,6,1,19,15,134,0,1,1
3070,2015,8,2015-10-31,Massachusetts,@,Ball State,L (10-20),32,44,72.7,259,1,36,189,5.3,0,80,448,5.6,14,11,1,26,12,87,0,1,1
3071,2015,9,2015-11-07,Massachusetts,,Akron,L (13-17),19,44,43.2,173,0,32,88,2.8,1,76,261,3.4,9,8,2,19,2,27,0,2,2
3072,2015,10,2015-11-14,Massachusetts,@,Eastern Michigan,W (28-17),10,20,50.0,109,1,57,330,5.8,3,77,439,5.7,6,16,2,24,6,56,0,1,1
3073,2015,11,2015-11-21,Massachusetts,,Miami (OH),L (13-20),17,34,50.0,181,0,30,69,2.3,1,64,250,3.9,9,3,1,13,4,25,0,1,1
3074,2015,12,2015-11-27,Massachusetts,@,Buffalo,W (31-26),9,22,40.9,163,0,49,295,6.0,4,71,458,6.5,6,11,1,18,4,21,1,2,3
3075,2015,,12 Games,Massachusetts,,,,281,495,56.8,3090,18,392,1707,4.4,15,887,4797,5.4,141,83,32,256,89,767,6,13,19
3076,2016,1,2016-09-03,Massachusetts,@,Florida,L (7-24),9,17,52.9,141,0,35,46,1.3,1,52,187,3.6,5,3,4,12,7,25,0,0,0
3077,2016,2,2016-09-10,Massachusetts,,Boston College,L (7-26),11,28,39.3,145,1,33,-23,-0.7,0,61,122,2.0,6,1,1,8,5,37,2,1,3
3078,2016,3,2016-09-17,Massachusetts,,Florida International,W (21-13),28,42,66.7,278,3,36,116,3.2,0,78,394,5.1,16,4,1,21,9,72,0,1,1
3079,2016,4,2016-09-24,Massachusetts,,Mississippi State,L (35-47),24,41,58.5,273,4,28,138,4.9,1,69,411,6.0,16,5,1,22,7,35,0,3,3
3080,2016,5,2016-10-01,Massachusetts,,Tulane,L (24-31),16,30,53.3,181,2,24,131,5.5,1,54,312,5.8,7,8,1,16,7,65,1,1,2
3081,2016,6,2016-10-07,Massachusetts,@,Old Dominion,L (16-36),16,33,48.5,237,1,32,169,5.3,1,65,406,6.2,11,10,1,22,10,85,0,2,2
3082,2016,7,2016-10-15,Massachusetts,,Louisiana Tech,L (28-56),29,40,72.5,268,3,33,131,4.0,1,73,399,5.5,14,11,0,25,7,73,1,1,2
3083,2016,8,2016-10-22,Massachusetts,@,South Carolina,L (28-34),20,42,47.6,247,3,37,142,3.8,1,79,389,4.9,13,8,2,23,8,77,2,2,4
3084,2016,9,2016-10-29,Massachusetts,,Wagner,W (34-10),26,41,63.4,364,3,24,143,6.0,1,65,507,7.8,15,7,2,24,7,60,0,1,1
3085,2016,10,2016-11-05,Massachusetts,@,Troy,L (31-52),23,44,52.3,316,3,28,44,1.6,1,72,360,5.0,13,5,0,18,8,76,1,1,2
3086,2016,11,2016-11-19,Massachusetts,@,Brigham Young,L (9-51),27,40,67.5,288,1,20,40,2.0,0,60,328,5.5,10,3,1,14,9,94,2,2,4
3087,2016,12,2016-11-26,Massachusetts,@,Hawaii,L (40-46),24,38,63.2,342,3,34,117,3.4,2,72,459,6.4,12,10,3,25,9,85,1,0,1
3088,2016,,12 Games,Massachusetts,,,,253,436,58.0,3080,27,364,1194,3.3,10,800,4274,5.3,138,75,17,230,93,784,10,15,25
3089,2017,1,2017-08-26,Massachusetts,,Hawaii,L (35-38),22,34,64.7,298,2,41,115,2.8,3,75,413,5.5,13,6,1,20,5,55,1,1,2
3090,2017,2,2017-09-02,Massachusetts,@,Coastal Carolina,L (28-38),27,45,60.0,362,1,26,79,3.0,3,71,441,6.2,17,5,1,23,7,64,2,0,2
3091,2017,3,2017-09-09,Massachusetts,,Old Dominion,L (7-17),22,37,59.5,253,1,36,79,2.2,0,73,332,4.5,10,9,1,20,3,40,0,0,0
3092,2017,4,2017-09-15,Massachusetts,@,Temple,L (21-29),23,39,59.0,377,2,33,81,2.5,1,72,458,6.4,18,5,2,25,6,48,1,0,1
3093,2017,5,2017-09-23,Massachusetts,@,Tennessee,L (13-17),13,22,59.1,137,1,37,144,3.9,1,59,281,4.8,7,6,1,14,7,43,0,0,0
3094,2017,6,2017-09-30,Massachusetts,,Ohio,L (50-58),33,58,56.9,403,5,37,147,4.0,1,95,550,5.8,17,9,4,30,5,39,1,1,2
3095,2017,7,2017-10-21,Massachusetts,,Georgia Southern,W (55-20),21,28,75.0,350,4,44,320,7.3,4,72,670,9.3,15,13,5,33,8,70,2,0,2
3096,2017,8,2017-10-28,Massachusetts,,Appalachian State,W (30-27),20,33,60.6,190,0,39,209,5.4,3,72,399,5.5,9,6,1,16,11,82,2,2,4
3097,2017,9,2017-11-04,Massachusetts,@,Mississippi State,L (23-34),15,28,53.6,223,1,32,127,4.0,0,60,350,5.8,3,6,3,12,5,55,0,1,1
3098,2017,10,2017-11-11,Massachusetts,N,Maine,W (44-31),21,39,53.8,355,4,36,100,2.8,1,75,455,6.1,14,5,4,23,13,96,0,0,0
3099,2017,11,2017-11-18,Massachusetts,@,Brigham Young,W (16-10),21,35,60.0,230,1,33,69,2.1,0,68,299,4.4,14,4,0,18,3,30,0,0,0
3100,2017,12,2017-12-02,Massachusetts,@,Florida International,L (45-63),34,49,69.4,392,4,24,156,6.5,2,73,548,7.5,17,8,1,26,6,57,2,1,3
3101,2017,,12 Games,Massachusetts,,,,272,447,60.9,3570,26,418,1626,3.9,19,865,5196,6.0,154,82,24,260,79,679,11,6,17
3102,2016,1,2016-09-10,McNeese State,@,Louisiana,L (22-30),29,46,63.0,265,0,42,99,2.4,2,88,364,4.1,18,6,3,27,8,67,1,0,1
3103,2014,1,2014-08-30,Memphis,,Austin Peay,W (63-0),20,27,74.1,242,2,55,303,5.5,7,82,545,6.6,10,14,4,28,6,55,1,1,2
3104,2014,2,2014-09-06,Memphis,@,UCLA,L (35-42),27,42,64.3,305,1,39,164,4.2,3,81,469,5.8,17,5,2,24,10,110,0,0,0
3105,2014,3,2014-09-20,Memphis,,Middle Tennessee State,W (36-17),21,35,60.0,219,2,51,261,5.1,1,86,480,5.6,14,11,1,26,6,35,0,1,1
3106,2014,4,2014-09-27,Memphis,@,Mississippi,L (3-24),13,31,41.9,81,0,31,23,0.7,0,62,104,1.7,4,4,5,13,9,105,1,1,2
3107,2014,5,2014-10-04,Memphis,N,Cincinnati,W (41-14),18,25,72.0,311,2,69,299,4.3,3,94,610,6.5,14,16,0,30,8,72,0,0,0
3108,2014,6,2014-10-11,Memphis,,Houston,L (24-28),26,37,70.3,243,2,41,125,3.0,1,78,368,4.7,12,7,1,20,4,41,2,3,5
3109,2014,7,2014-10-25,Memphis,@,Southern Methodist,W (48-10),20,27,74.1,352,2,53,230,4.3,4,80,582,7.3,17,10,2,29,8,69,1,0,1
3110,2014,8,2014-10-31,Memphis,,Tulsa,W (40-20),18,31,58.1,183,0,41,243,5.9,4,72,426,5.9,7,13,3,23,4,40,1,0,1
3111,2014,9,2014-11-07,Memphis,@,Temple,W (16-13),21,28,75.0,230,1,40,82,2.1,0,68,312,4.6,13,3,1,17,6,46,1,0,1
3112,2014,10,2014-11-15,Memphis,@,Tulane,W (38-7),14,25,56.0,178,1,40,156,3.9,2,65,334,5.1,8,5,0,13,4,51,2,0,2
3113,2014,11,2014-11-22,Memphis,,South Florida,W (31-20),18,23,78.3,232,2,39,238,6.1,2,62,470,7.6,8,10,1,19,6,58,0,0,0
3114,2014,12,2014-11-29,Memphis,,Connecticut,W (41-10),22,41,53.7,194,4,44,178,4.0,1,85,372,4.4,10,12,6,28,4,40,0,0,0
3115,2014,13,2014-12-22,Memphis,N,Brigham Young*,W (55-48),24,46,52.2,306,4,51,174,3.4,3,97,480,4.9,15,8,1,24,6,43,2,3,5
3116,2014,,13 Games,Memphis,,,,262,418,62.7,3076,23,594,2476,4.2,31,1012,5552,5.5,149,118,27,294,81,765,11,9,20
3117,2015,1,2015-09-05,Memphis,,Missouri State,W (63-7),16,21,76.2,202,3,60,317,5.3,5,81,519,6.4,9,16,2,27,9,92,0,0,0
3118,2015,2,2015-09-12,Memphis,@,Kansas,W (55-23),24,27,88.9,370,2,52,281,5.4,5,79,651,8.2,0,0,0,34,7,58,3,0,3
3119,2015,3,2015-09-19,Memphis,@,Bowling Green State,W (44-41),29,40,72.5,386,3,50,155,3.1,2,90,541,6.0,14,11,3,28,7,78,0,0,0
3120,2015,4,2015-09-24,Memphis,,Cincinnati,W (53-46),24,36,66.7,412,2,37,158,4.3,4,73,570,7.8,16,6,0,22,9,100,1,0,1
3121,2015,5,2015-10-02,Memphis,@,South Florida,W (24-17),20,33,60.6,305,2,39,120,3.1,1,72,425,5.9,12,7,1,20,7,75,0,0,0
3122,2015,6,2015-10-17,Memphis,,Mississippi,W (37-24),39,53,73.6,384,3,41,107,2.6,1,94,491,5.2,21,7,3,31,10,80,0,1,1
3123,2015,7,2015-10-23,Memphis,@,Tulsa,W (66-42),32,44,72.7,447,4,52,257,4.9,5,96,704,7.3,18,11,6,35,12,120,1,0,1
3124,2015,8,2015-10-31,Memphis,,Tulane,W (41-13),27,44,61.4,358,1,39,223,5.7,3,83,581,7.0,16,16,0,32,8,106,0,0,0
3125,2015,9,2015-11-07,Memphis,,Navy,L (20-45),26,42,61.9,305,1,31,133,4.3,1,73,438,6.0,13,7,1,21,4,43,2,1,3
3126,2015,10,2015-11-14,Memphis,@,Houston,L (34-35),20,32,62.5,278,2,54,212,3.9,2,86,490,5.7,11,14,1,26,7,45,1,1,2
3127,2015,11,2015-11-21,Memphis,@,Temple,L (12-31),25,34,73.5,156,0,35,76,2.2,0,69,232,3.4,10,3,0,13,8,79,0,0,0
3128,2015,12,2015-11-28,Memphis,,Southern Methodist,W (63-0),13,22,59.1,288,7,42,195,4.6,0,64,483,7.5,10,8,2,20,5,60,1,1,2
3129,2015,13,2015-12-30,Memphis,N,Auburn*,L (10-31),16,37,43.2,106,0,31,99,3.2,0,68,205,3.0,6,5,2,13,6,40,0,1,1
3130,2015,,13 Games,Memphis,,,,311,465,66.9,3997,30,563,2333,4.1,29,1028,6330,6.2,156,111,21,322,99,976,9,5,14
3131,2016,1,2016-09-03,Memphis,,Southeast Missouri State,W (35-17),26,40,65.0,295,3,32,117,3.7,1,72,412,5.7,18,5,4,27,4,40,1,2,3
3132,2016,2,2016-09-17,Memphis,,Kansas,W (43-7),15,25,60.0,189,2,47,205,4.4,2,72,394,5.5,6,12,1,19,8,89,0,0,0
3133,2016,3,2016-09-24,Memphis,,Bowling Green State,W (77-3),23,32,71.9,395,6,45,240,5.3,4,77,635,8.2,13,9,3,25,9,85,0,0,0
3134,2016,4,2016-10-01,Memphis,@,Mississippi,L (28-48),31,47,66.0,355,0,31,119,3.8,4,78,474,6.1,16,7,4,27,7,52,1,3,4
3135,2016,5,2016-10-06,Memphis,,Temple,W (34-27),17,26,65.4,174,0,31,151,4.9,2,57,325,5.7,10,4,1,15,3,25,1,0,1
3136,2016,6,2016-10-14,Memphis,@,Tulane,W (24-14),21,34,61.8,236,1,33,163,4.9,1,67,399,6.0,7,8,1,16,7,79,2,1,3
3137,2016,7,2016-10-22,Memphis,@,Navy,L (28-42),25,40,62.5,333,2,31,98,3.2,1,71,431,6.1,18,6,0,24,3,25,1,0,1
3138,2016,8,2016-10-29,Memphis,,Tulsa,L (30-59),19,40,47.5,349,3,42,159,3.8,1,82,508,6.2,11,9,2,22,12,98,2,2,4
3139,2016,9,2016-11-05,Memphis,@,Southern Methodist,W (51-7),24,33,72.7,314,4,39,160,4.1,1,72,474,6.6,13,10,1,24,3,26,0,0,0
3140,2016,10,2016-11-12,Memphis,,South Florida,L (42-49),29,46,63.0,331,3,35,277,7.9,2,81,608,7.5,15,12,2,29,6,60,0,1,1
3141,2016,11,2016-11-18,Memphis,@,Cincinnati,W (34-7),16,20,80.0,159,2,53,172,3.2,2,73,331,4.5,10,9,1,20,5,45,1,0,1
3142,2016,12,2016-11-25,Memphis,,Houston,W (48-44),30,45,66.7,409,4,34,146,4.3,2,79,555,7.0,19,6,3,28,10,94,0,0,0
3143,2016,13,2016-12-20,Memphis,N,Western Kentucky*,L (31-51),27,49,55.1,418,4,32,73,2.3,0,81,491,6.1,18,5,4,27,5,53,2,1,3
3144,2016,,13 Games,Memphis,,,,303,477,63.5,3957,34,485,2080,4.3,23,962,6037,6.3,174,102,27,303,82,771,11,10,21
3145,2017,1,2017-08-31,Memphis,,Louisiana-Monroe,W (37-29),10,25,40.0,97,0,39,319,8.2,4,64,416,6.5,4,10,2,16,10,96,1,1,2
3146,2017,2,2017-09-16,Memphis,,UCLA,W (48-45),23,39,59.0,398,6,37,162,4.4,0,76,560,7.4,15,5,6,26,11,109,1,2,3
3147,2017,3,2017-09-23,Memphis,,Southern Illinois,W (44-31),22,36,61.1,288,2,36,176,4.9,2,72,464,6.4,15,8,1,24,8,90,0,0,0
3148,2017,4,2017-09-30,Memphis,@,Central Florida,L (13-40),27,49,55.1,321,1,24,75,3.1,1,73,396,5.4,14,6,5,25,3,20,1,3,4
3149,2017,5,2017-10-06,Memphis,@,Connecticut,W (70-31),39,55,70.9,480,8,45,231,5.1,2,100,711,7.1,21,12,1,34,12,104,0,0,0
3150,2017,6,2017-10-14,Memphis,,Navy,W (30-27),24,40,60.0,279,3,29,118,4.1,0,69,397,5.8,14,6,4,24,9,39,1,0,1
3151,2017,7,2017-10-19,Memphis,@,Houston,W (42-38),33,53,62.3,471,1,23,30,1.3,4,76,501,6.6,20,4,4,28,2,10,1,1,2
3152,2017,8,2017-10-27,Memphis,,Tulane,W (56-26),18,31,58.1,298,3,32,259,8.1,4,63,557,8.8,12,6,0,18,8,80,0,1,1
3153,2017,9,2017-11-03,Memphis,@,Tulsa,W (41-14),28,40,70.0,333,4,37,191,5.2,1,77,524,6.8,17,6,5,28,10,77,0,0,0
3154,2017,10,2017-11-18,Memphis,,Southern Methodist,W (66-45),22,28,78.6,331,2,46,333,7.2,7,74,664,9.0,16,15,1,32,11,132,0,1,1
3155,2017,11,2017-11-25,Memphis,,East Carolina,W (70-13),10,15,66.7,302,3,34,333,9.8,5,49,635,13.0,8,14,1,23,8,88,0,0,0
3156,2017,12,2017-12-02,Memphis,@,Central Florida,L (55-62),30,44,68.2,471,4,45,282,6.3,3,89,753,8.5,18,12,2,32,14,127,1,1,2
3157,2017,13,2017-12-30,Memphis,,Iowa State*,L (20-21),21,33,63.6,286,2,26,53,2.0,0,59,339,5.7,14,2,1,17,5,34,0,0,0
3158,2017,,13 Games,Memphis,,,,307,488,62.9,4355,39,453,2562,5.7,33,941,6917,7.4,188,106,33,327,111,1006,6,10,16
3159,2016,1,2016-09-10,Mercer,@,Georgia Tech,L (10-35),25,40,62.5,235,1,28,85,3.0,0,68,320,4.7,11,8,0,19,5,45,0,0,0
3160,2017,1,2017-09-16,Mercer,@,Auburn,L (10-24),20,32,62.5,146,1,35,100,2.9,0,67,246,3.7,5,5,2,12,2,30,0,0,0
3161,2017,2,2017-11-18,Mercer,@,Alabama,L (0-56),7,22,31.8,54,0,39,107,2.7,0,61,161,2.6,5,4,0,9,2,10,0,3,3
3162,2017,,2 Games,Mercer,,,,27,54,50.0,200,1,74,207,2.8,0,128,407,3.2,10,9,2,21,4,40,0,3,3
3163,2014,1,2014-09-01,Miami (FL),@,Louisville,L (13-31),17,29,58.6,174,1,27,70,2.6,0,56,244,4.4,6,4,2,12,7,46,1,2,3
3164,2014,2,2014-09-06,Miami (FL),,Florida A&M,W (41-7),17,30,56.7,218,2,33,198,6.0,3,63,416,6.6,10,10,1,21,4,40,1,2,3
3165,2014,3,2014-09-13,Miami (FL),,Arkansas State,W (41-20),16,26,61.5,342,4,35,146,4.2,2,61,488,8.0,9,8,3,20,11,93,1,1,2
3166,2014,4,2014-09-20,Miami (FL),@,Nebraska,L (31-41),28,42,66.7,359,3,23,76,3.3,1,65,435,6.7,16,6,2,24,9,82,1,2,3
3167,2014,5,2014-09-27,Miami (FL),,Duke,W (22-10),20,34,58.8,223,2,41,203,5.0,1,75,426,5.7,9,12,0,21,8,93,2,0,2
3168,2014,6,2014-10-04,Miami (FL),@,Georgia Tech,L (17-28),16,25,64.0,245,1,19,107,5.6,1,44,352,8.0,11,6,2,19,5,38,0,2,2
3169,2014,7,2014-10-11,Miami (FL),,Cincinnati,W (55-34),17,25,68.0,286,3,35,335,9.6,3,60,621,10.4,9,9,2,20,13,155,1,0,1
3170,2014,8,2014-10-23,Miami (FL),@,Virginia Tech,W (30-6),7,16,43.8,92,1,53,364,6.9,3,69,456,6.6,5,16,1,22,4,28,0,0,0
3171,2014,9,2014-11-01,Miami (FL),,North Carolina,W (47-20),12,19,63.2,199,3,49,295,6.0,3,68,494,7.3,9,14,0,23,6,45,1,0,1
3172,2014,10,2014-11-15,Miami (FL),,Florida State,L (26-30),16,34,47.1,316,2,40,176,4.4,1,74,492,6.6,9,10,0,19,5,51,2,1,3
3173,2014,11,2014-11-22,Miami (FL),@,Virginia,L (13-30),20,33,60.6,263,1,23,64,2.8,0,56,327,5.8,10,4,1,15,9,59,1,1,2
3174,2014,12,2014-11-29,Miami (FL),,Pittsburgh,L (23-35),22,45,48.9,296,2,28,125,4.5,0,73,421,5.8,14,5,2,21,7,57,0,0,0
3175,2014,13,2014-12-27,Miami (FL),N,South Carolina*,L (21-24),19,33,57.6,236,1,40,186,4.7,1,73,422,5.8,10,10,1,21,5,40,1,1,2
3176,2014,,13 Games,Miami (FL),,,,227,391,58.1,3249,26,446,2345,5.3,19,837,5594,6.7,127,114,17,258,93,827,12,12,24
3177,2015,1,2015-09-05,Miami (FL),,Bethune-Cookman,W (45-0),17,31,54.8,184,2,26,195,7.5,3,57,379,6.6,10,9,1,20,4,30,1,0,1
3178,2015,2,2015-09-11,Miami (FL),@,Florida Atlantic,W (44-20),22,34,64.7,300,1,44,226,5.1,4,78,526,6.7,13,12,2,27,8,64,0,0,0
3179,2015,3,2015-09-19,Miami (FL),,Nebraska,W (36-33),25,42,59.5,379,2,33,132,4.0,1,75,511,6.8,18,4,2,24,13,114,0,1,1
3180,2015,4,2015-10-01,Miami (FL),@,Cincinnati,L (23-34),25,40,62.5,281,0,32,146,4.6,2,72,427,5.9,12,7,2,21,6,50,0,0,0
3181,2015,5,2015-10-10,Miami (FL),@,Florida State,L (24-29),29,49,59.2,405,3,19,20,1.1,0,68,425,6.3,17,2,0,19,7,73,0,0,0
3182,2015,6,2015-10-17,Miami (FL),,Virginia Tech,W (30-20),19,30,63.3,296,2,39,99,2.5,1,69,395,5.7,12,5,3,20,9,81,0,0,0
3183,2015,7,2015-10-24,Miami (FL),,Clemson,L (0-58),13,32,40.6,93,0,29,53,1.8,0,61,146,2.4,2,4,0,6,7,88,0,3,3
3184,2015,8,2015-10-31,Miami (FL),@,Duke,W (30-27),20,29,69.0,272,2,39,119,3.1,0,68,391,5.8,12,7,2,21,23,194,1,1,2
3185,2015,9,2015-11-07,Miami (FL),,Virginia,W (27-21),20,26,76.9,286,2,33,143,4.3,1,59,429,7.3,9,7,2,18,7,52,0,1,1
3186,2015,10,2015-11-14,Miami (FL),@,North Carolina,L (21-59),24,43,55.8,326,1,32,99,3.1,2,75,425,5.7,17,6,2,25,12,103,1,1,2
3187,2015,11,2015-11-21,Miami (FL),,Georgia Tech,W (38-21),16,26,61.5,300,1,28,86,3.1,3,54,386,7.1,11,4,0,15,9,76,0,0,0
3188,2015,12,2015-11-27,Miami (FL),@,Pittsburgh,W (29-24),21,35,60.0,261,1,40,116,2.9,1,75,377,5.0,10,8,2,20,7,64,0,0,0
3189,2015,13,2015-12-26,Miami (FL),N,Washington State*,L (14-20),17,32,53.1,219,1,30,125,4.2,1,62,344,5.5,9,4,0,13,9,105,1,2,3
3190,2015,,13 Games,Miami (FL),,,,268,449,59.7,3602,18,424,1559,3.7,19,873,5161,5.9,152,79,18,249,121,1094,4,9,13
3191,2016,1,2016-09-03,Miami (FL),,Florida A&M,W (70-3),13,21,61.9,150,4,36,373,10.4,5,57,523,9.2,8,13,1,22,6,54,1,0,1
3192,2016,2,2016-09-10,Miami (FL),,Florida Atlantic,W (38-10),17,31,54.8,191,0,39,279,7.2,5,70,470,6.7,8,13,0,21,9,90,0,2,2
3193,2016,3,2016-09-17,Miami (FL),@,Appalachian State,W (45-10),22,28,78.6,385,3,31,164,5.3,3,59,549,9.3,15,3,0,18,9,73,0,1,1
3194,2016,4,2016-10-01,Miami (FL),@,Georgia Tech,W (35-21),13,19,68.4,241,1,27,114,4.2,2,46,355,7.7,10,7,1,18,4,39,0,0,0
3195,2016,5,2016-10-08,Miami (FL),,Florida State,L (19-20),19,32,59.4,214,2,28,62,2.2,0,60,276,4.6,10,5,5,20,10,110,0,1,1
3196,2016,6,2016-10-15,Miami (FL),,North Carolina,L (13-20),16,32,50.0,224,0,36,139,3.9,1,68,363,5.3,10,6,1,17,4,43,1,0,1
3197,2016,7,2016-10-20,Miami (FL),@,Virginia Tech,L (16-37),23,38,60.5,323,2,29,42,1.4,0,67,365,5.4,12,3,0,15,6,62,0,1,1
3198,2016,8,2016-10-29,Miami (FL),@,Notre Dame,L (27-30),26,42,61.9,288,1,35,18,0.5,1,77,306,4.0,15,3,2,20,10,86,0,1,1
3199,2016,9,2016-11-05,Miami (FL),,Pittsburgh,W (51-28),32,47,68.1,356,4,36,178,4.9,2,83,534,6.4,15,7,0,22,8,71,0,0,0
3200,2016,10,2016-11-12,Miami (FL),@,Virginia,W (34-14),14,29,48.3,228,2,42,222,5.3,2,71,450,6.3,6,12,2,20,7,45,1,1,2
3201,2016,11,2016-11-19,Miami (FL),@,North Carolina State,W (27-13),22,38,57.9,286,0,32,129,4.0,3,70,415,5.9,14,8,2,24,6,45,0,0,0
3202,2016,12,2016-11-26,Miami (FL),,Duke,W (40-21),22,35,62.9,396,4,30,172,5.7,0,65,568,8.7,11,11,2,24,8,69,0,0,0
3203,2016,13,2016-12-28,Miami (FL),N,West Virginia*,W (31-14),24,34,70.6,282,4,34,81,2.4,0,68,363,5.3,14,4,2,20,8,89,0,0,0
3204,2016,,13 Games,Miami (FL),,,,263,426,61.7,3564,27,435,1973,4.5,24,861,5537,6.4,148,95,18,261,95,876,3,7,10
3205,2017,1,2017-09-02,Miami (FL),,Bethune-Cookman,W (41-13),18,31,58.1,233,3,34,317,9.3,2,65,550,8.5,11,15,2,28,7,68,0,0,0
3206,2017,2,2017-09-23,Miami (FL),,Toledo,W (52-30),27,36,75.0,333,3,26,254,9.8,4,62,587,9.5,13,12,2,27,8,75,0,1,1
3207,2017,3,2017-09-29,Miami (FL),@,Duke,W (31-6),15,26,57.7,270,2,35,139,4.0,2,61,409,6.7,9,8,2,19,5,59,0,1,1
3208,2017,4,2017-10-07,Miami (FL),@,Florida State,W (24-20),19,44,43.2,254,3,29,83,2.9,0,73,337,4.6,12,6,2,20,6,79,0,1,1
3209,2017,5,2017-10-14,Miami (FL),,Georgia Tech,W (25-24),23,38,60.5,297,1,36,184,5.1,1,74,481,6.5,12,12,0,24,6,45,0,0,0
3210,2017,6,2017-10-21,Miami (FL),,Syracuse,W (27-19),26,43,60.5,344,2,32,136,4.3,1,75,480,6.4,14,7,1,22,5,42,1,0,1
3211,2017,7,2017-10-28,Miami (FL),@,North Carolina,W (24-19),17,41,41.5,356,3,32,59,1.8,0,73,415,5.7,10,4,2,16,5,60,1,1,2
3212,2017,8,2017-11-04,Miami (FL),,Virginia Tech,W (28-10),12,24,50.0,219,2,33,211,6.4,2,57,430,7.5,11,7,3,21,7,66,0,3,3
3213,2017,9,2017-11-11,Miami (FL),,Notre Dame,W (41-8),15,24,62.5,137,1,42,237,5.6,3,66,374,5.7,6,11,1,18,1,5,0,0,0
3214,2017,10,2017-11-18,Miami (FL),,Virginia,W (44-28),15,28,53.6,210,3,32,148,4.6,2,60,358,6.0,10,5,0,15,4,40,0,2,2
3215,2017,11,2017-11-24,Miami (FL),@,Pittsburgh,L (14-24),15,36,41.7,187,2,23,45,2.0,0,59,232,3.9,9,4,1,14,6,52,1,0,1
3216,2017,12,2017-12-02,Miami (FL),N,Clemson,L (3-38),14,29,48.3,110,0,30,104,3.5,0,59,214,3.6,3,7,0,10,4,30,1,2,3
3217,2017,13,2017-12-30,Miami (FL),,Wisconsin*,L (24-34),11,26,42.3,203,1,29,174,6.0,2,55,377,6.9,8,8,1,17,4,20,0,3,3
3218,2017,,13 Games,Miami (FL),,,,227,426,53.3,3153,26,413,2091,5.1,19,839,5244,6.3,128,106,17,251,68,641,4,14,18
3219,2014,1,2014-08-30,Miami (OH),,Marshall,L (27-42),24,49,49.0,318,3,36,100,2.8,0,85,418,4.9,11,7,4,22,12,107,0,1,1
3220,2014,2,2014-09-06,Miami (OH),,Eastern Kentucky,L (10-17),25,52,48.1,359,1,38,60,1.6,0,90,419,4.7,14,7,4,25,9,61,3,3,6
3221,2014,3,2014-09-13,Miami (OH),@,Michigan,L (10-34),12,26,46.2,165,1,24,33,1.4,0,50,198,4.0,7,1,0,8,7,40,0,1,1
3222,2014,4,2014-09-20,Miami (OH),N,Cincinnati,L (24-31),13,26,50.0,262,2,44,102,2.3,1,70,364,5.2,8,11,0,19,6,38,2,1,3
3223,2014,5,2014-09-27,Miami (OH),@,Buffalo,L (27-35),12,38,31.6,238,3,22,133,6.0,1,60,371,6.2,8,4,1,13,6,55,0,0,0
3224,2014,6,2014-10-04,Miami (OH),,Massachusetts,W (42-41),32,58,55.2,437,4,27,120,4.4,2,85,557,6.6,23,6,2,31,10,95,1,0,1
3225,2014,7,2014-10-11,Miami (OH),@,Akron,L (19-29),24,41,58.5,352,3,23,60,2.6,0,64,412,6.4,19,3,1,23,12,102,2,1,3
3226,2014,8,2014-10-18,Miami (OH),@,Northern Illinois,L (41-51),23,42,54.8,346,2,30,168,5.6,4,72,514,7.1,16,8,2,26,8,56,0,0,0
3227,2014,9,2014-10-25,Miami (OH),,Kent State,W (10-3),11,28,39.3,120,0,33,167,5.1,1,61,287,4.7,5,8,2,15,8,62,0,0,0
3228,2014,10,2014-11-01,Miami (OH),,Western Michigan,L (10-41),11,29,37.9,149,1,29,87,3.0,0,58,236,4.1,7,7,4,18,5,40,0,2,2
3229,2014,11,2014-11-15,Miami (OH),@,Central Michigan,L (27-34),24,41,58.5,369,2,27,102,3.8,1,68,471,6.9,18,6,4,28,5,37,1,0,1
3230,2014,12,2014-11-25,Miami (OH),,Ohio,L (21-24),15,38,39.5,218,1,25,99,4.0,1,63,317,5.0,12,6,0,18,7,46,1,1,2
3231,2014,,12 Games,Miami (OH),,,,226,468,48.3,3333,23,358,1231,3.4,11,826,4564,5.5,148,74,24,246,95,739,10,10,20
3232,2015,1,2015-09-05,Miami (OH),,Presbyterian,W (26-7),17,23,73.9,261,2,40,205,5.1,2,63,466,7.4,7,9,2,18,13,162,2,0,2
3233,2015,2,2015-09-12,Miami (OH),@,Wisconsin,L (0-58),13,34,38.2,160,0,24,-3,-0.1,0,58,157,2.7,8,0,1,9,7,72,1,3,4
3234,2015,3,2015-09-19,Miami (OH),,Cincinnati,L (33-37),14,34,41.2,228,4,41,220,5.4,0,75,448,6.0,7,9,1,17,6,50,0,1,1
3235,2015,4,2015-09-26,Miami (OH),@,Western Kentucky,L (14-56),15,28,53.6,168,2,40,123,3.1,0,68,291,4.3,9,5,1,15,6,36,1,3,4
3236,2015,5,2015-10-03,Miami (OH),@,Kent State,L (14-20),21,51,41.2,325,1,36,91,2.5,1,87,416,4.8,13,8,3,24,10,83,0,4,4
3237,2015,6,2015-10-10,Miami (OH),@,Ohio,L (3-34),9,25,36.0,166,0,24,87,3.6,0,49,253,5.2,7,3,2,12,6,47,0,4,4
3238,2015,7,2015-10-17,Miami (OH),,Northern Illinois,L (12-45),16,33,48.5,156,1,41,153,3.7,0,74,309,4.2,6,9,2,17,9,75,1,1,2
3239,2015,8,2015-10-24,Miami (OH),@,Western Michigan,L (13-35),14,27,51.9,218,0,27,58,2.1,1,54,276,5.1,9,3,0,12,8,64,2,0,2
3240,2015,9,2015-10-29,Miami (OH),,Buffalo,L (24-29),13,36,36.1,224,2,31,124,4.0,0,67,348,5.2,10,6,3,19,6,53,1,0,1
3241,2015,10,2015-11-07,Miami (OH),,Eastern Michigan,W (28-13),13,18,72.2,150,2,47,291,6.2,2,65,441,6.8,7,12,2,21,4,30,1,1,2
3242,2015,11,2015-11-14,Miami (OH),,Akron,L (28-37),20,42,47.6,316,3,31,68,2.2,0,73,384,5.3,12,4,2,18,10,70,2,2,4
3243,2015,12,2015-11-21,Miami (OH),@,Massachusetts,W (20-13),12,23,52.2,160,1,46,139,3.0,1,69,299,4.3,10,7,1,18,4,30,1,0,1
3244,2015,,12 Games,Miami (OH),,,,177,374,47.3,2532,18,428,1556,3.6,7,802,4088,5.1,105,75,20,200,89,772,12,19,31
3245,2016,1,2016-09-03,Miami (OH),@,Iowa,L (21-45),19,29,65.5,266,2,41,158,3.9,1,70,424,6.1,11,13,1,25,5,22,3,0,3
3246,2016,2,2016-09-10,Miami (OH),,Eastern Illinois,L (17-21),13,22,59.1,250,2,43,147,3.4,0,65,397,6.1,10,10,2,22,12,89,0,1,1
3247,2016,3,2016-09-17,Miami (OH),,Western Kentucky,L (24-31),20,41,48.8,339,2,38,85,2.2,1,79,424,5.4,13,5,5,23,11,87,1,0,1
3248,2016,4,2016-09-24,Miami (OH),@,Cincinnati,L (20-27),13,24,54.2,248,2,29,67,2.3,0,53,315,5.9,8,5,1,14,12,107,1,1,2
3249,2016,5,2016-10-01,Miami (OH),,Ohio,L (7-17),18,34,52.9,205,1,32,33,1.0,0,66,238,3.6,12,4,2,18,10,99,2,2,4
3250,2016,6,2016-10-08,Miami (OH),@,Akron,L (13-35),14,28,50.0,153,1,34,107,3.1,0,62,260,4.2,9,6,0,15,6,50,1,2,3
3251,2016,7,2016-10-15,Miami (OH),,Kent State,W (18-14),10,21,47.6,181,2,37,79,2.1,0,58,260,4.5,7,6,1,14,4,28,1,0,1
3252,2016,8,2016-10-22,Miami (OH),@,Bowling Green State,W (40-26),22,35,62.9,215,3,44,218,5.0,2,79,433,5.5,12,9,3,24,10,106,1,0,1
3253,2016,9,2016-10-29,Miami (OH),@,Eastern Michigan,W (28-15),15,23,65.2,175,1,43,230,5.3,3,66,405,6.1,9,12,2,23,2,15,1,0,1
3254,2016,10,2016-11-04,Miami (OH),,Central Michigan,W (37-17),13,21,61.9,218,4,41,218,5.3,1,62,436,7.0,10,10,1,21,3,25,0,0,0
3255,2016,11,2016-11-12,Miami (OH),@,Buffalo,W (35-24),7,14,50.0,105,2,39,204,5.2,1,53,309,5.8,3,7,1,11,6,42,1,0,1
3256,2016,12,2016-11-22,Miami (OH),,Ball State,W (21-20),26,35,74.3,380,3,25,62,2.5,0,60,442,7.4,14,5,1,20,4,25,0,0,0
3257,2016,13,2016-12-26,Miami (OH),N,Mississippi State*,L (16-17),22,31,71.0,263,2,35,170,4.9,0,66,433,6.6,11,12,1,24,3,30,1,1,2
3258,2016,,13 Games,Miami (OH),,,,212,358,59.2,2998,27,481,1778,3.7,9,839,4776,5.7,129,104,21,254,88,725,13,7,20
3259,2017,1,2017-09-02,Miami (OH),@,Marshall,L (26-31),23,44,52.3,298,2,42,131,3.1,1,86,429,5.0,17,7,1,25,5,51,1,1,2
3260,2017,2,2017-09-09,Miami (OH),,Austin Peay,W (31-10),11,22,50.0,145,3,49,150,3.1,1,71,295,4.2,6,12,0,18,3,20,3,0,3
3261,2017,3,2017-09-16,Miami (OH),,Cincinnati,L (17-21),16,31,51.6,221,1,32,70,2.2,1,63,291,4.6,7,5,2,14,9,77,0,1,1
3262,2017,4,2017-09-23,Miami (OH),@,Central Michigan,W (31-14),11,19,57.9,217,2,40,177,4.4,2,59,394,6.7,9,7,4,20,10,90,0,0,0
3263,2017,5,2017-09-30,Miami (OH),@,Notre Dame,L (17-52),19,37,51.4,262,2,33,115,3.5,0,70,377,5.4,11,6,2,19,9,90,1,1,2
3264,2017,6,2017-10-07,Miami (OH),,Bowling Green State,L (29-37),24,43,55.8,374,2,44,238,5.4,1,87,612,7.0,18,14,5,37,7,62,1,1,2
3265,2017,7,2017-10-14,Miami (OH),@,Kent State,L (14-17),12,30,40.0,174,2,34,161,4.7,0,64,335,5.2,9,8,2,19,8,40,0,2,2
3266,2017,8,2017-10-21,Miami (OH),,Buffalo,W (24-14),13,20,65.0,177,0,43,172,4.0,3,63,349,5.5,8,6,2,16,9,102,0,0,0
3267,2017,9,2017-10-31,Miami (OH),@,Ohio,L (28-45),28,51,54.9,350,3,23,98,4.3,1,74,448,6.1,15,5,1,21,10,95,0,2,2
3268,2017,10,2017-11-07,Miami (OH),,Akron,W (24-14),19,32,59.4,235,3,31,189,6.1,0,63,424,6.7,13,10,3,26,4,40,0,2,2
3269,2017,11,2017-11-15,Miami (OH),,Eastern Michigan,L (24-27),22,32,68.8,251,1,38,141,3.7,2,70,392,5.6,14,5,0,19,11,75,1,1,2
3270,2017,12,2017-11-21,Miami (OH),@,Ball State,W (28-7),15,27,55.6,148,3,29,125,4.3,0,56,273,4.9,8,3,3,14,2,15,0,0,0
3271,2017,,12 Games,Miami (OH),,,,213,388,54.9,2852,24,438,1767,4.0,12,826,4619,5.6,135,88,25,248,87,757,7,11,18
3272,2014,1,2014-08-30,Michigan,,Appalachian State,W (52-14),16,19,84.2,210,3,36,350,9.7,3,55,560,10.2,10,12,2,24,4,44,0,1,1
3273,2014,2,2014-09-06,Michigan,@,Notre Dame,L (0-31),19,32,59.4,189,0,35,100,2.9,0,67,289,4.3,12,6,0,18,5,50,1,3,4
3274,2014,3,2014-09-13,Michigan,,Miami (OH),W (34-10),13,22,59.1,184,2,45,276,6.1,2,67,460,6.9,8,15,0,23,3,20,2,1,3
3275,2014,4,2014-09-20,Michigan,,Utah,L (10-26),18,39,46.2,190,0,36,118,3.3,0,75,308,4.1,8,11,0,19,3,20,1,3,4
3276,2014,5,2014-09-27,Michigan,,Minnesota,L (14-30),10,25,40.0,88,0,28,83,3.0,2,53,171,3.2,4,5,3,12,2,23,1,1,2
3277,2014,6,2014-10-04,Michigan,@,Rutgers,L (24-26),13,22,59.1,178,0,35,158,4.5,3,57,336,5.9,8,7,3,18,3,30,0,1,1
3278,2014,7,2014-10-11,Michigan,,Penn State,W (18-13),16,26,61.5,192,1,31,64,2.1,0,57,256,4.5,7,5,0,12,3,30,0,1,1
3279,2014,8,2014-10-25,Michigan,@,Michigan State,L (11-35),15,31,48.4,125,0,26,61,2.3,1,57,186,3.3,7,3,3,13,4,27,1,2,3
3280,2014,9,2014-11-01,Michigan,,Indiana,W (34-10),22,29,75.9,220,2,35,184,5.3,2,64,404,6.3,11,8,1,20,3,25,0,1,1
3281,2014,10,2014-11-08,Michigan,@,Northwestern,W (10-9),11,24,45.8,109,0,35,147,4.2,1,59,256,4.3,7,6,0,13,5,50,1,2,3
3282,2014,11,2014-11-22,Michigan,,Maryland,L (16-23),13,24,54.2,106,0,45,292,6.5,1,69,398,5.8,8,13,2,23,3,24,0,1,1
3283,2014,12,2014-11-29,Michigan,@,Ohio State,L (28-42),23,33,69.7,251,2,38,121,3.2,2,71,372,5.2,14,10,3,27,4,38,1,1,2
3284,2014,,12 Games,Michigan,,,,189,326,58.0,2042,10,425,1954,4.6,17,751,3996,5.3,104,101,17,222,42,381,8,18,26
3285,2015,1,2015-09-03,Michigan,@,Utah,L (17-24),27,43,62.8,279,2,29,76,2.6,0,72,355,4.9,15,3,2,20,3,25,0,3,3
3286,2015,2,2015-09-12,Michigan,,Oregon State,W (35-7),18,26,69.2,180,0,48,225,4.7,4,74,405,5.5,9,12,0,21,10,105,1,1,2
3287,2015,3,2015-09-19,Michigan,,Nevada-Las Vegas,W (28-7),14,25,56.0,123,1,39,254,6.5,3,64,377,5.9,6,11,0,17,3,34,0,1,1
3288,2015,4,2015-09-26,Michigan,,Brigham Young,W (31-0),14,25,56.0,194,1,51,254,5.0,3,76,448,5.9,11,8,3,22,5,53,0,0,0
3289,2015,5,2015-10-03,Michigan,@,Maryland,W (28-0),16,33,48.5,180,1,40,198,5.0,2,73,378,5.2,7,7,0,14,7,65,2,1,3
3290,2015,6,2015-10-10,Michigan,,Northwestern,W (38-0),17,23,73.9,179,0,46,201,4.4,3,69,380,5.5,10,11,0,21,3,28,0,0,0
3291,2015,7,2015-10-17,Michigan,,Michigan State,L (23-27),15,25,60.0,168,0,33,62,1.9,2,58,230,4.0,6,3,1,10,8,70,1,0,1
3292,2015,8,2015-10-31,Michigan,@,Minnesota,W (29-26),16,27,59.3,169,2,34,127,3.7,2,61,296,4.9,9,8,3,20,5,47,1,1,2
3293,2015,9,2015-11-07,Michigan,,Rutgers,W (49-16),18,26,69.2,337,2,42,150,3.6,4,68,487,7.2,14,8,3,25,6,60,0,0,0
3294,2015,10,2015-11-14,Michigan,@,Indiana,W (48-41),33,46,71.7,440,6,28,141,5.0,0,74,581,7.9,20,6,2,28,13,72,0,1,1
3295,2015,11,2015-11-21,Michigan,@,Penn State,W (28-16),25,38,65.8,256,2,30,87,2.9,2,68,343,5.0,12,5,2,19,13,117,1,1,2
3296,2015,12,2015-11-28,Michigan,,Ohio State,L (13-42),25,47,53.2,307,1,25,57,2.3,0,72,364,5.1,16,3,1,20,7,72,0,1,1
3297,2015,13,2016-01-01,Michigan,N,Florida*,W (41-7),20,31,64.5,278,3,46,225,4.9,2,77,503,6.5,14,11,3,28,4,30,0,0,0
3298,2015,,13 Games,Michigan,,,,258,415,62.2,3090,21,491,2057,4.2,27,906,5147,5.7,149,96,20,265,87,778,6,10,16
3299,2016,1,2016-09-03,Michigan,,Hawaii,W (63-3),17,20,85.0,206,3,39,306,7.8,4,59,512,8.7,9,17,0,26,3,33,0,1,1
3300,2016,2,2016-09-10,Michigan,,Central Florida,W (51-14),27,41,65.9,328,4,41,119,2.9,2,82,447,5.5,13,8,2,23,2,20,0,0,0
3301,2016,3,2016-09-17,Michigan,,Colorado,W (45-28),16,30,53.3,229,1,41,168,4.1,3,71,397,5.6,11,8,1,20,5,41,1,0,1
3302,2016,4,2016-09-24,Michigan,,Penn State,W (49-10),21,35,60.0,189,1,49,326,6.7,6,84,515,6.1,10,14,1,25,7,80,0,0,0
3303,2016,5,2016-10-01,Michigan,,Wisconsin,W (14-7),20,32,62.5,219,1,44,130,3.0,1,76,349,4.6,8,11,2,21,6,45,0,1,1
3304,2016,6,2016-10-08,Michigan,@,Rutgers,W (78-0),8,16,50.0,119,2,53,486,9.2,9,69,605,8.8,4,18,1,23,3,25,1,0,1
3305,2016,7,2016-10-22,Michigan,,Illinois,W (41-8),20,28,71.4,291,2,59,270,4.6,3,87,561,6.4,12,15,2,29,5,41,1,0,1
3306,2016,8,2016-10-29,Michigan,@,Michigan State,W (32-23),16,25,64.0,244,0,42,192,4.6,3,67,436,6.5,11,9,4,24,5,62,0,1,1
3307,2016,9,2016-11-05,Michigan,,Maryland,W (59-3),21,27,77.8,387,3,39,273,7.0,5,66,660,10.0,14,14,3,31,6,62,0,0,0
3308,2016,10,2016-11-12,Michigan,@,Iowa,L (13-14),11,26,42.3,103,0,35,98,2.8,1,61,201,3.3,7,5,2,14,5,48,1,1,2
3309,2016,11,2016-11-19,Michigan,,Indiana,W (20-10),7,16,43.8,59,0,50,225,4.5,2,66,284,4.3,2,12,1,15,5,40,0,0,0
3310,2016,12,2016-11-26,Michigan,@,Ohio State,L (27-30),23,36,63.9,219,2,43,91,2.1,1,79,310,3.9,9,7,0,16,7,59,1,2,3
3311,2016,13,2016-12-30,Michigan,N,Florida State*,L (32-33),21,38,55.3,163,1,36,89,2.5,1,74,252,3.4,10,5,1,16,4,37,0,1,1
3312,2016,,13 Games,Michigan,,,,228,370,61.6,2756,20,571,2773,4.9,41,941,5529,5.9,120,143,20,283,63,593,5,7,12
3313,2017,1,2017-09-02,Michigan,N,Florida,W (33-17),12,26,46.2,218,1,49,215,4.4,1,75,433,5.8,8,10,1,19,7,55,0,2,2
3314,2017,2,2017-09-09,Michigan,,Cincinnati,W (36-14),17,29,58.6,221,2,37,193,5.2,0,66,414,6.3,7,9,0,16,7,68,2,0,2
3315,2017,3,2017-09-16,Michigan,,Air Force,W (29-13),14,23,60.9,169,0,42,190,4.5,1,65,359,5.5,6,11,0,17,7,72,1,0,1
3316,2017,4,2017-09-23,Michigan,@,Purdue,W (28-10),21,31,67.7,284,1,44,139,3.2,3,75,423,5.6,14,6,4,24,7,57,1,1,2
3317,2017,5,2017-10-07,Michigan,,Michigan State,L (10-14),16,35,45.7,198,0,39,102,2.6,1,74,300,4.1,7,8,2,17,7,53,2,3,5
3318,2017,6,2017-10-14,Michigan,@,Indiana,W (27-20),10,20,50.0,58,0,44,271,6.2,3,64,329,5.1,3,12,2,17,16,141,0,0,0
3319,2017,7,2017-10-21,Michigan,@,Penn State,L (13-42),16,28,57.1,166,0,42,103,2.5,2,70,269,3.8,8,8,0,16,6,59,1,0,1
3320,2017,8,2017-10-28,Michigan,,Rutgers,W (35-14),13,20,65.0,137,1,51,334,6.5,4,71,471,6.6,9,16,0,25,3,25,0,1,1
3321,2017,9,2017-11-04,Michigan,,Minnesota,W (33-10),8,13,61.5,56,1,37,371,10.0,4,50,427,8.5,2,12,0,14,9,85,0,0,0
3322,2017,10,2017-11-11,Michigan,@,Maryland,W (35-10),9,18,50.0,145,2,38,160,4.2,3,56,305,5.4,6,8,2,16,1,10,0,0,0
3323,2017,11,2017-11-18,Michigan,@,Wisconsin,L (10-24),11,26,42.3,176,0,37,58,1.6,1,63,234,3.7,7,5,1,13,4,28,1,0,1
3324,2017,12,2017-11-25,Michigan,,Ohio State,L (20-31),17,32,53.1,195,1,36,100,2.8,2,68,295,4.3,8,7,1,16,6,50,0,1,1
3325,2017,13,2018-01-01,Michigan,N,South Carolina*,L (19-26),21,45,46.7,203,0,33,74,2.2,1,78,277,3.6,11,3,3,17,6,40,3,2,5
3326,2017,,13 Games,Michigan,,,,185,346,53.5,2226,9,529,2310,4.4,26,875,4536,5.2,96,115,16,227,86,743,11,10,21
3327,2014,1,2014-08-29,Michigan State,,Jacksonville State,W (45-7),18,24,75.0,354,3,50,211,4.2,3,74,565,7.6,11,11,3,25,2,13,0,0,0
3328,2014,2,2014-09-06,Michigan State,@,Oregon,L (27-46),29,47,61.7,343,2,36,123,3.4,1,83,466,5.6,18,7,0,25,5,38,0,2,2
3329,2014,3,2014-09-20,Michigan State,,Eastern Michigan,W (73-14),14,19,73.7,160,3,60,336,5.6,7,79,496,6.3,8,14,2,24,4,25,0,1,1
3330,2014,4,2014-09-27,Michigan State,,Wyoming,W (56-14),16,20,80.0,195,3,52,338,6.5,5,72,533,7.4,7,18,0,25,9,84,0,0,0
3331,2014,5,2014-10-04,Michigan State,,Nebraska,W (27-22),11,29,37.9,234,1,44,188,4.3,2,73,422,5.8,8,9,0,17,9,94,2,1,3
3332,2014,6,2014-10-11,Michigan State,@,Purdue,W (45-31),19,37,51.4,238,3,43,294,6.8,2,80,532,6.7,13,14,1,28,4,55,0,1,1
3333,2014,7,2014-10-18,Michigan State,@,Indiana,W (56-17),24,32,75.0,332,3,51,330,6.5,5,83,662,8.0,14,15,1,30,3,37,0,1,1
3334,2014,8,2014-10-25,Michigan State,,Michigan,W (35-11),12,22,54.5,227,1,46,219,4.8,3,68,446,6.6,7,14,1,22,8,88,2,0,2
3335,2014,9,2014-11-08,Michigan State,,Ohio State,L (37-49),25,45,55.6,358,2,34,178,5.2,3,79,536,6.8,18,10,1,29,11,105,0,0,0
3336,2014,10,2014-11-15,Michigan State,@,Maryland,W (37-15),14,31,45.2,240,0,47,242,5.1,3,78,482,6.2,11,12,0,23,10,75,0,0,0
3337,2014,11,2014-11-22,Michigan State,,Rutgers,W (45-3),17,26,65.4,278,2,44,242,5.5,4,70,520,7.4,13,12,1,26,3,35,2,0,2
3338,2014,12,2014-11-29,Michigan State,@,Penn State,W (34-10),13,26,50.0,180,1,41,118,2.9,2,67,298,4.4,11,6,1,18,5,30,0,1,1
3339,2014,13,2015-01-01,Michigan State,N,Baylor*,W (42-41),24,42,57.1,314,2,46,238,5.2,4,88,552,6.3,15,11,3,29,7,75,0,2,2
3340,2014,,13 Games,Michigan State,,,,236,400,59.0,3453,26,594,3057,5.1,44,994,6510,6.5,154,153,14,321,80,754,6,9,15
3341,2015,1,2015-09-04,Michigan State,@,Western Michigan,W (37-24),15,31,48.4,256,2,40,196,4.9,3,71,452,6.4,13,11,2,26,3,25,1,0,1
3342,2015,2,2015-09-12,Michigan State,,Oregon,W (31-28),20,32,62.5,192,2,37,197,5.3,2,69,389,5.6,11,9,1,21,2,15,0,1,1
3343,2015,3,2015-09-19,Michigan State,,Air Force,W (35-21),15,23,65.2,247,4,42,77,1.8,0,65,324,5.0,14,5,3,22,6,38,0,0,0
3344,2015,4,2015-09-26,Michigan State,,Central Michigan,W (30-10),11,19,57.9,143,1,36,181,5.0,3,55,324,5.9,6,11,1,18,8,78,0,0,0
3345,2015,5,2015-10-03,Michigan State,,Purdue,W (24-21),13,19,68.4,139,1,47,267,5.7,2,66,406,6.2,7,12,1,20,8,51,0,0,0
3346,2015,6,2015-10-10,Michigan State,@,Rutgers,W (31-24),24,39,61.5,367,2,36,123,3.4,2,75,490,6.5,16,6,0,22,1,5,0,1,1
3347,2015,7,2015-10-17,Michigan State,@,Michigan,W (27-23),18,39,46.2,328,1,33,58,1.8,2,72,386,5.4,13,3,4,20,5,44,0,0,0
3348,2015,8,2015-10-24,Michigan State,,Indiana,W (52-26),30,52,57.7,398,4,44,142,3.2,3,96,540,5.6,21,10,2,33,5,56,1,0,1
3349,2015,9,2015-11-07,Michigan State,@,Nebraska,L (38-39),24,39,61.5,348,4,34,143,4.2,1,73,491,6.7,17,5,3,25,8,76,0,1,1
3350,2015,10,2015-11-14,Michigan State,,Maryland,W (24-7),12,32,37.5,121,1,41,141,3.4,1,73,262,3.6,7,9,0,16,7,50,1,2,3
3351,2015,11,2015-11-21,Michigan State,@,Ohio State,W (17-14),8,16,50.0,91,1,51,203,4.0,1,67,294,4.4,3,14,0,17,4,30,2,0,2
3352,2015,12,2015-11-28,Michigan State,,Penn State,W (55-16),19,27,70.4,248,3,38,188,4.9,3,65,436,6.7,14,10,0,24,4,19,1,0,1
3353,2015,13,2015-12-05,Michigan State,N,Iowa,W (16-13),16,33,48.5,191,0,46,174,3.8,1,79,365,4.6,10,9,1,20,8,80,0,1,1
3354,2015,14,2015-12-31,Michigan State,N,Alabama*,L (0-38),19,39,48.7,210,0,26,29,1.1,0,65,239,3.7,11,2,3,16,6,33,0,2,2
3355,2015,,14 Games,Michigan State,,,,244,440,55.5,3279,26,551,2119,3.8,24,991,5398,5.4,163,116,21,300,75,600,6,8,14
3356,2016,1,2016-09-02,Michigan State,,Furman,W (28-13),13,18,72.2,190,3,40,171,4.3,1,58,361,6.2,9,9,1,19,10,120,1,1,2
3357,2016,2,2016-09-17,Michigan State,@,Notre Dame,W (36-28),19,26,73.1,241,2,52,260,5.0,3,78,501,6.4,12,9,1,22,3,45,0,1,1
3358,2016,3,2016-09-24,Michigan State,,Wisconsin,L (6-30),20,43,46.5,250,0,27,75,2.8,0,70,325,4.6,15,4,2,21,5,35,1,3,4
3359,2016,4,2016-10-01,Michigan State,@,Indiana,L (21-24),21,35,60.0,263,3,41,175,4.3,0,76,438,5.8,10,10,1,21,11,98,1,0,1
3360,2016,5,2016-10-08,Michigan State,,Brigham Young,L (14-31),13,21,61.9,121,0,32,85,2.7,2,53,206,3.9,7,5,1,13,4,39,0,1,1
3361,2016,6,2016-10-15,Michigan State,,Northwestern,L (40-54),27,42,64.3,424,4,23,51,2.2,0,65,475,7.3,15,3,0,18,5,34,1,1,2
3362,2016,7,2016-10-22,Michigan State,@,Maryland,L (17-28),11,24,45.8,156,0,44,270,6.1,2,68,426,6.3,9,13,0,22,7,84,1,1,2
3363,2016,8,2016-10-29,Michigan State,,Michigan,L (23-32),13,28,46.4,184,2,42,217,5.2,1,70,401,5.7,7,12,4,23,7,57,0,1,1
3364,2016,9,2016-11-05,Michigan State,@,Illinois,L (27-31),29,47,61.7,315,1,43,175,4.1,1,90,490,5.4,17,11,0,28,10,89,1,0,1
3365,2016,10,2016-11-12,Michigan State,,Rutgers,W (49-0),12,19,63.2,163,3,50,277,5.5,3,69,440,6.4,6,13,1,20,5,40,0,0,0
3366,2016,11,2016-11-19,Michigan State,,Ohio State,L (16-17),8,21,38.1,127,1,35,207,5.9,1,56,334,6.0,4,9,0,13,6,60,0,2,2
3367,2016,12,2016-11-26,Michigan State,@,Penn State,L (12-45),25,46,54.3,234,0,42,109,2.6,0,88,343,3.9,14,11,1,26,4,23,1,0,1
3368,2016,,12 Games,Michigan State,,,,211,370,57.0,2668,19,471,2072,4.4,14,841,4740,5.6,125,109,12,246,77,724,7,11,18
3369,2017,1,2017-09-02,Michigan State,,Bowling Green State,W (35-10),22,36,61.1,250,3,46,215,4.7,1,82,465,5.7,11,13,1,25,4,25,3,0,3
3370,2017,2,2017-09-09,Michigan State,,Western Michigan,W (28-14),13,21,61.9,161,1,49,296,6.0,3,70,457,6.5,9,12,0,21,3,30,1,1,2
3371,2017,3,2017-09-23,Michigan State,,Notre Dame,L (18-38),32,53,60.4,345,2,32,151,4.7,0,85,496,5.8,17,6,3,26,9,97,2,1,3
3372,2017,4,2017-09-30,Michigan State,,Iowa,W (17-10),18,28,64.3,212,2,40,88,2.2,0,68,300,4.4,12,4,3,19,9,65,0,0,0
3373,2017,5,2017-10-07,Michigan State,@,Michigan,W (14-10),11,22,50.0,94,1,40,158,4.0,1,62,252,4.1,3,8,2,13,11,81,0,0,0
3374,2017,6,2017-10-14,Michigan State,@,Minnesota,W (30-27),9,18,50.0,120,0,50,245,4.9,3,68,365,5.4,6,12,1,19,5,40,2,1,3
3375,2017,7,2017-10-21,Michigan State,,Indiana,W (17-9),16,30,53.3,185,1,44,89,2.0,1,74,274,3.7,10,5,4,19,3,35,1,0,1
3376,2017,8,2017-10-28,Michigan State,@,Northwestern,L (31-39),39,57,68.4,445,4,30,97,3.2,0,87,542,6.2,22,6,0,28,9,84,1,1,2
3377,2017,9,2017-11-04,Michigan State,,Penn State,W (27-24),33,56,58.9,400,2,24,74,3.1,1,80,474,5.9,17,4,4,25,8,87,0,1,1
3378,2017,10,2017-11-11,Michigan State,@,Ohio State,L (3-48),18,36,50.0,131,0,34,64,1.9,0,70,195,2.8,7,6,2,15,5,58,1,2,3
3379,2017,11,2017-11-18,Michigan State,,Maryland,W (17-7),2,14,14.3,20,0,51,271,5.3,2,65,291,4.5,1,15,3,19,3,36,1,0,1
3380,2017,12,2017-11-25,Michigan State,@,Rutgers,W (40-7),21,31,67.7,222,1,56,214,3.8,3,87,436,5.0,15,11,1,27,9,80,0,0,0
3381,2017,13,2017-12-28,Michigan State,N,Washington State*,W (42-17),13,22,59.1,213,3,48,227,4.7,3,70,440,6.3,9,15,1,25,6,50,0,1,1
3382,2017,,13 Games,Michigan State,,,,247,424,58.3,2798,20,544,2189,4.0,18,968,4987,5.2,139,117,25,281,84,768,12,8,20
3383,2014,1,2014-08-30,Middle Tennessee State,,Savannah State,W (61-7),17,20,85.0,291,1,46,228,5.0,6,66,519,7.9,8,13,1,22,9,70,2,1,3
3384,2014,2,2014-09-06,Middle Tennessee State,@,Minnesota,L (24-35),22,38,57.9,255,1,43,190,4.4,2,81,445,5.5,15,7,1,23,9,80,0,3,3
3385,2014,3,2014-09-13,Middle Tennessee State,,Western Kentucky,W (50-47),17,28,60.7,218,1,61,323,5.3,5,89,541,6.1,11,16,1,28,7,62,0,0,0
3386,2014,4,2014-09-20,Middle Tennessee State,@,Memphis,L (17-36),24,35,68.6,237,0,34,88,2.6,2,69,325,4.7,12,5,0,17,4,36,2,1,3
3387,2014,5,2014-09-26,Middle Tennessee State,@,Old Dominion,W (41-28),25,30,83.3,259,2,57,280,4.9,2,87,539,6.2,11,18,0,29,9,85,2,0,2
3388,2014,6,2014-10-04,Middle Tennessee State,,Southern Mississippi,W (37-31),22,27,81.5,344,2,39,239,6.1,3,66,583,8.8,13,9,0,22,6,49,1,0,1
3389,2014,7,2014-10-11,Middle Tennessee State,@,Marshall,L (24-49),25,37,67.6,201,2,37,169,4.6,1,74,370,5.0,8,10,2,20,8,101,1,1,2
3390,2014,8,2014-10-18,Middle Tennessee State,,Alabama-Birmingham,W (34-22),6,19,31.6,141,2,41,229,5.6,3,60,370,6.2,3,8,2,13,8,70,0,0,0
3391,2014,9,2014-11-01,Middle Tennessee State,,Brigham Young,L (7-27),16,32,50.0,119,1,37,109,2.9,0,69,228,3.3,6,9,2,17,2,12,0,2,2
3392,2014,10,2014-11-15,Middle Tennessee State,@,Florida International,L (28-38),21,33,63.6,286,3,45,142,3.2,1,78,428,5.5,12,9,1,22,7,70,2,3,5
3393,2014,11,2014-11-22,Middle Tennessee State,,Florida Atlantic,W (35-34),20,27,74.1,160,2,46,310,6.7,3,73,470,6.4,7,15,0,22,3,20,1,1,2
3394,2014,12,2014-11-29,Middle Tennessee State,@,Texas-El Paso,L (21-24),9,17,52.9,99,0,44,259,5.9,3,61,358,5.9,4,14,1,19,6,35,0,1,1
3395,2014,,12 Games,Middle Tennessee State,,,,224,343,65.3,2610,17,530,2566,4.8,31,873,5176,5.9,110,133,11,254,78,690,11,13,24
3396,2015,1,2015-09-05,Middle Tennessee State,,Jackson State,W (70-14),25,32,78.1,351,4,63,282,4.5,4,95,633,6.7,14,20,2,36,1,15,1,1,2
3397,2015,2,2015-09-12,Middle Tennessee State,@,Alabama,L (10-37),23,43,53.5,189,1,31,86,2.8,0,74,275,3.7,11,3,1,15,8,67,3,1,4
3398,2015,3,2015-09-19,Middle Tennessee State,,UNC Charlotte,W (73-14),24,29,82.8,379,5,49,316,6.4,4,78,695,8.9,12,12,1,25,3,36,2,0,2
3399,2015,4,2015-09-26,Middle Tennessee State,@,Illinois,L (25-27),29,43,67.4,330,3,37,38,1.0,0,80,368,4.6,12,6,1,19,7,59,1,0,1
3400,2015,5,2015-10-03,Middle Tennessee State,,Vanderbilt,L (13-17),32,51,62.7,286,1,23,34,1.5,0,74,320,4.3,13,4,1,18,5,30,2,0,2
3401,2015,6,2015-10-10,Middle Tennessee State,@,Western Kentucky,L (28-58),28,43,65.1,296,3,30,123,4.1,1,73,419,5.7,13,7,2,22,4,41,1,1,2
3402,2015,7,2015-10-17,Middle Tennessee State,,Florida International,W (42-34),17,26,65.4,261,0,43,200,4.7,6,69,461,6.7,10,12,0,22,8,87,1,1,2
3403,2015,8,2015-10-24,Middle Tennessee State,@,Louisiana Tech,L (16-45),36,56,64.3,381,2,24,33,1.4,0,80,414,5.2,15,5,1,21,7,59,1,2,3
3404,2015,9,2015-11-07,Middle Tennessee State,,Marshall,W (27-24),21,35,60.0,353,3,51,201,3.9,0,86,554,6.4,15,10,2,27,7,66,2,1,3
3405,2015,10,2015-11-14,Middle Tennessee State,@,Florida Atlantic,W (24-17),18,32,56.3,301,2,45,178,4.0,1,77,479,6.2,12,8,2,22,5,45,1,1,2
3406,2015,11,2015-11-21,Middle Tennessee State,,North Texas,W (41-7),30,41,73.2,329,3,39,165,4.2,2,80,494,6.2,14,14,2,30,1,5,1,1,2
3407,2015,12,2015-11-28,Middle Tennessee State,@,Texas-San Antonio,W (42-7),24,30,80.0,257,1,43,199,4.6,4,73,456,6.2,8,18,2,28,1,5,2,0,2
3408,2015,13,2015-12-24,Middle Tennessee State,N,Western Michigan*,L (31-45),26,39,66.7,327,3,26,115,4.4,1,65,442,6.8,11,7,0,18,5,40,1,1,2
3409,2015,,13 Games,Middle Tennessee State,,,,333,500,66.6,4040,31,504,1970,3.9,23,1004,6010,6.0,160,126,17,303,62,555,19,10,29
3410,2016,1,2016-09-03,Middle Tennessee State,,Alabama A&M,W (55-0),40,53,75.5,435,6,40,246,6.2,1,93,681,7.3,22,12,1,35,9,87,0,2,2
3411,2016,2,2016-09-10,Middle Tennessee State,@,Vanderbilt,L (24-47),38,65,58.5,399,3,21,96,4.6,0,86,495,5.8,19,6,0,25,9,92,1,1,2
3412,2016,3,2016-09-17,Middle Tennessee State,@,Bowling Green State,W (41-21),18,30,60.0,278,3,37,158,4.3,3,67,436,6.5,8,8,4,20,3,36,1,1,2
3413,2016,4,2016-09-24,Middle Tennessee State,,Louisiana Tech,W (38-34),27,46,58.7,356,2,33,197,6.0,3,79,553,7.0,15,9,1,25,4,35,0,0,0
3414,2016,5,2016-10-01,Middle Tennessee State,@,North Texas,W (30-13),24,45,53.3,295,2,32,182,5.7,1,77,477,6.2,13,7,4,24,9,79,0,1,1
3415,2016,6,2016-10-15,Middle Tennessee State,,Western Kentucky,L (43-44),42,54,77.8,434,3,32,171,5.3,2,86,605,7.0,22,7,3,32,4,30,0,1,1
3416,2016,7,2016-10-22,Middle Tennessee State,@,Missouri,W (51-45),24,42,57.1,284,4,39,316,8.1,2,81,600,7.4,11,11,5,27,9,65,0,0,0
3417,2016,8,2016-10-29,Middle Tennessee State,@,Florida International,W (42-35),22,35,62.9,332,4,19,134,7.1,1,54,466,8.6,13,10,0,23,2,30,0,0,0
3418,2016,9,2016-11-05,Middle Tennessee State,,Texas-San Antonio,L (25-45),22,38,57.9,259,2,28,110,3.9,1,66,369,5.6,9,9,1,19,4,32,1,3,4
3419,2016,10,2016-11-12,Middle Tennessee State,@,Marshall,L (17-42),25,37,67.6,220,1,25,63,2.5,1,62,283,4.6,11,3,1,15,5,42,2,2,4
3420,2016,11,2016-11-19,Middle Tennessee State,@,UNC Charlotte,W (38-31),26,44,59.1,250,4,30,221,7.4,1,74,471,6.4,12,8,1,21,8,90,0,2,2
3421,2016,12,2016-11-26,Middle Tennessee State,,Florida Atlantic,W (77-56),11,16,68.8,262,1,57,495,8.7,9,73,757,10.4,10,18,0,28,3,22,0,0,0
3422,2016,13,2016-12-24,Middle Tennessee State,N,Hawaii*,L (35-52),30,51,58.8,432,4,23,110,4.8,1,74,542,7.3,18,6,5,29,9,90,1,2,3
3423,2016,,13 Games,Middle Tennessee State,,,,349,556,62.8,4236,39,416,2499,6.0,26,972,6735,6.9,183,114,26,323,78,730,6,15,21
3424,2017,1,2017-09-02,Middle Tennessee State,,Vanderbilt,L (6-28),18,31,58.1,166,1,26,64,2.5,0,57,230,4.0,9,4,3,16,4,14,0,1,1
3425,2017,2,2017-09-09,Middle Tennessee State,@,Syracuse,W (30-23),22,36,61.1,269,3,33,94,2.8,1,69,363,5.3,11,7,2,20,9,113,2,1,3
3426,2017,3,2017-09-16,Middle Tennessee State,@,Minnesota,L (3-34),25,42,59.5,184,0,15,46,3.1,0,57,230,4.0,9,2,0,11,6,45,0,2,2
3427,2017,4,2017-09-23,Middle Tennessee State,,Bowling Green State,W (24-13),24,32,75.0,290,2,43,243,5.7,1,75,533,7.1,14,12,1,27,3,23,2,1,3
3428,2017,5,2017-09-30,Middle Tennessee State,@,Florida Atlantic,L (20-38),32,52,61.5,385,2,24,69,2.9,0,76,454,6.0,18,3,2,23,7,64,0,3,3
3429,2017,6,2017-10-07,Middle Tennessee State,,Florida International,W (37-17),25,31,80.6,250,1,34,176,5.2,3,65,426,6.6,14,12,2,25,4,35,0,0,0
3430,2017,7,2017-10-14,Middle Tennessee State,@,Alabama-Birmingham,L (23-25),24,44,54.5,263,1,32,131,4.1,0,76,394,5.2,14,9,3,26,10,88,0,2,2
3431,2017,8,2017-10-20,Middle Tennessee State,,Marshall,L (10-38),14,33,42.4,220,1,31,53,1.7,0,64,273,4.3,8,3,4,15,5,60,1,1,2
3432,2017,9,2017-11-04,Middle Tennessee State,,Texas-El Paso,W (30-3),13,30,43.3,190,3,36,210,5.8,1,66,400,6.1,7,9,2,18,9,92,0,1,1
3433,2017,10,2017-11-11,Middle Tennessee State,@,UNC Charlotte,W (35-21),18,31,58.1,255,3,41,202,4.9,2,72,457,6.3,7,12,2,21,9,85,0,0,0
3434,2017,11,2017-11-17,Middle Tennessee State,@,Western Kentucky,L (38-41),27,46,58.7,294,1,33,137,4.2,3,79,431,5.5,13,11,3,27,5,68,1,0,1
3435,2017,12,2017-11-25,Middle Tennessee State,,Old Dominion,W (41-10),21,30,70.0,266,3,50,320,6.4,2,80,586,7.3,13,15,2,30,4,50,0,2,2
3436,2017,13,2017-12-16,Middle Tennessee State,N,Arkansas State*,W (35-30),19,35,54.3,232,2,29,120,4.1,2,64,352,5.5,10,5,2,17,10,87,0,3,3
3437,2017,,13 Games,Middle Tennessee State,,,,282,473,59.6,3264,23,427,1865,4.4,15,900,5129,5.7,147,104,28,276,85,824,6,17,23
3438,2014,1,2014-08-28,Minnesota,,Eastern Illinois,W (42-20),10,18,55.6,156,1,40,182,4.6,4,58,338,5.8,6,11,1,18,5,50,1,0,1
3439,2014,2,2014-09-06,Minnesota,,Middle Tennessee State,W (35-24),5,11,45.5,67,1,50,284,5.7,3,61,351,5.8,3,14,1,18,3,24,0,1,1
3440,2014,3,2014-09-13,Minnesota,@,Texas Christian,L (7-30),14,29,48.3,169,1,39,99,2.5,0,68,268,3.9,8,5,1,14,4,40,2,3,5
3441,2014,4,2014-09-20,Minnesota,,San Jose State,W (24-7),1,7,14.3,7,0,58,380,6.6,3,65,387,6.0,1,18,0,19,10,80,1,1,2
3442,2014,5,2014-09-27,Minnesota,@,Michigan,W (30-14),14,23,60.9,167,1,47,206,4.4,1,70,373,5.3,9,11,0,20,7,65,0,0,0
3443,2014,6,2014-10-11,Minnesota,,Northwestern,W (24-17),10,15,66.7,153,0,39,121,3.1,2,54,274,5.1,5,7,2,14,6,47,0,1,1
3444,2014,7,2014-10-18,Minnesota,,Purdue,W (39-38),9,18,50.0,165,2,52,285,5.5,3,70,450,6.4,6,15,1,22,7,66,1,0,1
3445,2014,8,2014-10-25,Minnesota,@,Illinois,L (24-28),12,30,40.0,240,1,41,171,4.2,2,71,411,5.8,8,9,2,19,4,30,2,1,3
3446,2014,9,2014-11-08,Minnesota,,Iowa,W (51-14),10,14,71.4,138,4,59,291,4.9,3,73,429,5.9,4,18,1,23,2,17,0,0,0
3447,2014,10,2014-11-15,Minnesota,,Ohio State,L (24-31),7,20,35.0,85,0,44,218,5.0,3,64,303,4.7,5,9,3,17,7,54,0,2,2
3448,2014,11,2014-11-22,Minnesota,@,Nebraska,W (28-24),8,18,44.4,135,0,53,281,5.3,4,71,416,5.9,7,15,1,23,1,15,0,0,0
3449,2014,12,2014-11-29,Minnesota,@,Wisconsin,L (24-34),5,18,27.8,95,0,44,177,4.0,3,62,272,4.4,3,8,1,12,7,72,1,0,1
3450,2014,13,2015-01-01,Minnesota,N,Missouri*,L (17-33),22,33,66.7,267,1,33,106,3.2,1,66,373,5.7,11,8,0,19,6,45,3,0,3
3451,2014,,13 Games,Minnesota,,,,127,254,50.0,1844,12,599,2801,4.7,32,853,4645,5.4,76,148,14,238,69,605,11,9,20
3452,2015,1,2015-09-03,Minnesota,,Texas Christian,L (17-23),19,35,54.3,197,1,39,144,3.7,1,74,341,4.6,12,6,0,18,7,60,2,0,2
3453,2015,2,2015-09-12,Minnesota,@,Colorado State,W (23-20),23,45,51.1,233,2,41,180,4.4,0,86,413,4.8,11,9,3,23,8,60,2,0,2
3454,2015,3,2015-09-19,Minnesota,,Kent State,W (10-7),17,27,63.0,184,1,44,104,2.4,0,71,288,4.1,9,3,1,13,8,85,1,2,3
3455,2015,4,2015-09-26,Minnesota,,Ohio,W (27-24),22,31,71.0,264,0,36,204,5.7,3,67,468,7.0,14,8,2,24,4,31,1,0,1
3456,2015,5,2015-10-03,Minnesota,@,Northwestern,L (0-27),15,32,46.9,99,0,33,74,2.2,0,65,173,2.7,5,6,0,11,2,10,1,1,2
3457,2015,6,2015-10-10,Minnesota,@,Purdue,W (41-13),11,18,61.1,82,2,48,326,6.8,2,66,408,6.2,4,13,0,17,6,55,0,1,1
3458,2015,7,2015-10-17,Minnesota,,Nebraska,L (25-48),26,40,65.0,301,1,26,65,2.5,2,66,366,5.5,15,3,0,18,6,55,1,2,3
3459,2015,8,2015-10-31,Minnesota,,Michigan,L (26-29),16,33,48.5,317,1,35,144,4.1,1,68,461,6.8,13,5,2,20,7,53,0,0,0
3460,2015,9,2015-11-07,Minnesota,@,Ohio State,L (14-28),27,45,60.0,281,2,26,33,1.3,0,71,314,4.4,12,0,1,13,3,25,0,1,1
3461,2015,10,2015-11-14,Minnesota,@,Iowa,L (35-40),20,28,71.4,301,2,29,133,4.6,3,57,434,7.6,14,8,2,24,12,87,0,0,0
3462,2015,11,2015-11-21,Minnesota,,Illinois,W (32-23),15,26,57.7,88,1,32,255,8.0,3,58,343,5.9,5,9,2,16,5,30,1,0,1
3463,2015,12,2015-11-28,Minnesota,,Wisconsin,L (21-31),16,37,43.2,223,1,18,53,2.9,1,55,276,5.0,6,3,2,11,4,35,2,3,5
3464,2015,13,2015-12-28,Minnesota,N,Central Michigan*,W (21-14),24,30,80.0,223,1,39,158,4.1,1,69,381,5.5,13,7,1,21,1,5,0,1,1
3465,2015,,13 Games,Minnesota,,,,251,427,58.8,2793,15,446,1873,4.2,17,873,4666,5.3,133,80,16,229,73,591,11,11,22
3466,2016,1,2016-09-01,Minnesota,,Oregon State,W (30-23),13,27,48.1,130,0,47,150,3.2,4,74,280,3.8,8,11,2,21,8,70,1,0,1
3467,2016,2,2016-09-10,Minnesota,,Indiana State,W (58-28),21,32,65.6,301,4,44,292,6.6,3,76,593,7.8,16,14,1,31,10,82,0,0,0
3468,2016,3,2016-09-24,Minnesota,,Colorado State,W (31-24),16,20,80.0,174,0,45,243,5.4,4,65,417,6.4,10,10,1,21,9,68,0,1,1
3469,2016,4,2016-10-01,Minnesota,@,Penn State,L (26-29),24,41,58.5,241,1,48,228,4.8,1,89,469,5.3,14,13,4,31,8,83,0,1,1
3470,2016,5,2016-10-08,Minnesota,,Iowa,L (7-14),13,33,39.4,166,0,29,102,3.5,1,62,268,4.3,8,5,0,13,8,58,1,2,3
3471,2016,6,2016-10-15,Minnesota,@,Maryland,W (31-10),7,15,46.7,82,1,48,229,4.8,2,63,311,4.9,5,9,2,16,7,50,0,0,0
3472,2016,7,2016-10-22,Minnesota,,Rutgers,W (34-32),11,19,57.9,156,0,53,243,4.6,3,72,399,5.5,6,13,0,19,6,55,1,1,2
3473,2016,8,2016-10-29,Minnesota,@,Illinois,W (40-17),10,19,52.6,112,0,48,171,3.6,5,67,283,4.2,4,10,1,15,6,56,0,0,0
3474,2016,9,2016-11-05,Minnesota,,Purdue,W (44-31),14,23,60.9,231,0,43,235,5.5,5,66,466,7.1,6,12,0,18,5,65,0,1,1
3475,2016,10,2016-11-12,Minnesota,@,Nebraska,L (17-24),18,28,64.3,180,0,34,85,2.5,2,62,265,4.3,8,4,3,15,2,15,0,1,1
3476,2016,11,2016-11-19,Minnesota,,Northwestern,W (29-12),14,25,56.0,197,1,40,131,3.3,2,65,328,5.0,7,8,0,15,6,50,1,1,2
3477,2016,12,2016-11-26,Minnesota,@,Wisconsin,L (17-31),9,26,34.6,158,1,38,128,3.4,1,64,286,4.5,7,9,2,18,3,26,0,4,4
3478,2016,13,2016-12-27,Minnesota,N,Washington State*,W (17-12),11,20,55.0,129,1,41,150,3.7,1,61,279,4.6,8,8,1,17,10,65,1,0,1
3479,2016,,13 Games,Minnesota,,,,181,328,55.2,2257,9,558,2387,4.3,34,886,4644,5.2,107,126,17,250,88,743,5,12,17
3480,2017,1,2017-08-31,Minnesota,,Buffalo,W (17-7),19,32,59.4,239,1,51,169,3.3,1,83,408,4.9,10,10,1,21,4,35,0,1,1
3481,2017,2,2017-09-09,Minnesota,@,Oregon State,W (48-14),7,8,87.5,158,1,58,253,4.4,5,66,411,6.2,5,12,4,21,6,70,1,0,1
3482,2017,3,2017-09-16,Minnesota,,Middle Tennessee State,W (34-3),11,18,61.1,122,0,47,221,4.7,3,65,343,5.3,4,14,0,18,3,22,0,0,0
3483,2017,4,2017-09-30,Minnesota,,Maryland,L (24-31),13,26,50.0,229,1,31,80,2.6,2,57,309,5.4,11,4,3,18,3,29,0,2,2
3484,2017,5,2017-10-07,Minnesota,@,Purdue,L (17-31),11,25,44.0,101,2,47,227,4.8,0,72,328,4.6,4,11,1,16,5,47,1,1,2
3485,2017,6,2017-10-14,Minnesota,,Michigan State,L (27-30),16,32,50.0,216,3,27,74,2.7,0,59,290,4.9,10,4,0,14,1,15,1,1,2
3486,2017,7,2017-10-21,Minnesota,,Illinois,W (24-17),5,15,33.3,47,1,55,292,5.3,1,70,339,4.8,2,19,1,22,3,12,1,2,3
3487,2017,8,2017-10-28,Minnesota,@,Iowa,L (10-17),9,29,31.0,139,0,43,142,3.3,1,72,281,3.9,4,10,1,15,5,37,0,1,1
3488,2017,9,2017-11-04,Minnesota,@,Michigan,L (10-33),5,12,41.7,74,0,44,90,2.0,1,56,164,2.9,3,8,2,13,3,10,1,0,1
3489,2017,10,2017-11-11,Minnesota,,Nebraska,W (54-21),9,16,56.3,105,0,45,409,9.1,6,61,514,8.4,5,17,2,24,3,35,0,0,0
3490,2017,11,2017-11-18,Minnesota,@,Northwestern,L (0-39),2,11,18.2,43,0,38,139,3.7,0,49,182,3.7,1,6,0,7,2,18,2,3,5
3491,2017,12,2017-11-25,Minnesota,,Wisconsin,L (0-31),3,9,33.3,40,0,39,93,2.4,0,48,133,2.8,2,5,1,8,1,10,0,0,0
3492,2017,,12 Games,Minnesota,,,,110,233,47.2,1513,9,525,2189,4.2,20,758,3702,4.9,61,120,16,197,39,340,7,11,18
3493,2014,1,2014-08-30,Mississippi State,,Southern Mississippi,W (49-0),23,34,67.6,349,5,44,201,4.6,1,78,550,7.1,20,9,0,29,3,30,1,1,2
3494,2014,2,2014-09-06,Mississippi State,,Alabama-Birmingham,W (47-34),14,31,45.2,224,4,57,292,5.1,2,88,516,5.9,8,18,0,26,3,32,0,1,1
3495,2014,3,2014-09-13,Mississippi State,@,South Alabama,W (35-3),16,24,66.7,226,2,45,288,6.4,3,69,514,7.4,9,14,1,24,8,70,2,0,2
3496,2014,4,2014-09-20,Mississippi State,@,Louisiana State,W (34-29),15,24,62.5,268,2,49,302,6.2,2,73,570,7.8,9,14,0,23,6,41,2,0,2
3497,2014,5,2014-10-04,Mississippi State,,Texas A&M,W (48-31),21,27,77.8,279,2,50,280,5.6,5,77,559,7.3,13,11,2,26,3,20,2,0,2
3498,2014,6,2014-10-11,Mississippi State,,Auburn,W (38-23),18,35,51.4,246,1,44,223,5.1,4,79,469,5.9,12,10,2,24,7,50,1,3,4
3499,2014,7,2014-10-25,Mississippi State,@,Kentucky,W (45-31),18,33,54.5,216,1,51,326,6.4,4,84,542,6.5,11,18,1,30,2,20,0,1,1
3500,2014,8,2014-11-01,Mississippi State,,Arkansas,W (17-10),18,27,66.7,331,1,35,128,3.7,1,62,459,7.4,11,8,0,19,8,45,1,2,3
3501,2014,9,2014-11-08,Mississippi State,,Tennessee-Martin,W (45-16),17,27,63.0,266,3,32,254,7.9,3,59,520,8.8,12,8,1,21,3,20,1,0,1
3502,2014,10,2014-11-15,Mississippi State,@,Alabama,L (20-25),27,48,56.3,290,2,40,138,3.5,0,88,428,4.9,13,11,2,26,4,33,0,3,3
3503,2014,11,2014-11-22,Mississippi State,,Vanderbilt,W (51-0),19,25,76.0,219,4,51,283,5.5,2,76,502,6.6,11,18,3,32,11,87,0,0,0
3504,2014,12,2014-11-29,Mississippi State,@,Mississippi,L (17-31),22,37,59.5,282,1,47,163,3.5,1,84,445,5.3,11,9,1,21,4,25,0,0,0
3505,2014,13,2014-12-31,Mississippi State,N,Georgia Tech*,L (34-49),33,51,64.7,453,3,33,152,4.6,1,84,605,7.2,19,12,2,33,5,40,1,1,2
3506,2014,,13 Games,Mississippi State,,,,261,423,61.7,3649,31,578,3030,5.2,29,1001,6679,6.7,159,160,15,334,67,513,11,12,23
3507,2015,1,2015-09-05,Mississippi State,@,Southern Mississippi,W (34-16),22,38,57.9,237,2,28,205,7.3,1,66,442,6.7,9,8,2,19,6,60,2,0,2
3508,2015,2,2015-09-12,Mississippi State,,Louisiana State,L (19-21),34,54,63.0,335,1,26,43,1.7,1,80,378,4.7,0,0,0,27,5,45,0,0,0
3509,2015,3,2015-09-19,Mississippi State,,Northwestern State,W (62-13),16,18,88.9,372,4,37,275,7.4,5,55,647,11.8,11,15,0,26,2,20,2,0,2
3510,2015,4,2015-09-26,Mississippi State,@,Auburn,W (17-9),29,41,70.7,270,2,21,56,2.7,0,62,326,5.3,14,4,0,18,4,30,1,0,1
3511,2015,5,2015-10-03,Mississippi State,@,Texas A&M,L (17-30),20,34,58.8,210,0,34,196,5.8,2,68,406,6.0,9,10,1,20,3,30,2,0,2
3512,2015,6,2015-10-10,Mississippi State,,Troy,W (45-17),10,15,66.7,211,3,33,125,3.8,1,48,336,7.0,4,8,0,12,3,28,0,0,0
3513,2015,7,2015-10-17,Mississippi State,,Louisiana Tech,W (45-20),30,43,69.8,347,3,30,93,3.1,2,73,440,6.0,16,10,2,28,4,38,0,0,0
3514,2015,8,2015-10-24,Mississippi State,,Kentucky,W (42-16),26,36,72.2,382,3,36,204,5.7,3,72,586,8.1,19,11,0,30,6,62,0,1,1
3515,2015,9,2015-11-05,Mississippi State,@,Missouri,W (31-13),27,41,65.9,303,4,36,127,3.5,0,77,430,5.6,12,11,0,23,2,18,2,0,2
3516,2015,10,2015-11-14,Mississippi State,,Alabama,L (6-31),23,45,51.1,304,0,42,89,2.1,0,87,393,4.5,11,8,1,20,4,40,1,1,2
3517,2015,11,2015-11-21,Mississippi State,@,Arkansas,W (51-50),38,51,74.5,508,5,35,123,3.5,2,86,631,7.3,21,10,1,32,3,30,2,1,3
3518,2015,12,2015-11-28,Mississippi State,,Mississippi,L (27-38),31,42,73.8,254,2,34,148,4.4,1,76,402,5.3,12,9,0,21,6,50,1,1,2
3519,2015,13,2015-12-30,Mississippi State,N,North Carolina State*,W (51-28),25,42,59.5,380,4,35,189,5.4,3,77,569,7.4,15,9,2,26,5,55,0,1,1
3520,2015,,13 Games,Mississippi State,,,,331,500,66.2,4113,33,427,1873,4.4,21,927,5986,6.5,153,113,9,302,53,506,13,5,18
3521,2016,1,2016-09-03,Mississippi State,,South Alabama,L (20-21),20,31,64.5,143,1,34,239,7.0,1,65,382,5.9,11,8,3,22,5,41,0,0,0
3522,2016,2,2016-09-10,Mississippi State,,South Carolina,W (27-14),20,30,66.7,195,3,43,294,6.8,0,73,489,6.7,9,12,3,24,6,60,0,1,1
3523,2016,3,2016-09-17,Mississippi State,@,Louisiana State,L (20-23),17,32,53.1,214,1,32,56,1.8,1,64,270,4.2,9,4,1,14,5,35,1,0,1
3524,2016,4,2016-09-24,Mississippi State,@,Massachusetts,W (47-35),26,39,66.7,305,3,44,297,6.8,2,83,602,7.3,14,17,0,31,9,90,1,0,1
3525,2016,5,2016-10-08,Mississippi State,,Auburn,L (14-38),18,35,51.4,186,2,33,103,3.1,0,68,289,4.3,9,7,0,16,7,80,2,1,3
3526,2016,6,2016-10-14,Mississippi State,@,Brigham Young,L (21-28),18,37,48.6,223,1,49,163,3.3,2,86,386,4.5,11,9,3,23,7,63,0,2,2
3527,2016,7,2016-10-22,Mississippi State,@,Kentucky,L (38-40),13,21,61.9,81,1,39,281,7.2,3,60,362,6.0,4,11,1,16,7,50,0,1,1
3528,2016,8,2016-10-29,Mississippi State,,Samford,W (56-41),20,35,57.1,417,5,46,252,5.5,2,81,669,8.3,14,13,2,29,4,35,1,2,3
3529,2016,9,2016-11-05,Mississippi State,,Texas A&M,W (35-28),18,31,58.1,209,2,58,365,6.3,3,89,574,6.4,8,19,2,29,3,30,0,2,2
3530,2016,10,2016-11-12,Mississippi State,@,Alabama,L (3-51),16,43,37.2,180,0,35,94,2.7,0,78,274,3.5,9,6,2,17,4,31,0,1,1
3531,2016,11,2016-11-19,Mississippi State,,Arkansas,L (42-58),23,33,69.7,328,2,35,205,5.9,4,68,533,7.8,14,10,1,25,3,22,0,0,0
3532,2016,12,2016-11-26,Mississippi State,@,Mississippi,W (55-20),8,17,47.1,109,3,47,457,9.7,4,64,566,8.8,5,17,1,23,6,55,1,0,1
3533,2016,13,2016-12-26,Mississippi State,N,Miami (OH)*,W (17-16),13,27,48.1,136,0,33,199,6.0,2,60,335,5.6,6,9,2,17,2,25,0,0,0
3534,2016,,13 Games,Mississippi State,,,,230,411,56.0,2726,24,528,3005,5.7,24,939,5731,6.1,123,142,21,286,68,617,6,10,16
3535,2017,1,2017-09-02,Mississippi State,,Charleston Southern,W (49-0),20,36,55.6,274,3,50,281,5.6,3,86,555,6.5,11,17,1,29,7,60,0,0,0
3536,2017,2,2017-09-09,Mississippi State,@,Louisiana Tech,W (57-21),13,20,65.0,132,3,40,327,8.2,3,60,459,7.7,6,15,0,21,5,39,0,1,1
3537,2017,3,2017-09-16,Mississippi State,,Louisiana State,W (37-7),15,23,65.2,180,2,48,285,5.9,2,71,465,6.5,9,12,4,25,5,49,0,0,0
3538,2017,4,2017-09-23,Mississippi State,@,Georgia,L (3-31),15,33,45.5,103,0,37,177,4.8,0,70,280,4.0,5,10,0,15,4,35,0,2,2
3539,2017,5,2017-09-30,Mississippi State,@,Auburn,L (10-49),13,37,35.1,157,1,47,194,4.1,0,84,351,4.2,5,12,1,18,10,39,0,2,2
3540,2017,6,2017-10-14,Mississippi State,,Brigham Young,W (35-10),20,31,64.5,240,2,53,306,5.8,3,84,546,6.5,14,19,2,35,6,60,1,2,3
3541,2017,7,2017-10-21,Mississippi State,,Kentucky,W (45-7),19,27,70.4,159,1,48,282,5.9,4,75,441,5.9,7,16,2,25,5,55,0,0,0
3542,2017,8,2017-10-28,Mississippi State,@,Texas A&M,W (35-14),12,21,57.1,141,2,52,228,4.4,2,73,369,5.1,7,11,1,19,5,45,0,1,1
3543,2017,9,2017-11-04,Mississippi State,,Massachusetts,W (34-23),14,26,53.8,139,0,45,254,5.6,2,71,393,5.5,7,13,1,21,5,63,0,3,3
3544,2017,10,2017-11-11,Mississippi State,,Alabama,L (24-31),13,24,54.2,158,0,49,172,3.5,3,73,330,4.5,9,10,3,22,4,30,0,0,0
3545,2017,11,2017-11-18,Mississippi State,@,Arkansas,W (28-21),12,23,52.2,153,2,48,195,4.1,2,71,348,4.9,6,13,0,19,4,47,2,0,2
3546,2017,12,2017-11-23,Mississippi State,,Mississippi,L (28-31),14,32,43.8,207,1,62,294,4.7,2,94,501,5.3,9,16,2,27,9,88,3,2,5
3547,2017,13,2017-12-30,Mississippi State,N,Louisville*,W (31-27),11,20,55.0,127,0,55,277,5.0,4,75,404,5.4,4,18,1,23,11,100,2,1,3
3548,2017,,13 Games,Mississippi State,,,,191,353,54.1,2170,17,634,3272,5.2,30,987,5442,5.5,99,182,18,299,80,710,8,14,22
3549,2016,1,2016-09-02,Mississippi Valley State,@,Eastern Michigan,L (14-61),19,38,50.0,178,1,32,23,0.7,1,70,201,2.9,9,5,4,18,11,66,2,0,2
3550,2014,1,2014-08-30,Missouri,,South Dakota State,W (38-18),13,21,61.9,178,3,39,215,5.5,1,60,393,6.6,6,13,0,19,5,27,0,0,0
3551,2014,2,2014-09-06,Missouri,@,Toledo,W (49-24),21,33,63.6,325,5,47,177,3.8,2,80,502,6.3,15,9,1,25,2,25,0,2,2
3552,2014,3,2014-09-13,Missouri,,Central Florida,W (38-10),14,24,58.3,144,4,35,178,5.1,0,59,322,5.5,8,10,1,19,4,47,0,1,1
3553,2014,4,2014-09-20,Missouri,,Indiana,L (27-31),29,48,60.4,331,2,35,172,4.9,1,83,503,6.1,18,8,2,27,10,75,0,1,1
3554,2014,5,2014-09-27,Missouri,@,South Carolina,W (21-20),12,34,35.3,132,0,36,148,4.1,3,70,280,4.0,5,9,2,16,8,74,0,0,0
3555,2014,6,2014-10-11,Missouri,,Georgia,L (0-34),9,21,42.9,97,0,22,50,2.3,0,43,147,3.4,5,4,1,10,4,30,1,4,5
3556,2014,7,2014-10-18,Missouri,@,Florida,W (42-13),6,18,33.3,20,0,31,99,3.2,1,49,119,2.4,1,6,0,7,11,74,0,1,1
3557,2014,8,2014-10-25,Missouri,,Vanderbilt,W (24-14),11,23,47.8,141,2,46,244,5.3,1,69,385,5.6,7,12,1,20,14,100,0,0,0
3558,2014,9,2014-11-01,Missouri,,Kentucky,W (20-10),18,33,54.5,164,2,45,156,3.5,0,78,320,4.1,10,8,3,21,5,50,0,0,0
3559,2014,10,2014-11-15,Missouri,@,Texas A&M,W (34-27),23,40,57.5,252,1,49,335,6.8,3,89,587,6.6,13,16,3,32,12,81,0,1,1
3560,2014,11,2014-11-22,Missouri,@,Tennessee,W (29-21),12,25,48.0,230,2,45,180,4.0,2,70,410,5.9,8,9,2,19,12,82,0,0,0
3561,2014,12,2014-11-28,Missouri,,Arkansas,W (21-14),25,42,59.5,265,1,41,158,3.9,1,83,423,5.1,12,12,2,26,7,75,1,1,2
3562,2014,13,2014-12-06,Missouri,N,Alabama,L (13-42),16,34,47.1,272,1,23,41,1.8,0,57,313,5.5,9,1,0,10,6,60,1,0,1
3563,2014,14,2015-01-01,Missouri,N,Minnesota*,W (33-17),12,19,63.2,97,2,45,337,7.5,2,64,434,6.8,5,12,1,18,2,15,0,2,2
3564,2014,,14 Games,Missouri,,,,221,415,53.3,2648,25,539,2490,4.6,17,954,5138,5.4,122,129,19,269,102,815,3,13,16
3565,2015,1,2015-09-05,Missouri,,Southeast Missouri State,W (34-3),18,32,56.3,319,3,33,98,3.0,0,65,417,6.4,11,5,3,19,6,54,0,1,1
3566,2015,2,2015-09-12,Missouri,@,Arkansas State,W (27-20),16,37,43.2,148,3,34,140,4.1,0,71,288,4.1,8,8,3,19,9,75,0,3,3
3567,2015,3,2015-09-19,Missouri,,Connecticut,W (9-6),20,31,64.5,185,0,34,85,2.5,1,65,270,4.2,7,7,2,16,3,30,1,1,2
3568,2015,4,2015-09-26,Missouri,@,Kentucky,L (13-21),18,35,51.4,227,1,33,111,3.4,0,68,338,5.0,12,7,5,24,3,30,0,0,0
3569,2015,5,2015-10-03,Missouri,,South Carolina,W (24-10),21,28,75.0,136,2,42,163,3.9,1,70,299,4.3,5,13,0,18,3,29,0,0,0
3570,2015,6,2015-10-10,Missouri,,Florida,L (3-21),16,39,41.0,151,0,26,106,4.1,0,65,257,4.0,6,6,0,12,6,38,0,2,2
3571,2015,7,2015-10-17,Missouri,@,Georgia,L (6-9),11,26,42.3,143,0,22,21,1.0,0,48,164,3.4,5,0,1,6,4,27,1,0,1
3572,2015,8,2015-10-24,Missouri,@,Vanderbilt,L (3-10),14,34,41.2,108,0,19,80,4.2,0,53,188,3.5,5,3,2,10,6,37,1,0,1
3573,2015,9,2015-11-05,Missouri,,Mississippi State,L (13-31),11,26,42.3,107,0,45,215,4.8,1,71,322,4.5,6,9,1,16,6,38,0,2,2
3574,2015,10,2015-11-14,Missouri,N,Brigham Young,W (20-16),19,28,67.9,244,1,55,190,3.5,1,83,434,5.2,12,9,2,23,8,91,1,1,2
3575,2015,11,2015-11-21,Missouri,,Tennessee,L (8-19),13,30,43.3,135,0,29,88,3.0,1,59,223,3.8,5,4,1,10,7,50,1,1,2
3576,2015,12,2015-11-27,Missouri,@,Arkansas,L (3-28),9,27,33.3,83,0,25,88,3.5,0,52,171,3.3,3,5,0,8,2,18,0,1,1
3577,2015,,12 Games,Missouri,,,,186,373,49.9,1986,10,397,1385,3.5,5,770,3371,4.4,85,76,20,181,63,517,5,12,17
3578,2016,1,2016-09-03,Missouri,@,West Virginia,L (11-26),24,53,45.3,282,1,47,180,3.8,0,100,462,4.6,11,13,2,26,6,51,1,0,1
3579,2016,2,2016-09-10,Missouri,,Eastern Michigan,W (61-21),27,40,67.5,477,5,38,170,4.5,2,78,647,8.3,15,12,3,30,8,75,2,0,2
3580,2016,3,2016-09-17,Missouri,,Georgia,L (27-28),23,38,60.5,376,3,37,95,2.6,0,75,471,6.3,10,8,0,18,7,50,2,3,5
3581,2016,4,2016-09-24,Missouri,,Delaware State,W (79-0),29,39,74.4,430,6,39,268,6.9,5,78,698,8.9,15,17,2,34,6,60,0,0,0
3582,2016,5,2016-10-01,Missouri,@,Louisiana State,L (7-42),18,38,47.4,188,1,22,77,3.5,0,60,265,4.4,10,3,1,14,5,50,0,1,1
3583,2016,6,2016-10-15,Missouri,@,Florida,L (14-40),7,22,31.8,98,0,46,265,5.8,2,68,363,5.3,4,11,1,16,5,24,1,2,3
3584,2016,7,2016-10-22,Missouri,,Middle Tennessee State,L (45-51),20,40,50.0,281,2,64,348,5.4,4,104,629,6.0,13,21,2,36,13,125,2,0,2
3585,2016,8,2016-10-29,Missouri,,Kentucky,L (21-35),19,32,59.4,229,2,37,157,4.2,1,69,386,5.6,9,8,1,18,9,65,0,0,0
3586,2016,9,2016-11-05,Missouri,@,South Carolina,L (21-31),23,40,57.5,302,1,36,163,4.5,2,76,465,6.1,12,11,1,24,5,45,1,2,3
3587,2016,10,2016-11-12,Missouri,,Vanderbilt,W (26-17),22,37,59.5,294,2,37,187,5.1,1,74,481,6.5,10,7,3,20,7,90,1,0,1
3588,2016,11,2016-11-19,Missouri,@,Tennessee,L (37-63),21,43,48.8,320,1,67,420,6.3,4,110,740,6.7,13,27,1,41,7,51,2,2,4
3589,2016,12,2016-11-25,Missouri,,Arkansas,W (28-24),16,26,61.5,268,1,30,131,4.4,3,56,399,7.1,8,6,1,15,2,10,1,0,1
3590,2016,,12 Games,Missouri,,,,249,448,55.6,3545,25,500,2461,4.9,24,948,6006,6.3,130,144,18,292,80,696,13,10,23
3591,2017,1,2017-09-02,Missouri,,Missouri State,W (72-43),21,34,61.8,521,7,41,294,7.2,3,75,815,10.9,19,15,1,35,6,52,1,1,2
3592,2017,2,2017-09-09,Missouri,,South Carolina,L (13-31),14,32,43.8,245,1,37,178,4.8,0,69,423,6.1,10,11,0,21,4,24,1,2,3
3593,2017,3,2017-09-16,Missouri,,Purdue,L (3-35),12,28,42.9,133,0,24,70,2.9,0,52,203,3.9,5,4,1,10,6,46,1,2,3
3594,2017,4,2017-09-23,Missouri,,Auburn,L (14-51),23,39,59.0,216,2,30,124,4.1,0,69,340,4.9,12,7,2,21,7,55,3,1,4
3595,2017,5,2017-10-07,Missouri,@,Kentucky,L (34-40),22,43,51.2,355,3,33,213,6.5,1,76,568,7.5,11,13,0,24,7,55,2,0,2
3596,2017,6,2017-10-14,Missouri,@,Georgia,L (28-53),15,25,60.0,253,4,24,59,2.5,0,49,312,6.4,6,4,0,10,4,40,0,1,1
3597,2017,7,2017-10-21,Missouri,,Idaho,W (68-21),24,34,70.6,475,6,30,183,6.1,2,64,658,10.3,20,7,1,28,6,45,0,1,1
3598,2017,8,2017-10-28,Missouri,@,Connecticut,W (52-12),34,43,79.1,408,5,34,175,5.1,2,77,583,7.6,16,12,3,31,12,107,0,1,1
3599,2017,9,2017-11-04,Missouri,,Florida,W (45-16),15,21,71.4,228,3,46,227,4.9,3,67,455,6.8,10,12,4,26,7,71,0,1,1
3600,2017,10,2017-11-11,Missouri,,Tennessee,W (50-17),14,30,46.7,226,4,53,433,8.2,2,83,659,7.9,7,20,2,29,7,60,0,1,1
3601,2017,11,2017-11-18,Missouri,@,Vanderbilt,W (45-17),10,25,40.0,235,3,39,191,4.9,1,64,426,6.7,7,9,1,17,11,56,0,0,0
3602,2017,12,2017-11-24,Missouri,@,Arkansas,W (48-45),25,42,59.5,448,5,60,248,4.1,1,102,696,6.8,17,14,4,35,10,77,0,2,2
3603,2017,13,2017-12-27,Missouri,N,Texas*,L (16-33),18,34,52.9,269,1,33,134,4.1,1,67,403,6.0,10,5,2,17,9,86,3,1,4
3604,2017,,13 Games,Missouri,,,,247,430,57.4,4012,44,484,2529,5.2,16,914,6541,7.2,150,133,21,304,96,774,11,14,25
3605,2017,1,2017-09-09,Montana,@,Washington,L (7-63),19,31,61.3,132,0,33,31,0.9,0,64,163,2.5,4,4,2,10,4,35,2,2,4
3606,2016,1,2016-09-01,Montana State,@,Idaho,L (17-20),20,36,55.6,190,1,38,110,2.9,1,74,300,4.1,11,6,3,20,4,30,0,1,1
3607,2017,1,2017-09-02,Montana State,@,Washington State,L (0-31),5,12,41.7,28,0,32,115,3.6,0,44,143,3.3,1,6,0,7,4,23,0,1,1
3608,2014,1,2014-08-30,Navy,N,Ohio State,L (17-34),2,4,50.0,20,0,63,370,5.9,2,67,390,5.8,1,21,0,22,3,20,1,0,1
3609,2014,2,2014-09-06,Navy,@,Temple,W (31-24),4,8,50.0,30,0,63,487,7.7,4,71,517,7.3,1,24,2,27,1,15,3,0,3
3610,2014,3,2014-09-13,Navy,@,Texas State,W (35-21),5,7,71.4,117,2,57,352,6.2,3,64,469,7.3,3,13,1,17,4,50,0,1,1
3611,2014,4,2014-09-20,Navy,,Rutgers,L (24-31),12,22,54.5,231,1,43,171,4.0,2,65,402,6.2,8,11,1,20,3,34,1,0,1
3612,2014,5,2014-09-27,Navy,,Western Kentucky,L (27-36),3,15,20.0,55,0,52,412,7.9,4,67,467,7.0,3,19,0,22,3,25,1,1,2
3613,2014,6,2014-10-04,Navy,@,Air Force,L (21-30),8,16,50.0,142,1,55,251,4.6,2,71,393,5.5,5,12,3,20,5,55,1,1,2
3614,2014,7,2014-10-11,Navy,,Virginia Military Institute,W (51-14),3,6,50.0,82,1,49,352,7.2,5,55,434,7.9,3,17,0,20,3,18,1,1,2
3615,2014,8,2014-10-25,Navy,,San Jose State,W (41-31),4,8,50.0,56,0,68,423,6.2,5,76,479,6.3,2,25,1,28,0,0,1,0,1
3616,2014,9,2014-11-01,Navy,N,Notre Dame,L (39-49),6,17,35.3,118,2,60,336,5.6,3,77,454,5.9,5,18,0,23,3,56,0,1,1
3617,2014,10,2014-11-15,Navy,,Georgia Southern,W (52-19),5,8,62.5,71,1,50,394,7.9,6,58,465,8.0,3,20,0,23,0,0,0,0,0
3618,2014,11,2014-11-28,Navy,@,South Alabama,W (42-40),1,4,25.0,42,0,54,388,7.2,6,58,430,7.4,1,15,2,18,1,15,3,0,3
3619,2014,12,2014-12-13,Navy,N,Army,W (17-10),6,8,75.0,77,1,55,205,3.7,1,63,282,4.5,2,14,0,16,3,20,1,0,1
3620,2014,13,2014-12-23,Navy,N,San Diego State*,W (17-16),3,7,42.9,17,0,58,254,4.4,2,65,271,4.2,0,13,0,13,5,45,4,0,4
3621,2014,,13 Games,Navy,,,,62,130,47.7,1058,9,727,4395,6.0,45,857,5453,6.4,37,222,10,269,34,353,17,5,22
3622,2015,1,2015-09-05,Navy,,Colgate,W (48-10),3,6,50.0,67,0,47,371,7.9,5,53,438,8.3,2,16,1,19,3,34,1,0,1
3623,2015,2,2015-09-19,Navy,,East Carolina,W (45-21),4,7,57.1,41,0,75,415,5.5,6,82,456,5.6,2,23,3,28,6,55,0,0,0
3624,2015,3,2015-09-26,Navy,@,Connecticut,W (28-18),3,5,60.0,40,1,61,303,5.0,3,66,343,5.2,3,17,1,21,3,37,0,0,0
3625,2015,4,2015-10-03,Navy,,Air Force,W (33-11),4,10,40.0,117,1,51,270,5.3,3,61,387,6.3,4,9,1,14,7,35,0,0,0
3626,2015,5,2015-10-10,Navy,@,Notre Dame,L (24-41),3,6,50.0,22,0,49,318,6.5,3,55,340,6.2,0,16,0,16,3,41,2,1,3
3627,2015,6,2015-10-24,Navy,,Tulane,W (31-14),8,12,66.7,158,1,54,133,2.5,3,66,291,4.4,5,11,2,18,3,30,0,0,0
3628,2015,7,2015-10-31,Navy,,South Florida,W (29-17),3,9,33.3,16,0,69,428,6.2,3,78,444,5.7,0,21,1,22,2,20,1,0,1
3629,2015,8,2015-11-07,Navy,@,Memphis,W (45-20),3,5,60.0,85,1,66,374,5.7,5,71,459,6.5,1,20,2,23,2,5,0,0,0
3630,2015,9,2015-11-14,Navy,,Southern Methodist,W (55-14),2,9,22.2,81,1,65,403,6.2,7,74,484,6.5,2,24,2,28,0,0,0,0,0
3631,2015,10,2015-11-21,Navy,@,Tulsa,W (44-21),2,3,66.7,55,1,61,469,7.7,5,64,524,8.2,2,22,0,24,4,27,1,0,1
3632,2015,11,2015-11-27,Navy,@,Houston,L (31-52),13,18,72.2,312,1,38,147,3.9,3,56,459,8.2,8,8,1,17,2,15,0,1,1
3633,2015,12,2015-12-12,Navy,N,Army,W (21-17),6,14,42.9,113,1,41,199,4.9,2,55,312,5.7,3,8,0,11,3,25,0,0,0
3634,2015,13,2015-12-28,Navy,N,Pittsburgh*,W (44-28),10,18,55.6,173,1,71,417,5.9,5,89,590,6.6,8,22,1,31,2,15,1,0,1
3635,2015,,13 Games,Navy,,,,64,122,52.5,1280,9,748,4247,5.7,53,870,5527,6.4,40,217,15,272,40,339,6,2,8
3636,2016,1,2016-09-03,Navy,,Fordham,W (52-16),4,4,100.0,123,1,53,427,8.1,6,57,550,9.6,3,15,0,18,2,16,0,0,0
3637,2016,2,2016-09-10,Navy,,Connecticut,W (28-24),6,8,75.0,130,0,50,235,4.7,3,58,365,6.3,4,14,0,18,2,30,1,0,1
3638,2016,3,2016-09-17,Navy,@,Tulane,W (21-14),5,12,41.7,59,0,52,300,5.8,3,64,359,5.6,3,16,2,21,3,30,2,0,2
3639,2016,4,2016-10-01,Navy,@,Air Force,L (14-28),17,31,54.8,260,0,38,57,1.5,2,69,317,4.6,11,5,2,18,3,15,1,2,3
3640,2016,5,2016-10-08,Navy,,Houston,W (46-40),3,5,60.0,76,2,63,306,4.9,2,68,382,5.6,3,16,1,20,1,5,0,0,0
3641,2016,6,2016-10-22,Navy,,Memphis,W (42-28),3,4,75.0,85,2,74,447,6.0,4,78,532,6.8,3,23,1,27,3,20,1,0,1
3642,2016,7,2016-10-28,Navy,@,South Florida,L (45-52),15,27,55.6,299,1,54,317,5.9,6,81,616,7.6,10,19,0,29,2,10,0,1,1
3643,2016,8,2016-11-05,Navy,N,Notre Dame,W (28-27),5,8,62.5,48,0,56,320,5.7,4,64,368,5.8,2,17,2,21,1,5,0,0,0
3644,2016,9,2016-11-12,Navy,,Tulsa,W (42-40),6,8,75.0,111,1,64,390,6.1,5,72,501,7.0,4,19,1,24,5,35,0,0,0
3645,2016,10,2016-11-19,Navy,@,East Carolina,W (66-31),3,5,60.0,113,0,68,480,7.1,9,73,593,8.1,3,24,1,28,4,40,0,0,0
3646,2016,11,2016-11-26,Navy,@,Southern Methodist,W (75-31),5,9,55.6,104,1,48,496,10.3,9,57,600,10.5,4,17,2,23,4,50,1,0,1
3647,2016,12,2016-12-03,Navy,,Temple,L (10-34),8,15,53.3,138,0,44,168,3.8,1,59,306,5.2,6,6,1,13,0,0,1,2,3
3648,2016,13,2016-12-10,Navy,N,Army,L (17-21),6,10,60.0,89,0,26,112,4.3,2,36,201,5.6,4,4,0,8,3,15,1,2,3
3649,2016,14,2016-12-23,Navy,N,Louisiana Tech*,L (45-48),7,12,58.3,159,1,49,300,6.1,5,61,459,7.5,5,17,3,25,6,70,1,0,1
3650,2016,,14 Games,Navy,,,,93,158,58.9,1794,9,739,4355,5.9,61,897,6149,6.9,65,212,16,293,39,341,9,7,16
3651,2017,1,2017-09-01,Navy,@,Florida Atlantic,W (42-19),3,10,30.0,110,1,68,416,6.1,5,78,526,6.7,3,20,0,23,2,20,1,1,2
3652,2017,2,2017-09-09,Navy,,Tulane,W (23-21),4,12,33.3,132,1,52,194,3.7,1,64,326,5.1,2,12,1,15,0,0,1,1,2
3653,2017,3,2017-09-23,Navy,,Cincinnati,W (42-32),2,3,66.7,53,1,72,569,7.9,5,75,622,8.3,2,26,3,31,4,50,1,0,1
3654,2017,4,2017-09-30,Navy,@,Tulsa,W (31-21),3,4,75.0,90,0,68,421,6.2,4,72,511,7.1,2,22,0,24,9,83,1,0,1
3655,2017,5,2017-10-07,Navy,,Air Force,W (48-45),4,12,33.3,86,2,57,471,8.3,4,69,557,8.1,3,19,0,22,4,35,0,0,0
3656,2017,6,2017-10-14,Navy,@,Memphis,L (27-30),1,8,12.5,20,0,68,314,4.6,3,76,334,4.4,1,17,1,19,5,65,3,2,5
3657,2017,7,2017-10-21,Navy,,Central Florida,L (21-31),5,13,38.5,171,1,59,248,4.2,2,72,419,5.8,4,15,0,19,4,40,1,2,3
3658,2017,8,2017-11-02,Navy,@,Temple,L (26-34),13,19,68.4,226,3,52,136,2.6,0,71,362,5.1,8,11,1,20,7,69,0,1,1
3659,2017,9,2017-11-11,Navy,,Southern Methodist,W (43-40),0,1,0.0,0,0,72,559,7.8,6,73,559,7.7,0,21,3,24,5,68,1,1,2
3660,2017,10,2017-11-18,Navy,@,Notre Dame,L (17-24),3,8,37.5,41,1,72,277,3.8,1,80,318,4.0,2,19,2,23,2,16,0,1,1
3661,2017,11,2017-11-24,Navy,@,Houston,L (14-24),3,8,37.5,74,0,60,217,3.6,2,68,291,4.3,2,16,1,19,4,32,0,1,1
3662,2017,12,2017-12-09,Navy,N,Army,L (13-14),1,2,50.0,2,0,46,294,6.4,1,48,296,6.2,0,11,1,12,4,25,0,0,0
3663,2017,13,2017-12-28,Navy,,Virginia*,W (49-7),0,1,0.0,0,0,76,452,5.9,7,77,452,5.9,0,23,1,24,3,25,0,0,0
3664,2017,,13 Games,Navy,,,,42,101,41.6,1005,10,822,4568,5.6,41,923,5573,6.0,29,232,14,275,53,528,9,10,19
3665,2014,1,2014-08-30,Nebraska,,Florida Atlantic,W (55-7),17,35,48.6,286,2,57,498,8.7,5,92,784,8.5,11,24,0,35,6,60,0,0,0
3666,2014,2,2014-09-06,Nebraska,,McNeese State,W (31-24),16,31,51.6,242,2,33,195,5.9,2,64,437,6.8,9,7,1,17,5,40,0,1,1
3667,2014,3,2014-09-13,Nebraska,@,Fresno State,W (55-19),14,24,58.3,282,4,42,280,6.7,2,66,562,8.5,13,7,2,22,6,61,1,0,1
3668,2014,4,2014-09-20,Nebraska,,Miami (FL),W (41-31),9,13,69.2,113,2,54,343,6.4,2,67,456,6.8,5,17,5,27,7,69,1,1,2
3669,2014,5,2014-09-27,Nebraska,,Illinois,W (45-14),10,21,47.6,166,1,70,458,6.5,5,91,624,6.9,6,26,3,35,8,70,1,1,2
3670,2014,6,2014-10-04,Nebraska,@,Michigan State,L (22-27),21,45,46.7,282,0,37,47,1.3,2,82,329,4.0,12,5,3,20,6,48,2,2,4
3671,2014,7,2014-10-18,Nebraska,@,Northwestern,W (38-17),19,30,63.3,237,1,44,234,5.3,4,74,471,6.4,11,12,2,25,7,68,0,0,0
3672,2014,8,2014-10-25,Nebraska,,Rutgers,W (42-24),14,22,63.6,163,2,41,292,7.1,4,63,455,7.2,8,11,2,21,5,35,1,1,2
3673,2014,9,2014-11-01,Nebraska,,Purdue,W (35-14),8,21,38.1,118,1,51,179,3.5,4,72,297,4.1,6,10,1,17,3,30,1,2,3
3674,2014,10,2014-11-15,Nebraska,@,Wisconsin,L (24-59),6,18,33.3,62,1,46,118,2.6,2,64,180,2.8,3,7,2,12,7,55,4,1,5
3675,2014,11,2014-11-22,Nebraska,,Minnesota,L (24-28),12,20,60.0,223,1,38,174,4.6,1,58,397,6.8,7,10,1,18,3,25,2,0,2
3676,2014,12,2014-11-28,Nebraska,@,Iowa,W (37-34),12,28,42.9,202,4,31,161,5.2,0,59,363,6.2,8,4,1,13,5,49,0,2,2
3677,2014,13,2014-12-27,Nebraska,N,Southern California*,L (42-45),32,51,62.7,381,3,43,144,3.3,2,94,525,5.6,16,9,3,28,7,45,0,1,1
3678,2014,,13 Games,Nebraska,,,,190,359,52.9,2757,24,587,3123,5.3,35,946,5880,6.2,115,149,26,290,75,655,13,12,25
3679,2015,1,2015-09-05,Nebraska,,Brigham Young,L (28-33),24,41,58.5,319,3,37,126,3.4,1,78,445,5.7,16,9,0,25,12,90,1,1,2
3680,2015,2,2015-09-12,Nebraska,,South Alabama,W (48-9),26,38,68.4,303,3,37,258,7.0,3,75,561,7.5,16,14,1,31,7,80,0,1,1
3681,2015,3,2015-09-19,Nebraska,@,Miami (FL),L (33-36),21,45,46.7,309,4,32,153,4.8,0,77,462,6.0,12,8,4,24,12,98,0,3,3
3682,2015,4,2015-09-26,Nebraska,,Southern Mississippi,W (36-28),23,35,65.7,368,2,39,242,6.2,1,74,610,8.2,14,10,1,25,12,98,1,1,2
3683,2015,5,2015-10-03,Nebraska,@,Illinois,L (13-14),10,31,32.3,105,0,34,187,5.5,1,65,292,4.5,2,9,1,12,6,42,1,1,2
3684,2015,6,2015-10-10,Nebraska,,Wisconsin,L (21-23),11,28,39.3,129,1,37,196,5.3,2,65,325,5.0,7,5,1,13,9,89,1,0,1
3685,2015,7,2015-10-17,Nebraska,@,Minnesota,W (48-25),18,26,69.2,261,3,39,203,5.2,2,65,464,7.1,14,8,1,23,2,25,0,0,0
3686,2015,8,2015-10-24,Nebraska,,Northwestern,L (28-30),24,48,50.0,291,1,38,82,2.2,2,86,373,4.3,13,6,3,22,6,64,0,1,1
3687,2015,9,2015-10-31,Nebraska,@,Purdue,L (45-55),29,48,60.4,407,4,29,77,2.7,2,77,484,6.3,22,3,3,28,7,40,1,4,5
3688,2015,10,2015-11-07,Nebraska,,Michigan State,W (39-38),19,33,57.6,320,2,36,179,5.0,3,69,499,7.2,12,11,1,24,5,55,0,2,2
3689,2015,11,2015-11-14,Nebraska,@,Rutgers,W (31-14),14,21,66.7,188,3,38,174,4.6,1,59,362,6.1,8,7,1,16,2,15,0,3,3
3690,2015,12,2015-11-27,Nebraska,,Iowa,L (20-28),25,45,55.6,296,0,38,137,3.6,2,83,433,5.2,14,7,1,22,8,95,0,4,4
3691,2015,13,2015-12-26,Nebraska,N,UCLA*,W (37-29),12,19,63.2,174,1,62,326,5.3,4,81,500,6.2,10,17,4,31,6,38,1,0,1
3692,2015,,13 Games,Nebraska,,,,256,458,55.9,3470,27,496,2340,4.7,24,954,5810,6.1,160,114,22,296,94,829,6,21,27
3693,2016,1,2016-09-03,Nebraska,,Fresno State,W (43-10),6,13,46.2,114,1,51,292,5.7,5,64,406,6.3,4,15,1,20,7,80,0,0,0
3694,2016,2,2016-09-10,Nebraska,,Wyoming,W (52-17),21,35,60.0,412,4,43,138,3.2,2,78,550,7.1,17,5,3,25,7,93,0,1,1
3695,2016,3,2016-09-17,Nebraska,,Oregon,W (35-32),17,35,48.6,200,3,47,228,4.9,2,82,428,5.2,10,12,4,26,7,55,1,0,1
3696,2016,4,2016-09-24,Nebraska,@,Northwestern,W (24-13),18,29,62.1,246,1,47,310,6.6,2,76,556,7.3,12,12,2,26,4,60,2,0,2
3697,2016,5,2016-10-01,Nebraska,,Illinois,W (31-16),16,23,69.6,220,1,49,203,4.1,3,72,423,5.9,12,9,2,23,3,35,1,1,2
3698,2016,6,2016-10-15,Nebraska,@,Indiana,W (27-22),10,26,38.5,208,1,45,152,3.4,1,71,360,5.1,8,9,0,17,9,53,0,2,2
3699,2016,7,2016-10-22,Nebraska,,Purdue,W (27-14),17,31,54.8,252,1,36,158,4.4,2,67,410,6.1,11,10,1,22,7,67,0,1,1
3700,2016,8,2016-10-29,Nebraska,@,Wisconsin,L (17-23),12,31,38.7,153,0,44,152,3.5,2,75,305,4.1,9,7,0,16,2,10,0,2,2
3701,2016,9,2016-11-05,Nebraska,@,Ohio State,L (3-62),9,33,27.3,126,0,24,78,3.3,0,57,204,3.6,6,2,1,9,4,43,0,2,2
3702,2016,10,2016-11-12,Nebraska,,Minnesota,W (24-17),19,28,67.9,217,2,32,157,4.9,1,60,374,6.2,10,9,0,19,8,81,0,0,0
3703,2016,11,2016-11-19,Nebraska,,Maryland,W (28-7),23,37,62.2,220,1,45,181,4.0,3,82,401,4.9,13,11,4,28,2,20,0,0,0
3704,2016,12,2016-11-25,Nebraska,@,Iowa,L (10-40),14,37,37.8,127,1,31,90,2.9,0,68,217,3.2,8,6,3,17,8,57,0,0,0
3705,2016,13,2016-12-30,Nebraska,N,Tennessee*,L (24-38),19,42,45.2,257,2,28,61,2.2,1,70,318,4.5,12,5,1,18,7,41,1,0,1
3706,2016,,13 Games,Nebraska,,,,201,400,50.3,2752,18,522,2200,4.2,24,922,4952,5.4,132,112,22,266,75,695,5,9,14
3707,2017,1,2017-09-02,Nebraska,,Arkansas State,W (43-36),19,32,59.4,238,2,38,225,5.9,2,70,463,6.6,14,10,1,25,8,75,0,0,0
3708,2017,2,2017-09-09,Nebraska,@,Oregon,L (35-42),19,41,46.3,252,3,29,109,3.8,2,70,361,5.2,11,6,2,19,3,25,0,4,4
3709,2017,3,2017-09-16,Nebraska,,Northern Illinois,L (17-21),25,47,53.2,299,0,36,85,2.4,2,83,384,4.6,12,6,0,18,5,48,0,3,3
3710,2017,4,2017-09-23,Nebraska,,Rutgers,W (27-17),13,26,50.0,109,2,47,197,4.2,1,73,306,4.2,8,11,2,21,6,46,0,2,2
3711,2017,5,2017-09-29,Nebraska,@,Illinois,W (28-6),17,24,70.8,246,3,38,165,4.3,1,62,411,6.6,12,9,2,23,5,70,1,0,1
3712,2017,6,2017-10-07,Nebraska,,Wisconsin,L (17-38),18,35,51.4,271,1,26,110,4.2,0,61,381,6.2,10,5,1,16,4,35,1,1,2
3713,2017,7,2017-10-14,Nebraska,,Ohio State,L (14-56),27,47,57.4,349,2,16,44,2.8,0,63,393,6.2,12,2,0,14,12,104,0,1,1
3714,2017,8,2017-10-28,Nebraska,@,Purdue,W (25-24),32,50,64.0,431,2,27,40,1.5,0,77,471,6.1,16,5,4,25,9,95,0,0,0
3715,2017,9,2017-11-04,Nebraska,,Northwestern,L (24-31),21,38,55.3,225,2,31,112,3.6,0,69,337,4.9,12,7,2,21,7,68,0,3,3
3716,2017,10,2017-11-11,Nebraska,@,Minnesota,L (21-54),25,36,69.4,311,1,33,69,2.1,2,69,380,5.5,13,5,2,20,4,54,0,0,0
3717,2017,11,2017-11-18,Nebraska,@,Penn State,L (44-56),26,41,63.4,399,2,26,67,2.6,3,67,466,7.0,16,4,1,21,9,89,0,0,0
3718,2017,12,2017-11-24,Nebraska,,Iowa,L (14-56),23,42,54.8,200,2,21,67,3.2,0,63,267,4.2,9,3,0,12,3,19,0,3,3
3719,2017,,12 Games,Nebraska,,,,265,459,57.7,3330,22,368,1290,3.5,13,827,4620,5.6,145,73,17,235,75,728,2,17,19
3720,2014,1,2014-08-30,Nevada,,Southern Utah,W (28-19),30,41,73.2,303,1,55,244,4.4,3,96,547,5.7,16,14,0,30,4,19,1,1,2
3721,2014,2,2014-09-05,Nevada,,Washington State,W (24-13),12,21,57.1,110,0,56,214,3.8,3,77,324,4.2,4,10,3,17,9,90,0,0,0
3722,2014,3,2014-09-13,Nevada,@,Arizona,L (28-35),29,39,74.4,321,3,40,108,2.7,0,79,429,5.4,17,8,0,25,8,74,0,0,0
3723,2014,4,2014-09-27,Nevada,@,San Jose State,W (21-10),10,18,55.6,64,0,36,192,5.3,2,54,256,4.7,2,12,2,16,8,56,0,0,0
3724,2014,5,2014-10-04,Nevada,,Boise State,L (46-51),23,43,53.5,306,3,30,156,5.2,2,73,462,6.3,15,6,3,24,3,22,0,4,4
3725,2014,6,2014-10-11,Nevada,,Colorado State,L (24-31),27,50,54.0,297,2,36,160,4.4,1,86,457,5.3,16,8,1,25,3,45,0,1,1
3726,2014,7,2014-10-18,Nevada,@,Brigham Young,W (42-35),26,40,65.0,285,1,36,126,3.5,4,76,411,5.4,12,7,1,20,6,36,0,0,0
3727,2014,8,2014-10-25,Nevada,@,Hawaii,W (26-18),18,28,64.3,132,1,60,295,4.9,2,88,427,4.9,7,19,0,26,4,36,0,1,1
3728,2014,9,2014-11-01,Nevada,,San Diego State,W (30-14),10,24,41.7,109,1,47,229,4.9,2,71,338,4.8,6,9,2,17,5,44,0,1,1
3729,2014,10,2014-11-15,Nevada,@,Air Force,L (38-45),24,36,66.7,275,2,45,223,5.0,3,81,498,6.1,15,11,1,27,4,42,0,1,1
3730,2014,11,2014-11-22,Nevada,,Fresno State,L (20-40),11,24,45.8,126,1,38,227,6.0,2,62,353,5.7,4,9,0,13,7,90,3,1,4
3731,2014,12,2014-11-29,Nevada,@,Nevada-Las Vegas,W (49-27),5,13,38.5,46,3,53,408,7.7,3,66,454,6.9,2,18,1,21,11,87,0,1,1
3732,2014,13,2014-12-20,Nevada,N,Louisiana*,L (3-16),14,29,48.3,124,0,28,89,3.2,0,57,213,3.7,6,6,1,13,1,5,1,0,1
3733,2014,,13 Games,Nevada,,,,239,406,58.9,2498,18,560,2671,4.8,27,966,5169,5.4,122,137,15,274,73,646,5,11,16
3734,2015,1,2015-09-03,Nevada,,California-Davis,W (31-17),13,23,56.5,163,1,39,232,5.9,3,62,395,6.4,7,13,2,22,6,50,0,0,0
3735,2015,2,2015-09-12,Nevada,,Arizona,L (20-44),18,34,52.9,159,2,42,168,4.0,0,76,327,4.3,7,8,0,15,9,105,0,1,1
3736,2015,3,2015-09-19,Nevada,@,Texas A&M,L (27-44),16,29,55.2,206,2,45,153,3.4,1,74,359,4.9,10,6,3,19,3,29,0,1,1
3737,2015,4,2015-09-26,Nevada,@,Buffalo,W (24-21),12,21,57.1,90,0,39,289,7.4,3,60,379,6.3,4,10,1,15,9,95,0,0,0
3738,2015,5,2015-10-03,Nevada,,Nevada-Las Vegas,L (17-23),20,44,45.5,202,1,35,141,4.0,1,79,343,4.3,13,8,3,24,6,53,0,1,1
3739,2015,6,2015-10-10,Nevada,,New Mexico,W (35-17),16,19,84.2,166,2,54,351,6.5,3,73,517,7.1,10,18,2,30,1,5,2,0,2
3740,2015,7,2015-10-17,Nevada,@,Wyoming,L (21-28),25,41,61.0,287,2,30,118,3.9,1,71,405,5.7,15,10,2,27,5,41,0,0,0
3741,2015,8,2015-10-24,Nevada,,Hawaii,W (30-20),12,23,52.2,128,1,56,244,4.4,2,79,372,4.7,6,13,1,20,4,35,0,1,1
3742,2015,9,2015-11-05,Nevada,@,Fresno State,W (30-16),12,17,70.6,206,1,50,292,5.8,1,67,498,7.4,7,11,0,18,10,78,0,1,1
3743,2015,10,2015-11-14,Nevada,,San Jose State,W (37-34),16,26,61.5,174,3,49,235,4.8,2,75,409,5.5,10,12,1,23,2,5,0,0,0
3744,2015,11,2015-11-21,Nevada,@,Utah State,L (27-31),8,18,44.4,55,0,46,209,4.5,3,64,264,4.1,3,11,1,15,3,32,2,0,2
3745,2015,12,2015-11-28,Nevada,@,San Diego State,L (14-31),12,23,52.2,228,0,31,35,1.1,1,54,263,4.9,8,2,0,10,7,60,1,2,3
3746,2015,13,2015-12-29,Nevada,N,Colorado State*,W (28-23),6,13,46.2,74,0,40,271,6.8,2,53,345,6.5,5,12,1,18,3,20,0,0,0
3747,2015,,13 Games,Nevada,,,,186,331,56.2,2138,15,556,2738,4.9,23,887,4876,5.5,105,134,17,256,68,608,5,7,12
3748,2016,1,2016-09-02,Nevada,,Cal Poly,W (30-27),17,24,70.8,189,2,34,174,5.1,2,58,363,6.3,9,8,1,18,4,40,0,0,0
3749,2016,2,2016-09-10,Nevada,@,Notre Dame,L (10-39),12,26,46.2,201,0,30,99,3.3,1,56,300,5.4,5,7,4,16,11,88,0,1,1
3750,2016,3,2016-09-17,Nevada,,Buffalo,W (38-14),17,25,68.0,169,1,64,352,5.5,4,89,521,5.9,12,18,2,32,5,35,0,0,0
3751,2016,4,2016-09-24,Nevada,@,Purdue,L (14-24),23,33,69.7,185,2,33,68,2.1,0,66,253,3.8,10,8,0,18,1,10,0,0,0
3752,2016,5,2016-10-01,Nevada,@,Hawaii,L (17-38),19,33,57.6,203,1,42,194,4.6,1,75,397,5.3,7,14,2,23,9,95,0,0,0
3753,2016,6,2016-10-08,Nevada,,Fresno State,W (27-22),14,23,60.9,163,3,49,226,4.6,1,72,389,5.4,6,15,2,23,3,35,1,0,1
3754,2016,7,2016-10-15,Nevada,@,San Jose State,L (10-14),9,22,40.9,144,1,34,113,3.3,0,56,257,4.6,5,7,1,13,3,35,0,2,2
3755,2016,8,2016-10-22,Nevada,,Wyoming,L (34-42),31,48,64.6,347,1,32,132,4.1,3,80,479,6.0,19,10,3,32,7,75,0,1,1
3756,2016,9,2016-11-05,Nevada,@,New Mexico,L (26-35),19,34,55.9,301,3,23,108,4.7,1,57,409,7.2,11,7,1,19,5,25,0,2,2
3757,2016,10,2016-11-12,Nevada,,San Diego State,L (16-46),21,37,56.8,276,1,34,90,2.6,0,71,366,5.2,11,7,1,19,2,20,0,3,3
3758,2016,11,2016-11-19,Nevada,,Utah State,W (38-37),13,26,50.0,127,1,50,214,4.3,3,76,341,4.5,5,16,1,22,1,10,1,0,1
3759,2016,12,2016-11-26,Nevada,@,Nevada-Las Vegas,W (45-10),15,23,65.2,193,1,49,318,6.5,4,72,511,7.1,10,16,1,27,1,14,0,0,0
3760,2016,,12 Games,Nevada,,,,210,354,59.3,2498,17,474,2088,4.4,20,828,4586,5.5,110,133,19,262,52,482,2,9,11
3761,2017,1,2017-09-02,Nevada,@,Northwestern,L (20-31),16,37,43.2,199,2,26,142,5.5,0,63,341,5.4,9,8,2,19,6,65,1,1,2
3762,2017,2,2017-09-09,Nevada,,Toledo,L (24-37),19,37,51.4,277,2,24,109,4.5,1,61,386,6.3,10,7,5,22,9,75,1,1,2
3763,2017,3,2017-09-16,Nevada,,Idaho State,L (28-30),19,33,57.6,205,3,56,218,3.9,1,89,423,4.8,9,12,4,25,7,62,2,1,3
3764,2017,4,2017-09-23,Nevada,@,Washington State,L (7-45),14,30,46.7,105,0,24,46,1.9,1,54,151,2.8,5,5,3,13,5,53,0,3,3
3765,2017,5,2017-09-30,Nevada,@,Fresno State,L (21-41),31,49,63.3,253,2,23,61,2.7,1,72,314,4.4,12,3,1,16,4,20,0,3,3
3766,2017,6,2017-10-07,Nevada,,Hawaii,W (35-21),26,34,76.5,298,4,38,268,7.1,1,72,566,7.9,12,11,3,26,6,39,0,1,1
3767,2017,7,2017-10-14,Nevada,@,Colorado State,L (42-44),25,42,59.5,508,5,31,56,1.8,1,73,564,7.7,16,4,3,23,3,30,0,0,0
3768,2017,8,2017-10-20,Nevada,,Air Force,L (42-45),18,35,51.4,267,3,20,157,7.9,2,55,424,7.7,10,9,2,21,3,25,0,0,0
3769,2017,9,2017-11-04,Nevada,@,Boise State,L (14-41),24,37,64.9,160,1,29,142,4.9,1,66,302,4.6,8,7,2,17,2,25,0,3,3
3770,2017,10,2017-11-11,Nevada,,San Jose State,W (59-14),20,28,71.4,265,3,44,176,4.0,2,72,441,6.1,9,8,3,20,8,70,0,0,0
3771,2017,11,2017-11-18,Nevada,@,San Diego State,L (23-42),33,55,60.0,414,3,18,34,1.9,0,73,448,6.1,15,3,0,18,2,20,1,1,2
3772,2017,12,2017-11-25,Nevada,,Nevada-Las Vegas,W (23-16),25,34,73.5,294,2,29,117,4.0,1,63,411,6.5,11,7,0,18,4,67,1,1,2
3773,2017,,12 Games,Nevada,,,,270,451,59.9,3245,30,362,1526,4.2,12,813,4771,5.9,126,84,28,238,59,551,6,15,21
3774,2014,1,2014-08-29,Nevada-Las Vegas,@,Arizona,L (13-58),22,41,53.7,252,1,31,119,3.8,0,72,371,5.2,14,5,1,20,7,64,0,1,1
3775,2014,2,2014-09-06,Nevada-Las Vegas,,Northern Colorado,W (13-12),11,20,55.0,121,1,48,211,4.4,0,68,332,4.9,6,13,0,19,6,75,0,4,4
3776,2014,3,2014-09-13,Nevada-Las Vegas,,Northern Illinois,L (34-48),24,42,57.1,397,2,32,102,3.2,2,74,499,6.7,18,3,5,26,5,32,0,1,1
3777,2014,4,2014-09-20,Nevada-Las Vegas,@,Houston,L (14-47),16,39,41.0,146,0,39,170,4.4,2,78,316,4.1,5,7,4,16,11,105,0,3,3
3778,2014,5,2014-09-27,Nevada-Las Vegas,@,San Diego State,L (17-34),18,33,54.5,346,1,38,109,2.9,1,71,455,6.4,13,9,4,26,8,72,0,2,2
3779,2014,6,2014-10-04,Nevada-Las Vegas,@,San Jose State,L (10-33),11,28,39.3,116,0,31,105,3.4,1,59,221,3.7,5,6,1,12,3,15,1,1,2
3780,2014,7,2014-10-10,Nevada-Las Vegas,,Fresno State,W (30-27),29,40,72.5,332,1,46,146,3.2,2,86,478,5.6,15,5,2,22,8,61,0,1,1
3781,2014,8,2014-10-25,Nevada-Las Vegas,@,Utah State,L (20-34),22,38,57.9,267,3,27,15,0.6,0,65,282,4.3,10,2,1,13,4,35,1,2,3
3782,2014,9,2014-11-01,Nevada-Las Vegas,,New Mexico,L (28-31),28,44,63.6,271,0,37,214,5.8,4,81,485,6.0,14,13,2,29,10,69,1,2,3
3783,2014,10,2014-11-08,Nevada-Las Vegas,,Air Force,L (21-48),22,45,48.9,306,1,30,33,1.1,2,75,339,4.5,12,5,2,19,3,30,0,0,0
3784,2014,11,2014-11-15,Nevada-Las Vegas,@,Brigham Young,L (23-42),20,45,44.4,204,1,45,199,4.4,1,90,403,4.5,10,7,1,18,6,43,0,1,1
3785,2014,12,2014-11-22,Nevada-Las Vegas,@,Hawaii,L (35-37),24,44,54.5,423,3,26,51,2.0,2,70,474,6.8,17,4,1,22,7,80,0,1,1
3786,2014,13,2014-11-29,Nevada-Las Vegas,,Nevada,L (27-49),21,39,53.8,171,2,36,205,5.7,1,75,376,5.0,9,12,4,25,3,35,1,3,4
3787,2014,,13 Games,Nevada-Las Vegas,,,,268,498,53.8,3352,16,466,1679,3.6,18,964,5031,5.2,148,91,28,267,81,716,4,22,26
3788,2015,1,2015-09-05,Nevada-Las Vegas,@,Northern Illinois,L (30-38),22,40,55.0,329,2,47,164,3.5,1,87,493,5.7,15,10,3,28,3,30,0,1,1
3789,2015,2,2015-09-12,Nevada-Las Vegas,,UCLA,L (3-37),6,23,26.1,56,0,43,181,4.2,0,66,237,3.6,2,7,2,11,8,85,1,1,2
3790,2015,3,2015-09-19,Nevada-Las Vegas,@,Michigan,L (7-28),14,26,53.8,143,1,36,92,2.6,0,62,235,3.8,8,6,1,15,2,10,0,2,2
3791,2015,4,2015-09-26,Nevada-Las Vegas,,Idaho State,W (80-8),10,15,66.7,109,4,54,517,9.6,6,69,626,9.1,5,20,0,25,10,95,0,0,0
3792,2015,5,2015-10-03,Nevada-Las Vegas,@,Nevada,W (23-17),13,19,68.4,134,0,44,167,3.8,2,63,301,4.8,8,8,2,18,8,76,0,1,1
3793,2015,6,2015-10-10,Nevada-Las Vegas,,San Jose State,L (27-33),15,30,50.0,217,2,48,186,3.9,1,78,403,5.2,8,14,1,23,4,40,0,2,2
3794,2015,7,2015-10-16,Nevada-Las Vegas,@,Fresno State,L (28-31),12,24,50.0,111,2,48,188,3.9,2,72,299,4.2,8,10,2,20,2,16,0,0,0
3795,2015,8,2015-10-31,Nevada-Las Vegas,,Boise State,L (27-55),30,51,58.8,387,0,25,100,4.0,1,76,487,6.4,17,6,5,28,5,39,0,2,2
3796,2015,9,2015-11-07,Nevada-Las Vegas,,Hawaii,W (41-21),15,24,62.5,258,2,53,289,5.5,3,77,547,7.1,9,11,2,22,6,60,1,1,2
3797,2015,10,2015-11-14,Nevada-Las Vegas,@,Colorado State,L (35-49),22,44,50.0,330,3,36,172,4.8,2,80,502,6.3,13,9,2,24,5,60,0,0,0
3798,2015,11,2015-11-21,Nevada-Las Vegas,,San Diego State,L (14-52),18,35,51.4,190,2,32,80,2.5,0,67,270,4.0,10,5,3,18,3,14,2,2,4
3799,2015,12,2015-11-28,Nevada-Las Vegas,@,Wyoming,L (28-35),19,34,55.9,273,3,34,183,5.4,1,68,456,6.7,13,9,1,23,1,13,0,1,1
3800,2015,,12 Games,Nevada-Las Vegas,,,,196,365,53.7,2537,21,500,2319,4.6,19,865,4856,5.6,116,115,24,255,57,538,4,13,17
3801,2016,1,2016-09-01,Nevada-Las Vegas,,Jackson State,W (63-13),11,13,84.6,223,3,44,280,6.4,4,57,503,8.8,8,13,0,21,6,61,1,0,1
3802,2016,2,2016-09-10,Nevada-Las Vegas,@,UCLA,L (21-42),11,28,39.3,153,1,35,175,5.0,2,63,328,5.2,8,10,0,18,7,70,0,2,2
3803,2016,3,2016-09-17,Nevada-Las Vegas,@,Central Michigan,L (21-44),15,41,36.6,131,1,38,182,4.8,1,79,313,4.0,7,8,0,15,9,94,0,2,2
3804,2016,4,2016-09-24,Nevada-Las Vegas,,Idaho,L (30-33),14,26,53.8,175,1,49,364,7.4,2,75,539,7.2,9,15,2,26,6,58,0,2,2
3805,2016,5,2016-10-01,Nevada-Las Vegas,,Fresno State,W (45-20),8,16,50.0,129,1,54,364,6.7,5,70,493,7.0,4,13,2,19,4,45,0,0,0
3806,2016,6,2016-10-08,Nevada-Las Vegas,@,San Diego State,L (7-26),2,13,15.4,9,0,36,113,3.1,0,49,122,2.5,1,7,1,9,0,0,0,1,1
3807,2016,7,2016-10-15,Nevada-Las Vegas,@,Hawaii,W (41-38),19,29,65.5,279,2,51,256,5.0,3,80,535,6.7,12,15,2,29,8,86,0,0,0
3808,2016,8,2016-10-22,Nevada-Las Vegas,,Colorado State,L (23-42),7,23,30.4,185,2,32,175,5.5,1,55,360,6.5,6,11,0,17,5,21,1,1,2
3809,2016,9,2016-10-29,Nevada-Las Vegas,@,San Jose State,L (24-30),12,30,40.0,185,1,40,217,5.4,2,70,402,5.7,7,10,3,20,11,87,0,1,1
3810,2016,10,2016-11-12,Nevada-Las Vegas,,Wyoming,W (69-66),20,33,60.6,252,3,64,401,6.3,5,97,653,6.7,13,18,0,31,4,35,1,0,1
3811,2016,11,2016-11-18,Nevada-Las Vegas,@,Boise State,L (25-42),10,20,50.0,113,1,44,189,4.3,2,64,302,4.7,5,12,0,17,6,54,0,0,0
3812,2016,12,2016-11-26,Nevada-Las Vegas,,Nevada,L (10-45),9,22,40.9,121,0,34,182,5.4,1,56,303,5.4,5,8,1,14,1,3,0,1,1
3813,2016,,12 Games,Nevada-Las Vegas,,,,138,294,46.9,1955,16,521,2898,5.6,28,815,4853,6.0,85,140,11,236,67,614,3,10,13
3814,2017,1,2017-09-02,Nevada-Las Vegas,,Howard,L (40-43),11,21,52.4,220,1,46,344,7.5,3,67,564,8.4,9,16,0,25,13,90,3,0,3
3815,2017,2,2017-09-09,Nevada-Las Vegas,@,Idaho,W (44-16),10,16,62.5,193,1,50,357,7.1,4,66,550,8.3,5,16,1,22,5,47,0,1,1
3816,2017,3,2017-09-23,Nevada-Las Vegas,@,Ohio State,L (21-54),11,20,55.0,88,0,41,176,4.3,2,61,264,4.3,4,8,5,17,4,30,0,2,2
3817,2017,4,2017-09-30,Nevada-Las Vegas,,San Jose State,W (41-13),11,16,68.8,203,2,52,345,6.6,4,68,548,8.1,9,15,1,25,6,55,0,0,0
3818,2017,5,2017-10-07,Nevada-Las Vegas,,San Diego State,L (10-41),12,28,42.9,177,1,31,106,3.4,0,59,283,4.8,7,5,0,12,5,49,0,0,0
3819,2017,6,2017-10-14,Nevada-Las Vegas,@,Air Force,L (30-34),12,27,44.4,145,0,39,266,6.8,3,66,411,6.2,6,9,0,15,2,20,1,1,2
3820,2017,7,2017-10-21,Nevada-Las Vegas,,Utah State,L (28-52),13,30,43.3,85,0,53,375,7.1,4,83,460,5.5,3,20,2,25,4,32,1,2,3
3821,2017,8,2017-10-28,Nevada-Las Vegas,@,Fresno State,W (26-16),17,29,58.6,155,0,44,173,3.9,2,73,328,4.5,10,9,3,22,5,35,0,0,0
3822,2017,9,2017-11-04,Nevada-Las Vegas,,Hawaii,W (31-23),20,31,64.5,281,2,42,131,3.1,2,73,412,5.6,15,7,1,23,4,36,0,1,1
3823,2017,10,2017-11-10,Nevada-Las Vegas,,Brigham Young,L (21-31),20,33,60.6,325,2,34,122,3.6,1,67,447,6.7,12,9,0,21,6,75,0,2,2
3824,2017,11,2017-11-17,Nevada-Las Vegas,@,New Mexico,W (38-35),13,25,52.0,211,1,46,323,7.0,3,71,534,7.5,10,14,1,25,1,5,0,0,0
3825,2017,12,2017-11-25,Nevada-Las Vegas,@,Nevada,L (16-23),12,23,52.2,160,0,50,164,3.3,1,73,324,4.4,7,14,1,22,1,5,1,0,1
3826,2017,,12 Games,Nevada-Las Vegas,,,,162,299,54.2,2243,10,528,2882,5.5,29,827,5125,6.2,97,142,15,254,56,479,6,9,15
3827,2016,1,2016-09-03,New Hampshire,@,San Diego State,L (0-31),7,20,35.0,70,0,31,71,2.3,0,51,141,2.8,3,4,1,8,8,49,0,1,1
3828,2017,1,2017-09-09,New Hampshire,N,Georgia Southern,W (22-12),13,22,59.1,129,2,32,145,4.5,1,54,274,5.1,7,7,0,14,6,41,0,0,0
3829,2014,1,2014-08-30,New Mexico,,Texas-El Paso,L (24-31),5,9,55.6,67,0,52,410,7.9,3,61,477,7.8,3,17,0,20,3,25,2,1,3
3830,2014,2,2014-09-06,New Mexico,,Arizona State,L (23-58),7,11,63.6,130,1,57,207,3.6,2,68,337,5.0,6,11,2,19,8,73,3,0,3
3831,2014,3,2014-09-20,New Mexico,@,New Mexico State,W (38-35),8,14,57.1,67,2,49,432,8.8,3,63,499,7.9,4,19,1,24,6,57,1,0,1
3832,2014,4,2014-09-26,New Mexico,,Fresno State,L (24-35),4,8,50.0,97,1,56,280,5.0,2,64,377,5.9,4,14,0,18,5,59,0,0,0
3833,2014,5,2014-10-04,New Mexico,@,Texas-San Antonio,W (21-9),9,14,64.3,87,0,48,283,5.9,3,62,370,6.0,4,10,1,15,2,30,0,0,0
3834,2014,6,2014-10-10,New Mexico,,San Diego State,L (14-24),11,24,45.8,111,1,38,152,4.0,1,62,263,4.2,4,8,3,15,6,57,0,1,1
3835,2014,7,2014-10-18,New Mexico,@,Air Force,L (31-35),4,10,40.0,23,0,52,367,7.1,3,62,390,6.3,1,13,0,14,1,15,2,0,2
3836,2014,8,2014-11-01,New Mexico,@,Nevada-Las Vegas,W (31-28),2,7,28.6,5,0,61,301,4.9,4,68,306,4.5,0,17,1,18,5,30,1,0,1
3837,2014,9,2014-11-08,New Mexico,,Boise State,L (49-60),9,16,56.3,122,0,49,505,10.3,6,65,627,9.6,6,12,0,18,5,50,0,0,0
3838,2014,10,2014-11-15,New Mexico,@,Utah State,L (21-28),8,18,44.4,154,1,49,246,5.0,2,67,400,6.0,6,12,0,18,3,16,0,1,1
3839,2014,11,2014-11-22,New Mexico,@,Colorado State,L (20-58),3,11,27.3,55,0,40,301,7.5,3,51,356,7.0,1,13,1,15,5,58,2,2,4
3840,2014,12,2014-11-29,New Mexico,,Wyoming,W (36-30),6,7,85.7,141,1,32,241,7.5,2,39,382,9.8,2,8,0,10,4,50,1,1,2
3841,2014,,12 Games,New Mexico,,,,76,149,51.0,1059,7,583,3725,6.4,34,732,4784,6.5,41,154,9,204,53,520,12,6,18
3842,2015,1,2015-09-05,New Mexico,,Mississippi Valley State,W (66-0),11,18,61.1,151,0,51,370,7.3,8,69,521,7.6,8,17,1,26,6,55,0,0,0
3843,2015,2,2015-09-12,New Mexico,,Tulsa,L (21-40),11,21,52.4,166,1,47,224,4.8,2,68,390,5.7,0,0,0,18,14,154,1,1,2
3844,2015,3,2015-09-18,New Mexico,@,Arizona State,L (10-34),12,29,41.4,111,0,47,184,3.9,1,76,295,3.9,5,9,1,15,5,35,0,1,1
3845,2015,4,2015-09-26,New Mexico,@,Wyoming,W (38-28),5,8,62.5,107,1,47,302,6.4,4,55,409,7.4,3,12,0,15,6,69,0,0,0
3846,2015,5,2015-10-03,New Mexico,,New Mexico State,W (38-29),5,17,29.4,45,0,61,401,6.6,4,78,446,5.7,2,18,1,21,4,27,1,1,2
3847,2015,6,2015-10-10,New Mexico,@,Nevada,L (17-35),19,24,79.2,138,0,37,135,3.6,1,61,273,4.5,5,9,0,14,5,60,1,1,2
3848,2015,7,2015-10-17,New Mexico,,Hawaii,W (28-27),15,26,57.7,195,2,53,197,3.7,1,79,392,5.0,8,16,4,28,9,64,2,0,2
3849,2015,8,2015-10-24,New Mexico,@,San Jose State,L (21-31),8,20,40.0,130,0,32,205,6.4,3,52,335,6.4,4,9,2,15,3,34,1,1,2
3850,2015,9,2015-11-07,New Mexico,,Utah State,W (14-13),4,12,33.3,104,1,48,132,2.8,1,60,236,3.9,2,8,0,10,7,67,0,1,1
3851,2015,10,2015-11-14,New Mexico,@,Boise State,W (31-24),9,13,69.2,218,0,39,195,5.0,4,52,413,7.9,4,6,1,11,16,135,1,1,2
3852,2015,11,2015-11-21,New Mexico,,Colorado State,L (21-28),4,10,40.0,58,0,50,268,5.4,3,60,326,5.4,3,16,1,20,3,15,0,3,3
3853,2015,12,2015-11-28,New Mexico,,Air Force,W (47-35),4,9,44.4,135,0,56,377,6.7,6,65,512,7.9,4,13,0,17,3,25,0,1,1
3854,2015,13,2015-12-19,New Mexico,N,Arizona*,L (37-45),10,22,45.5,189,1,69,319,4.6,4,91,508,5.6,6,19,0,25,8,103,0,3,3
3855,2015,,13 Games,New Mexico,,,,117,229,51.1,1747,6,637,3309,5.2,42,866,5056,5.8,54,152,11,235,89,843,7,14,21
3856,2016,1,2016-09-01,New Mexico,,South Dakota,W (48-21),13,19,68.4,187,2,49,428,8.7,3,68,615,9.0,9,15,0,24,4,30,1,0,1
3857,2016,2,2016-09-10,New Mexico,@,New Mexico State,L (31-32),12,23,52.2,115,0,45,221,4.9,4,68,336,4.9,7,13,3,23,5,55,1,1,2
3858,2016,3,2016-09-17,New Mexico,@,Rutgers,L (28-37),13,24,54.2,169,1,56,293,5.2,3,80,462,5.8,8,12,1,21,7,65,1,1,2
3859,2016,4,2016-10-01,New Mexico,,San Jose State,W (48-41),4,8,50.0,45,0,64,446,7.0,5,72,491,6.8,2,19,1,22,8,70,0,1,1
3860,2016,5,2016-10-07,New Mexico,,Boise State,L (21-49),4,15,26.7,39,1,61,382,6.3,2,76,421,5.5,2,21,0,23,12,88,0,1,1
3861,2016,6,2016-10-15,New Mexico,N,Air Force,W (45-40),3,8,37.5,70,2,55,373,6.8,4,63,443,7.0,3,14,1,18,3,25,0,0,0
3862,2016,7,2016-10-22,New Mexico,,Louisiana-Monroe,W (59-17),7,11,63.6,146,1,51,476,9.3,5,62,622,10.0,3,18,2,23,7,70,3,0,3
3863,2016,8,2016-10-29,New Mexico,@,Hawaii,W (28-21),11,15,73.3,84,0,40,237,5.9,3,55,321,5.8,4,11,0,15,8,79,0,1,1
3864,2016,9,2016-11-05,New Mexico,,Nevada,W (35-26),8,12,66.7,100,1,64,373,5.8,4,76,473,6.2,5,18,0,23,6,41,1,1,2
3865,2016,10,2016-11-12,New Mexico,@,Utah State,W (24-21),8,17,47.1,154,0,57,249,4.4,2,74,403,5.4,5,16,1,22,6,64,0,0,0
3866,2016,11,2016-11-19,New Mexico,@,Colorado State,L (31-49),6,16,37.5,81,2,48,285,5.9,2,64,366,5.7,5,13,1,19,8,68,0,0,0
3867,2016,12,2016-11-26,New Mexico,,Wyoming,W (56-35),4,5,80.0,122,1,46,568,12.3,7,51,690,13.5,4,17,0,21,6,52,1,0,1
3868,2016,13,2016-12-17,New Mexico,N,Texas-San Antonio*,W (23-20),3,6,50.0,77,0,52,219,4.2,3,58,296,5.1,3,13,1,17,2,30,0,0,0
3869,2016,,13 Games,New Mexico,,,,96,179,53.6,1389,11,688,4550,6.6,47,867,5939,6.9,60,200,11,271,82,737,8,6,14
3870,2017,1,2017-09-02,New Mexico,,Abilene Christian,W (38-14),12,18,66.7,222,1,40,259,6.5,3,58,481,8.3,9,10,2,21,4,29,2,0,2
3871,2017,2,2017-09-09,New Mexico,,New Mexico State,L (28-30),20,38,52.6,254,2,37,176,4.8,1,75,430,5.7,11,7,3,21,13,104,2,2,4
3872,2017,3,2017-09-14,New Mexico,@,Boise State,L (14-28),8,16,50.0,79,1,51,198,3.9,1,67,277,4.1,6,10,2,18,1,5,1,1,2
3873,2017,4,2017-09-23,New Mexico,@,Tulsa,W (16-13),9,14,64.3,108,0,59,338,5.7,1,73,446,6.1,6,15,4,25,6,49,2,1,3
3874,2017,5,2017-09-30,New Mexico,,Air Force,W (56-38),4,9,44.4,146,2,41,363,8.9,6,50,509,10.2,3,12,1,16,7,65,0,0,0
3875,2017,6,2017-10-14,New Mexico,@,Fresno State,L (0-38),15,30,50.0,213,0,37,109,2.9,0,67,322,4.8,8,6,0,14,3,35,1,1,2
3876,2017,7,2017-10-20,New Mexico,,Colorado State,L (24-27),7,19,36.8,132,1,47,320,6.8,2,66,452,6.8,4,13,4,21,12,105,1,0,1
3877,2017,8,2017-10-28,New Mexico,@,Wyoming,L (3-42),10,25,40.0,69,0,40,115,2.9,0,65,184,2.8,3,9,1,13,6,55,2,5,7
3878,2017,9,2017-11-04,New Mexico,,Utah State,L (10-24),12,22,54.5,75,0,57,265,4.6,1,79,340,4.3,3,17,1,21,9,63,4,0,4
3879,2017,10,2017-11-11,New Mexico,@,Texas A&M,L (14-55),7,17,41.2,24,0,42,120,2.9,1,59,144,2.4,0,8,3,11,2,19,0,1,1
3880,2017,11,2017-11-17,New Mexico,,Nevada-Las Vegas,L (35-38),0,4,0.0,0,0,56,482,8.6,5,60,482,8.0,0,19,0,19,5,49,0,1,1
3881,2017,12,2017-11-24,New Mexico,@,San Diego State,L (10-35),16,30,53.3,167,1,34,82,2.4,0,64,249,3.9,6,4,1,11,5,35,0,2,2
3882,2017,,12 Games,New Mexico,,,,120,242,49.6,1489,8,541,2827,5.2,21,783,4316,5.5,59,130,22,211,73,613,15,14,29
3883,2014,1,2014-08-28,New Mexico State,,Cal Poly,W (28-10),18,27,66.7,118,2,47,197,4.2,2,74,315,4.3,8,12,1,21,3,50,0,1,1
3884,2014,2,2014-09-06,New Mexico State,@,Georgia State,W (34-31),25,44,56.8,241,3,41,194,4.7,0,85,435,5.1,13,11,2,26,5,38,2,1,3
3885,2014,3,2014-09-13,New Mexico State,@,Texas-El Paso,L (24-42),23,41,56.1,335,2,21,90,4.3,1,62,425,6.9,13,6,1,20,4,17,0,2,2
3886,2014,4,2014-09-20,New Mexico State,,New Mexico,L (35-38),32,47,68.1,333,2,45,174,3.9,3,92,507,5.5,15,12,2,29,5,44,0,2,2
3887,2014,5,2014-09-27,New Mexico State,@,Louisiana State,L (7-63),16,33,48.5,102,0,37,172,4.6,1,70,274,3.9,5,7,1,13,5,35,2,2,4
3888,2014,6,2014-10-04,New Mexico State,,Georgia Southern,L (28-36),35,50,70.0,334,0,42,183,4.4,4,92,517,5.6,16,13,1,30,2,10,1,3,4
3889,2014,7,2014-10-11,New Mexico State,@,Troy,L (24-41),22,33,66.7,272,2,38,123,3.2,1,71,395,5.6,14,6,0,20,1,12,2,2,4
3890,2014,8,2014-10-18,New Mexico State,@,Idaho,L (17-29),9,16,56.3,100,0,34,214,6.3,2,50,314,6.3,5,4,2,11,7,39,1,3,4
3891,2014,9,2014-11-01,New Mexico State,,Texas State,L (29-37),36,52,69.2,404,3,48,235,4.9,1,100,639,6.4,17,15,0,32,11,76,0,2,2
3892,2014,10,2014-11-08,New Mexico State,,Louisiana,L (16-44),19,34,55.9,204,1,33,103,3.1,1,67,307,4.6,8,6,0,14,1,5,1,3,4
3893,2014,11,2014-11-22,New Mexico State,,Louisiana-Monroe,L (17-30),15,32,46.9,102,0,51,276,5.4,2,83,378,4.6,6,11,2,19,3,21,1,1,2
3894,2014,12,2014-11-29,New Mexico State,@,Arkansas State,L (35-68),28,43,65.1,314,4,34,178,5.2,1,77,492,6.4,14,5,3,22,10,80,0,2,2
3895,2014,,12 Games,New Mexico State,,,,278,452,61.5,2859,19,471,2139,4.5,19,923,4998,5.4,134,108,15,257,57,427,10,24,34
3896,2015,1,2015-09-05,New Mexico State,@,Florida,L (13-61),14,28,50.0,128,1,23,72,3.1,1,51,200,3.9,4,4,0,8,1,9,0,1,1
3897,2015,2,2015-09-12,New Mexico State,,Georgia State,L (32-34),31,55,56.4,445,3,23,84,3.7,1,78,529,6.8,17,6,3,26,7,129,0,1,1
3898,2015,3,2015-09-19,New Mexico State,,Texas-El Paso,L (47-50),14,28,50.0,285,3,35,266,7.6,2,63,551,8.7,8,11,2,21,13,149,0,1,1
3899,2015,4,2015-10-03,New Mexico State,@,New Mexico,L (29-38),12,28,42.9,108,0,39,308,7.9,3,67,416,6.2,2,11,1,14,7,39,1,2,3
3900,2015,5,2015-10-10,New Mexico State,@,Mississippi,L (3-52),22,37,59.5,141,0,37,98,2.6,0,74,239,3.2,7,10,1,18,3,35,0,2,2
3901,2015,6,2015-10-17,New Mexico State,@,Georgia Southern,L (26-56),20,37,54.1,253,3,29,133,4.6,0,66,386,5.8,9,7,3,19,4,40,0,1,1
3902,2015,7,2015-10-24,New Mexico State,,Troy,L (7-52),13,34,38.2,161,1,47,231,4.9,0,81,392,4.8,6,14,0,20,8,82,2,0,2
3903,2015,8,2015-10-31,New Mexico State,,Idaho,W (55-48),24,40,60.0,326,3,41,315,7.7,5,81,641,7.9,10,14,0,24,6,47,1,1,2
3904,2015,9,2015-11-07,New Mexico State,@,Texas State,W (31-21),24,45,53.3,297,2,48,230,4.8,2,93,527,5.7,11,12,3,26,5,37,0,0,0
3905,2015,10,2015-11-21,New Mexico State,@,Louisiana,W (37-34),16,42,38.1,261,4,46,237,5.2,0,88,498,5.7,12,12,3,27,3,30,0,0,0
3906,2015,11,2015-11-28,New Mexico State,,Arkansas State,L (28-52),26,41,63.4,315,4,25,119,4.8,0,66,434,6.6,13,4,3,20,9,86,1,3,4
3907,2015,12,2015-12-05,New Mexico State,@,Louisiana-Monroe,L (35-42),23,36,63.9,308,2,52,89,1.7,2,88,397,4.5,10,7,1,18,10,100,2,2,4
3908,2015,,12 Games,New Mexico State,,,,239,451,53.0,3028,26,445,2182,4.9,16,896,5210,5.8,109,112,20,241,76,783,7,14,21
3909,2016,1,2016-09-03,New Mexico State,@,Texas-El Paso,L (22-38),17,41,41.5,206,0,30,139,4.6,2,71,345,4.9,8,9,2,19,7,40,0,0,0
3910,2016,2,2016-09-10,New Mexico State,,New Mexico,W (32-31),21,35,60.0,205,2,35,102,2.9,1,70,307,4.4,10,8,4,22,7,75,0,0,0
3911,2016,3,2016-09-17,New Mexico State,@,Kentucky,L (42-62),17,34,50.0,277,3,45,223,5.0,3,79,500,6.3,12,12,2,26,5,33,0,2,2
3912,2016,4,2016-09-24,New Mexico State,@,Troy,L (6-52),29,54,53.7,445,1,33,94,2.8,0,87,539,6.2,18,6,1,25,5,45,0,5,5
3913,2016,5,2016-10-01,New Mexico State,,Louisiana,W (37-31),31,49,63.3,354,2,42,145,3.5,1,91,499,5.5,16,12,3,31,9,43,0,2,2
3914,2016,6,2016-10-15,New Mexico State,@,Idaho,L (23-55),23,36,63.9,366,3,29,62,2.1,0,65,428,6.6,10,7,0,17,6,64,2,0,2
3915,2016,7,2016-10-22,New Mexico State,,Georgia Southern,L (19-22),22,39,56.4,250,2,40,168,4.2,0,79,418,5.3,11,11,4,26,6,57,2,1,3
3916,2016,8,2016-10-29,New Mexico State,@,Texas A&M,L (10-52),21,38,55.3,147,1,39,169,4.3,0,77,316,4.1,6,8,4,18,5,30,0,0,0
3917,2016,9,2016-11-12,New Mexico State,@,Arkansas State,L (22-41),26,45,57.8,256,1,40,182,4.6,1,85,438,5.2,11,13,1,25,9,86,1,1,2
3918,2016,10,2016-11-19,New Mexico State,,Texas State,W (50-10),23,38,60.5,231,5,44,252,5.7,1,82,483,5.9,8,15,3,26,10,121,1,0,1
3919,2016,11,2016-11-26,New Mexico State,,Appalachian State,L (7-37),12,27,44.4,92,1,27,143,5.3,0,54,235,4.4,3,6,1,10,2,15,0,2,2
3920,2016,12,2016-12-03,New Mexico State,@,South Alabama,L (28-35),11,25,44.0,110,1,48,353,7.4,3,73,463,6.3,7,12,2,21,5,57,1,2,3
3921,2016,,12 Games,New Mexico State,,,,253,461,54.9,2939,22,452,2032,4.5,12,913,4971,5.4,120,119,27,266,76,666,7,15,22
3922,2017,1,2017-08-31,New Mexico State,@,Arizona State,L (31-37),40,58,69.0,398,3,30,151,5.0,2,88,549,6.2,18,9,0,27,6,59,0,2,2
3923,2017,2,2017-09-09,New Mexico State,@,New Mexico,W (30-28),34,57,59.6,401,4,25,104,4.2,0,82,505,6.2,17,5,1,23,10,82,1,1,2
3924,2017,3,2017-09-16,New Mexico State,,Troy,L (24-27),32,45,71.1,331,3,16,75,4.7,0,61,406,6.7,14,4,0,18,6,66,0,0,0
3925,2017,4,2017-09-23,New Mexico State,,Texas-El Paso,W (41-14),26,43,60.5,283,2,27,183,6.8,3,70,466,6.7,12,7,2,21,11,103,1,1,2
3926,2017,5,2017-09-30,New Mexico State,@,Arkansas,L (24-42),23,38,60.5,344,2,14,11,0.8,1,52,355,6.8,15,2,1,18,6,29,1,1,2
3927,2017,6,2017-10-07,New Mexico State,@,Appalachian State,L (31-45),27,50,54.0,356,2,42,176,4.2,2,92,532,5.8,13,13,2,28,10,57,0,6,6
3928,2017,7,2017-10-14,New Mexico State,@,Georgia Southern,W (35-27),32,52,61.5,399,4,26,92,3.5,1,78,491,6.3,16,5,4,25,2,15,0,2,2
3929,2017,8,2017-10-28,New Mexico State,,Arkansas State,L (21-37),20,40,50.0,221,1,32,35,1.1,2,72,256,3.6,7,4,2,13,4,39,0,2,2
3930,2017,9,2017-11-04,New Mexico State,@,Texas State,W (45-35),31,49,63.3,503,4,33,119,3.6,2,82,622,7.6,19,6,1,26,8,55,2,0,2
3931,2017,10,2017-11-18,New Mexico State,@,Louisiana,L (34-47),32,44,72.7,313,1,19,89,4.7,2,63,402,6.4,17,6,3,26,6,49,0,3,3
3932,2017,11,2017-11-25,New Mexico State,,Idaho,W (17-10),31,49,63.3,231,0,37,172,4.6,2,86,403,4.7,11,12,0,23,6,60,1,1,2
3933,2017,12,2017-12-02,New Mexico State,,South Alabama,W (22-17),40,61,65.6,451,2,23,40,1.7,0,84,491,5.8,23,3,0,26,9,55,0,1,1
3934,2017,13,2017-12-29,New Mexico State,N,Utah State*,W (26-20),29,54,53.7,191,1,29,184,6.3,1,83,375,4.5,9,6,1,16,4,45,1,2,3
3935,2017,,13 Games,New Mexico State,,,,397,640,62.0,4422,29,353,1431,4.1,18,993,5853,5.9,191,82,17,290,88,714,7,22,29
3936,2014,1,2014-08-30,North Carolina,,Liberty,W (56-29),29,45,64.4,235,3,48,208,4.3,4,93,443,4.8,14,13,2,29,10,60,1,3,4
3937,2014,2,2014-09-06,North Carolina,,San Diego State,W (31-27),21,31,67.7,263,2,33,131,4.0,1,64,394,6.2,11,8,1,20,5,37,0,1,1
3938,2014,3,2014-09-20,North Carolina,@,East Carolina,L (41-70),24,43,55.8,294,3,39,145,3.7,2,82,439,5.4,14,8,1,23,8,85,0,1,1
3939,2014,4,2014-09-27,North Carolina,@,Clemson,L (35-50),30,49,61.2,394,4,30,84,2.8,1,79,478,6.1,13,8,1,22,15,130,0,1,1
3940,2014,5,2014-10-04,North Carolina,,Virginia Tech,L (17-34),18,37,48.6,198,1,29,125,4.3,1,66,323,4.9,8,8,0,16,10,62,2,1,3
3941,2014,6,2014-10-11,North Carolina,@,Notre Dame,L (43-50),25,42,59.5,326,3,42,190,4.5,2,84,516,6.1,17,10,3,30,9,94,1,1,2
3942,2014,7,2014-10-18,North Carolina,,Georgia Tech,W (48-43),38,47,80.9,390,4,41,189,4.6,3,88,579,6.6,19,12,0,31,4,35,0,1,1
3943,2014,8,2014-10-25,North Carolina,@,Virginia,W (28-27),16,29,55.2,275,3,34,99,2.9,1,63,374,5.9,8,6,6,20,6,45,0,1,1
3944,2014,9,2014-11-01,North Carolina,@,Miami (FL),L (20-47),24,38,63.2,247,0,32,11,0.3,2,70,258,3.7,8,5,4,17,5,28,1,1,2
3945,2014,10,2014-11-15,North Carolina,,Pittsburgh,W (40-35),23,40,57.5,276,1,43,226,5.3,5,83,502,6.0,14,14,2,30,6,41,0,0,0
3946,2014,11,2014-11-20,North Carolina,@,Duke,W (45-20),18,27,66.7,276,2,57,316,5.5,3,84,592,7.0,11,15,2,28,9,85,3,0,3
3947,2014,12,2014-11-29,North Carolina,,North Carolina State,L (7-35),17,35,48.6,177,1,28,30,1.1,0,63,207,3.3,8,6,4,18,6,49,0,2,2
3948,2014,13,2014-12-26,North Carolina,N,Rutgers*,L (21-40),32,46,69.6,263,2,40,219,5.5,1,86,482,5.6,12,15,0,25,6,70,2,0,2
3949,2014,,13 Games,North Carolina,,,,315,509,61.9,3614,29,496,1973,4.0,26,1005,5587,5.6,157,128,26,309,99,821,10,13,23
3950,2015,1,2015-09-03,North Carolina,N,South Carolina,L (13-17),19,31,61.3,232,1,32,208,6.5,0,63,440,7.0,11,8,1,20,6,30,0,3,3
3951,2015,2,2015-09-12,North Carolina,,North Carolina A&T,W (53-14),20,27,74.1,248,3,44,215,4.9,4,71,463,6.5,14,10,0,24,5,50,0,0,0
3952,2015,3,2015-09-19,North Carolina,,Illinois,W (48-14),19,26,73.1,217,3,37,254,6.9,2,63,471,7.5,10,10,3,23,6,51,0,1,1
3953,2015,4,2015-09-26,North Carolina,,Delaware,W (41-14),23,33,69.7,377,4,35,191,5.5,1,68,568,8.4,14,11,4,29,2,20,1,0,1
3954,2015,5,2015-10-03,North Carolina,@,Georgia Tech,W (38-31),15,26,57.7,182,1,31,231,7.5,4,57,413,7.2,8,11,2,21,6,42,0,0,0
3955,2015,6,2015-10-17,North Carolina,,Wake Forest,W (50-14),18,26,69.2,326,3,33,212,6.4,4,59,538,9.1,11,10,1,22,6,44,0,2,2
3956,2015,7,2015-10-24,North Carolina,,Virginia,W (26-13),21,26,80.8,226,0,38,196,5.2,3,64,422,6.6,12,11,1,24,13,135,1,1,2
3957,2015,8,2015-10-29,North Carolina,@,Pittsburgh,W (26-19),14,23,60.9,270,2,35,174,5.0,0,58,444,7.7,8,8,1,17,3,15,0,0,0
3958,2015,9,2015-11-07,North Carolina,,Duke,W (66-31),28,40,70.0,537,4,40,167,4.2,5,80,704,8.8,17,9,3,29,5,39,0,0,0
3959,2015,10,2015-11-14,North Carolina,,Miami (FL),W (59-21),16,22,72.7,189,1,46,298,6.5,6,68,487,7.2,10,15,5,30,5,56,0,0,0
3960,2015,11,2015-11-21,North Carolina,@,Virginia Tech,W (30-27),13,26,50.0,205,1,47,240,5.1,3,73,445,6.1,9,12,1,22,9,60,3,0,3
3961,2015,12,2015-11-28,North Carolina,@,North Carolina State,W (45-34),20,31,64.5,179,2,41,374,9.1,4,72,553,7.7,9,14,2,25,3,30,2,1,3
3962,2015,13,2015-12-05,North Carolina,N,Clemson,L (37-45),12,35,34.3,240,3,32,142,4.4,2,67,382,5.7,10,7,4,21,6,44,1,1,2
3963,2015,14,2015-12-29,North Carolina,N,Baylor*,L (38-49),22,36,61.1,243,3,36,244,6.8,2,72,487,6.8,15,10,3,28,5,34,1,1,2
3964,2015,,14 Games,North Carolina,,,,260,408,63.7,3671,31,527,3146,6.0,40,935,6817,7.3,158,146,31,335,80,650,9,10,19
3965,2016,1,2016-09-03,North Carolina,N,Georgia,L (24-33),24,40,60.0,156,0,19,159,8.4,2,59,315,5.3,10,6,0,16,13,101,0,0,0
3966,2016,2,2016-09-10,North Carolina,@,Illinois,W (48-23),19,25,76.0,265,2,37,197,5.3,4,62,462,7.5,12,6,3,21,6,46,1,0,1
3967,2016,3,2016-09-17,North Carolina,,James Madison,W (56-28),29,33,87.9,462,3,32,173,5.4,5,65,635,9.8,18,9,3,30,10,110,1,0,1
3968,2016,4,2016-09-24,North Carolina,,Pittsburgh,W (37-36),35,46,76.1,453,5,22,18,0.8,0,68,471,6.9,18,3,1,22,5,41,1,0,1
3969,2016,5,2016-10-01,North Carolina,@,Florida State,W (37-35),31,38,81.6,405,3,32,133,4.2,2,70,538,7.7,18,8,2,28,6,49,1,0,1
3970,2016,6,2016-10-08,North Carolina,,Virginia Tech,L (3-34),13,33,39.4,58,0,29,73,2.5,0,62,131,2.1,4,3,1,8,8,49,2,2,4
3971,2016,7,2016-10-15,North Carolina,@,Miami (FL),W (20-13),33,46,71.7,299,2,43,162,3.8,0,89,461,5.2,11,12,0,23,11,70,0,0,0
3972,2016,8,2016-10-22,North Carolina,@,Virginia,W (35-14),24,31,77.4,310,3,36,178,4.9,2,67,488,7.3,15,9,1,25,7,60,2,0,2
3973,2016,9,2016-11-05,North Carolina,,Georgia Tech,W (48-20),23,35,65.7,353,1,35,283,8.1,5,70,636,9.1,16,10,0,26,6,45,0,0,0
3974,2016,10,2016-11-10,North Carolina,@,Duke,L (27-28),24,33,72.7,297,3,27,106,3.9,0,60,403,6.7,13,8,2,23,7,65,0,2,2
3975,2016,11,2016-11-19,North Carolina,,Citadel,W (41-7),12,21,57.1,193,3,26,163,6.3,0,47,356,7.6,6,8,1,15,6,61,0,0,0
3976,2016,12,2016-11-25,North Carolina,,North Carolina State,L (21-28),23,39,59.0,280,3,26,133,5.1,0,65,413,6.4,12,6,2,20,7,50,1,0,1
3977,2016,13,2016-12-30,North Carolina,N,Stanford*,L (23-25),23,39,59.0,280,2,37,118,3.2,1,76,398,5.2,15,8,3,26,7,50,1,2,3
3978,2016,,13 Games,North Carolina,,,,313,459,68.2,3811,30,401,1896,4.7,21,860,5707,6.6,168,96,19,283,99,797,10,6,16
3979,2017,1,2017-09-02,North Carolina,,California,L (30-35),25,44,56.8,221,1,45,219,4.9,3,89,440,4.9,16,10,2,28,7,50,1,2,3
3980,2017,2,2017-09-09,North Carolina,,Louisville,L (35-47),29,38,76.3,384,3,23,17,0.7,1,61,401,6.6,18,0,2,20,5,50,0,0,0
3981,2017,3,2017-09-16,North Carolina,@,Old Dominion,W (53-23),16,26,61.5,259,1,50,252,5.0,6,76,511,6.7,9,14,2,25,9,110,1,0,1
3982,2017,4,2017-09-23,North Carolina,,Duke,L (17-27),17,32,53.1,259,1,33,118,3.6,1,65,377,5.8,10,5,0,15,6,65,0,1,1
3983,2017,5,2017-09-30,North Carolina,@,Georgia Tech,L (7-33),18,32,56.3,141,0,26,106,4.1,1,58,247,4.3,7,4,0,11,6,60,0,2,2
3984,2017,6,2017-10-07,North Carolina,,Notre Dame,L (10-33),19,42,45.2,179,1,28,86,3.1,0,70,265,3.8,6,6,1,13,10,104,2,1,3
3985,2017,7,2017-10-14,North Carolina,,Virginia,L (14-20),7,18,38.9,46,0,35,211,6.0,2,53,257,4.8,4,7,1,12,6,52,0,3,3
3986,2017,8,2017-10-21,North Carolina,@,Virginia Tech,L (7-59),8,22,36.4,118,1,42,54,1.3,0,64,172,2.7,5,5,1,11,14,100,1,2,3
3987,2017,9,2017-10-28,North Carolina,,Miami (FL),L (19-24),20,46,43.5,252,2,46,176,3.8,0,92,428,4.7,12,12,3,27,7,56,1,3,4
3988,2017,10,2017-11-09,North Carolina,@,Pittsburgh,W (34-31),21,32,65.6,270,3,32,96,3.0,0,64,366,5.7,15,5,1,21,7,65,0,0,0
3989,2017,11,2017-11-18,North Carolina,,Western Carolina,W (65-10),20,30,66.7,298,5,43,313,7.3,3,73,611,8.4,13,17,1,31,4,33,0,0,0
3990,2017,12,2017-11-25,North Carolina,@,North Carolina State,L (21-33),21,45,46.7,277,3,24,83,3.5,0,69,360,5.2,14,4,4,22,12,127,0,2,2
3991,2017,,12 Games,North Carolina,,,,221,407,54.3,2704,21,427,1731,4.1,17,834,4435,5.3,129,89,18,236,93,872,6,16,22
3992,2014,1,2014-08-30,North Carolina State,,Georgia Southern,W (24-23),28,40,70.0,291,3,35,173,4.9,0,75,464,6.2,14,10,2,26,4,20,0,1,1
3993,2014,2,2014-09-06,North Carolina State,,Old Dominion,W (46-34),21,29,72.4,253,2,39,242,6.2,4,68,495,7.3,14,14,0,28,1,5,0,0,0
3994,2014,3,2014-09-13,North Carolina State,@,South Florida,W (49-17),21,33,63.6,274,2,53,315,5.9,5,86,589,6.8,15,15,0,30,5,38,1,1,2
3995,2014,4,2014-09-20,North Carolina State,,Presbyterian,W (42-0),14,22,63.6,195,3,31,265,8.5,3,53,460,8.7,7,11,3,21,7,70,0,0,0
3996,2014,5,2014-09-27,North Carolina State,,Florida State,L (41-56),32,50,64.0,359,3,37,161,4.4,2,87,520,6.0,15,13,1,29,8,83,2,0,2
3997,2014,6,2014-10-04,North Carolina State,@,Clemson,L (0-41),4,19,21.1,35,0,38,119,3.1,0,57,154,2.7,1,8,3,12,5,45,3,0,3
3998,2014,7,2014-10-11,North Carolina State,,Boston College,L (14-30),14,30,46.7,174,1,28,43,1.5,1,58,217,3.7,8,5,0,13,2,20,1,1,2
3999,2014,8,2014-10-18,North Carolina State,@,Louisville,L (18-30),18,32,56.3,223,2,31,128,4.1,0,63,351,5.6,9,8,3,20,2,20,0,1,1
4000,2014,9,2014-11-01,North Carolina State,@,Syracuse,W (24-17),20,33,60.6,186,1,35,121,3.5,0,68,307,4.5,8,5,1,14,9,80,0,0,0
4001,2014,10,2014-11-08,North Carolina State,,Georgia Tech,L (23-56),18,35,51.4,213,1,28,155,5.5,2,63,368,5.8,13,9,1,23,6,52,1,2,3
4002,2014,11,2014-11-15,North Carolina State,,Wake Forest,W (42-13),8,19,42.1,83,1,46,362,7.9,5,65,445,6.8,4,14,2,20,2,10,0,0,0
4003,2014,12,2014-11-29,North Carolina State,@,North Carolina,W (35-7),9,11,81.8,66,3,58,388,6.7,2,69,454,6.6,3,15,2,20,6,81,0,0,0
4004,2014,13,2014-12-26,North Carolina State,N,Central Florida*,W (34-27),17,28,60.7,300,2,49,187,3.8,2,77,487,6.3,11,13,2,26,6,34,1,0,1
4005,2014,,13 Games,North Carolina State,,,,224,381,58.8,2652,24,508,2659,5.2,26,889,5311,6.0,122,140,20,282,63,558,9,6,15
4006,2015,1,2015-09-05,North Carolina State,,Troy,W (49-21),22,26,84.6,199,2,58,251,4.3,5,84,450,5.4,12,15,3,30,1,15,0,0,0
4007,2015,2,2015-09-12,North Carolina State,,Eastern Kentucky,W (35-0),21,30,70.0,244,1,48,199,4.1,4,78,443,5.7,13,10,1,24,7,56,1,0,1
4008,2015,3,2015-09-19,North Carolina State,@,Old Dominion,W (38-14),18,27,66.7,179,1,52,256,4.9,4,79,435,5.5,10,16,0,26,2,26,0,0,0
4009,2015,4,2015-09-26,North Carolina State,@,South Alabama,W (63-13),21,27,77.8,256,2,41,330,8.0,7,68,586,8.6,11,15,0,26,4,44,0,0,0
4010,2015,5,2015-10-03,North Carolina State,,Louisville,L (13-20),16,28,57.1,183,1,30,45,1.5,1,58,228,3.9,6,3,2,11,4,50,2,0,2
4011,2015,6,2015-10-09,North Carolina State,@,Virginia Tech,L (13-28),12,25,48.0,113,1,40,157,3.9,0,65,270,4.2,7,9,1,17,9,81,0,1,1
4012,2015,7,2015-10-24,North Carolina State,@,Wake Forest,W (35-17),20,34,58.8,227,2,30,248,8.3,2,64,475,7.4,8,9,2,19,6,46,0,0,0
4013,2015,8,2015-10-31,North Carolina State,,Clemson,L (41-56),24,41,58.5,254,3,27,135,5.0,2,68,389,5.7,13,4,1,18,4,40,1,0,1
4014,2015,9,2015-11-07,North Carolina State,@,Boston College,W (24-8),14,27,51.9,212,1,33,139,4.2,2,60,351,5.9,6,5,1,12,5,50,1,1,2
4015,2015,10,2015-11-14,North Carolina State,@,Florida State,L (17-34),28,49,57.1,218,1,31,79,2.5,1,80,297,3.7,15,5,1,21,9,59,1,0,1
4016,2015,11,2015-11-21,North Carolina State,,Syracuse,W (42-29),21,34,61.8,235,2,47,276,5.9,3,81,511,6.3,13,14,0,27,10,98,1,1,2
4017,2015,12,2015-11-28,North Carolina State,,North Carolina,L (34-45),17,37,45.9,206,2,52,308,5.9,2,89,514,5.8,9,18,1,28,7,72,0,1,1
4018,2015,13,2015-12-30,North Carolina State,N,Mississippi State*,L (28-51),12,28,42.9,214,1,51,210,4.1,3,79,424,5.4,8,10,2,20,4,50,0,2,2
4019,2015,,13 Games,North Carolina State,,,,246,413,59.6,2740,20,540,2633,4.9,36,953,5373,5.6,131,133,15,279,72,687,7,6,13
4020,2016,1,2016-09-01,North Carolina State,,William & Mary,W (48-14),23,30,76.7,262,2,57,259,4.5,5,87,521,6.0,13,14,1,28,7,80,0,1,1
4021,2016,2,2016-09-10,North Carolina State,@,East Carolina,L (30-33),21,32,65.6,287,1,31,215,6.9,3,63,502,8.0,10,8,1,19,8,54,1,0,1
4022,2016,3,2016-09-17,North Carolina State,,Old Dominion,W (49-22),27,32,84.4,316,4,39,158,4.1,3,71,474,6.7,18,8,2,28,2,24,1,0,1
4023,2016,4,2016-10-01,North Carolina State,,Wake Forest,W (33-16),24,37,64.9,327,3,39,200,5.1,1,76,527,6.9,16,10,2,28,13,144,0,0,0
4024,2016,5,2016-10-08,North Carolina State,,Notre Dame,W (10-3),7,14,50.0,41,0,51,157,3.1,0,65,198,3.0,2,11,1,14,2,20,2,0,2
4025,2016,6,2016-10-15,North Carolina State,@,Clemson,L (17-24),21,42,50.0,269,0,32,128,4.0,1,74,397,5.4,12,9,2,23,13,120,0,2,2
4026,2016,7,2016-10-22,North Carolina State,@,Louisville,L (13-54),16,36,44.4,236,2,25,14,0.6,0,61,250,4.1,8,0,1,9,6,65,0,3,3
4027,2016,8,2016-10-29,North Carolina State,,Boston College,L (14-21),23,41,56.1,307,2,23,31,1.3,0,64,338,5.3,10,2,2,14,8,94,1,2,3
4028,2016,9,2016-11-05,North Carolina State,,Florida State,L (20-24),25,41,61.0,304,1,41,165,4.0,1,82,469,5.7,19,8,4,31,3,28,0,1,1
4029,2016,10,2016-11-12,North Carolina State,@,Syracuse,W (35-20),23,34,67.6,360,1,48,184,3.8,4,82,544,6.6,14,12,1,27,6,66,0,2,2
4030,2016,11,2016-11-19,North Carolina State,,Miami (FL),L (13-27),20,44,45.5,210,0,29,119,4.1,1,73,329,4.5,9,8,1,18,4,51,1,1,2
4031,2016,12,2016-11-25,North Carolina State,@,North Carolina,W (28-21),14,24,58.3,233,1,53,259,4.9,3,77,492,6.4,9,15,0,24,5,59,1,0,1
4032,2016,13,2016-12-26,North Carolina State,N,Vanderbilt*,W (41-17),19,31,61.3,235,3,36,141,3.9,1,67,376,5.6,14,5,2,21,1,5,1,0,1
4033,2016,,13 Games,North Carolina State,,,,263,438,60.0,3387,20,504,2030,4.0,23,942,5417,5.8,154,110,20,284,78,810,8,12,20
4034,2017,1,2017-09-02,North Carolina State,N,South Carolina,L (28-35),45,64,70.3,415,2,35,89,2.5,2,99,504,5.1,21,7,1,29,8,65,2,0,2
4035,2017,2,2017-09-09,North Carolina State,,Marshall,W (37-20),29,36,80.6,341,3,33,144,4.4,2,69,485,7.0,14,7,2,23,3,33,0,0,0
4036,2017,3,2017-09-16,North Carolina State,,Furman,W (49-16),24,30,80.0,248,1,39,242,6.2,5,69,490,7.1,12,13,0,25,5,50,0,0,0
4037,2017,4,2017-09-23,North Carolina State,@,Florida State,W (27-21),23,33,69.7,255,2,37,110,3.0,1,70,365,5.2,11,6,4,21,6,41,0,0,0
4038,2017,5,2017-09-30,North Carolina State,,Syracuse,W (33-25),21,34,61.8,206,1,47,256,5.4,3,81,462,5.7,11,15,3,29,6,49,0,0,0
4039,2017,6,2017-10-05,North Carolina State,,Louisville,W (39-25),20,32,62.5,367,1,39,153,3.9,3,71,520,7.3,14,7,2,23,6,50,1,0,1
4040,2017,7,2017-10-14,North Carolina State,@,Pittsburgh,W (35-17),14,25,56.0,198,1,38,248,6.5,3,63,446,7.1,10,8,0,18,3,39,0,0,0
4041,2017,8,2017-10-28,North Carolina State,@,Notre Dame,L (14-35),17,37,45.9,213,1,24,50,2.1,0,61,263,4.3,9,4,1,14,12,89,0,1,1
4042,2017,9,2017-11-04,North Carolina State,,Clemson,L (31-38),31,50,62.0,338,3,34,153,4.5,1,84,491,5.8,14,12,1,27,6,69,0,2,2
4043,2017,10,2017-11-11,North Carolina State,@,Boston College,W (17-14),13,32,40.6,146,0,41,221,5.4,2,73,367,5.0,9,8,0,17,2,10,1,1,2
4044,2017,11,2017-11-18,North Carolina State,@,Wake Forest,L (24-30),34,52,65.4,327,1,42,175,4.2,2,94,502,5.3,16,10,2,28,5,64,2,1,3
4045,2017,12,2017-11-25,North Carolina State,,North Carolina,W (33-21),20,30,66.7,204,0,45,292,6.5,5,75,496,6.6,8,12,5,25,11,108,0,1,1
4046,2017,13,2017-12-29,North Carolina State,N,Arizona State*,W (52-31),24,29,82.8,318,1,41,169,4.1,6,70,487,7.0,13,10,1,24,5,54,1,0,1
4047,2017,,13 Games,North Carolina State,,,,315,484,65.1,3576,17,495,2302,4.7,35,979,5878,6.0,162,119,22,303,78,721,7,6,13
4048,2014,1,2014-08-30,North Texas,@,Texas,L (7-38),3,17,17.6,15,0,43,79,1.8,0,60,94,1.6,0,6,2,8,6,56,0,4,4
4049,2014,2,2014-09-06,North Texas,,Southern Methodist,W (43-6),12,17,70.6,108,0,55,245,4.5,3,72,353,4.9,6,11,0,17,15,166,0,0,0
4050,2014,3,2014-09-11,North Texas,,Louisiana Tech,L (21-42),18,34,52.9,175,0,36,104,2.9,3,70,279,4.0,7,7,4,18,9,90,2,0,2
4051,2014,4,2014-09-20,North Texas,,Nicholls State,W (77-3),13,17,76.5,202,3,38,324,8.5,5,55,526,9.6,7,13,0,20,5,40,1,0,1
4052,2014,5,2014-10-04,North Texas,@,Indiana,L (24-49),18,34,52.9,205,3,35,143,4.1,0,69,348,5.0,9,12,1,22,2,10,0,2,2
4053,2014,6,2014-10-11,North Texas,@,Alabama-Birmingham,L (21-56),20,36,55.6,291,2,43,160,3.7,1,79,451,5.7,12,12,0,24,3,30,3,2,5
4054,2014,7,2014-10-18,North Texas,,Southern Mississippi,L (20-30),20,35,57.1,287,0,26,108,4.2,2,61,395,6.5,11,6,4,21,4,55,0,0,0
4055,2014,8,2014-10-25,North Texas,@,Rice,L (21-41),16,34,47.1,190,1,33,26,0.8,1,67,216,3.2,7,6,3,16,4,40,1,1,2
4056,2014,9,2014-11-08,North Texas,,Florida Atlantic,W (31-10),13,17,76.5,107,1,52,235,4.5,3,69,342,5.0,5,13,1,19,3,35,1,1,2
4057,2014,10,2014-11-15,North Texas,@,Texas-El Paso,L (17-35),15,27,55.6,101,1,30,100,3.3,1,57,201,3.5,6,4,3,13,5,25,0,1,1
4058,2014,11,2014-11-22,North Texas,,Florida International,W (17-14),9,20,45.0,105,1,44,161,3.7,1,64,266,4.2,5,8,3,16,2,30,0,2,2
4059,2014,12,2014-11-29,North Texas,@,Texas-San Antonio,L (27-34),24,43,55.8,287,1,37,150,4.1,1,80,437,5.5,11,8,0,19,5,53,1,0,1
4060,2014,,12 Games,North Texas,,,,181,331,54.7,2073,13,472,1835,3.9,21,803,3908,4.9,86,106,21,213,63,630,9,13,22
4061,2015,1,2015-09-12,North Texas,@,Southern Methodist,L (13-31),16,34,47.1,128,0,33,112,3.4,1,67,240,3.6,7,7,3,17,7,73,2,2,4
4062,2015,2,2015-09-19,North Texas,,Rice,L (24-38),19,35,54.3,303,2,27,175,6.5,1,62,478,7.7,13,6,1,20,4,45,2,1,3
4063,2015,3,2015-09-26,North Texas,@,Iowa,L (16-62),17,43,39.5,173,1,45,183,4.1,0,88,356,4.0,8,14,0,22,8,62,1,2,3
4064,2015,4,2015-10-03,North Texas,@,Southern Mississippi,L (14-49),14,32,43.8,201,1,49,185,3.8,1,81,386,4.8,7,14,5,26,5,40,0,1,1
4065,2015,5,2015-10-10,North Texas,,Portland State,L (7-66),16,41,39.0,122,1,31,76,2.5,0,72,198,2.8,4,7,2,13,8,74,1,0,1
4066,2015,6,2015-10-15,North Texas,,Western Kentucky,L (28-55),17,35,48.6,228,4,35,203,5.8,0,70,431,6.2,9,13,0,22,5,37,1,1,2
4067,2015,7,2015-10-24,North Texas,@,Marshall,L (13-30),15,37,40.5,128,1,40,209,5.2,0,77,337,4.4,5,14,3,22,5,28,0,1,1
4068,2015,8,2015-10-31,North Texas,,Texas-San Antonio,W (30-23),11,22,50.0,104,0,38,267,7.0,3,60,371,6.2,7,12,1,20,8,79,1,0,1
4069,2015,9,2015-11-07,North Texas,@,Louisiana Tech,L (13-56),25,45,55.6,234,2,36,82,2.3,0,81,316,3.9,11,9,0,20,3,35,3,1,4
4070,2015,10,2015-11-14,North Texas,@,Tennessee,L (0-24),13,26,50.0,107,0,32,92,2.9,0,58,199,3.4,8,6,0,14,5,35,0,0,0
4071,2015,11,2015-11-21,North Texas,@,Middle Tennessee State,L (7-41),17,28,60.7,133,0,39,191,4.9,1,67,324,4.8,3,15,0,18,6,52,2,1,3
4072,2015,12,2015-11-28,North Texas,,Texas-El Paso,L (17-20),10,29,34.5,76,0,31,129,4.2,0,60,205,3.4,1,8,1,10,10,120,1,1,2
4073,2015,,12 Games,North Texas,,,,190,407,46.7,1937,12,436,1904,4.4,7,843,3841,4.6,83,125,16,224,74,680,14,11,25
4074,2016,1,2016-09-03,North Texas,,Southern Methodist,L (21-34),32,50,64.0,311,2,29,83,2.9,1,79,394,5.0,20,5,1,26,6,68,0,3,3
4075,2016,2,2016-09-10,North Texas,,Bethune-Cookman,W (41-20),15,33,45.5,121,0,51,329,6.5,4,84,450,5.4,7,18,3,28,4,48,0,1,1
4076,2016,3,2016-09-17,North Texas,@,Florida,L (0-32),6,22,27.3,66,0,28,-13,-0.5,0,50,53,1.1,3,2,3,8,7,70,0,1,1
4077,2016,4,2016-09-24,North Texas,@,Rice,W (42-35),17,29,58.6,224,1,42,215,5.1,5,71,439,6.2,9,8,2,19,10,70,1,0,1
4078,2016,5,2016-10-01,North Texas,,Middle Tennessee State,L (13-30),33,54,61.1,303,1,22,5,0.2,1,76,308,4.1,11,3,2,16,9,90,0,0,0
4079,2016,6,2016-10-08,North Texas,,Marshall,W (38-21),18,28,64.3,206,1,54,252,4.7,3,82,458,5.6,10,11,2,23,10,78,2,0,2
4080,2016,7,2016-10-22,North Texas,@,Army,W (35-18),9,17,52.9,118,1,33,202,6.1,3,50,320,6.4,6,7,2,15,10,91,0,1,1
4081,2016,8,2016-10-29,North Texas,@,Texas-San Antonio,L (17-31),27,38,71.1,257,1,34,152,4.5,1,72,409,5.7,12,8,2,22,2,25,2,2,4
4082,2016,9,2016-11-05,North Texas,,Louisiana Tech,L (24-45),23,34,67.6,207,1,30,82,2.7,2,64,289,4.5,10,7,1,18,10,99,0,1,1
4083,2016,10,2016-11-12,North Texas,@,Western Kentucky,L (7-45),17,33,51.5,117,0,20,115,5.8,1,53,232,4.4,4,3,0,7,8,66,1,1,2
4084,2016,11,2016-11-19,North Texas,,Southern Mississippi,W (29-23),14,29,48.3,267,2,29,111,3.8,1,58,378,6.5,9,6,3,18,12,95,2,1,3
4085,2016,12,2016-11-26,North Texas,@,Texas-El Paso,L (24-52),23,42,54.8,197,2,27,107,4.0,1,69,304,4.4,9,9,3,21,3,35,0,0,0
4086,2016,13,2016-12-27,North Texas,N,Army*,L (31-38),27,40,67.5,314,3,27,96,3.6,1,67,410,6.1,11,7,1,19,6,55,0,2,2
4087,2016,,13 Games,North Texas,,,,261,449,58.1,2708,15,426,1736,4.1,24,875,4444,5.1,121,94,25,240,97,890,8,13,21
4088,2017,1,2017-09-02,North Texas,,Lamar,W (59-14),17,24,70.8,232,3,59,438,7.4,5,83,670,8.1,11,21,0,31,5,40,1,0,1
4089,2017,2,2017-09-09,North Texas,@,Southern Methodist,L (32-54),32,47,68.1,424,3,27,69,2.6,1,74,493,6.7,17,4,1,22,7,58,1,2,3
4090,2017,3,2017-09-16,North Texas,@,Iowa,L (14-31),18,29,62.1,193,1,17,112,6.6,1,46,305,6.6,10,5,2,17,13,119,1,1,2
4091,2017,4,2017-09-23,North Texas,,Alabama-Birmingham,W (46-43),15,29,51.7,261,3,44,287,6.5,2,73,548,7.5,11,14,3,28,4,33,2,0,2
4092,2017,5,2017-09-30,North Texas,@,Southern Mississippi,W (43-28),24,41,58.5,366,2,46,174,3.8,3,87,540,6.2,11,10,3,24,3,19,1,1,2
4093,2017,6,2017-10-14,North Texas,,Texas-San Antonio,W (29-26),20,35,57.1,354,3,31,104,3.4,1,66,458,6.9,14,5,0,19,3,29,0,1,1
4094,2017,7,2017-10-21,North Texas,@,Florida Atlantic,L (31-69),31,47,66.0,283,2,33,137,4.2,2,80,420,5.3,15,9,1,25,6,41,1,2,3
4095,2017,8,2017-10-28,North Texas,,Old Dominion,W (45-38),25,36,69.4,309,1,41,151,3.7,4,77,460,6.0,15,8,1,24,3,45,1,1,2
4096,2017,9,2017-11-04,North Texas,@,Louisiana Tech,W (24-23),23,37,62.2,211,1,41,204,5.0,2,78,415,5.3,10,15,1,26,4,45,0,1,1
4097,2017,10,2017-11-11,North Texas,,Texas-El Paso,W (45-10),23,35,65.7,213,4,39,259,6.6,2,74,472,6.4,10,13,4,27,4,40,1,0,1
4098,2017,11,2017-11-18,North Texas,,Army,W (52-49),24,36,66.7,386,4,33,103,3.1,3,69,489,7.1,13,9,3,25,1,1,0,1,1
4099,2017,12,2017-11-25,North Texas,@,Rice,W (30-14),18,25,72.0,195,1,44,188,4.3,1,69,383,5.6,11,13,1,25,3,20,0,1,1
4100,2017,13,2017-12-02,North Texas,@,Florida Atlantic,L (17-41),28,45,62.2,356,1,35,81,2.3,1,80,437,5.5,20,5,1,26,6,57,0,2,2
4101,2017,14,2017-12-16,North Texas,N,Troy*,L (30-50),30,54,55.6,303,3,25,-8,-0.3,0,79,295,3.7,16,2,3,21,7,66,3,2,5
4102,2017,,14 Games,North Texas,,,,328,520,63.1,4086,32,515,2299,4.5,28,1035,6385,6.2,184,133,24,340,69,613,12,15,27
4103,2016,1,2016-09-03,Northern Arizona,@,Arizona State,L (13-44),23,33,69.7,369,1,34,56,1.6,0,67,425,6.3,11,2,3,16,11,81,0,0,0
4104,2017,1,2017-09-02,Northern Arizona,@,Arizona,L (24-62),27,50,54.0,377,0,40,226,5.7,3,90,603,6.7,12,13,4,29,9,78,1,2,3
4105,2016,1,2016-09-17,Northern Colorado,@,Colorado State,L (21-47),23,33,69.7,318,2,34,93,2.7,1,67,411,6.1,17,6,1,24,8,71,0,1,1
4106,2017,1,2017-09-16,Northern Colorado,@,Colorado,L (21-41),20,37,54.1,202,3,31,71,2.3,0,68,273,4.0,6,6,6,18,7,60,1,1,2
4107,2014,1,2014-08-28,Northern Illinois,,Presbyterian,W (55-3),19,32,59.4,211,2,77,424,5.5,5,109,635,5.8,10,26,0,36,6,55,0,0,0
4108,2014,2,2014-09-06,Northern Illinois,@,Northwestern,W (23-15),13,23,56.5,180,2,55,221,4.0,1,78,401,5.1,7,10,3,20,8,75,0,0,0
4109,2014,3,2014-09-13,Northern Illinois,@,Nevada-Las Vegas,W (48-34),18,28,64.3,285,3,69,331,4.8,3,97,616,6.4,15,20,0,35,8,95,1,0,1
4110,2014,4,2014-09-20,Northern Illinois,@,Arkansas,L (14-52),19,31,61.3,180,2,32,123,3.8,0,63,303,4.8,8,8,1,17,9,67,1,0,1
4111,2014,5,2014-10-04,Northern Illinois,,Kent State,W (17-14),15,25,60.0,198,0,39,181,4.6,2,64,379,5.9,5,8,2,15,9,81,0,1,1
4112,2014,6,2014-10-11,Northern Illinois,,Central Michigan,L (17-34),18,33,54.5,231,2,33,110,3.3,0,66,341,5.2,10,7,2,19,3,34,0,1,1
4113,2014,7,2014-10-18,Northern Illinois,,Miami (OH),W (51-41),16,22,72.7,225,1,55,433,7.9,6,77,658,8.5,9,20,1,30,5,43,1,0,1
4114,2014,8,2014-10-25,Northern Illinois,@,Eastern Michigan,W (28-17),10,17,58.8,54,0,44,332,7.5,4,61,386,6.3,2,14,2,18,3,37,0,0,0
4115,2014,9,2014-11-05,Northern Illinois,@,Ball State,W (35-21),18,31,58.1,149,0,62,236,3.8,4,93,385,4.1,11,12,1,24,8,85,2,0,2
4116,2014,10,2014-11-11,Northern Illinois,,Toledo,W (27-24),14,22,63.6,190,1,46,226,4.9,2,68,416,6.1,7,10,0,17,5,34,0,0,0
4117,2014,11,2014-11-18,Northern Illinois,@,Ohio,W (21-14),16,24,66.7,184,2,41,141,3.4,1,65,325,5.0,8,10,1,19,6,85,1,0,1
4118,2014,12,2014-11-28,Northern Illinois,@,Western Michigan,W (31-21),9,20,45.0,159,1,34,196,5.8,3,54,355,6.6,5,10,0,15,3,22,2,0,2
4119,2014,13,2014-12-05,Northern Illinois,N,Bowling Green State,W (51-17),29,49,59.2,218,2,51,334,6.5,4,100,552,5.5,12,17,0,29,5,40,1,1,2
4120,2014,14,2014-12-23,Northern Illinois,N,Marshall*,L (23-52),15,28,53.6,225,1,50,200,4.0,1,78,425,5.4,12,11,2,25,4,41,0,0,0
4121,2014,,14 Games,Northern Illinois,,,,229,385,59.5,2689,19,688,3488,5.1,36,1073,6177,5.8,121,183,15,319,82,794,9,3,12
4122,2015,1,2015-09-05,Northern Illinois,,Nevada-Las Vegas,W (38-30),21,26,80.8,360,2,42,185,4.4,3,68,545,8.0,13,11,0,24,7,55,0,0,0
4123,2015,2,2015-09-12,Northern Illinois,,Murray State,W (57-26),31,41,75.6,389,4,43,254,5.9,3,84,643,7.7,18,11,1,30,5,58,2,0,2
4124,2015,3,2015-09-19,Northern Illinois,@,Ohio State,L (13-20),14,31,45.2,80,0,43,110,2.6,1,74,190,2.6,4,6,0,10,5,31,0,2,2
4125,2015,4,2015-09-26,Northern Illinois,@,Boston College,L (14-17),11,25,44.0,81,0,31,72,2.3,1,56,153,2.7,4,4,2,10,7,45,1,1,2
4126,2015,5,2015-10-03,Northern Illinois,@,Central Michigan,L (19-29),12,30,40.0,105,0,59,211,3.6,2,89,316,3.6,6,11,0,17,8,69,3,1,4
4127,2015,6,2015-10-10,Northern Illinois,,Ball State,W (59-41),29,32,90.6,363,2,59,273,4.6,6,91,636,7.0,18,16,1,35,5,86,1,0,1
4128,2015,7,2015-10-17,Northern Illinois,@,Miami (OH),W (45-12),17,26,65.4,203,1,37,311,8.4,5,63,514,8.2,9,12,0,21,2,32,2,0,2
4129,2015,8,2015-10-24,Northern Illinois,,Eastern Michigan,W (49-21),24,38,63.2,267,4,59,324,5.5,3,97,591,6.1,11,20,3,34,8,70,0,0,0
4130,2015,9,2015-11-03,Northern Illinois,@,Toledo,W (32-27),16,25,64.0,277,2,54,124,2.3,1,79,401,5.1,8,9,1,18,6,55,1,1,2
4131,2015,10,2015-11-11,Northern Illinois,@,Buffalo,W (41-30),15,24,62.5,190,2,67,334,5.0,3,91,524,5.8,8,16,0,24,6,59,1,1,2
4132,2015,11,2015-11-18,Northern Illinois,,Western Michigan,W (27-19),11,23,47.8,158,2,43,289,6.7,2,66,447,6.8,8,9,2,19,5,39,0,1,1
4133,2015,12,2015-11-24,Northern Illinois,,Ohio,L (21-26),20,34,58.8,255,2,38,73,1.9,1,72,328,4.6,9,9,0,18,6,50,1,0,1
4134,2015,13,2015-12-04,Northern Illinois,N,Bowling Green State,L (14-34),12,28,42.9,152,1,38,107,2.8,0,66,259,3.9,6,9,2,17,6,49,2,3,5
4135,2015,14,2015-12-23,Northern Illinois,N,Boise State*,L (7-55),7,21,33.3,38,0,30,-5,-0.2,0,51,33,0.6,3,2,2,7,5,30,3,0,3
4136,2015,,14 Games,Northern Illinois,,,,240,404,59.4,2918,22,643,2662,4.1,31,1047,5580,5.3,125,145,14,284,81,728,17,10,27
4137,2016,1,2016-09-03,Northern Illinois,@,Wyoming,L (34-40),24,39,61.5,329,3,37,133,3.6,2,76,462,6.1,12,6,1,19,12,106,1,0,1
4138,2016,2,2016-09-10,Northern Illinois,@,South Florida,L (17-48),22,35,62.9,161,1,41,157,3.8,1,76,318,4.2,8,9,2,19,4,50,0,0,0
4139,2016,3,2016-09-17,Northern Illinois,,San Diego State,L (28-42),17,35,48.6,213,3,39,155,4.0,1,74,368,5.0,6,10,5,21,8,103,0,2,2
4140,2016,4,2016-09-24,Northern Illinois,,Western Illinois,L (23-28),25,37,67.6,251,2,41,301,7.3,1,78,552,7.1,9,13,3,25,10,93,0,1,1
4141,2016,5,2016-10-01,Northern Illinois,@,Ball State,W (31-24),26,41,63.4,298,2,46,355,7.7,2,87,653,7.5,16,13,1,30,6,60,2,1,3
4142,2016,6,2016-10-08,Northern Illinois,@,Western Michigan,L (30-45),15,31,48.4,233,1,42,251,6.0,2,73,484,6.6,9,13,3,25,6,64,0,2,2
4143,2016,7,2016-10-15,Northern Illinois,,Central Michigan,L (28-34),18,30,60.0,165,3,37,174,4.7,1,67,339,5.1,8,7,1,16,3,26,0,2,2
4144,2016,8,2016-10-22,Northern Illinois,,Buffalo,W (44-7),16,30,53.3,199,1,51,312,6.1,4,81,511,6.3,11,15,2,28,3,22,0,1,1
4145,2016,9,2016-11-01,Northern Illinois,,Bowling Green State,W (45-20),21,31,67.7,193,0,49,286,5.8,6,80,479,6.0,9,21,2,29,11,91,0,1,1
4146,2016,10,2016-11-09,Northern Illinois,N,Toledo,L (24-31),24,43,55.8,227,3,43,214,5.0,0,86,441,5.1,13,9,1,23,8,85,0,1,1
4147,2016,11,2016-11-16,Northern Illinois,@,Eastern Michigan,W (31-24),11,25,44.0,161,1,52,324,6.2,3,77,485,6.3,8,11,1,20,9,95,0,1,1
4148,2016,12,2016-11-25,Northern Illinois,@,Kent State,W (31-21),13,23,56.5,258,0,71,215,3.0,4,94,473,5.0,12,12,3,27,4,45,1,1,2
4149,2016,,12 Games,Northern Illinois,,,,232,400,58.0,2688,20,549,2877,5.2,27,949,5565,5.9,121,139,25,282,84,840,4,13,17
4150,2017,1,2017-09-01,Northern Illinois,,Boston College,L (20-23),16,39,41.0,203,2,35,164,4.7,0,74,367,5.0,10,5,3,18,8,70,0,1,1
4151,2017,2,2017-09-09,Northern Illinois,,Eastern Illinois,W (38-10),24,35,68.6,269,3,47,230,4.9,2,82,499,6.1,11,12,3,26,15,194,2,1,3
4152,2017,3,2017-09-16,Northern Illinois,@,Nebraska,W (21-17),15,23,65.2,128,0,27,108,4.0,1,50,236,4.7,5,7,1,13,3,25,1,0,1
4153,2017,4,2017-09-30,Northern Illinois,@,San Diego State,L (28-34),23,38,60.5,262,3,44,156,3.5,1,82,418,5.1,11,9,3,23,4,42,1,3,4
4154,2017,5,2017-10-07,Northern Illinois,,Kent State,W (24-3),13,22,59.1,114,3,50,152,3.0,0,72,266,3.7,7,9,0,15,7,59,1,2,3
4155,2017,6,2017-10-14,Northern Illinois,@,Buffalo,W (14-13),20,31,64.5,224,1,55,219,4.0,1,86,443,5.2,11,15,2,28,3,35,2,0,2
4156,2017,7,2017-10-21,Northern Illinois,@,Bowling Green State,W (48-17),21,34,61.8,239,3,55,338,6.1,2,89,577,6.5,13,16,0,29,6,39,1,0,1
4157,2017,8,2017-10-26,Northern Illinois,,Eastern Michigan,W (30-27),23,40,57.5,278,2,36,114,3.2,2,76,392,5.2,10,6,2,18,9,72,1,0,1
4158,2017,9,2017-11-02,Northern Illinois,@,Toledo,L (17-27),24,44,54.5,245,0,40,185,4.6,2,84,430,5.1,12,11,2,25,7,45,0,2,2
4159,2017,10,2017-11-09,Northern Illinois,,Ball State,W (63-17),11,24,45.8,211,5,45,222,4.9,2,69,433,6.3,9,9,2,20,1,5,1,0,1
4160,2017,11,2017-11-15,Northern Illinois,,Western Michigan,W (35-31),6,11,54.5,64,1,49,248,5.1,3,60,312,5.2,2,13,2,17,7,65,3,0,3
4161,2017,12,2017-11-24,Northern Illinois,@,Central Michigan,L (24-31),20,36,55.6,128,1,40,137,3.4,1,76,265,3.5,8,9,2,19,7,60,0,2,2
4162,2017,13,2017-12-26,Northern Illinois,N,Duke*,L (14-36),15,28,53.6,234,1,29,65,2.2,1,57,299,5.2,6,5,2,13,3,11,0,0,0
4163,2017,,13 Games,Northern Illinois,,,,231,405,57.0,2599,25,552,2338,4.2,18,957,4937,5.2,115,126,24,264,80,722,13,11,24
4164,2014,1,2014-08-30,Northwestern,,California,L (24-31),24,44,54.5,246,2,36,108,3.0,1,80,354,4.4,10,11,1,22,1,0,0,2,2
4165,2014,2,2014-09-06,Northwestern,,Northern Illinois,L (15-23),28,43,65.1,322,2,37,72,1.9,0,80,394,4.9,15,4,2,21,9,93,0,1,1
4166,2014,3,2014-09-20,Northwestern,,Western Illinois,W (24-7),15,25,60.0,117,0,41,166,4.0,3,66,283,4.3,7,7,1,15,5,35,2,0,2
4167,2014,4,2014-09-27,Northwestern,@,Penn State,W (29-6),21,37,56.8,258,0,38,103,2.7,3,75,361,4.8,14,3,0,17,8,75,0,1,1
4168,2014,5,2014-10-04,Northwestern,,Wisconsin,W (20-14),15,29,51.7,182,1,46,203,4.4,1,75,385,5.1,11,10,1,22,4,20,0,0,0
4169,2014,6,2014-10-11,Northwestern,@,Minnesota,L (17-24),32,50,64.0,269,1,34,124,3.6,1,84,393,4.7,16,9,3,28,6,41,0,1,1
4170,2014,7,2014-10-18,Northwestern,,Nebraska,L (17-38),18,39,46.2,173,0,34,117,3.4,2,73,290,4.0,9,8,4,21,8,65,0,1,1
4171,2014,8,2014-11-01,Northwestern,@,Iowa,L (7-48),9,24,37.5,75,0,43,105,2.4,1,67,180,2.7,6,7,0,13,5,53,1,0,1
4172,2014,9,2014-11-08,Northwestern,,Michigan,L (9-10),32,49,65.3,273,1,35,-9,-0.3,0,84,264,3.1,14,3,1,18,3,101,1,2,3
4173,2014,10,2014-11-15,Northwestern,@,Notre Dame,W (43-40),30,48,62.5,284,1,48,263,5.5,3,96,547,5.7,12,14,2,28,5,62,2,2,4
4174,2014,11,2014-11-22,Northwestern,@,Purdue,W (38-14),13,24,54.2,181,1,56,233,4.2,3,80,414,5.2,10,8,2,20,4,35,1,1,2
4175,2014,12,2014-11-29,Northwestern,,Illinois,L (33-47),24,42,57.1,218,1,38,154,4.1,2,80,372,4.7,11,7,1,19,4,48,2,3,5
4176,2014,,12 Games,Northwestern,,,,261,454,57.5,2598,10,486,1639,3.4,20,940,4237,4.5,135,91,18,244,62,628,9,14,23
4177,2015,1,2015-09-05,Northwestern,,Stanford,W (16-6),12,25,48.0,105,0,54,225,4.2,1,79,330,4.2,8,9,0,17,5,57,0,0,0
4178,2015,2,2015-09-12,Northwestern,,Eastern Illinois,W (41-0),11,16,68.8,152,1,69,344,5.0,3,85,496,5.8,9,18,1,28,3,26,1,0,1
4179,2015,3,2015-09-19,Northwestern,@,Duke,W (19-10),9,23,39.1,70,0,54,201,3.7,1,77,271,3.5,4,11,0,15,2,10,0,2,2
4180,2015,4,2015-09-26,Northwestern,,Ball State,W (24-19),18,31,58.1,256,3,57,290,5.1,0,88,546,6.2,11,12,0,23,8,57,2,1,3
4181,2015,5,2015-10-03,Northwestern,,Minnesota,W (27-0),14,19,73.7,128,0,51,184,3.6,2,70,312,4.5,9,7,0,16,3,20,0,0,0
4182,2015,6,2015-10-10,Northwestern,@,Michigan,L (0-38),15,33,45.5,130,0,25,38,1.5,0,58,168,2.9,9,3,1,13,5,39,0,1,1
4183,2015,7,2015-10-17,Northwestern,,Iowa,L (10-40),20,43,46.5,147,1,26,51,2.0,0,69,198,2.9,6,5,2,13,5,55,2,1,3
4184,2015,8,2015-10-24,Northwestern,@,Nebraska,W (30-28),13,28,46.4,177,1,28,156,5.6,1,56,333,5.9,8,5,2,15,5,58,0,0,0
4185,2015,9,2015-11-07,Northwestern,,Penn State,W (23-21),16,32,50.0,169,1,47,227,4.8,1,79,396,5.0,12,8,2,22,7,80,0,1,1
4186,2015,10,2015-11-14,Northwestern,,Purdue,W (21-14),11,24,45.8,132,0,48,250,5.2,3,72,382,5.3,7,11,3,21,4,23,1,2,3
4187,2015,11,2015-11-21,Northwestern,@,Wisconsin,W (13-7),9,20,45.0,60,0,50,149,3.0,1,70,209,3.0,6,5,1,12,7,46,0,0,0
4188,2015,12,2015-11-28,Northwestern,N,Illinois,W (24-14),12,25,48.0,146,1,54,204,3.8,2,79,350,4.4,7,8,3,18,1,10,1,1,2
4189,2015,13,2016-01-01,Northwestern,N,Tennessee*,L (6-45),14,33,42.4,129,0,37,132,3.6,1,70,261,3.7,5,10,3,18,3,35,0,4,4
4190,2015,,13 Games,Northwestern,,,,174,352,49.4,1801,8,600,2451,4.1,16,952,4252,4.5,101,112,18,231,58,516,7,13,20
4191,2016,1,2016-09-03,Northwestern,,Western Michigan,L (21-22),15,22,68.2,196,0,31,123,4.0,3,53,319,6.0,8,7,0,15,2,20,1,0,1
4192,2016,2,2016-09-10,Northwestern,,Illinois State,L (7-9),17,41,41.5,191,1,31,86,2.8,0,72,277,3.8,10,4,2,16,6,70,0,0,0
4193,2016,3,2016-09-17,Northwestern,,Duke,W (24-13),18,39,46.2,320,3,44,86,2.0,0,83,406,4.9,11,7,4,22,5,37,0,2,2
4194,2016,4,2016-09-24,Northwestern,,Nebraska,L (13-24),25,38,65.8,251,1,32,137,4.3,1,70,388,5.5,12,9,2,23,4,36,0,2,2
4195,2016,5,2016-10-01,Northwestern,@,Iowa,W (38-31),18,30,60.0,164,3,42,198,4.7,2,72,362,5.0,9,8,3,20,1,5,1,0,1
4196,2016,6,2016-10-15,Northwestern,@,Michigan State,W (54-40),27,35,77.1,281,3,51,209,4.1,3,86,490,5.7,12,13,1,26,4,25,0,1,1
4197,2016,7,2016-10-22,Northwestern,,Indiana,W (24-14),24,44,54.5,285,3,44,123,2.8,0,88,408,4.6,16,8,2,26,6,43,0,0,0
4198,2016,8,2016-10-29,Northwestern,@,Ohio State,L (20-24),23,44,52.3,258,1,29,148,5.1,1,73,406,5.6,15,6,0,21,2,20,0,1,1
4199,2016,9,2016-11-05,Northwestern,,Wisconsin,L (7-21),28,52,53.8,277,1,19,39,2.1,0,71,316,4.5,12,2,0,14,5,28,1,0,1
4200,2016,10,2016-11-12,Northwestern,@,Purdue,W (45-17),23,37,62.2,352,3,46,253,5.5,3,83,605,7.3,14,14,0,28,0,0,0,2,2
4201,2016,11,2016-11-19,Northwestern,@,Minnesota,L (12-29),28,45,62.2,276,1,33,63,1.9,1,78,339,4.3,13,6,2,21,3,20,2,0,2
4202,2016,12,2016-11-26,Northwestern,,Illinois,W (42-21),13,20,65.0,121,1,49,278,5.7,5,69,399,5.8,9,10,3,22,5,50,1,0,1
4203,2016,13,2016-12-28,Northwestern,N,Pittsburgh*,W (31-24),23,36,63.9,214,1,50,248,5.0,3,86,462,5.4,15,10,2,27,4,35,1,1,2
4204,2016,,13 Games,Northwestern,,,,282,483,58.4,3186,22,501,1991,4.0,22,984,5177,5.3,156,104,21,281,47,389,7,9,16
4205,2017,1,2017-09-02,Northwestern,,Nevada,W (31-20),28,38,73.7,352,2,50,156,3.1,2,88,508,5.8,14,9,4,26,8,90,1,1,2
4206,2017,2,2017-09-09,Northwestern,@,Duke,L (17-41),14,33,42.4,169,1,21,22,1.0,1,54,191,3.5,10,3,2,15,3,26,1,2,3
4207,2017,3,2017-09-16,Northwestern,,Bowling Green State,W (49-7),24,31,77.4,375,2,43,303,7.0,5,74,678,9.2,15,15,0,30,4,23,2,0,2
4208,2017,4,2017-09-30,Northwestern,@,Wisconsin,L (24-33),29,45,64.4,219,3,34,25,0.7,0,79,244,3.1,14,4,2,20,5,50,0,2,2
4209,2017,5,2017-10-07,Northwestern,,Penn State,L (7-31),23,43,53.5,198,0,30,67,2.2,1,73,265,3.6,9,6,0,15,8,74,1,2,3
4210,2017,6,2017-10-14,Northwestern,@,Maryland,W (37-21),27,49,55.1,293,1,44,238,5.4,3,93,531,5.7,15,14,1,30,7,90,0,2,2
4211,2017,7,2017-10-21,Northwestern,,Iowa,W (17-10),21,36,58.3,192,0,46,147,3.2,2,82,339,4.1,8,12,1,21,5,40,0,0,0
4212,2017,8,2017-10-28,Northwestern,,Michigan State,W (39-31),34,49,69.4,368,3,28,64,2.3,2,77,432,5.6,21,4,3,28,1,9,1,0,1
4213,2017,9,2017-11-04,Northwestern,@,Nebraska,W (31-24),19,35,54.3,243,0,45,232,5.2,4,80,475,5.9,9,14,3,26,6,65,0,2,2
4214,2017,10,2017-11-11,Northwestern,,Purdue,W (23-13),26,46,56.5,296,1,38,94,2.5,1,84,390,4.6,17,4,1,22,4,40,0,0,0
4215,2017,11,2017-11-18,Northwestern,,Minnesota,W (39-0),9,13,69.2,86,3,55,277,5.0,3,68,363,5.3,7,14,1,22,3,30,0,0,0
4216,2017,12,2017-11-25,Northwestern,@,Illinois,W (42-7),13,21,61.9,140,1,47,306,6.5,4,68,446,6.6,6,13,2,21,3,30,0,1,1
4217,2017,13,2017-12-29,Northwestern,N,Kentucky*,W (24-23),9,21,42.9,109,0,56,333,5.9,2,77,442,5.7,5,13,2,20,7,70,0,0,0
4218,2017,,13 Games,Northwestern,,,,276,460,60.0,3040,17,537,2264,4.2,30,997,5304,5.3,150,125,22,296,64,637,6,12,18
4219,2016,1,2016-09-02,Northwestern State,@,Baylor,L (7-55),5,19,26.3,31,0,40,47,1.2,1,59,78,1.3,1,6,2,9,7,37,0,0,0
4220,2017,1,2017-09-02,Northwestern State,@,Louisiana Tech,L (24-52),20,40,50.0,256,2,33,133,4.0,1,73,389,5.3,10,10,2,22,8,54,1,2,3
4221,2014,1,2014-08-30,Notre Dame,,Rice,W (48-17),14,22,63.6,295,2,42,281,6.7,4,64,576,9.0,9,14,0,23,2,10,0,0,0
4222,2014,2,2014-09-06,Notre Dame,,Michigan,W (31-0),23,34,67.6,226,3,31,54,1.7,1,65,280,4.3,14,3,3,20,3,20,0,0,0
4223,2014,3,2014-09-13,Notre Dame,N,Purdue,W (30-14),25,40,62.5,259,2,38,139,3.7,1,78,398,5.1,17,8,2,27,7,43,1,0,1
4224,2014,4,2014-09-27,Notre Dame,N,Syracuse,W (31-15),32,39,82.1,362,4,41,161,3.9,0,80,523,6.5,17,10,2,29,8,80,3,2,5
4225,2014,5,2014-10-04,Notre Dame,,Stanford,W (17-14),20,43,46.5,241,2,32,129,4.0,0,75,370,4.9,13,5,3,21,1,10,1,1,2
4226,2014,6,2014-10-11,Notre Dame,,North Carolina,W (50-43),21,38,55.3,300,3,43,216,5.0,4,81,516,6.4,12,11,4,27,10,76,2,1,3
4227,2014,7,2014-10-18,Notre Dame,@,Florida State,L (27-31),31,52,59.6,313,3,35,157,4.5,0,87,470,5.4,11,12,3,26,9,67,0,2,2
4228,2014,8,2014-11-01,Notre Dame,N,Navy,W (49-39),18,25,72.0,315,3,39,218,5.6,4,64,533,8.3,11,13,1,25,1,5,0,1,1
4229,2014,9,2014-11-08,Notre Dame,@,Arizona State,L (31-55),22,41,53.7,446,2,38,41,1.1,2,79,487,6.2,19,5,0,24,5,43,1,4,5
4230,2014,10,2014-11-15,Notre Dame,,Northwestern,L (40-43),21,40,52.5,287,3,40,211,5.3,2,80,498,6.2,15,10,3,28,4,47,3,1,4
4231,2014,11,2014-11-22,Notre Dame,,Louisville,L (28-31),16,24,66.7,236,2,29,99,3.4,1,53,335,6.3,9,6,1,16,3,36,0,1,1
4232,2014,12,2014-11-29,Notre Dame,@,Southern California,L (14-49),16,39,41.0,245,0,25,104,4.2,2,64,349,5.5,12,6,2,20,3,35,1,1,2
4233,2014,13,2014-12-30,Notre Dame,N,Louisiana State*,W (31-28),18,26,69.2,186,1,51,263,5.2,3,77,449,5.8,9,14,0,23,2,15,0,0,0
4234,2014,,13 Games,Notre Dame,,,,277,463,59.8,3711,30,484,2073,4.3,24,947,5784,6.1,168,117,24,309,58,487,12,14,26
4235,2015,1,2015-09-05,Notre Dame,,Texas,W (38-3),19,23,82.6,313,3,52,214,4.1,2,75,527,7.0,14,14,2,30,6,39,0,0,0
4236,2015,2,2015-09-12,Notre Dame,@,Virginia,W (34-27),15,30,50.0,207,3,34,253,7.4,1,64,460,7.2,7,12,1,20,4,40,0,0,0
4237,2015,3,2015-09-19,Notre Dame,,Georgia Tech,W (30-22),21,30,70.0,242,1,32,215,6.7,3,62,457,7.4,9,8,0,17,8,55,1,1,2
4238,2015,4,2015-09-26,Notre Dame,,Massachusetts,W (62-27),18,28,64.3,224,2,51,457,9.0,6,79,681,8.6,13,17,0,30,8,75,0,1,1
4239,2015,5,2015-10-03,Notre Dame,@,Clemson,L (22-24),19,35,54.3,321,2,33,116,3.5,1,68,437,6.4,12,6,2,20,6,45,3,1,4
4240,2015,6,2015-10-10,Notre Dame,,Navy,W (41-24),22,31,71.0,281,1,40,178,4.5,4,71,459,6.5,13,12,2,27,4,35,0,1,1
4241,2015,7,2015-10-17,Notre Dame,,Southern California,W (41-31),16,25,64.0,262,2,35,214,6.1,2,60,476,7.9,7,12,2,21,4,40,1,0,1
4242,2015,8,2015-10-31,Notre Dame,@,Temple,W (24-20),23,36,63.9,299,1,31,168,5.4,2,67,467,7.0,9,7,4,20,8,81,0,2,2
4243,2015,9,2015-11-07,Notre Dame,@,Pittsburgh,W (42-30),19,26,73.1,262,5,42,175,4.2,1,68,437,6.4,11,11,0,22,2,20,1,0,1
4244,2015,10,2015-11-14,Notre Dame,,Wake Forest,W (28-7),13,19,68.4,111,0,30,171,5.7,3,49,282,5.8,8,5,2,15,4,45,0,0,0
4245,2015,11,2015-11-21,Notre Dame,N,Boston College,W (19-16),20,38,52.6,320,2,34,127,3.7,0,72,447,6.2,15,4,3,22,4,31,2,3,5
4246,2015,12,2015-11-28,Notre Dame,@,Stanford,L (36-38),13,25,52.0,234,1,35,299,8.5,2,60,533,8.9,10,14,0,24,6,65,1,0,1
4247,2015,13,2016-01-01,Notre Dame,N,Ohio State*,L (28-44),22,38,57.9,284,2,32,121,3.8,2,70,405,5.8,15,7,2,24,3,20,1,1,2
4248,2015,,13 Games,Notre Dame,,,,240,384,62.5,3360,25,481,2708,5.6,29,865,6068,7.0,143,129,20,292,67,591,10,10,20
4249,2016,1,2016-09-04,Notre Dame,@,Texas,L (47-50),17,30,56.7,238,5,46,206,4.5,1,76,444,5.8,11,10,1,22,8,64,0,0,0
4250,2016,2,2016-09-10,Notre Dame,,Nevada,W (39-10),19,27,70.4,205,2,46,239,5.2,3,73,444,6.1,9,10,2,21,9,94,0,1,1
4251,2016,3,2016-09-17,Notre Dame,,Michigan State,L (28-36),20,37,54.1,344,2,25,57,2.3,2,62,401,6.5,14,3,2,19,4,51,2,1,3
4252,2016,4,2016-09-24,Notre Dame,,Duke,L (35-38),22,37,59.5,381,2,37,153,4.1,3,74,534,7.2,15,9,0,24,2,20,2,1,3
4253,2016,5,2016-10-01,Notre Dame,N,Syracuse,W (50-33),23,35,65.7,471,3,37,183,4.9,2,72,654,9.1,17,6,2,25,6,55,0,1,1
4254,2016,6,2016-10-08,Notre Dame,@,North Carolina State,L (3-10),9,26,34.6,54,0,38,59,1.6,0,64,113,1.8,4,5,1,10,5,40,2,1,3
4255,2016,7,2016-10-15,Notre Dame,,Stanford,L (10-17),14,29,48.3,154,0,35,153,4.4,1,64,307,4.8,7,9,0,16,7,47,0,2,2
4256,2016,8,2016-10-29,Notre Dame,,Miami (FL),W (30-27),25,38,65.8,263,2,29,148,5.1,1,67,411,6.1,12,7,1,20,7,53,2,0,2
4257,2016,9,2016-11-05,Notre Dame,N,Navy,L (27-28),19,27,70.4,223,3,29,147,5.1,0,56,370,6.6,11,10,0,21,7,47,0,0,0
4258,2016,10,2016-11-12,Notre Dame,N,Army,W (44-6),18,29,62.1,215,3,43,261,6.1,2,72,476,6.6,9,19,3,31,7,35,0,1,1
4259,2016,11,2016-11-19,Notre Dame,,Virginia Tech,L (31-34),17,34,50.0,249,2,36,200,5.6,2,70,449,6.4,10,12,0,22,10,78,0,0,0
4260,2016,12,2016-11-26,Notre Dame,@,Southern California,L (27-45),21,39,53.8,254,3,37,154,4.2,1,76,408,5.4,13,7,3,23,6,54,1,1,2
4261,2016,,12 Games,Notre Dame,,,,224,388,57.7,3051,27,438,1960,4.5,18,826,5011,6.1,132,107,15,254,78,638,9,9,18
4262,2017,1,2017-09-02,Notre Dame,,Temple,W (49-16),17,30,56.7,184,2,44,422,9.6,5,74,606,8.2,7,16,3,26,4,20,0,1,1
4263,2017,2,2017-09-09,Notre Dame,,Georgia,L (19-20),20,40,50.0,210,0,37,55,1.5,1,77,265,3.4,8,3,7,18,8,63,2,0,2
4264,2017,3,2017-09-16,Notre Dame,@,Boston College,W (49-20),11,27,40.7,96,0,51,515,10.1,7,78,611,7.8,5,14,0,19,5,45,1,1,2
4265,2017,4,2017-09-23,Notre Dame,@,Michigan State,W (38-18),14,20,70.0,173,1,40,182,4.6,3,60,355,5.9,10,7,4,21,6,65,0,0,0
4266,2017,5,2017-09-30,Notre Dame,,Miami (OH),W (52-17),10,23,43.5,170,3,39,333,8.5,4,62,503,8.1,7,10,4,21,5,60,0,0,0
4267,2017,6,2017-10-07,Notre Dame,@,North Carolina,W (33-10),17,31,54.8,146,1,57,341,6.0,3,88,487,5.5,9,16,2,27,10,80,0,2,2
4268,2017,7,2017-10-21,Notre Dame,,Southern California,W (49-14),9,22,40.9,120,2,47,377,8.0,5,69,497,7.2,6,17,0,23,7,51,0,0,0
4269,2017,8,2017-10-28,Notre Dame,,North Carolina State,W (35-14),10,19,52.6,104,2,54,318,5.9,2,73,422,5.8,6,15,4,25,4,29,0,0,0
4270,2017,9,2017-11-04,Notre Dame,,Wake Forest,W (48-37),23,38,60.5,330,2,46,380,8.3,4,84,710,8.5,14,16,0,30,5,40,0,0,0
4271,2017,10,2017-11-11,Notre Dame,@,Miami (FL),L (8-41),13,27,48.1,152,1,36,109,3.0,0,63,261,4.1,9,4,0,13,6,49,1,3,4
4272,2017,11,2017-11-18,Notre Dame,,Navy,W (24-17),9,18,50.0,164,2,31,163,5.3,1,49,327,6.7,7,8,1,16,3,35,1,0,1
4273,2017,12,2017-11-25,Notre Dame,@,Stanford,L (20-38),12,29,41.4,261,2,44,154,3.5,0,73,415,5.7,8,9,0,17,8,81,1,2,3
4274,2017,13,2018-01-01,Notre Dame,N,Louisiana State*,W (21-17),17,28,60.7,216,2,33,154,4.7,0,61,370,6.1,8,10,0,18,4,15,1,1,2
4275,2017,,13 Games,Notre Dame,,,,182,352,51.7,2326,20,559,3503,6.3,35,911,5829,6.4,104,145,25,274,75,633,7,10,17
4276,2014,1,2014-08-30,Ohio,@,Kent State,W (17-14),18,24,75.0,262,2,44,175,4.0,0,68,437,6.4,13,6,1,20,1,5,4,0,4
4277,2014,2,2014-09-06,Ohio,@,Kentucky,L (3-20),14,32,43.8,149,0,28,74,2.6,0,60,223,3.7,5,7,1,13,5,46,1,0,1
4278,2014,3,2014-09-13,Ohio,@,Marshall,L (14-44),22,38,57.9,236,2,32,141,4.4,0,70,377,5.4,11,10,1,22,8,75,1,1,2
4279,2014,4,2014-09-20,Ohio,,Idaho,W (36-24),12,19,63.2,233,1,47,272,5.8,3,66,505,7.7,8,10,1,19,9,64,1,0,1
4280,2014,5,2014-09-27,Ohio,,Eastern Illinois,W (34-19),17,31,54.8,158,0,41,229,5.6,4,72,387,5.4,6,11,3,20,6,60,0,2,2
4281,2014,6,2014-10-04,Ohio,@,Central Michigan,L (10-28),7,21,33.3,98,0,23,89,3.9,1,44,187,4.3,4,3,1,8,2,18,0,0,0
4282,2014,7,2014-10-11,Ohio,,Bowling Green State,L (13-31),34,64,53.1,386,0,46,127,2.8,1,110,513,4.7,18,7,4,29,16,153,2,0,2
4283,2014,8,2014-10-18,Ohio,,Akron,W (23-20),17,37,45.9,197,2,39,159,4.1,0,76,356,4.7,8,8,3,19,11,120,1,1,2
4284,2014,9,2014-10-25,Ohio,@,Western Michigan,L (21-42),20,36,55.6,284,1,36,88,2.4,2,72,372,5.2,11,6,1,18,6,48,1,1,2
4285,2014,10,2014-11-05,Ohio,,Buffalo,W (37-14),8,19,42.1,156,0,55,233,4.2,4,74,389,5.3,6,11,2,19,1,5,2,0,2
4286,2014,11,2014-11-18,Ohio,,Northern Illinois,L (14-21),19,28,67.9,141,1,39,203,5.2,1,67,344,5.1,6,15,3,24,4,30,1,1,2
4287,2014,12,2014-11-25,Ohio,@,Miami (OH),W (24-21),14,26,53.8,174,2,40,179,4.5,0,66,353,5.3,7,12,3,22,3,24,0,3,3
4288,2014,,12 Games,Ohio,,,,202,375,53.9,2474,11,470,1969,4.2,16,845,4443,5.3,103,106,24,233,72,648,14,9,23
4289,2015,1,2015-09-03,Ohio,@,Idaho,W (45-28),20,25,80.0,284,3,38,205,5.4,2,63,489,7.8,10,11,2,23,10,92,1,0,1
4290,2015,2,2015-09-12,Ohio,,Marshall,W (21-10),15,28,53.6,156,1,51,229,4.5,2,79,385,4.9,8,11,3,22,11,120,1,1,2
4291,2015,3,2015-09-19,Ohio,,Southeastern Louisiana,W (35-14),18,27,66.7,346,2,31,115,3.7,3,58,461,7.9,11,5,2,18,9,94,0,1,1
4292,2015,4,2015-09-26,Ohio,@,Minnesota,L (24-27),17,27,63.0,194,2,38,151,4.0,1,65,345,5.3,9,9,0,18,9,51,0,0,0
4293,2015,5,2015-10-03,Ohio,@,Akron,W (14-12),18,29,62.1,179,1,32,48,1.5,1,61,227,3.7,7,6,4,17,8,99,0,1,1
4294,2015,6,2015-10-10,Ohio,,Miami (OH),W (34-3),25,40,62.5,278,1,37,150,4.1,2,77,428,5.6,15,8,2,25,5,61,0,1,1
4295,2015,7,2015-10-17,Ohio,,Western Michigan,L (14-49),22,40,55.0,255,1,30,99,3.3,1,70,354,5.1,14,4,2,20,3,28,0,0,0
4296,2015,8,2015-10-24,Ohio,@,Buffalo,L (17-41),33,54,61.1,368,0,34,54,1.6,2,88,422,4.8,16,3,3,22,7,58,0,4,4
4297,2015,9,2015-11-04,Ohio,@,Bowling Green State,L (24-62),21,41,51.2,244,0,56,299,5.3,3,97,543,5.6,17,14,3,34,7,75,0,2,2
4298,2015,10,2015-11-10,Ohio,,Kent State,W (27-0),8,14,57.1,114,1,57,333,5.8,0,71,447,6.3,3,17,2,22,7,80,0,0,0
4299,2015,11,2015-11-17,Ohio,,Ball State,W (48-31),15,22,68.2,275,3,56,332,5.9,3,78,607,7.8,9,19,2,30,6,75,0,0,0
4300,2015,12,2015-11-24,Ohio,@,Northern Illinois,W (26-21),14,29,48.3,168,2,50,230,4.6,0,79,398,5.0,6,11,1,18,2,20,1,1,2
4301,2015,13,2015-12-19,Ohio,N,Appalachian State*,L (29-31),15,29,51.7,165,0,36,107,3.0,1,65,272,4.2,8,5,2,15,7,85,1,2,3
4302,2015,,13 Games,Ohio,,,,241,405,59.5,3026,17,546,2352,4.3,21,951,5378,5.7,133,123,28,284,91,938,4,13,17
4303,2016,1,2016-09-03,Ohio,,Texas State,L (54-56),28,46,60.9,393,4,51,237,4.6,2,97,630,6.5,12,11,2,25,13,141,2,0,2
4304,2016,2,2016-09-10,Ohio,@,Kansas,W (37-21),19,36,52.8,167,1,57,329,5.8,2,93,496,5.3,8,17,2,27,6,57,0,1,1
4305,2016,3,2016-09-17,Ohio,@,Tennessee,L (19-28),23,46,50.0,230,1,30,88,2.9,0,76,318,4.2,10,3,4,17,5,30,0,0,0
4306,2016,4,2016-09-24,Ohio,,Gardner-Webb,W (37-21),25,38,65.8,310,3,45,221,4.9,2,83,531,6.4,14,16,1,31,4,35,0,1,1
4307,2016,5,2016-10-01,Ohio,@,Miami (OH),W (17-7),7,18,38.9,56,0,49,141,2.9,1,67,197,2.9,3,10,5,18,3,29,0,1,1
4308,2016,6,2016-10-08,Ohio,,Bowling Green State,W (30-24),21,29,72.4,203,1,37,183,4.9,3,66,386,5.8,13,7,2,22,9,108,0,1,1
4309,2016,7,2016-10-15,Ohio,,Eastern Michigan,L (20-27),26,43,60.5,291,1,30,124,4.1,1,73,415,5.7,16,8,1,25,4,40,1,1,2
4310,2016,8,2016-10-22,Ohio,@,Kent State,W (14-10),11,19,57.9,127,0,36,208,5.8,2,55,335,6.1,3,10,0,13,8,83,2,1,3
4311,2016,9,2016-10-27,Ohio,@,Toledo,W (31-26),11,22,50.0,243,3,48,269,5.6,1,70,512,7.3,9,12,2,23,5,55,1,0,1
4312,2016,10,2016-11-03,Ohio,,Buffalo,W (34-10),12,22,54.5,216,2,39,156,4.0,2,61,372,6.1,7,10,1,18,5,59,0,0,0
4313,2016,11,2016-11-15,Ohio,@,Central Michigan,L (20-27),16,36,44.4,208,1,36,149,4.1,1,72,357,5.0,8,7,4,19,2,20,3,1,4
4314,2016,12,2016-11-22,Ohio,,Akron,W (9-3),14,25,56.0,169,0,35,132,3.8,0,60,301,5.0,7,8,2,17,8,66,1,0,1
4315,2016,13,2016-12-02,Ohio,N,Western Michigan,L (23-29),14,31,45.2,214,3,22,37,1.7,0,53,251,4.7,9,3,2,14,2,16,2,1,3
4316,2016,14,2016-12-23,Ohio,N,Troy*,L (23-28),23,47,48.9,315,2,30,78,2.6,0,77,393,5.1,12,6,5,23,5,33,1,4,5
4317,2016,,14 Games,Ohio,,,,250,458,54.6,3142,22,545,2352,4.3,17,1003,5494,5.5,131,128,33,292,79,772,13,12,25
4318,2017,1,2017-09-02,Ohio,,Hampton,W (59-0),13,19,68.4,172,1,53,248,4.7,7,72,420,5.8,6,14,2,22,6,54,0,1,1
4319,2017,2,2017-09-08,Ohio,@,Purdue,L (21-44),17,29,58.6,223,1,38,173,4.6,2,67,396,5.9,14,8,1,23,3,30,2,0,2
4320,2017,3,2017-09-16,Ohio,,Kansas,W (42-30),16,22,72.7,254,3,41,196,4.8,2,63,450,7.1,10,9,2,21,7,61,0,1,1
4321,2017,4,2017-09-23,Ohio,@,Eastern Michigan,W (27-20),19,31,61.3,197,2,46,171,3.7,0,77,368,4.8,8,9,2,19,4,36,2,0,2
4322,2017,5,2017-09-30,Ohio,@,Massachusetts,W (58-50),13,24,54.2,181,2,40,292,7.3,5,64,473,7.4,8,14,3,25,7,69,0,0,0
4323,2017,6,2017-10-07,Ohio,,Central Michigan,L (23-26),17,31,54.8,160,0,39,190,4.9,3,70,350,5.0,9,12,1,22,5,28,3,1,4
4324,2017,7,2017-10-14,Ohio,@,Bowling Green State,W (48-30),7,22,31.8,105,1,43,335,7.8,5,65,440,6.8,4,12,2,18,6,58,0,2,2
4325,2017,8,2017-10-21,Ohio,,Kent State,W (48-3),9,20,45.0,138,2,42,336,8.0,4,62,474,7.6,4,15,4,23,5,40,1,0,1
4326,2017,9,2017-10-31,Ohio,,Miami (OH),W (45-28),21,33,63.6,294,3,36,149,4.1,3,69,443,6.4,12,8,6,26,6,50,0,0,0
4327,2017,10,2017-11-08,Ohio,,Toledo,W (38-10),7,15,46.7,139,1,56,393,7.0,4,71,532,7.5,5,16,2,23,5,45,2,1,3
4328,2017,11,2017-11-14,Ohio,@,Akron,L (34-37),10,23,43.5,113,1,43,282,6.6,3,66,395,6.0,5,12,6,23,2,19,1,2,3
4329,2017,12,2017-11-24,Ohio,@,Buffalo,L (24-31),15,30,50.0,265,1,43,159,3.7,2,73,424,5.8,10,8,2,20,4,30,1,1,2
4330,2017,13,2017-12-22,Ohio,N,Alabama-Birmingham*,W (41-6),14,22,63.6,210,2,32,249,7.8,4,54,459,8.5,9,11,4,24,6,70,0,0,0
4331,2017,,13 Games,Ohio,,,,178,321,55.5,2451,20,552,3173,5.7,44,873,5624,6.4,104,148,37,289,66,590,12,9,21
4332,2014,1,2014-08-30,Ohio State,N,Navy,W (34-17),12,15,80.0,226,2,40,194,4.9,1,55,420,7.6,7,12,0,19,2,20,0,1,1
4333,2014,2,2014-09-06,Ohio State,,Virginia Tech,L (21-35),9,29,31.0,219,1,40,108,2.7,2,69,327,4.7,7,9,3,19,7,62,0,3,3
4334,2014,3,2014-09-13,Ohio State,,Kent State,W (66-0),25,34,73.5,344,6,53,284,5.4,3,87,628,7.2,15,15,3,33,6,63,2,1,3
4335,2014,4,2014-09-27,Ohio State,,Cincinnati,W (50-28),26,36,72.2,330,4,65,380,5.8,2,101,710,7.0,17,27,1,45,7,40,1,0,1
4336,2014,5,2014-10-04,Ohio State,@,Maryland,W (52-24),19,24,79.2,264,4,53,269,5.1,2,77,533,6.9,10,15,1,26,7,66,0,0,0
4337,2014,6,2014-10-18,Ohio State,,Rutgers,W (56-17),19,31,61.3,261,3,40,324,8.1,4,71,585,8.2,12,19,0,31,4,28,1,0,1
4338,2014,7,2014-10-25,Ohio State,@,Penn State,W (31-24),12,19,63.2,74,1,57,219,3.8,3,76,293,3.9,4,14,1,19,8,70,0,2,2
4339,2014,8,2014-11-01,Ohio State,,Illinois,W (55-14),20,34,58.8,249,4,44,296,6.7,3,78,545,7.0,12,16,0,28,6,56,1,0,1
4340,2014,9,2014-11-08,Ohio State,@,Michigan State,W (49-37),16,26,61.5,300,3,41,268,6.5,4,67,568,8.5,9,14,2,25,7,50,2,0,2
4341,2014,10,2014-11-15,Ohio State,@,Minnesota,W (31-24),15,25,60.0,200,3,38,289,7.6,1,63,489,7.8,8,12,2,22,4,49,2,1,3
4342,2014,11,2014-11-22,Ohio State,,Indiana,W (42-27),25,35,71.4,302,4,39,225,5.8,1,74,527,7.1,13,11,0,24,3,25,1,2,3
4343,2014,12,2014-11-29,Ohio State,,Michigan,W (42-28),15,24,62.5,183,1,39,233,6.0,4,63,416,6.6,8,11,1,20,9,84,0,0,0
4344,2014,13,2014-12-06,Ohio State,N,Wisconsin,W (59-0),12,18,66.7,257,3,38,301,7.9,4,56,558,10.0,10,12,2,24,5,44,0,0,0
4345,2014,14,2015-01-01,Ohio State,N,Alabama*,W (42-35),19,36,52.8,256,2,42,281,6.7,2,78,537,6.9,10,12,1,23,4,24,1,1,2
4346,2014,15,2015-01-12,Ohio State,N,Oregon*,W (42-20),16,23,69.6,242,1,61,296,4.9,5,84,538,6.4,8,18,2,28,5,30,3,1,4
4347,2014,,15 Games,Ohio State,,,,260,409,63.6,3707,42,690,3967,5.7,41,1099,7674,7.0,150,217,19,386,84,711,14,12,26
4348,2015,1,2015-09-07,Ohio State,@,Virginia Tech,W (42-24),10,19,52.6,212,3,37,360,9.7,3,56,572,10.2,8,11,2,21,6,58,2,1,3
4349,2015,2,2015-09-12,Ohio State,,Hawaii,W (38-0),20,34,58.8,181,0,49,182,3.7,4,83,363,4.4,11,13,2,26,7,115,0,0,0
4350,2015,3,2015-09-19,Ohio State,,Northern Illinois,W (20-13),16,29,55.2,136,1,37,162,4.4,0,66,298,4.5,6,8,0,14,6,39,2,3,5
4351,2015,4,2015-09-26,Ohio State,,Western Michigan,W (38-12),20,36,55.6,288,2,34,223,6.6,2,70,511,7.3,13,11,1,25,12,86,0,2,2
4352,2015,5,2015-10-03,Ohio State,@,Indiana,W (34-27),18,27,66.7,245,1,34,272,8.0,3,61,517,8.5,8,5,0,13,8,109,2,1,3
4353,2015,6,2015-10-10,Ohio State,,Maryland,W (49-28),23,30,76.7,317,2,47,182,3.9,5,77,499,6.5,15,13,3,31,6,45,0,0,0
4354,2015,7,2015-10-17,Ohio State,,Penn State,W (38-10),13,19,68.4,114,2,50,315,6.3,3,69,429,6.2,7,18,0,25,5,70,0,0,0
4355,2015,8,2015-10-24,Ohio State,@,Rutgers,W (49-7),17,21,81.0,247,3,49,281,5.7,4,70,528,7.5,12,13,2,27,0,0,1,0,1
4356,2015,9,2015-11-07,Ohio State,,Minnesota,W (28-14),12,22,54.5,187,1,44,189,4.3,2,66,376,5.7,9,9,0,18,5,45,1,0,1
4357,2015,10,2015-11-14,Ohio State,@,Illinois,W (28-3),17,25,68.0,157,1,50,283,5.7,3,75,440,5.9,8,14,1,23,7,40,1,1,2
4358,2015,11,2015-11-21,Ohio State,,Michigan State,L (14-17),9,16,56.3,46,1,29,86,3.0,1,45,132,2.9,1,4,0,5,4,20,0,0,0
4359,2015,12,2015-11-28,Ohio State,@,Michigan,W (42-13),9,15,60.0,113,1,54,369,6.8,5,69,482,7.0,4,18,3,25,5,39,0,0,0
4360,2015,13,2016-01-01,Ohio State,N,Notre Dame*,W (44-28),19,31,61.3,211,1,54,285,5.3,4,85,496,5.8,12,14,1,27,4,45,0,1,1
4361,2015,,13 Games,Ohio State,,,,203,324,62.7,2454,19,568,3189,5.6,39,892,5643,6.3,114,151,15,280,75,711,9,9,18
4362,2016,1,2016-09-03,Ohio State,,Bowling Green State,W (77-10),27,39,69.2,417,7,55,359,6.5,3,94,776,8.3,14,25,2,41,9,66,0,1,1
4363,2016,2,2016-09-10,Ohio State,,Tulsa,W (48-3),14,22,63.6,149,0,48,268,5.6,4,70,417,6.0,7,12,1,20,9,67,1,0,1
4364,2016,3,2016-09-17,Ohio State,@,Oklahoma,W (45-24),14,20,70.0,152,4,48,291,6.1,1,68,443,6.5,7,14,1,22,11,75,0,0,0
4365,2016,4,2016-10-01,Ohio State,,Rutgers,W (58-0),25,36,69.4,259,4,53,410,7.7,4,89,669,7.5,10,21,1,32,6,64,0,1,1
4366,2016,5,2016-10-08,Ohio State,,Indiana,W (38-17),9,21,42.9,93,1,50,290,5.8,4,71,383,5.4,3,15,0,18,9,83,1,1,2
4367,2016,6,2016-10-15,Ohio State,@,Wisconsin,W (30-23),17,29,58.6,226,1,45,185,4.1,2,74,411,5.6,10,12,1,23,4,40,0,1,1
4368,2016,7,2016-10-22,Ohio State,@,Penn State,L (21-24),28,43,65.1,245,1,40,168,4.2,1,83,413,5.0,9,9,1,19,8,45,0,0,0
4369,2016,8,2016-10-29,Ohio State,,Northwestern,W (24-20),21,32,65.6,223,0,41,208,5.1,3,73,431,5.9,10,13,0,23,2,10,0,0,0
4370,2016,9,2016-11-05,Ohio State,,Nebraska,W (62-3),32,44,72.7,352,4,42,238,5.7,2,86,590,6.9,17,15,2,34,4,35,1,0,1
4371,2016,10,2016-11-12,Ohio State,@,Maryland,W (62-3),24,36,66.7,328,3,43,253,5.9,5,79,581,7.4,15,13,4,32,6,55,0,0,0
4372,2016,11,2016-11-19,Ohio State,@,Michigan State,W (17-16),10,22,45.5,86,1,45,224,5.0,1,67,310,4.6,3,11,2,16,4,40,1,0,1
4373,2016,12,2016-11-26,Ohio State,,Michigan,W (30-27),15,32,46.9,124,0,50,206,4.1,3,82,330,4.0,7,13,3,23,2,6,0,1,1
4374,2016,13,2016-12-31,Ohio State,N,Clemson,L (0-31),19,33,57.6,127,0,23,88,3.8,0,56,215,3.8,4,3,2,9,8,72,1,2,3
4375,2016,,13 Games,Ohio State,,,,255,409,62.3,2781,26,583,3188,5.5,33,992,5969,6.0,116,176,20,312,82,658,5,7,12
4376,2017,1,2017-08-31,Ohio State,@,Indiana,W (49-21),20,35,57.1,304,3,51,292,5.7,3,86,596,6.9,10,14,2,26,5,50,0,0,0
4377,2017,2,2017-09-09,Ohio State,,Oklahoma,L (16-31),19,35,54.3,183,0,34,167,4.9,1,69,350,5.1,9,11,1,21,9,87,0,1,1
4378,2017,3,2017-09-16,Ohio State,,Army,W (38-7),29,37,78.4,316,2,32,270,8.4,3,69,586,8.5,12,18,0,30,5,55,0,0,0
4379,2017,4,2017-09-23,Ohio State,,Nevada-Las Vegas,W (54-21),31,44,70.5,474,7,40,190,4.8,0,84,664,7.9,17,16,1,34,8,85,2,1,3
4380,2017,5,2017-09-30,Ohio State,@,Rutgers,W (56-0),20,31,64.5,353,4,36,278,7.7,4,67,631,9.4,11,11,2,24,10,106,0,0,0
4381,2017,6,2017-10-07,Ohio State,,Maryland,W (62-14),23,36,63.9,303,3,50,281,5.6,5,86,584,6.8,15,13,5,33,8,85,2,0,2
4382,2017,7,2017-10-14,Ohio State,@,Nebraska,W (56-14),31,39,79.5,354,5,47,279,5.9,3,86,633,7.4,19,18,4,41,7,53,0,0,0
4383,2017,8,2017-10-28,Ohio State,,Penn State,W (39-38),33,39,84.6,328,4,39,201,5.2,1,78,529,6.8,14,10,3,27,10,79,2,0,2
4384,2017,9,2017-11-04,Ohio State,@,Iowa,L (24-55),18,34,52.9,208,3,30,163,5.4,0,64,371,5.8,9,10,1,20,9,95,0,4,4
4385,2017,10,2017-11-11,Ohio State,,Michigan State,W (48-3),15,23,65.2,189,2,42,335,8.0,4,65,524,8.1,9,13,3,25,2,27,0,2,2
4386,2017,11,2017-11-18,Ohio State,,Illinois,W (52-14),16,29,55.2,218,3,59,325,5.5,4,88,543,6.2,11,14,2,27,7,68,1,0,1
4387,2017,12,2017-11-25,Ohio State,@,Michigan,W (31-20),9,15,60.0,124,1,48,226,4.7,3,63,350,5.6,4,11,2,17,9,75,0,0,0
4388,2017,13,2017-12-02,Ohio State,N,Wisconsin,W (27-21),12,26,46.2,211,2,42,238,5.7,1,68,449,6.6,5,9,2,16,5,48,1,2,3
4389,2017,14,2017-12-29,Ohio State,N,Southern California*,W (24-7),11,17,64.7,114,0,38,163,4.3,2,55,277,5.0,5,6,2,13,3,30,1,0,1
4390,2017,,14 Games,Ohio State,,,,287,440,65.2,3679,39,588,3408,5.8,34,1028,7087,6.9,150,174,30,354,97,943,9,10,19
4391,2014,1,2014-08-30,Oklahoma,,Louisiana Tech,W (48-16),19,34,55.9,253,1,40,183,4.6,5,74,436,5.9,13,11,2,26,3,34,1,1,2
4392,2014,2,2014-09-06,Oklahoma,@,Tulsa,W (52-7),24,38,63.2,319,2,31,261,8.4,4,69,580,8.4,14,9,3,26,5,60,0,0,0
4393,2014,3,2014-09-13,Oklahoma,,Tennessee,W (34-10),20,33,60.6,308,1,34,146,4.3,2,67,454,6.8,14,7,0,21,5,41,1,1,2
4394,2014,4,2014-09-20,Oklahoma,@,West Virginia,W (45-33),17,30,56.7,209,1,46,301,6.5,4,76,510,6.7,10,13,1,24,8,82,0,1,1
4395,2014,5,2014-10-04,Oklahoma,@,Texas Christian,L (33-37),14,36,38.9,309,1,42,152,3.6,3,78,461,5.9,8,10,1,19,7,73,0,2,2
4396,2014,6,2014-10-11,Oklahoma,N,Texas,W (31-26),12,20,60.0,129,1,30,103,3.4,1,50,232,4.6,6,5,0,11,3,20,0,0,0
4397,2014,7,2014-10-18,Oklahoma,,Kansas State,L (30-31),28,36,77.8,335,3,42,198,4.7,1,78,533,6.8,15,14,1,30,3,19,0,2,2
4398,2014,8,2014-11-01,Oklahoma,@,Iowa State,W (59-14),23,43,53.5,241,3,59,510,8.6,5,102,751,7.4,11,29,1,41,5,60,0,3,3
4399,2014,9,2014-11-08,Oklahoma,,Baylor,L (14-48),13,29,44.8,148,2,33,171,5.2,0,62,319,5.1,5,8,0,13,7,59,0,1,1
4400,2014,10,2014-11-15,Oklahoma,@,Texas Tech,W (42-30),10,20,50.0,133,1,51,384,7.5,5,71,517,7.3,6,18,1,25,9,67,0,3,3
4401,2014,11,2014-11-22,Oklahoma,,Kansas,W (44-7),3,13,23.1,39,0,55,510,9.3,5,68,549,8.1,3,15,1,19,4,25,2,0,2
4402,2014,12,2014-12-06,Oklahoma,,Oklahoma State,L (35-38),10,17,58.8,120,1,63,304,4.8,4,80,424,5.3,7,11,3,21,3,28,1,0,1
4403,2014,13,2014-12-29,Oklahoma,N,Clemson*,L (6-40),17,37,45.9,103,0,31,172,5.5,1,68,275,4.0,6,11,0,17,8,80,2,3,5
4404,2014,,13 Games,Oklahoma,,,,210,386,54.4,2646,17,557,3395,6.1,40,943,6041,6.4,118,161,14,293,70,648,7,17,24
4405,2015,1,2015-09-05,Oklahoma,,Akron,W (41-3),28,42,66.7,439,3,33,100,3.0,2,75,539,7.2,18,5,3,26,9,90,1,1,2
4406,2015,2,2015-09-12,Oklahoma,@,Tennessee,W (31-24),19,39,48.7,187,3,48,161,3.4,1,87,348,4.0,7,9,4,20,9,67,0,2,2
4407,2015,3,2015-09-19,Oklahoma,,Tulsa,W (52-38),32,38,84.2,487,4,47,286,6.1,3,85,773,9.1,22,14,3,39,8,85,2,0,2
4408,2015,4,2015-10-03,Oklahoma,,West Virginia,W (44-24),14,25,56.0,320,3,33,107,3.2,1,58,427,7.4,11,3,2,16,12,134,1,1,2
4409,2015,5,2015-10-10,Oklahoma,N,Texas,L (17-24),20,28,71.4,211,1,37,67,1.8,1,65,278,4.3,12,6,3,21,5,45,1,0,1
4410,2015,6,2015-10-17,Oklahoma,@,Kansas State,W (55-0),25,32,78.1,336,5,52,232,4.5,1,84,568,6.8,18,12,0,30,3,24,0,0,0
4411,2015,7,2015-10-24,Oklahoma,,Texas Tech,W (63-27),15,22,68.2,212,2,57,405,7.1,7,79,617,7.8,9,24,2,35,3,34,1,1,2
4412,2015,8,2015-10-31,Oklahoma,@,Kansas,W (62-7),33,41,80.5,445,5,41,265,6.5,3,82,710,8.7,19,11,5,35,4,40,2,0,2
4413,2015,9,2015-11-07,Oklahoma,,Iowa State,W (52-16),25,33,75.8,405,4,39,279,7.2,3,72,684,9.5,14,13,1,28,2,10,1,0,1
4414,2015,10,2015-11-14,Oklahoma,@,Baylor,W (44-34),24,34,70.6,270,3,53,241,4.5,3,87,511,5.9,13,12,3,28,8,83,0,1,1
4415,2015,11,2015-11-21,Oklahoma,,Texas Christian,W (30-29),14,37,37.8,203,2,59,333,5.6,1,96,536,5.6,10,17,1,28,8,90,0,1,1
4416,2015,12,2015-11-28,Oklahoma,@,Oklahoma State,W (58-23),17,25,68.0,180,2,42,344,8.2,5,67,524,7.8,11,11,1,23,4,33,0,0,0
4417,2015,13,2015-12-31,Oklahoma,N,Clemson*,L (17-37),26,43,60.5,311,1,33,67,2.0,1,76,378,5.0,16,6,2,24,5,65,0,2,2
4418,2015,,13 Games,Oklahoma,,,,292,439,66.5,4006,38,574,2887,5.0,32,1013,6893,6.8,180,143,30,353,80,800,9,9,18
4419,2016,1,2016-09-03,Oklahoma,N,Houston,L (23-33),24,34,70.6,323,2,26,70,2.7,1,60,393,6.6,11,5,1,17,5,66,2,0,2
4420,2016,2,2016-09-10,Oklahoma,,Louisiana-Monroe,W (59-17),26,35,74.3,352,5,46,288,6.3,3,81,640,7.9,18,11,1,30,4,30,1,0,1
4421,2016,3,2016-09-17,Oklahoma,,Ohio State,L (24-45),17,32,53.1,226,2,35,178,5.1,0,67,404,6.0,9,9,1,19,4,28,0,2,2
4422,2016,4,2016-10-01,Oklahoma,@,Texas Christian,W (52-46),23,30,76.7,274,2,48,260,5.4,5,78,534,6.8,11,10,2,23,5,54,2,0,2
4423,2016,5,2016-10-08,Oklahoma,N,Texas,W (45-40),22,31,71.0,390,3,55,282,5.1,3,86,672,7.8,14,14,0,28,5,55,2,2,4
4424,2016,6,2016-10-15,Oklahoma,,Kansas State,W (38-17),26,32,81.3,372,5,33,138,4.2,0,65,510,7.8,15,9,0,24,3,35,0,1,1
4425,2016,7,2016-10-22,Oklahoma,@,Texas Tech,W (66-59),27,36,75.0,545,7,40,309,7.7,2,76,854,11.2,21,12,0,33,6,60,0,0,0
4426,2016,8,2016-10-29,Oklahoma,,Kansas,W (56-3),20,33,60.6,271,4,38,267,7.0,2,71,538,7.6,14,9,1,24,6,45,1,0,1
4427,2016,9,2016-11-03,Oklahoma,@,Iowa State,W (34-24),25,34,73.5,328,4,42,149,3.5,0,76,477,6.3,16,11,1,28,5,50,0,1,1
4428,2016,10,2016-11-12,Oklahoma,,Baylor,W (45-24),20,25,80.0,300,2,50,253,5.1,4,75,553,7.4,14,9,0,23,3,30,0,1,1
4429,2016,11,2016-11-19,Oklahoma,@,West Virginia,W (56-28),9,15,60.0,169,2,64,316,4.9,5,79,485,6.1,7,15,5,27,6,72,0,1,1
4430,2016,12,2016-12-03,Oklahoma,,Oklahoma State,W (38-20),13,19,68.4,288,3,52,341,6.6,2,71,629,8.9,12,11,2,25,4,54,1,0,1
4431,2016,13,2017-01-02,Oklahoma,N,Auburn*,W (35-19),19,28,67.9,296,2,43,228,5.3,3,71,524,7.4,14,11,3,28,10,100,0,0,0
4432,2016,,13 Games,Oklahoma,,,,271,384,70.6,4134,43,572,3079,5.4,30,956,7213,7.5,176,136,17,329,66,679,9,8,17
4433,2017,1,2017-09-02,Oklahoma,,Texas-El Paso,W (56-7),32,36,88.9,496,4,38,180,4.7,4,74,676,9.1,23,14,1,35,5,60,0,0,0
4434,2017,2,2017-09-09,Oklahoma,@,Ohio State,W (31-16),27,35,77.1,386,3,37,104,2.8,1,72,490,6.8,17,6,4,27,3,26,2,0,2
4435,2017,3,2017-09-16,Oklahoma,,Tulane,W (56-14),20,30,66.7,434,5,32,197,6.2,2,62,631,10.2,15,8,1,24,4,37,2,0,2
4436,2017,4,2017-09-23,Oklahoma,@,Baylor,W (49-41),13,19,68.4,283,3,40,342,8.6,4,59,625,10.6,8,12,0,20,10,105,1,0,1
4437,2017,5,2017-10-07,Oklahoma,,Iowa State,L (31-38),25,34,73.5,323,2,35,190,5.4,2,69,513,7.4,18,10,0,28,6,59,1,0,1
4438,2017,6,2017-10-14,Oklahoma,N,Texas,W (29-24),18,28,64.3,344,2,39,174,4.5,1,67,518,7.7,8,12,0,20,8,81,0,1,1
4439,2017,7,2017-10-21,Oklahoma,@,Kansas State,W (42-35),32,41,78.0,410,2,38,209,5.5,3,79,619,7.8,18,10,0,28,5,37,1,1,2
4440,2017,8,2017-10-28,Oklahoma,,Texas Tech,W (49-27),22,34,64.7,281,4,47,336,7.1,3,81,617,7.6,15,14,2,31,7,94,0,1,1
4441,2017,9,2017-11-04,Oklahoma,@,Oklahoma State,W (62-52),24,36,66.7,598,5,40,187,4.7,3,76,785,10.3,19,10,1,30,9,81,0,2,2
4442,2017,10,2017-11-11,Oklahoma,,Texas Christian,W (38-20),18,27,66.7,333,3,41,200,4.9,2,68,533,7.8,12,8,1,21,4,29,0,0,0
4443,2017,11,2017-11-18,Oklahoma,@,Kansas,W (41-3),23,35,65.7,312,3,36,157,4.4,2,71,469,6.6,15,6,3,24,8,63,0,0,0
4444,2017,12,2017-11-25,Oklahoma,,West Virginia,W (59-31),16,19,84.2,333,4,35,313,8.9,4,54,646,12.0,13,12,2,27,9,102,0,0,0
4445,2017,13,2017-12-02,Oklahoma,N,Texas Christian,W (41-17),15,23,65.2,243,4,43,218,5.1,0,66,461,7.0,10,10,2,22,3,30,0,0,0
4446,2017,14,2018-01-01,Oklahoma,N,Georgia*,L (48-54),24,36,66.7,289,3,45,242,5.4,2,81,531,6.6,11,11,2,24,1,5,0,1,1
4447,2017,,14 Games,Oklahoma,,,,309,433,71.4,5065,47,546,3049,5.6,33,979,8114,8.3,202,143,19,361,82,809,7,6,13
4448,2014,1,2014-08-30,Oklahoma State,N,Florida State,L (31-37),15,28,53.6,203,1,42,161,3.8,3,70,364,5.2,9,9,4,22,7,70,1,1,2
4449,2014,2,2014-09-06,Oklahoma State,,Missouri State,W (40-23),21,35,60.0,274,2,35,206,5.9,2,70,480,6.9,10,10,2,22,5,45,0,0,0
4450,2014,3,2014-09-13,Oklahoma State,,Texas-San Antonio,W (43-13),16,30,53.3,315,2,49,162,3.3,2,79,477,6.0,12,8,4,24,5,45,0,0,0
4451,2014,4,2014-09-25,Oklahoma State,,Texas Tech,W (45-35),17,31,54.8,370,4,42,158,3.8,2,73,528,7.2,12,7,3,22,10,129,0,2,2
4452,2014,5,2014-10-04,Oklahoma State,,Iowa State,W (37-20),26,41,63.4,271,1,42,129,3.1,2,83,400,4.8,12,10,3,25,7,40,0,2,2
4453,2014,6,2014-10-11,Oklahoma State,@,Kansas,W (27-20),17,31,54.8,161,1,37,114,3.1,1,68,275,4.0,7,5,3,15,7,44,1,1,2
4454,2014,7,2014-10-18,Oklahoma State,@,Texas Christian,L (9-42),10,25,40.0,132,0,39,126,3.2,0,64,258,4.0,5,7,0,12,4,23,0,2,2
4455,2014,8,2014-10-25,Oklahoma State,,West Virginia,L (10-34),21,41,51.2,242,1,39,194,5.0,0,80,436,5.5,15,7,1,23,4,30,0,2,2
4456,2014,9,2014-11-01,Oklahoma State,@,Kansas State,L (14-48),12,23,52.2,148,0,40,112,2.8,1,63,260,4.1,7,8,0,15,5,54,1,2,3
4457,2014,10,2014-11-15,Oklahoma State,,Texas,L (7-28),17,29,58.6,158,1,23,34,1.5,0,52,192,3.7,7,2,0,9,5,70,1,1,2
4458,2014,11,2014-11-22,Oklahoma State,@,Baylor,L (28-49),13,25,52.0,281,2,43,116,2.7,2,68,397,5.8,8,6,3,17,4,45,0,2,2
4459,2014,12,2014-12-06,Oklahoma State,@,Oklahoma,W (38-35),19,35,54.3,273,2,26,112,4.3,2,61,385,6.3,11,6,1,18,9,55,0,1,1
4460,2014,13,2015-01-02,Oklahoma State,N,Washington*,W (30-22),18,27,66.7,321,2,49,152,3.1,1,76,473,6.2,13,7,2,22,7,50,1,1,2
4461,2014,,13 Games,Oklahoma State,,,,222,401,55.4,3149,19,506,1776,3.5,18,907,4925,5.4,128,92,26,246,79,700,5,17,22
4462,2015,1,2015-09-03,Oklahoma State,@,Central Michigan,W (24-13),22,32,68.8,266,1,35,153,4.4,2,67,419,6.3,13,6,0,19,4,35,0,0,0
4463,2015,2,2015-09-12,Oklahoma State,,Central Arkansas,W (32-8),25,39,64.1,414,3,35,164,4.7,1,74,578,7.8,13,12,0,25,8,65,0,1,1
4464,2015,3,2015-09-19,Oklahoma State,,Texas-San Antonio,W (69-14),19,26,73.1,312,3,40,217,5.4,3,66,529,8.0,11,11,0,22,5,45,1,0,1
4465,2015,4,2015-09-26,Oklahoma State,@,Texas,W (30-27),24,36,66.7,292,2,46,103,2.2,1,82,395,4.8,17,4,6,27,7,40,1,2,3
4466,2015,5,2015-10-03,Oklahoma State,,Kansas State,W (36-34),35,56,62.5,441,4,27,49,1.8,1,83,490,5.9,23,2,1,26,8,95,1,1,2
4467,2015,6,2015-10-10,Oklahoma State,@,West Virginia,W (33-26),22,43,51.2,228,1,38,134,3.5,2,81,362,4.5,11,5,4,20,7,55,0,3,3
4468,2015,7,2015-10-24,Oklahoma State,,Kansas,W (58-10),27,36,75.0,381,3,47,202,4.3,4,83,583,7.0,15,15,3,33,2,25,0,0,0
4469,2015,8,2015-10-31,Oklahoma State,@,Texas Tech,W (70-53),27,43,62.8,478,5,36,184,5.1,3,79,662,8.4,20,8,1,29,7,65,0,1,1
4470,2015,9,2015-11-07,Oklahoma State,,Texas Christian,W (49-29),18,27,66.7,375,5,26,81,3.1,1,53,456,8.6,13,1,2,16,7,67,0,0,0
4471,2015,10,2015-11-14,Oklahoma State,@,Iowa State,W (35-31),26,38,68.4,343,2,48,154,3.2,3,86,497,5.8,17,11,0,28,6,48,1,0,1
4472,2015,11,2015-11-21,Oklahoma State,,Baylor,L (35-45),28,51,54.9,433,4,23,8,0.3,1,74,441,6.0,15,3,1,19,4,25,0,0,0
4473,2015,12,2015-11-28,Oklahoma State,,Oklahoma,L (23-58),25,45,55.6,325,2,29,132,4.6,0,74,457,6.2,15,5,2,22,2,10,0,2,2
4474,2015,13,2016-01-01,Oklahoma State,N,Mississippi*,L (20-48),27,45,60.0,303,0,30,63,2.1,2,75,366,4.9,14,5,1,20,7,77,1,0,1
4475,2015,,13 Games,Oklahoma State,,,,325,517,62.9,4591,35,460,1644,3.6,24,977,6235,6.4,197,88,21,306,74,652,5,10,15
4476,2016,1,2016-09-03,Oklahoma State,,Southeastern Louisiana,W (61-7),25,35,71.4,253,2,38,144,3.8,4,73,397,5.4,14,9,0,23,5,55,1,0,1
4477,2016,2,2016-09-10,Oklahoma State,,Central Michigan,L (27-30),28,44,63.6,288,3,26,50,1.9,0,70,338,4.8,17,3,3,23,4,40,0,1,1
4478,2016,3,2016-09-17,Oklahoma State,,Pittsburgh,W (45-38),26,46,56.5,540,2,32,100,3.1,4,78,640,8.2,17,5,3,25,8,55,2,0,2
4479,2016,4,2016-09-24,Oklahoma State,@,Baylor,L (24-35),27,46,58.7,279,0,55,213,3.9,3,101,492,4.9,15,12,3,30,4,32,3,1,4
4480,2016,5,2016-10-01,Oklahoma State,,Texas,W (49-31),19,28,67.9,392,3,43,163,3.8,3,71,555,7.8,13,8,1,22,7,70,0,0,0
4481,2016,6,2016-10-08,Oklahoma State,,Iowa State,W (38-31),26,44,59.1,351,4,33,108,3.3,1,77,459,6.0,13,7,0,20,5,63,0,0,0
4482,2016,7,2016-10-22,Oklahoma State,@,Kansas,W (44-20),18,27,66.7,252,1,46,230,5.0,4,73,482,6.6,8,15,0,23,5,45,1,0,1
4483,2016,8,2016-10-29,Oklahoma State,,West Virginia,W (37-20),26,36,72.2,273,3,31,85,2.7,1,67,358,5.3,13,2,2,17,3,30,0,0,0
4484,2016,9,2016-11-05,Oklahoma State,@,Kansas State,W (43-37),29,38,76.3,457,5,26,180,6.9,1,64,637,10.0,20,8,1,29,7,67,1,2,3
4485,2016,10,2016-11-12,Oklahoma State,,Texas Tech,W (45-44),20,28,71.4,395,2,38,210,5.5,4,66,605,9.2,16,11,0,27,7,80,1,0,1
4486,2016,11,2016-11-19,Oklahoma State,@,Texas Christian,W (31-6),17,35,48.6,207,1,45,334,7.4,3,80,541,6.8,7,18,3,28,6,42,1,0,1
4487,2016,12,2016-12-03,Oklahoma State,@,Oklahoma,L (20-38),11,25,44.0,186,0,37,217,5.9,2,62,403,6.5,6,10,1,17,3,22,0,0,0
4488,2016,13,2016-12-29,Oklahoma State,N,Colorado*,W (38-8),23,33,69.7,338,3,41,189,4.6,2,74,527,7.1,15,8,1,24,5,42,0,0,0
4489,2016,,13 Games,Oklahoma State,,,,295,465,63.4,4211,29,491,2223,4.5,32,956,6434,6.7,174,116,18,308,69,643,10,4,14
4490,2017,1,2017-08-31,Oklahoma State,,Tulsa,W (59-24),21,26,80.8,308,3,37,332,9.0,4,63,640,10.2,8,15,2,25,5,51,2,0,2
4491,2017,2,2017-09-08,Oklahoma State,@,South Alabama,W (44-7),26,41,63.4,342,3,37,163,4.4,1,78,505,6.5,19,8,2,29,4,25,0,0,0
4492,2017,3,2017-09-16,Oklahoma State,@,Pittsburgh,W (59-21),26,37,70.3,572,5,32,131,4.1,2,69,703,10.2,19,7,1,27,4,30,1,1,2
4493,2017,4,2017-09-23,Oklahoma State,,Texas Christian,L (31-44),22,42,52.4,398,2,31,101,3.3,2,73,499,6.8,17,8,1,26,8,77,1,3,4
4494,2017,5,2017-09-30,Oklahoma State,@,Texas Tech,W (41-34),27,38,71.1,376,3,44,221,5.0,2,82,597,7.3,20,9,3,32,8,78,0,1,1
4495,2017,6,2017-10-14,Oklahoma State,,Baylor,W (59-16),20,33,60.6,471,3,38,276,7.3,5,71,747,10.5,15,12,2,29,5,40,2,0,2
4496,2017,7,2017-10-21,Oklahoma State,@,Texas,W (13-10),25,38,65.8,282,0,51,146,2.9,1,89,428,4.8,12,10,4,26,2,20,1,0,1
4497,2017,8,2017-10-28,Oklahoma State,@,West Virginia,W (50-39),20,34,58.8,216,3,56,246,4.4,4,90,462,5.1,12,14,1,27,6,56,3,1,4
4498,2017,9,2017-11-04,Oklahoma State,,Oklahoma,L (52-62),28,54,51.9,448,5,34,213,6.3,2,88,661,7.5,17,10,5,32,5,40,1,2,3
4499,2017,10,2017-11-11,Oklahoma State,@,Iowa State,W (49-42),25,31,80.6,376,3,37,146,3.9,3,68,522,7.7,15,7,1,23,9,105,0,0,0
4500,2017,11,2017-11-18,Oklahoma State,,Kansas State,L (40-45),32,53,60.4,425,3,31,85,2.7,2,84,510,6.1,23,4,3,30,2,20,0,2,2
4501,2017,12,2017-11-25,Oklahoma State,,Kansas,W (58-17),32,44,72.7,494,2,42,167,4.0,5,86,661,7.7,20,7,2,29,4,30,0,0,0
4502,2017,13,2017-12-28,Oklahoma State,N,Virginia Tech*,W (30-21),21,32,65.6,351,2,31,141,4.5,1,63,492,7.8,16,7,1,24,4,20,0,0,0
4503,2017,,13 Games,Oklahoma State,,,,325,503,64.6,5059,37,501,2368,4.7,34,1004,7427,7.4,213,118,28,359,66,592,11,10,21
4504,2014,1,2014-09-06,Old Dominion,@,North Carolina State,L (34-46),36,50,72.0,308,2,37,196,5.3,3,87,504,5.8,12,16,0,28,3,20,0,1,1
4505,2014,2,2014-09-13,Old Dominion,,Eastern Michigan,W (17-3),17,30,56.7,187,0,37,180,4.9,1,67,367,5.5,8,7,1,16,4,45,1,1,2
4506,2014,3,2014-09-20,Old Dominion,@,Rice,W (45-42),27,43,62.8,430,5,21,100,4.8,1,64,530,8.3,17,7,1,25,5,55,0,0,0
4507,2014,4,2014-09-26,Old Dominion,,Middle Tennessee State,L (28-41),29,44,65.9,362,4,19,41,2.2,0,63,403,6.4,16,5,3,24,2,25,1,3,4
4508,2014,5,2014-10-04,Old Dominion,,Marshall,L (14-56),10,25,40.0,85,1,42,201,4.8,1,67,286,4.3,4,10,1,15,1,9,0,1,1
4509,2014,6,2014-10-11,Old Dominion,@,Texas-El Paso,L (35-42),13,25,52.0,196,3,28,161,5.8,2,53,357,6.7,9,6,1,16,4,35,0,0,0
4510,2014,7,2014-10-25,Old Dominion,@,Western Kentucky,L (51-66),27,40,67.5,471,3,34,172,5.1,4,74,643,8.7,19,9,1,29,5,51,1,2,3
4511,2014,8,2014-11-01,Old Dominion,@,Vanderbilt,L (28-42),21,36,58.3,291,2,12,45,3.8,1,48,336,7.0,13,1,2,16,4,48,0,1,1
4512,2014,9,2014-11-08,Old Dominion,,Florida International,W (38-35),20,35,57.1,315,2,35,210,6.0,3,70,525,7.5,12,10,4,26,1,10,1,0,1
4513,2014,10,2014-11-22,Old Dominion,,Louisiana Tech,W (30-27),29,40,72.5,302,2,32,93,2.9,2,72,395,5.5,16,6,1,23,3,35,0,4,4
4514,2014,11,2014-11-29,Old Dominion,@,Florida Atlantic,W (31-28),32,50,64.0,282,3,32,206,6.4,1,82,488,6.0,16,5,5,26,8,77,0,1,1
4515,2014,,11 Games,Old Dominion,,,,261,418,62.4,3229,27,329,1605,4.9,19,747,4834,6.5,142,82,20,244,40,410,4,14,18
4516,2015,1,2015-09-05,Old Dominion,@,Eastern Michigan,W (38-34),18,32,56.3,184,1,41,229,5.6,4,73,413,5.7,10,11,4,25,6,75,0,0,0
4517,2015,2,2015-09-12,Old Dominion,,Norfolk State,W (24-10),12,22,54.5,122,0,59,338,5.7,3,81,460,5.7,7,17,0,24,6,51,0,1,1
4518,2015,3,2015-09-19,Old Dominion,,North Carolina State,L (14-38),11,23,47.8,151,2,21,-3,-0.1,0,44,148,3.4,4,2,2,8,0,0,0,0,0
4519,2015,4,2015-09-26,Old Dominion,,Appalachian State,L (0-49),16,28,57.1,133,0,21,42,2.0,0,49,175,3.6,5,3,0,8,7,59,2,2,4
4520,2015,5,2015-10-03,Old Dominion,@,Marshall,L (7-27),13,37,35.1,101,0,43,184,4.3,1,80,285,3.6,3,12,1,16,3,10,2,2,4
4521,2015,6,2015-10-17,Old Dominion,,UNC Charlotte,W (37-34),26,46,56.5,367,4,31,115,3.7,0,77,482,6.3,16,6,2,24,6,50,1,1,2
4522,2015,7,2015-10-24,Old Dominion,@,Florida International,L (12-41),18,34,52.9,201,0,33,297,9.0,2,67,498,7.4,9,11,0,20,6,41,2,1,3
4523,2015,8,2015-10-31,Old Dominion,,Western Kentucky,L (30-55),19,34,55.9,195,3,37,147,4.0,1,71,342,4.8,9,11,0,20,2,20,1,0,1
4524,2015,9,2015-11-07,Old Dominion,@,Texas-San Antonio,W (36-31),29,48,60.4,378,2,37,170,4.6,2,85,548,6.4,21,7,2,30,0,0,0,1,1
4525,2015,10,2015-11-14,Old Dominion,,Texas-El Paso,W (31-21),26,42,61.9,291,2,31,150,4.8,2,73,441,6.0,16,5,1,22,5,41,0,0,0
4526,2015,11,2015-11-21,Old Dominion,@,Southern Mississippi,L (31-56),23,45,51.1,224,3,23,114,5.0,0,68,338,5.0,12,5,1,18,4,50,1,1,2
4527,2015,12,2015-11-28,Old Dominion,,Florida Atlantic,L (31-33),24,42,57.1,287,3,24,38,1.6,1,66,325,4.9,12,1,2,15,4,40,1,0,1
4528,2015,,12 Games,Old Dominion,,,,235,433,54.3,2634,20,401,1821,4.5,16,834,4455,5.3,124,91,15,230,49,437,10,9,19
4529,2016,1,2016-09-04,Old Dominion,,Hampton,W (54-21),14,29,48.3,253,4,38,211,5.6,2,67,464,6.9,9,9,2,20,9,66,1,0,1
4530,2016,2,2016-09-10,Old Dominion,@,Appalachian State,L (7-31),17,36,47.2,169,0,31,157,5.1,1,67,326,4.9,9,5,4,18,5,45,0,1,1
4531,2016,3,2016-09-17,Old Dominion,@,North Carolina State,L (22-49),17,27,63.0,204,2,32,117,3.7,1,59,321,5.4,9,5,1,15,7,50,0,0,0
4532,2016,4,2016-09-24,Old Dominion,,Texas-San Antonio,W (33-19),21,35,60.0,207,2,45,238,5.3,3,80,445,5.6,12,9,6,27,3,30,0,0,0
4533,2016,5,2016-10-01,Old Dominion,@,UNC Charlotte,W (52-17),17,29,58.6,274,3,40,207,5.2,4,69,481,7.0,12,10,0,22,10,85,1,1,2
4534,2016,6,2016-10-07,Old Dominion,,Massachusetts,W (36-16),20,35,57.1,248,1,47,274,5.8,3,82,522,6.4,14,12,3,29,5,49,0,0,0
4535,2016,7,2016-10-22,Old Dominion,@,Western Kentucky,L (24-59),19,34,55.9,263,2,23,67,2.9,1,57,330,5.8,10,2,1,13,7,61,0,1,1
4536,2016,8,2016-10-29,Old Dominion,@,Texas-El Paso,W (31-21),14,22,63.6,262,2,30,131,4.4,2,52,393,7.6,9,6,0,15,5,52,0,1,1
4537,2016,9,2016-11-05,Old Dominion,,Marshall,W (38-14),16,27,59.3,199,3,50,262,5.2,2,77,461,6.0,10,13,3,26,2,10,0,0,0
4538,2016,10,2016-11-12,Old Dominion,,Southern Mississippi,W (51-35),13,19,68.4,150,2,31,170,5.5,4,50,320,6.4,5,3,2,10,2,20,0,0,0
4539,2016,11,2016-11-19,Old Dominion,@,Florida Atlantic,W (42-24),26,36,72.2,416,5,43,207,4.8,0,79,623,7.9,15,12,4,31,3,15,0,0,0
4540,2016,12,2016-11-26,Old Dominion,,Florida International,W (42-28),15,25,60.0,209,2,51,312,6.1,4,76,521,6.9,11,14,2,27,3,24,2,1,3
4541,2016,13,2016-12-23,Old Dominion,N,Eastern Michigan*,W (24-20),11,20,55.0,188,3,39,206,5.3,0,59,394,6.7,7,13,0,20,5,65,0,1,1
4542,2016,,13 Games,Old Dominion,,,,220,374,58.8,3042,31,500,2559,5.1,27,874,5601,6.4,132,113,28,273,66,572,4,6,10
4543,2017,1,2017-09-02,Old Dominion,,Albany,W (31-17),18,26,69.2,187,1,31,98,3.2,3,57,285,5.0,7,5,3,15,3,30,1,2,3
4544,2017,2,2017-09-09,Old Dominion,@,Massachusetts,W (17-7),13,29,44.8,169,1,48,197,4.1,1,77,366,4.8,8,9,2,19,5,32,0,0,0
4545,2017,3,2017-09-16,Old Dominion,,North Carolina,L (23-53),14,32,43.8,214,2,33,102,3.1,0,65,316,4.9,6,5,3,14,3,38,2,1,3
4546,2017,4,2017-09-23,Old Dominion,@,Virginia Tech,L (0-38),8,26,30.8,85,0,24,64,2.7,0,50,149,3.0,3,3,1,7,5,35,0,1,1
4547,2017,5,2017-10-07,Old Dominion,,Florida Atlantic,L (28-58),16,39,41.0,163,2,36,248,6.9,2,75,411,5.5,8,8,4,20,4,29,0,4,4
4548,2017,6,2017-10-14,Old Dominion,@,Marshall,L (3-35),14,27,51.9,116,0,36,81,2.3,0,63,197,3.1,6,6,1,13,6,55,1,1,2
4549,2017,7,2017-10-20,Old Dominion,,Western Kentucky,L (31-35),17,25,68.0,180,0,48,268,5.6,4,73,448,6.1,11,9,0,20,9,84,1,3,4
4550,2017,8,2017-10-28,Old Dominion,@,North Texas,L (38-45),21,35,60.0,181,0,48,205,4.3,2,83,386,4.7,9,12,0,21,2,25,1,2,3
4551,2017,9,2017-11-04,Old Dominion,,UNC Charlotte,W (6-0),20,30,66.7,178,0,49,148,3.0,0,79,326,4.1,13,6,1,20,2,12,0,0,0
4552,2017,10,2017-11-11,Old Dominion,@,Florida International,W (37-30),17,24,70.8,240,2,36,199,5.5,2,60,439,7.3,10,8,3,21,2,15,0,0,0
4553,2017,11,2017-11-18,Old Dominion,,Rice,W (24-21),20,29,69.0,188,0,39,172,4.4,3,68,360,5.3,10,10,1,21,2,20,0,0,0
4554,2017,12,2017-11-25,Old Dominion,@,Middle Tennessee State,L (10-41),15,27,55.6,120,1,33,185,5.6,0,60,305,5.1,7,6,1,14,5,55,0,0,0
4555,2017,,12 Games,Old Dominion,,,,193,349,55.3,2021,9,461,1967,4.3,17,810,3988,4.9,98,87,20,205,48,430,6,14,20
4556,2014,1,2014-08-28,Ole Miss,N,Boise State,W (35-13),25,36,69.4,387,4,34,71,2.1,1,70,458,6.5,13,6,3,22,14,78,0,3,3
4557,2014,2,2014-09-06,Ole Miss,N,Vanderbilt,W (41-3),28,38,73.7,367,1,50,180,3.6,3,88,547,6.2,18,13,3,34,5,35,1,0,1
4558,2014,3,2014-09-13,Ole Miss,,Louisiana,W (56-15),29,36,80.6,340,4,35,214,6.1,3,71,554,7.8,18,9,0,27,4,30,0,1,1
4559,2014,4,2014-09-27,Ole Miss,,Memphis,W (24-3),22,37,59.5,248,2,42,178,4.2,1,79,426,5.4,13,9,4,26,10,117,2,2,4
4560,2014,5,2014-10-04,Ole Miss,,Alabama,W (23-17),18,31,58.1,251,3,32,76,2.4,0,63,327,5.2,12,4,0,16,3,25,1,0,1
4561,2014,6,2014-10-11,Ole Miss,@,Texas A&M,W (35-20),13,19,68.4,178,1,35,160,4.6,2,54,338,6.3,8,9,0,17,2,20,0,0,0
4562,2014,7,2014-10-18,Ole Miss,,Tennessee,W (34-3),14,31,45.2,203,2,47,180,3.8,2,78,383,4.9,8,10,0,18,1,15,0,0,0
4563,2014,8,2014-10-25,Ole Miss,@,Louisiana State,L (7-10),14,34,41.2,176,1,34,137,4.0,0,68,313,4.6,7,7,1,15,8,52,0,1,1
4564,2014,9,2014-11-01,Ole Miss,,Auburn,L (31-35),28,40,70.0,339,2,30,146,4.9,2,70,485,6.9,13,6,5,24,6,48,2,0,2
4565,2014,10,2014-11-08,Ole Miss,,Presbyterian,W (48-0),24,30,80.0,238,3,36,402,11.2,4,66,640,9.7,9,12,1,22,4,40,0,1,1
4566,2014,11,2014-11-22,Ole Miss,@,Arkansas,L (0-30),18,38,47.4,253,0,33,63,1.9,0,71,316,4.5,14,4,1,19,4,20,3,3,6
4567,2014,12,2014-11-29,Ole Miss,,Mississippi State,W (31-17),14,31,45.2,327,1,31,205,6.6,3,62,532,8.6,9,6,0,15,2,25,0,1,1
4568,2014,13,2014-12-31,Ole Miss,N,Texas Christian*,L (3-42),11,27,40.7,120,0,37,9,0.2,0,64,129,2.0,7,2,1,10,6,44,1,3,4
4569,2014,,13 Games,Ole Miss,,,,258,428,60.3,3427,24,476,2021,4.2,21,904,5448,6.0,149,97,19,265,69,549,10,15,25
4570,2015,1,2015-09-05,Ole Miss,,Tennessee-Martin,W (76-3),19,28,67.9,324,5,36,338,9.4,5,64,662,10.3,12,15,1,28,3,30,0,1,1
4571,2015,2,2015-09-12,Ole Miss,,Fresno State,W (73-21),26,37,70.3,392,4,35,215,6.1,4,72,607,8.4,17,9,1,27,5,58,2,1,3
4572,2015,3,2015-09-19,Ole Miss,@,Alabama,W (43-37),18,33,54.5,341,3,32,92,2.9,2,65,433,6.7,8,6,2,16,8,57,0,0,0
4573,2015,4,2015-09-26,Ole Miss,,Vanderbilt,W (27-16),24,42,57.1,321,1,42,151,3.6,2,84,472,5.6,13,11,6,30,11,119,0,2,2
4574,2015,5,2015-10-03,Ole Miss,@,Florida,L (10-38),26,40,65.0,259,1,33,69,2.1,0,73,328,4.5,14,7,2,23,5,30,3,1,4
4575,2015,6,2015-10-10,Ole Miss,,New Mexico State,W (52-3),25,35,71.4,400,3,34,265,7.8,4,69,665,9.6,16,14,1,31,3,23,2,1,3
4576,2015,7,2015-10-17,Ole Miss,@,Memphis,L (24-37),34,48,70.8,440,3,24,40,1.7,0,72,480,6.7,20,4,1,25,8,90,0,2,2
4577,2015,8,2015-10-24,Ole Miss,,Texas A&M,W (23-3),26,41,63.4,241,2,51,230,4.5,0,92,471,5.1,8,14,6,28,10,108,1,3,4
4578,2015,9,2015-10-31,Ole Miss,@,Auburn,W (27-19),34,52,65.4,402,2,39,156,4.0,1,91,558,6.1,18,9,0,27,7,40,0,2,2
4579,2015,10,2015-11-07,Ole Miss,,Arkansas,L (52-53),24,34,70.6,368,3,32,222,6.9,4,66,590,8.9,18,12,1,31,4,22,0,0,0
4580,2015,11,2015-11-21,Ole Miss,,Louisiana State,W (38-17),19,34,55.9,280,2,31,152,4.9,3,65,432,6.6,13,6,2,21,7,39,1,0,1
4581,2015,12,2015-11-28,Ole Miss,@,Mississippi State,W (38-27),21,30,70.0,236,2,37,243,6.6,2,67,479,7.1,11,14,1,26,3,11,0,0,0
4582,2015,13,2016-01-01,Ole Miss,N,Oklahoma State*,W (48-20),22,35,62.9,347,4,37,207,5.6,2,72,554,7.7,14,10,4,28,5,75,0,1,1
4583,2015,,13 Games,Ole Miss,,,,318,489,65.0,4351,35,463,2380,5.1,29,952,6731,7.1,182,131,28,341,79,702,9,14,23
4584,2016,1,2016-09-05,Ole Miss,N,Florida State,L (34-45),21,39,53.8,313,4,25,67,2.7,1,64,380,5.9,12,6,3,21,8,74,1,3,4
4585,2016,2,2016-09-10,Ole Miss,,Wofford,W (38-13),22,30,73.3,242,4,34,174,5.1,1,64,416,6.5,13,9,0,22,2,25,0,1,1
4586,2016,3,2016-09-17,Ole Miss,,Alabama,L (43-48),26,40,65.0,421,3,33,101,3.1,1,73,522,7.2,17,4,2,23,6,65,2,0,2
4587,2016,4,2016-09-24,Ole Miss,,Georgia,W (45-14),21,30,70.0,330,3,31,180,5.8,2,61,510,8.4,12,9,2,23,4,25,0,1,1
4588,2016,5,2016-10-01,Ole Miss,,Memphis,W (48-28),30,44,68.2,361,1,44,263,6.0,4,88,624,7.1,20,14,0,34,6,65,0,1,1
4589,2016,6,2016-10-15,Ole Miss,@,Arkansas,L (30-34),18,39,46.2,253,1,31,150,4.8,3,70,403,5.8,13,6,1,20,4,45,0,1,1
4590,2016,7,2016-10-22,Ole Miss,@,Louisiana State,L (21-38),20,33,60.6,218,1,36,107,3.0,1,69,325,4.7,11,5,3,19,4,30,0,2,2
4591,2016,8,2016-10-29,Ole Miss,,Auburn,L (29-40),36,59,61.0,465,3,31,105,3.4,0,90,570,6.3,26,5,1,32,6,35,0,1,1
4592,2016,9,2016-11-05,Ole Miss,,Georgia Southern,W (37-27),17,28,60.7,245,1,45,196,4.4,3,73,441,6.0,9,12,4,25,6,65,0,1,1
4593,2016,10,2016-11-12,Ole Miss,@,Texas A&M,W (29-28),25,42,59.5,338,2,47,152,3.2,1,89,490,5.5,15,12,3,30,4,20,1,1,2
4594,2016,11,2016-11-19,Ole Miss,@,Vanderbilt,L (17-38),26,51,51.0,273,2,27,90,3.3,0,78,363,4.7,12,4,2,18,6,51,1,0,1
4595,2016,12,2016-11-26,Ole Miss,,Mississippi State,L (20-55),27,48,56.3,320,2,38,208,5.5,0,86,528,6.1,17,13,1,31,3,20,0,2,2
4596,2016,,12 Games,Ole Miss,,,,289,483,59.8,3779,27,422,1793,4.2,17,905,5572,6.2,177,99,22,298,59,520,5,14,19
4597,2017,1,2017-09-02,Ole Miss,,South Alabama,W (47-27),28,35,80.0,429,4,29,102,3.5,1,64,531,8.3,16,7,0,23,7,45,1,0,1
4598,2017,2,2017-09-09,Ole Miss,,Tennessee-Martin,W (45-23),32,43,74.4,489,5,18,54,3.0,1,61,543,8.9,20,2,2,24,7,62,0,1,1
4599,2017,3,2017-09-16,Ole Miss,@,California,L (16-27),26,44,59.1,363,2,29,53,1.8,0,73,416,5.7,11,5,3,19,16,113,0,3,3
4600,2017,4,2017-09-30,Ole Miss,@,Alabama,L (3-66),14,29,48.3,165,0,26,88,3.4,0,55,253,4.6,5,4,2,11,3,30,0,2,2
4601,2017,5,2017-10-07,Ole Miss,@,Auburn,L (23-44),34,51,66.7,346,2,30,83,2.8,1,81,429,5.3,16,6,1,23,4,30,0,0,0
4602,2017,6,2017-10-14,Ole Miss,,Vanderbilt,W (57-35),22,35,62.9,351,4,41,252,6.1,3,76,603,7.9,13,12,2,27,11,79,0,0,0
4603,2017,7,2017-10-21,Ole Miss,,Louisiana State,L (24-40),17,34,50.0,194,0,28,153,5.5,2,62,347,5.6,10,9,2,21,5,55,0,3,3
4604,2017,8,2017-10-28,Ole Miss,,Arkansas,L (37-38),20,30,66.7,368,0,28,200,7.1,4,58,568,9.8,14,8,0,22,3,27,2,1,3
4605,2017,9,2017-11-04,Ole Miss,@,Kentucky,W (37-34),31,41,75.6,382,4,26,91,3.5,0,67,473,7.1,18,7,0,25,7,65,0,0,0
4606,2017,10,2017-11-11,Ole Miss,,Louisiana,W (50-22),28,36,77.8,418,3,43,223,5.2,4,79,641,8.1,18,10,2,30,2,20,0,1,1
4607,2017,11,2017-11-18,Ole Miss,,Texas A&M,L (24-31),19,34,55.9,189,2,39,202,5.2,1,73,391,5.4,6,10,3,19,13,102,1,1,2
4608,2017,12,2017-11-23,Ole Miss,@,Mississippi State,W (31-28),10,22,45.5,247,2,32,108,3.4,2,54,355,6.6,4,6,1,11,13,121,1,1,2
4609,2017,,12 Games,Ole Miss,,,,281,434,64.7,3941,28,369,1609,4.4,19,803,5550,6.9,151,86,18,255,91,749,5,13,18
4610,2014,1,2014-08-30,Oregon,,South Dakota,W (62-13),25,32,78.1,380,4,38,293,7.7,4,70,673,9.6,16,16,0,32,9,64,1,0,1
4611,2014,2,2014-09-06,Oregon,,Michigan State,W (46-27),17,28,60.7,318,3,40,173,4.3,3,68,491,7.2,10,7,2,19,9,70,0,0,0
4612,2014,3,2014-09-13,Oregon,,Wyoming,W (48-14),25,31,80.6,293,2,37,263,7.1,5,68,556,8.2,15,15,2,32,4,30,0,0,0
4613,2014,4,2014-09-20,Oregon,@,Washington State,W (38-31),21,25,84.0,329,5,42,172,4.1,0,67,501,7.5,10,10,2,22,10,86,0,0,0
4614,2014,5,2014-10-02,Oregon,,Arizona,L (24-31),21,33,63.6,302,3,41,144,3.5,0,74,446,6.0,18,4,3,25,10,79,2,0,2
4615,2014,6,2014-10-11,Oregon,@,UCLA,W (42-30),17,27,63.0,210,2,41,258,6.3,4,68,468,6.9,9,14,3,26,4,37,0,0,0
4616,2014,7,2014-10-18,Oregon,,Washington,W (45-20),24,33,72.7,336,2,50,218,4.4,4,83,554,6.7,15,13,1,29,7,90,0,0,0
4617,2014,8,2014-10-24,Oregon,@,California,W (59-41),18,30,60.0,326,5,46,264,5.7,2,76,590,7.8,12,13,2,27,10,106,1,1,2
4618,2014,9,2014-11-01,Oregon,,Stanford,W (45-16),19,31,61.3,258,2,46,267,5.8,4,77,525,6.8,13,15,2,30,7,60,0,1,1
4619,2014,10,2014-11-08,Oregon,@,Utah,W (51-27),17,29,58.6,239,3,50,269,5.4,2,79,508,6.4,10,15,2,27,8,73,1,0,1
4620,2014,11,2014-11-22,Oregon,,Colorado,W (44-10),26,36,72.2,332,3,41,265,6.5,3,77,597,7.8,18,11,1,30,8,98,0,0,0
4621,2014,12,2014-11-29,Oregon,@,Oregon State,W (47-19),19,25,76.0,367,4,40,198,5.0,2,65,565,8.7,12,13,1,26,8,77,1,0,1
4622,2014,13,2014-12-05,Oregon,N,Arizona,W (51-13),27,40,67.5,326,2,54,301,5.6,4,94,627,6.7,15,13,3,31,13,84,0,0,0
4623,2014,14,2015-01-01,Oregon,N,Florida State*,W (59-20),26,36,72.2,338,2,45,301,6.7,5,81,639,7.9,12,17,1,30,6,50,1,1,2
4624,2014,15,2015-01-12,Oregon,N,Ohio State*,L (20-42),24,38,63.2,333,2,33,132,4.0,0,71,465,6.5,13,7,0,20,10,76,0,1,1
4625,2014,,15 Games,Oregon,,,,326,474,68.8,4687,44,644,3518,5.5,42,1118,8205,7.3,198,183,25,406,123,1080,7,4,11
4626,2015,1,2015-09-05,Oregon,,Eastern Washington,W (61-42),19,25,76.0,246,2,57,485,8.5,6,82,731,8.9,11,21,2,34,8,70,1,0,1
4627,2015,2,2015-09-12,Oregon,@,Michigan State,L (28-31),22,39,56.4,309,1,43,123,2.9,2,82,432,5.3,17,7,2,26,9,56,0,2,2
4628,2015,3,2015-09-19,Oregon,,Georgia State,W (61-28),23,31,74.2,228,2,53,311,5.9,3,84,539,6.4,10,18,1,29,7,62,1,0,1
4629,2015,4,2015-09-26,Oregon,,Utah,L (20-62),14,30,46.7,178,2,40,222,5.6,1,70,400,5.7,9,10,1,20,10,90,1,2,3
4630,2015,5,2015-10-03,Oregon,@,Colorado,W (41-24),13,21,61.9,176,2,60,361,6.0,3,81,537,6.6,6,19,2,27,4,45,0,1,1
4631,2015,6,2015-10-10,Oregon,,Washington State,L (38-45),13,24,54.2,123,2,50,410,8.2,3,74,533,7.2,5,13,0,18,5,44,1,1,2
4632,2015,7,2015-10-17,Oregon,@,Washington,W (26-20),14,25,56.0,272,2,51,170,3.3,1,76,442,5.8,9,9,3,21,9,82,0,0,0
4633,2015,8,2015-10-29,Oregon,@,Arizona State,W (61-55),23,41,56.1,315,4,28,186,6.6,3,69,501,7.3,9,7,3,19,6,50,0,1,1
4634,2015,9,2015-11-07,Oregon,,California,W (44-28),17,29,58.6,300,4,63,477,7.6,1,92,777,8.4,11,23,2,36,10,90,0,2,2
4635,2015,10,2015-11-14,Oregon,@,Stanford,W (38-36),10,12,83.3,205,2,36,231,6.4,3,48,436,9.1,8,9,1,18,4,45,1,0,1
4636,2015,11,2015-11-21,Oregon,,Southern California,W (48-28),20,25,80.0,407,6,38,171,4.5,0,63,578,9.2,15,11,2,28,4,42,0,1,1
4637,2015,12,2015-11-27,Oregon,,Oregon State,W (52-42),28,38,73.7,366,3,51,308,6.0,4,89,674,7.6,16,17,4,37,9,93,1,0,1
4638,2015,13,2016-01-02,Oregon,N,Texas Christian*,L (41-47),20,35,57.1,233,1,48,186,3.9,4,83,419,5.0,11,9,1,21,5,24,1,0,1
4639,2015,,13 Games,Oregon,,,,236,375,62.9,3358,33,618,3641,5.9,34,993,6999,7.0,137,173,24,334,90,793,7,10,17
4640,2016,1,2016-09-03,Oregon,,California-Davis,W (53-28),21,30,70.0,271,3,37,251,6.8,4,67,522,7.8,12,8,1,21,8,71,2,0,2
4641,2016,2,2016-09-10,Oregon,,Virginia,W (44-26),21,31,67.7,331,3,45,301,6.7,3,76,632,8.3,11,10,4,25,12,117,0,0,0
4642,2016,3,2016-09-17,Oregon,@,Nebraska,L (32-35),14,23,60.9,146,0,47,336,7.1,5,70,482,6.9,5,14,1,20,13,126,0,0,0
4643,2016,4,2016-09-24,Oregon,,Colorado,L (38-41),22,33,66.7,293,2,45,215,4.8,3,78,508,6.5,14,8,2,24,8,75,0,1,1
4644,2016,5,2016-10-01,Oregon,@,Washington State,L (33-51),17,27,63.0,202,0,37,214,5.8,4,64,416,6.5,8,12,0,20,4,42,1,1,2
4645,2016,6,2016-10-08,Oregon,,Washington,L (21-70),21,34,61.8,179,2,43,230,5.3,1,77,409,5.3,9,11,2,22,5,40,1,1,2
4646,2016,7,2016-10-21,Oregon,@,California,L (49-52),22,40,55.0,258,6,45,192,4.3,1,85,450,5.3,13,9,5,27,14,134,0,1,1
4647,2016,8,2016-10-29,Oregon,,Arizona State,W (54-35),31,42,73.8,489,4,46,245,5.3,2,88,734,8.3,16,14,0,30,9,73,1,0,1
4648,2016,9,2016-11-05,Oregon,@,Southern California,L (20-45),20,37,54.1,203,1,30,85,2.8,2,67,288,4.3,9,7,3,19,7,43,0,0,0
4649,2016,10,2016-11-12,Oregon,,Stanford,L (27-52),21,30,70.0,274,2,45,226,5.0,2,75,500,6.7,11,10,3,24,8,77,2,2,4
4650,2016,11,2016-11-19,Oregon,@,Utah,W (30-28),30,43,69.8,324,3,43,251,5.8,1,86,575,6.7,17,10,0,27,5,37,1,0,1
4651,2016,12,2016-11-26,Oregon,@,Oregon State,L (24-34),17,29,58.6,213,2,30,171,5.7,1,59,384,6.5,9,9,3,21,6,75,1,0,1
4652,2016,,12 Games,Oregon,,,,257,399,64.4,3183,28,493,2717,5.5,29,892,5900,6.6,134,122,24,280,99,910,9,6,15
4653,2017,1,2017-09-02,Oregon,,Southern Utah,W (77-21),23,27,85.2,355,1,52,348,6.7,9,79,703,8.9,14,20,3,37,12,115,2,0,2
4654,2017,2,2017-09-09,Oregon,,Nebraska,W (42-35),25,33,75.8,365,3,44,201,4.6,3,77,566,7.4,10,11,1,22,12,103,1,1,2
4655,2017,3,2017-09-16,Oregon,@,Wyoming,W (49-13),18,30,60.0,251,1,65,307,4.7,6,95,558,5.9,12,18,2,32,4,40,2,1,3
4656,2017,4,2017-09-23,Oregon,@,Arizona State,L (35-37),19,35,54.3,281,3,30,120,4.0,2,65,401,6.2,11,5,4,20,14,99,1,0,1
4657,2017,5,2017-09-30,Oregon,,California,W (45-24),17,22,77.3,131,1,56,328,5.9,5,78,459,5.9,6,15,3,24,10,110,0,1,1
4658,2017,6,2017-10-07,Oregon,,Washington State,L (10-33),15,27,55.6,145,1,45,132,2.9,0,72,277,3.8,5,6,2,13,10,95,1,2,3
4659,2017,7,2017-10-14,Oregon,@,Stanford,L (7-49),5,13,38.5,33,0,43,276,6.4,1,56,309,5.5,3,9,0,12,9,101,1,2,3
4660,2017,8,2017-10-21,Oregon,@,UCLA,L (14-31),8,15,53.3,74,0,62,246,4.0,2,77,320,4.2,5,14,5,24,3,15,1,1,2
4661,2017,9,2017-10-28,Oregon,,Utah,W (41-20),10,13,76.9,69,2,49,347,7.1,2,62,416,6.7,3,15,1,19,8,60,1,0,1
4662,2017,10,2017-11-04,Oregon,@,Washington,L (3-38),7,13,53.8,31,0,55,247,4.5,0,68,278,4.1,0,16,0,16,5,50,1,1,2
4663,2017,11,2017-11-18,Oregon,,Arizona,W (48-28),14,21,66.7,235,1,50,353,7.1,5,71,588,8.3,9,13,2,24,12,117,0,1,1
4664,2017,12,2017-11-25,Oregon,,Oregon State,W (69-10),16,26,61.5,266,3,49,311,6.3,5,75,577,7.7,8,17,3,28,12,138,0,0,0
4665,2017,13,2017-12-16,Oregon,N,Boise State*,L (28-38),26,36,72.2,233,2,28,47,1.7,0,64,280,4.4,10,3,1,14,10,95,2,2,4
4666,2017,,13 Games,Oregon,,,,203,311,65.3,2469,18,628,3263,5.2,40,939,5732,6.1,96,162,27,285,121,1138,13,12,25
4667,2014,1,2014-08-30,Oregon State,,Portland State,W (29-14),26,45,57.8,328,1,37,177,4.8,1,82,505,6.2,16,8,1,25,13,119,1,0,1
4668,2014,2,2014-09-06,Oregon State,@,Hawaii,W (38-30),26,37,70.3,300,3,36,164,4.6,2,73,464,6.4,10,7,5,22,13,99,1,1,2
4669,2014,3,2014-09-20,Oregon State,,San Diego State,W (28-7),24,31,77.4,275,0,36,97,2.7,4,67,372,5.6,12,8,5,25,7,52,1,1,2
4670,2014,4,2014-09-27,Oregon State,@,Southern California,L (10-35),15,35,42.9,123,0,21,58,2.8,0,56,181,3.2,4,6,7,17,13,108,0,2,2
4671,2014,5,2014-10-04,Oregon State,@,Colorado,W (36-31),27,37,73.0,278,1,32,167,5.2,3,69,445,6.4,13,7,2,22,5,42,0,0,0
4672,2014,6,2014-10-16,Oregon State,,Utah,L (23-29),21,37,56.8,272,2,46,118,2.6,0,83,390,4.7,9,9,3,21,9,75,1,1,2
4673,2014,7,2014-10-25,Oregon State,@,Stanford,L (14-38),18,38,47.4,209,0,29,12,0.4,2,67,221,3.3,9,3,0,12,8,67,0,0,0
4674,2014,8,2014-11-01,Oregon State,,California,L (31-45),30,45,66.7,320,2,23,148,6.4,2,68,468,6.9,17,6,2,25,8,90,0,1,1
4675,2014,9,2014-11-08,Oregon State,,Washington State,L (32-39),31,41,75.6,419,1,24,37,1.5,2,65,456,7.0,15,6,2,23,10,100,0,0,0
4676,2014,10,2014-11-15,Oregon State,,Arizona State,W (35-27),19,33,57.6,251,2,37,247,6.7,2,70,498,7.1,9,8,2,19,9,76,1,1,2
4677,2014,11,2014-11-22,Oregon State,@,Washington,L (13-37),30,46,65.2,314,2,23,47,2.0,0,69,361,5.2,12,3,2,17,5,55,0,1,1
4678,2014,12,2014-11-29,Oregon State,,Oregon,L (19-47),23,47,48.9,216,1,32,146,4.6,1,79,362,4.6,12,7,2,21,7,75,1,0,1
4679,2014,,12 Games,Oregon State,,,,290,472,61.4,3305,15,376,1418,3.8,19,848,4723,5.6,138,78,33,249,107,958,6,8,14
4680,2015,1,2015-09-04,Oregon State,,Weber State,W (26-7),12,22,54.5,110,2,56,281,5.0,0,78,391,5.0,5,13,4,22,7,67,0,1,1
4681,2015,2,2015-09-12,Oregon State,@,Michigan,L (7-35),9,20,45.0,79,1,33,59,1.8,0,53,138,2.6,5,4,3,12,8,62,1,0,1
4682,2015,3,2015-09-19,Oregon State,,San Jose State,W (35-21),13,25,52.0,135,1,46,303,6.6,3,71,438,6.2,9,14,1,24,4,35,1,1,2
4683,2015,4,2015-09-25,Oregon State,,Stanford,L (24-42),20,36,55.6,275,1,36,111,3.1,2,72,386,5.4,13,7,0,20,6,65,1,0,1
4684,2015,5,2015-10-10,Oregon State,@,Arizona,L (7-44),12,35,34.3,98,0,31,151,4.9,1,66,249,3.8,5,8,2,15,5,59,0,1,1
4685,2015,6,2015-10-17,Oregon State,@,Washington State,L (31-52),17,30,56.7,176,1,45,218,4.8,2,75,394,5.3,10,11,0,21,11,86,0,2,2
4686,2015,7,2015-10-24,Oregon State,,Colorado,L (13-17),13,32,40.6,199,0,41,202,4.9,1,73,401,5.5,7,9,1,17,8,65,0,1,1
4687,2015,8,2015-10-31,Oregon State,@,Utah,L (12-27),19,35,54.3,204,1,30,108,3.6,0,65,312,4.8,9,5,2,16,5,40,0,0,0
4688,2015,9,2015-11-07,Oregon State,,UCLA,L (0-41),10,24,41.7,131,0,33,115,3.5,0,57,246,4.3,4,6,2,12,5,45,1,3,4
4689,2015,10,2015-11-14,Oregon State,@,California,L (24-54),15,36,41.7,194,2,34,204,6.0,1,70,398,5.7,10,8,3,21,7,70,0,0,0
4690,2015,11,2015-11-21,Oregon State,,Washington,L (7-52),8,23,34.8,109,1,23,148,6.4,0,46,257,5.6,4,3,1,8,3,30,1,1,2
4691,2015,12,2015-11-27,Oregon State,@,Oregon,L (42-52),13,25,52.0,199,0,38,228,6.0,5,63,427,6.8,8,12,3,23,7,80,0,1,1
4692,2015,,12 Games,Oregon State,,,,161,343,46.9,1909,10,446,2128,4.8,15,789,4037,5.1,89,100,22,211,76,704,5,11,16
4693,2016,1,2016-09-01,Oregon State,@,Minnesota,L (23-30),25,40,62.5,228,3,34,89,2.6,0,74,317,4.3,11,4,3,18,4,55,2,0,2
4694,2016,2,2016-09-17,Oregon State,,Idaho State,W (37-7),15,30,50.0,172,0,41,246,6.0,3,71,418,5.9,7,8,2,17,9,95,0,1,1
4695,2016,3,2016-09-24,Oregon State,,Boise State,L (24-38),22,34,64.7,191,0,35,96,2.7,2,69,287,4.2,8,7,2,17,7,50,1,0,1
4696,2016,4,2016-10-01,Oregon State,@,Colorado,L (6-47),13,32,40.6,100,0,34,126,3.7,0,66,226,3.4,6,7,1,14,5,31,0,2,2
4697,2016,5,2016-10-08,Oregon State,,California,W (47-44),13,24,54.2,85,0,50,474,9.5,6,74,559,7.6,6,19,2,27,10,81,0,2,2
4698,2016,6,2016-10-15,Oregon State,,Utah,L (14-19),9,30,30.0,100,1,35,197,5.6,1,65,297,4.6,4,10,1,15,9,65,1,1,2
4699,2016,7,2016-10-22,Oregon State,@,Washington,L (17-41),12,27,44.4,148,0,30,177,5.9,2,57,325,5.7,8,6,1,15,6,40,0,2,2
4700,2016,8,2016-10-29,Oregon State,,Washington State,L (31-35),23,39,59.0,327,2,28,171,6.1,2,67,498,7.4,12,6,2,20,13,110,0,0,0
4701,2016,9,2016-11-05,Oregon State,@,Stanford,L (15-26),10,24,41.7,137,1,22,129,5.9,1,46,266,5.8,3,3,2,8,9,102,0,2,2
4702,2016,10,2016-11-12,Oregon State,@,UCLA,L (24-38),22,34,64.7,232,0,34,75,2.2,2,68,307,4.5,9,5,2,16,12,119,2,1,3
4703,2016,11,2016-11-19,Oregon State,,Arizona,W (42-17),16,19,84.2,265,5,46,210,4.6,1,65,475,7.3,11,14,1,26,5,49,1,0,1
4704,2016,12,2016-11-26,Oregon State,,Oregon,W (34-24),13,20,65.0,101,1,51,316,6.2,4,71,417,5.9,5,20,0,25,7,65,1,0,1
4705,2016,,12 Games,Oregon State,,,,193,353,54.7,2086,13,440,2306,5.2,24,793,4392,5.5,90,109,19,218,96,862,8,11,19
4706,2017,1,2017-08-26,Oregon State,@,Colorado State,L (27-58),27,47,57.4,304,2,29,152,5.2,1,76,456,6.0,17,6,0,23,3,21,2,3,5
4707,2017,2,2017-09-02,Oregon State,,Portland State,W (35-32),18,25,72.0,235,1,32,154,4.8,3,57,389,6.8,11,5,2,18,5,52,1,1,2
4708,2017,3,2017-09-09,Oregon State,,Minnesota,L (14-48),17,29,58.6,145,1,26,80,3.1,1,55,225,4.1,6,6,2,14,7,91,3,0,3
4709,2017,4,2017-09-16,Oregon State,@,Washington State,L (23-52),24,37,64.9,199,1,33,155,4.7,2,70,354,5.1,9,10,2,21,8,80,2,0,2
4710,2017,5,2017-09-30,Oregon State,,Washington,L (7-42),11,22,50.0,74,0,28,110,3.9,1,50,184,3.7,2,6,0,8,8,86,2,0,2
4711,2017,6,2017-10-07,Oregon State,@,Southern California,L (10-38),16,29,55.2,197,0,36,122,3.4,1,65,319,4.9,7,8,1,16,7,69,2,1,3
4712,2017,7,2017-10-14,Oregon State,,Colorado,L (33-36),20,37,54.1,289,0,46,280,6.1,3,83,569,6.9,14,16,0,30,9,79,0,1,1
4713,2017,8,2017-10-26,Oregon State,,Stanford,L (14-15),13,22,59.1,126,0,41,138,3.4,2,63,264,4.2,7,9,4,20,6,47,2,1,3
4714,2017,9,2017-11-04,Oregon State,@,California,L (23-37),14,26,53.8,195,1,31,104,3.4,1,57,299,5.2,6,10,2,18,9,99,0,0,0
4715,2017,10,2017-11-11,Oregon State,@,Arizona,L (28-49),16,28,57.1,209,4,40,151,3.8,0,68,360,5.3,10,10,2,22,5,39,0,1,1
4716,2017,11,2017-11-18,Oregon State,,Arizona State,L (24-40),26,37,70.3,269,0,33,106,3.2,3,70,375,5.4,14,4,5,23,8,67,1,2,3
4717,2017,12,2017-11-25,Oregon State,@,Oregon,L (10-69),12,23,52.2,113,1,36,98,2.7,0,59,211,3.6,3,5,7,15,9,86,1,2,3
4718,2017,,12 Games,Oregon State,,,,214,362,59.1,2355,11,411,1650,4.0,18,773,4005,5.2,106,95,27,228,84,816,16,12,28
4719,2014,1,2014-08-30,Penn State,N,Central Florida,W (26-24),32,47,68.1,454,1,28,57,2.0,1,75,511,6.8,14,7,3,24,9,90,1,2,3
4720,2014,2,2014-09-06,Penn State,,Akron,W (21-3),22,37,59.5,319,3,31,106,3.4,0,68,425,6.3,16,7,4,27,3,25,1,2,3
4721,2014,3,2014-09-13,Penn State,@,Rutgers,W (13-10),25,44,56.8,309,0,33,64,1.9,1,77,373,4.8,13,4,2,19,5,40,0,1,1
4722,2014,4,2014-09-20,Penn State,,Massachusetts,W (48-7),18,32,56.3,236,1,45,228,5.1,5,77,464,6.0,11,11,1,23,6,52,0,0,0
4723,2014,5,2014-09-27,Penn State,,Northwestern,L (6-29),22,46,47.8,216,0,25,50,2.0,0,71,266,3.7,9,3,2,14,4,35,1,1,2
4724,2014,6,2014-10-11,Penn State,@,Michigan,L (13-18),21,33,63.6,160,1,35,54,1.5,0,68,214,3.1,8,7,1,16,5,23,0,1,1
4725,2014,7,2014-10-25,Penn State,,Ohio State,L (24-31),31,50,62.0,224,1,31,16,0.5,1,81,240,3.0,11,5,4,20,4,42,0,2,2
4726,2014,8,2014-11-01,Penn State,,Maryland,L (19-20),18,42,42.9,177,1,41,42,1.0,0,83,219,2.6,10,4,2,16,8,64,3,1,4
4727,2014,9,2014-11-08,Penn State,@,Indiana,W (13-7),12,29,41.4,168,0,37,162,4.4,1,66,330,5.0,7,6,2,15,7,55,0,2,2
4728,2014,10,2014-11-15,Penn State,,Temple,W (30-13),12,26,46.2,112,0,47,254,5.4,2,73,366,5.0,5,13,1,19,5,45,1,2,3
4729,2014,11,2014-11-22,Penn State,@,Illinois,L (14-16),8,16,50.0,93,1,47,172,3.7,1,63,265,4.2,5,8,2,15,5,34,1,0,1
4730,2014,12,2014-11-29,Penn State,,Michigan State,L (10-34),21,45,46.7,195,0,22,38,1.7,1,67,233,3.5,11,4,1,16,4,35,1,1,2
4731,2014,13,2014-12-27,Penn State,N,Boston College*,W (31-30),34,50,68.0,371,4,29,82,2.8,0,79,453,5.7,17,5,3,25,10,60,2,0,2
4732,2014,,13 Games,Penn State,,,,276,497,55.5,3034,13,451,1325,2.9,13,948,4359,4.6,137,84,28,249,75,600,11,15,26
4733,2015,1,2015-09-05,Penn State,@,Temple,L (10-27),11,25,44.0,103,0,27,77,2.9,1,52,180,3.5,4,4,1,9,6,39,0,1,1
4734,2015,2,2015-09-12,Penn State,,Buffalo,W (27-14),14,27,51.9,128,1,39,200,5.1,2,66,328,5.0,5,9,1,15,7,65,0,0,0
4735,2015,3,2015-09-19,Penn State,,Rutgers,W (28-3),10,19,52.6,141,0,41,330,8.0,4,60,471,7.9,4,13,0,17,8,80,0,1,1
4736,2015,4,2015-09-26,Penn State,,San Diego State,W (37-21),22,36,61.1,328,3,34,72,2.1,0,70,400,5.7,14,2,3,19,5,37,1,0,1
4737,2015,5,2015-10-03,Penn State,,Army,W (20-14),10,19,52.6,156,1,34,108,3.2,1,53,264,5.0,5,7,0,12,3,20,0,0,0
4738,2015,6,2015-10-10,Penn State,,Indiana,W (29-7),22,40,55.0,266,2,32,154,4.8,2,72,420,5.8,14,5,3,22,3,30,1,0,1
4739,2015,7,2015-10-17,Penn State,@,Ohio State,L (10-38),7,13,53.8,120,1,40,195,4.9,0,53,315,5.9,2,8,4,14,3,22,1,0,1
4740,2015,8,2015-10-24,Penn State,N,Maryland,W (31-30),13,30,43.3,315,3,31,48,1.5,1,61,363,6.0,11,4,1,16,6,39,3,0,3
4741,2015,9,2015-10-31,Penn State,,Illinois,W (39-0),22,33,66.7,280,3,37,120,3.2,2,70,400,5.7,12,9,2,23,3,25,2,0,2
4742,2015,10,2015-11-07,Penn State,@,Northwestern,L (21-23),22,41,53.7,237,1,30,125,4.2,2,71,362,5.1,8,6,3,17,9,70,1,1,2
4743,2015,11,2015-11-21,Penn State,,Michigan,L (16-28),13,32,40.6,137,1,22,70,3.2,0,54,207,3.8,4,4,6,14,3,30,1,0,1
4744,2015,12,2015-11-28,Penn State,@,Michigan State,L (16-55),27,47,57.4,296,2,25,122,4.9,0,72,418,5.8,10,9,1,20,6,45,2,2,4
4745,2015,13,2016-01-02,Penn State,N,Georgia*,L (17-24),22,42,52.4,281,2,32,120,3.8,0,74,401,5.4,12,3,1,16,6,39,0,1,1
4746,2015,,13 Games,Penn State,,,,215,404,53.2,2788,20,424,1741,4.1,15,828,4529,5.5,105,83,26,214,68,541,12,6,18
4747,2016,1,2016-09-03,Penn State,,Kent State,W (33-13),16,31,51.6,209,2,38,145,3.8,1,69,354,5.1,9,9,1,19,5,55,1,0,1
4748,2016,2,2016-09-10,Penn State,@,Pittsburgh,L (39-42),24,35,68.6,332,1,31,74,2.4,4,66,406,6.2,12,6,2,20,4,35,3,1,4
4749,2016,3,2016-09-17,Penn State,,Temple,W (34-27),18,24,75.0,287,1,37,116,3.1,3,61,403,6.6,8,8,5,21,7,62,2,1,3
4750,2016,4,2016-09-24,Penn State,@,Michigan,L (10-49),16,27,59.3,121,1,28,70,2.5,0,55,191,3.5,6,3,3,12,2,13,1,1,2
4751,2016,5,2016-10-01,Penn State,,Minnesota,W (29-26),19,42,45.2,335,1,28,136,4.9,2,70,471,6.7,8,7,4,19,5,65,0,0,0
4752,2016,6,2016-10-08,Penn State,,Maryland,W (38-14),10,19,52.6,152,2,62,372,6.0,3,81,524,6.5,5,21,2,28,6,45,1,0,1
4753,2016,7,2016-10-22,Penn State,,Ohio State,W (24-21),8,23,34.8,154,1,33,165,5.0,1,56,319,5.7,6,6,1,13,1,5,1,0,1
4754,2016,8,2016-10-29,Penn State,@,Purdue,W (62-24),13,25,52.0,254,3,38,257,6.8,5,63,511,8.1,10,11,3,24,11,91,0,0,0
4755,2016,9,2016-11-05,Penn State,,Iowa,W (41-14),11,18,61.1,240,2,52,359,6.9,3,70,599,8.6,9,15,0,24,9,86,0,0,0
4756,2016,10,2016-11-12,Penn State,@,Indiana,W (45-31),16,30,53.3,332,2,45,77,1.7,3,75,409,5.5,11,5,2,18,5,40,0,2,2
4757,2016,11,2016-11-19,Penn State,@,Rutgers,W (39-0),17,33,51.5,210,1,49,339,6.9,3,82,549,6.7,8,16,1,25,3,15,1,0,1
4758,2016,12,2016-11-26,Penn State,,Michigan State,W (45-12),18,24,75.0,386,4,33,77,2.3,2,57,463,8.1,14,4,0,18,1,15,0,0,0
4759,2016,13,2016-12-03,Penn State,N,Wisconsin,W (38-31),22,31,71.0,384,4,29,51,1.8,1,60,435,7.3,16,3,2,21,3,25,2,0,2
4760,2016,14,2017-01-02,Penn State,N,Southern California*,L (49-52),18,29,62.1,254,4,33,211,6.4,3,62,465,7.5,12,8,3,23,5,65,0,3,3
4761,2016,,14 Games,Penn State,,,,226,391,57.8,3650,29,536,2449,4.6,34,927,6099,6.6,134,122,29,285,67,617,12,8,20
4762,2017,1,2017-09-02,Penn State,,Akron,W (52-0),21,31,67.7,322,2,34,247,7.3,4,65,569,8.8,14,7,3,24,5,45,0,1,1
4763,2017,2,2017-09-09,Penn State,,Pittsburgh,W (33-14),15,28,53.6,164,3,24,148,6.2,1,52,312,6.0,7,6,1,14,1,15,0,1,1
4764,2017,3,2017-09-16,Penn State,,Georgia State,W (56-0),21,29,72.4,360,5,24,166,6.9,3,53,526,9.9,11,8,0,19,5,45,0,0,0
4765,2017,4,2017-09-23,Penn State,@,Iowa,W (21-19),31,48,64.6,284,1,51,295,5.8,1,99,579,5.8,14,15,0,29,8,90,1,1,2
4766,2017,5,2017-09-30,Penn State,,Indiana,W (45-14),24,37,64.9,331,3,37,39,1.1,1,74,370,5.0,15,4,1,20,2,7,0,1,1
4767,2017,6,2017-10-07,Penn State,@,Northwestern,W (31-7),29,41,70.7,286,1,38,95,2.5,3,79,381,4.8,14,6,3,23,3,30,0,0,0
4768,2017,7,2017-10-21,Penn State,,Michigan,W (42-13),17,26,65.4,282,1,35,224,6.4,5,61,506,8.3,12,10,3,25,1,10,0,1,1
4769,2017,8,2017-10-28,Penn State,@,Ohio State,L (38-39),17,29,58.6,192,2,35,91,2.6,2,64,283,4.4,9,5,3,17,9,73,0,0,0
4770,2017,9,2017-11-04,Penn State,@,Michigan State,L (24-27),27,48,56.3,401,3,21,65,3.1,0,69,466,6.8,17,4,1,22,7,86,0,3,3
4771,2017,10,2017-11-11,Penn State,,Rutgers,W (35-6),16,21,76.2,214,2,31,90,2.9,3,52,304,5.8,11,6,1,18,4,20,0,0,0
4772,2017,11,2017-11-18,Penn State,,Nebraska,W (56-44),26,39,66.7,346,4,35,263,7.5,4,74,609,8.2,18,9,5,32,5,39,1,0,1
4773,2017,12,2017-11-25,Penn State,@,Maryland,W (66-3),25,40,62.5,248,3,48,286,6.0,6,88,534,6.1,12,13,3,28,2,10,0,0,0
4774,2017,13,2017-12-30,Penn State,N,Washington*,W (35-28),32,41,78.0,342,2,38,203,5.3,3,79,545,6.9,18,6,1,25,2,20,1,2,3
4775,2017,,13 Games,Penn State,,,,301,458,65.7,3772,32,451,2212,4.9,36,909,5984,6.6,172,99,25,296,54,490,3,10,13
4776,2014,1,2014-08-30,Pitt,,Delaware,W (62-0),11,14,78.6,92,2,56,409,7.3,7,70,501,7.2,7,20,1,28,5,45,1,0,1
4777,2014,2,2014-09-05,Pitt,@,Boston College,W (30-20),10,20,50.0,111,2,50,302,6.0,1,70,413,5.9,3,18,1,22,6,54,0,1,1
4778,2014,3,2014-09-13,Pitt,@,Florida International,W (42-25),11,19,57.9,101,1,54,321,5.9,4,73,422,5.8,3,17,1,21,5,40,2,1,3
4779,2014,4,2014-09-20,Pitt,,Iowa,L (20-24),19,30,63.3,250,0,42,185,4.4,2,72,435,6.0,13,10,1,24,8,80,0,1,1
4780,2014,5,2014-09-27,Pitt,,Akron,L (10-21),20,34,58.8,220,1,40,129,3.2,0,74,349,4.7,13,8,1,22,7,55,1,1,2
4781,2014,6,2014-10-04,Pitt,@,Virginia,L (19-24),16,30,53.3,195,2,35,116,3.3,0,65,311,4.8,9,8,2,19,10,75,0,1,1
4782,2014,7,2014-10-16,Pitt,,Virginia Tech,W (21-16),11,18,61.1,121,1,43,210,4.9,2,61,331,5.4,2,13,0,15,7,70,1,1,2
4783,2014,8,2014-10-25,Pitt,,Georgia Tech,L (28-56),23,35,65.7,328,1,31,198,6.4,3,66,526,8.0,14,5,0,19,2,15,6,0,6
4784,2014,9,2014-11-01,Pitt,,Duke,L (48-51),16,24,66.7,236,2,65,358,5.5,4,89,594,6.7,11,26,0,37,8,61,0,0,0
4785,2014,10,2014-11-15,Pitt,@,North Carolina,L (35-40),11,16,68.8,218,1,53,305,5.8,4,69,523,7.6,8,15,0,23,5,47,1,0,1
4786,2014,11,2014-11-22,Pitt,,Syracuse,W (30-7),14,20,70.0,189,2,52,256,4.9,1,72,445,6.2,7,16,5,28,9,58,0,1,1
4787,2014,12,2014-11-29,Pitt,@,Miami (FL),W (35-23),8,12,66.7,134,1,47,226,4.8,4,59,360,6.1,5,14,3,22,6,50,0,0,0
4788,2014,13,2015-01-02,Pitt,N,Houston*,L (34-35),18,36,50.0,222,1,41,227,5.5,3,77,449,5.8,12,12,4,28,5,44,0,0,0
4789,2014,,13 Games,Pitt,,,,188,308,61.0,2417,17,609,3242,5.3,35,917,5659,6.2,107,182,19,308,83,694,12,7,19
4790,2015,1,2015-09-05,Pitt,,Youngstown State,W (45-37),11,18,61.1,133,1,43,325,7.6,4,61,458,7.5,3,12,1,16,4,23,1,2,3
4791,2015,2,2015-09-12,Pitt,@,Akron,W (24-7),18,25,72.0,180,1,46,127,2.8,2,71,307,4.3,10,7,4,21,5,30,0,0,0
4792,2015,3,2015-09-19,Pitt,@,Iowa,L (24-27),21,31,67.7,227,2,27,55,2.0,0,58,282,4.9,12,3,0,15,3,35,0,2,2
4793,2015,4,2015-10-03,Pitt,@,Virginia Tech,W (17-13),9,15,60.0,110,1,46,166,3.6,1,61,276,4.5,6,8,1,15,8,60,1,0,1
4794,2015,5,2015-10-10,Pitt,,Virginia,W (26-19),17,24,70.8,222,2,35,141,4.0,1,59,363,6.2,9,7,0,16,5,40,2,0,2
4795,2015,6,2015-10-17,Pitt,@,Georgia Tech,W (31-28),15,23,65.2,191,3,43,200,4.7,1,66,391,5.9,8,12,1,21,4,30,0,0,0
4796,2015,7,2015-10-24,Pitt,@,Syracuse,W (23-20),21,28,75.0,239,0,46,188,4.1,2,74,427,5.8,11,13,0,24,6,60,0,0,0
4797,2015,8,2015-10-29,Pitt,,North Carolina,L (19-26),27,42,64.3,262,1,37,153,4.1,1,79,415,5.3,13,10,2,25,6,55,1,0,1
4798,2015,9,2015-11-07,Pitt,,Notre Dame,L (30-42),12,32,37.5,223,1,31,175,5.6,2,63,398,6.3,8,9,1,18,3,25,0,1,1
4799,2015,10,2015-11-14,Pitt,@,Duke,W (31-13),13,23,56.5,180,3,58,268,4.6,1,81,448,5.5,9,15,2,26,5,40,1,0,1
4800,2015,11,2015-11-21,Pitt,,Louisville,W (45-34),22,34,64.7,232,4,45,244,5.4,1,79,476,6.0,11,14,0,25,5,54,0,0,0
4801,2015,12,2015-11-27,Pitt,,Miami (FL),L (24-29),13,27,48.1,142,1,31,189,6.1,2,58,331,5.7,7,6,2,15,10,73,1,1,2
4802,2015,13,2015-12-28,Pitt,N,Navy*,L (28-44),13,21,61.9,137,1,21,198,9.4,1,42,335,8.0,9,8,0,17,1,5,0,3,3
4803,2015,,13 Games,Pitt,,,,212,343,61.8,2478,21,509,2429,4.8,19,852,4907,5.8,116,124,14,254,65,530,7,9,16
4804,2016,1,2016-09-03,Pitt,,Villanova,W (28-7),19,33,57.6,175,2,34,86,2.5,1,67,261,3.9,11,3,3,17,3,40,1,0,1
4805,2016,2,2016-09-10,Pitt,,Penn State,W (42-39),11,15,73.3,91,3,56,341,6.1,3,71,432,6.1,6,13,0,19,10,79,1,1,2
4806,2016,3,2016-09-17,Pitt,@,Oklahoma State,L (38-45),14,30,46.7,237,1,54,290,5.4,3,84,527,6.3,9,12,0,21,8,73,0,1,1
4807,2016,4,2016-09-24,Pitt,@,North Carolina,L (36-37),14,18,77.8,140,0,55,281,5.1,4,73,421,5.8,8,13,0,21,4,40,1,0,1
4808,2016,5,2016-10-01,Pitt,,Marshall,W (43-27),17,24,70.8,280,2,41,252,6.1,3,65,532,8.2,13,11,5,29,3,34,0,0,0
4809,2016,6,2016-10-08,Pitt,,Georgia Tech,W (37-34),14,20,70.0,192,1,42,215,5.1,3,62,407,6.6,8,13,1,22,2,15,1,0,1
4810,2016,7,2016-10-15,Pitt,@,Virginia,W (45-31),11,21,52.4,137,2,49,209,4.3,2,70,346,4.9,6,10,3,19,8,69,0,0,0
4811,2016,8,2016-10-27,Pitt,,Virginia Tech,L (36-39),14,23,60.9,278,1,32,180,5.6,4,55,458,8.3,10,5,2,17,9,63,1,1,2
4812,2016,9,2016-11-05,Pitt,@,Miami (FL),L (28-51),17,36,47.2,287,2,34,130,3.8,1,70,417,6.0,11,9,2,22,5,25,1,1,2
4813,2016,10,2016-11-12,Pitt,@,Clemson,W (43-42),22,38,57.9,308,5,33,156,4.7,1,71,464,6.5,11,7,5,23,3,40,1,0,1
4814,2016,11,2016-11-19,Pitt,,Duke,W (56-14),11,18,61.1,237,3,40,224,5.6,4,58,461,7.9,7,11,0,18,7,55,0,1,1
4815,2016,12,2016-11-26,Pitt,,Syracuse,W (76-61),9,19,47.4,251,4,40,393,9.8,6,59,644,10.9,7,12,1,20,7,64,1,1,2
4816,2016,13,2016-12-28,Pitt,N,Northwestern*,L (24-31),16,29,55.2,269,2,32,169,5.3,1,61,438,7.2,8,9,1,18,5,50,1,3,4
4817,2016,,13 Games,Pitt,,,,189,324,58.3,2882,28,542,2926,5.4,36,866,5808,6.7,115,128,23,266,74,647,9,9,18
4818,2017,1,2017-09-02,Pitt,,Youngstown State,W (28-21),17,24,70.8,140,1,53,208,3.9,3,77,348,4.5,8,18,1,24,0,0,1,0,1
4819,2017,2,2017-09-09,Pitt,@,Penn State,L (14-33),24,41,58.5,187,0,45,155,3.4,1,86,342,4.0,11,12,1,24,6,55,1,2,3
4820,2017,3,2017-09-16,Pitt,,Oklahoma State,L (21-59),20,35,57.1,288,1,34,103,3.0,1,69,391,5.7,9,8,0,17,6,50,0,2,2
4821,2017,4,2017-09-23,Pitt,@,Georgia Tech,L (17-35),22,35,62.9,198,1,20,37,1.9,0,55,235,4.3,9,2,0,11,3,26,1,0,1
4822,2017,5,2017-09-30,Pitt,,Rice,W (42-10),28,34,82.4,410,4,33,69,2.1,2,67,479,7.1,18,5,1,24,2,25,1,0,1
4823,2017,6,2017-10-07,Pitt,@,Syracuse,L (24-27),22,33,66.7,229,0,26,129,5.0,2,59,358,6.1,10,5,1,16,6,65,0,0,0
4824,2017,7,2017-10-14,Pitt,,North Carolina State,L (17-35),24,45,53.3,231,1,32,95,3.0,1,77,326,4.2,12,7,1,20,1,10,1,1,2
4825,2017,8,2017-10-21,Pitt,@,Duke,W (24-17),8,18,44.4,149,0,57,336,5.9,3,75,485,6.5,6,13,1,20,9,88,0,0,0
4826,2017,9,2017-10-28,Pitt,,Virginia,W (31-14),10,18,55.6,134,1,40,176,4.4,2,58,310,5.3,6,11,2,19,6,65,0,1,1
4827,2017,10,2017-11-09,Pitt,,North Carolina,L (31-34),11,17,64.7,142,0,45,267,5.9,4,62,409,6.6,8,14,3,25,1,15,1,0,1
4828,2017,11,2017-11-18,Pitt,@,Virginia Tech,L (14-20),20,33,60.6,311,2,30,55,1.8,0,63,366,5.8,13,3,0,16,1,5,0,2,2
4829,2017,12,2017-11-24,Pitt,,Miami (FL),W (24-14),18,29,62.1,193,1,45,152,3.4,2,74,345,4.7,6,12,2,20,5,54,2,0,2
4830,2017,,12 Games,Pitt,,,,224,362,61.9,2612,12,460,1782,3.9,21,822,4394,5.3,116,110,13,236,46,458,8,8,16
4831,2016,1,2016-09-10,Prairie View A&M,@,Texas A&M,L (0-67),14,40,35.0,173,0,28,32,1.1,0,68,205,3.0,8,2,0,10,11,95,0,1,1
4832,2016,2,2016-10-22,Prairie View A&M,@,Rice,L (44-65),18,29,62.1,278,2,32,179,5.6,3,61,457,7.5,10,7,3,20,11,107,0,2,2
4833,2016,,2 Games,Prairie View A&M,,,,32,69,46.4,451,2,60,211,3.5,3,129,662,5.1,18,9,3,30,22,202,0,3,3
4834,2016,1,2016-09-01,Presbyterian,@,Central Michigan,L (3-49),10,22,45.5,82,0,33,44,1.3,0,55,126,2.3,4,2,0,6,6,60,1,2,3
4835,2016,2,2016-11-19,Presbyterian,@,South Alabama,L (7-31),11,24,45.8,78,0,46,197,4.3,0,70,275,3.9,6,10,2,18,6,60,1,1,2
4836,2016,,2 Games,Presbyterian,,,,21,46,45.7,160,0,79,241,3.1,0,125,401,3.2,10,12,2,24,12,120,2,3,5
4837,2017,1,2017-08-31,Presbyterian,@,Wake Forest,L (7-51),2,9,22.2,41,0,45,207,4.6,1,54,248,4.6,2,10,0,12,5,45,0,1,1
4838,2014,1,2014-08-30,Purdue,,Western Michigan,W (43-34),19,38,50.0,181,2,39,226,5.8,3,77,407,5.3,10,11,1,22,7,52,0,0,0
4839,2014,2,2014-09-06,Purdue,,Central Michigan,L (17-38),24,49,49.0,204,1,34,122,3.6,1,83,326,3.9,9,10,0,19,7,69,1,2,3
4840,2014,3,2014-09-13,Purdue,N,Notre Dame,L (14-30),27,40,67.5,234,2,26,56,2.2,0,66,290,4.4,11,5,1,17,5,41,1,2,3
4841,2014,4,2014-09-20,Purdue,,Southern Illinois,W (35-13),15,26,57.7,198,2,44,183,4.2,2,70,381,5.4,9,11,3,23,4,26,1,0,1
4842,2014,5,2014-09-27,Purdue,,Iowa,L (10-24),13,32,40.6,72,0,30,84,2.8,0,62,156,2.5,2,7,0,9,3,19,0,2,2
4843,2014,6,2014-10-04,Purdue,@,Illinois,W (38-27),15,20,75.0,202,1,45,349,7.8,4,65,551,8.5,8,10,1,19,6,64,0,0,0
4844,2014,7,2014-10-11,Purdue,,Michigan State,L (31-45),24,37,64.9,211,1,25,129,5.2,3,62,340,5.5,11,5,2,18,4,21,1,1,2
4845,2014,8,2014-10-18,Purdue,@,Minnesota,L (38-39),16,26,61.5,153,3,35,298,8.5,2,61,451,7.4,6,10,1,17,7,55,0,2,2
4846,2014,9,2014-11-01,Purdue,@,Nebraska,L (14-35),18,46,39.1,216,1,32,124,3.9,1,78,340,4.4,8,8,0,16,5,51,0,2,2
4847,2014,10,2014-11-08,Purdue,,Wisconsin,L (16-34),17,37,45.9,204,1,26,26,1.0,0,63,230,3.7,7,3,1,11,2,15,0,0,0
4848,2014,11,2014-11-22,Purdue,,Northwestern,L (14-38),26,48,54.2,251,2,32,61,1.9,0,80,312,3.9,13,6,1,20,4,41,3,2,5
4849,2014,12,2014-11-29,Purdue,@,Indiana,L (16-23),19,35,54.3,123,0,34,228,6.7,1,69,351,5.1,6,9,1,16,5,49,1,3,4
4850,2014,,12 Games,Purdue,,,,233,434,53.7,2249,16,402,1886,4.7,17,836,4135,4.9,100,95,12,207,59,503,8,16,24
4851,2015,1,2015-09-06,Purdue,@,Marshall,L (31-41),31,48,64.6,270,1,47,184,3.9,3,95,454,4.8,14,10,4,28,4,53,0,4,4
4852,2015,2,2015-09-12,Purdue,,Indiana State,W (38-14),20,36,55.6,289,4,45,251,5.6,1,81,540,6.7,10,12,2,24,5,42,2,0,2
4853,2015,3,2015-09-19,Purdue,,Virginia Tech,L (24-51),12,35,34.3,121,0,29,144,5.0,2,64,265,4.1,3,4,2,9,10,79,1,2,3
4854,2015,4,2015-09-26,Purdue,,Bowling Green State,L (28-35),30,40,75.0,349,2,38,77,2.0,2,78,426,5.5,15,6,4,25,9,92,0,1,1
4855,2015,5,2015-10-03,Purdue,@,Michigan State,L (21-24),15,31,48.4,136,1,32,165,5.2,2,63,301,4.8,7,6,3,16,2,20,2,1,3
4856,2015,6,2015-10-10,Purdue,,Minnesota,L (13-41),21,49,42.9,207,1,28,68,2.4,1,77,275,3.6,11,4,2,17,0,0,1,3,4
4857,2015,7,2015-10-17,Purdue,@,Wisconsin,L (7-24),15,26,57.7,136,0,29,55,1.9,1,55,191,3.5,7,4,1,12,7,67,1,0,1
4858,2015,8,2015-10-31,Purdue,,Nebraska,W (55-45),28,43,65.1,274,4,37,183,4.9,4,80,457,5.7,10,8,2,20,6,58,0,0,0
4859,2015,9,2015-11-07,Purdue,,Illinois,L (14-48),29,47,61.7,174,1,28,89,3.2,1,75,263,3.5,7,8,2,17,3,34,0,2,2
4860,2015,10,2015-11-14,Purdue,@,Northwestern,L (14-21),26,45,57.8,287,1,30,73,2.4,1,75,360,4.8,12,5,1,18,6,60,0,1,1
4861,2015,11,2015-11-21,Purdue,@,Iowa,L (20-40),26,46,56.5,268,1,38,137,3.6,1,84,405,4.8,13,7,1,21,5,43,1,0,1
4862,2015,12,2015-11-28,Purdue,,Indiana,L (36-54),37,58,63.8,336,2,36,150,4.2,3,94,486,5.2,18,11,1,30,8,99,2,2,4
4863,2015,,12 Games,Purdue,,,,290,504,57.5,2847,18,417,1576,3.8,22,921,4423,4.8,127,85,25,237,65,647,10,16,26
4864,2016,1,2016-09-03,Purdue,,Eastern Kentucky,W (45-24),26,44,59.1,251,1,39,261,6.7,4,83,512,6.2,15,9,1,25,2,17,0,1,1
4865,2016,2,2016-09-10,Purdue,,Cincinnati,L (20-38),32,57,56.1,401,2,25,103,4.1,1,82,504,6.1,20,7,2,29,2,24,0,5,5
4866,2016,3,2016-09-24,Purdue,,Nevada,W (24-14),21,31,67.7,300,2,44,166,3.8,1,75,466,6.2,14,11,0,25,4,50,3,1,4
4867,2016,4,2016-10-01,Purdue,@,Maryland,L (7-50),22,53,41.5,195,1,27,10,0.4,0,80,205,2.6,10,3,3,16,8,69,0,1,1
4868,2016,5,2016-10-08,Purdue,@,Illinois,W (34-31),23,37,62.2,228,1,41,231,5.6,3,78,459,5.9,8,14,3,25,5,45,0,2,2
4869,2016,6,2016-10-15,Purdue,,Iowa,L (35-49),30,59,50.8,458,5,21,47,2.2,0,80,505,6.3,17,3,4,24,6,38,0,1,1
4870,2016,7,2016-10-22,Purdue,@,Nebraska,L (14-27),25,45,55.6,309,2,21,26,1.2,0,66,335,5.1,9,4,0,13,4,32,0,2,2
4871,2016,8,2016-10-29,Purdue,,Penn State,L (24-62),36,55,65.5,295,2,26,46,1.8,1,81,341,4.2,12,4,4,20,8,76,2,2,4
4872,2016,9,2016-11-05,Purdue,@,Minnesota,L (31-44),29,49,59.2,391,4,28,23,0.8,0,77,414,5.4,13,4,2,19,2,10,2,1,3
4873,2016,10,2016-11-12,Purdue,,Northwestern,L (17-45),29,51,56.9,264,1,32,130,4.1,1,83,394,4.7,13,9,0,22,2,15,0,4,4
4874,2016,11,2016-11-19,Purdue,,Wisconsin,L (20-49),15,31,48.4,222,2,22,71,3.2,0,53,293,5.5,8,5,3,16,4,20,0,3,3
4875,2016,12,2016-11-26,Purdue,@,Indiana,L (24-26),24,45,53.3,225,2,34,42,1.2,1,79,267,3.4,13,5,2,20,5,51,1,2,3
4876,2016,,12 Games,Purdue,,,,312,557,56.0,3539,25,360,1156,3.2,12,917,4695,5.1,152,78,24,254,52,447,8,25,33
4877,2017,1,2017-09-02,Purdue,N,Louisville,L (28-35),33,57,57.9,293,4,21,51,2.4,0,78,344,4.4,17,5,3,25,6,69,1,3,4
4878,2017,2,2017-09-08,Purdue,,Ohio,W (44-21),16,24,66.7,295,4,44,263,6.0,1,68,558,8.2,10,14,1,25,4,45,0,0,0
4879,2017,3,2017-09-16,Purdue,@,Missouri,W (35-3),26,34,76.5,272,2,50,205,4.1,3,84,477,5.7,13,12,1,26,3,25,0,1,1
4880,2017,4,2017-09-23,Purdue,,Michigan,L (10-28),13,30,43.3,159,1,20,30,1.5,0,50,189,3.8,6,2,1,9,10,82,1,0,1
4881,2017,5,2017-10-07,Purdue,,Minnesota,W (31-17),25,36,69.4,307,2,29,132,4.6,1,65,439,6.8,8,12,2,22,6,61,2,2,4
4882,2017,6,2017-10-14,Purdue,@,Wisconsin,L (9-17),13,29,44.8,155,0,26,66,2.5,0,55,221,4.0,8,4,2,14,7,45,0,1,1
4883,2017,7,2017-10-21,Purdue,@,Rutgers,L (12-14),23,44,52.3,195,1,41,279,6.8,0,85,474,5.6,10,13,2,25,9,55,0,2,2
4884,2017,8,2017-10-28,Purdue,,Nebraska,L (24-25),16,28,57.1,164,1,38,199,5.2,2,66,363,5.5,9,8,3,20,7,63,0,0,0
4885,2017,9,2017-11-04,Purdue,,Illinois,W (29-10),18,28,64.3,226,1,44,209,4.8,2,72,435,6.0,13,11,1,25,8,66,1,0,1
4886,2017,10,2017-11-11,Purdue,@,Northwestern,L (13-23),38,61,62.3,398,2,22,40,1.8,0,83,438,5.3,18,3,1,22,5,50,0,1,1
4887,2017,11,2017-11-18,Purdue,@,Iowa,W (24-15),22,37,59.5,229,3,29,65,2.2,0,66,294,4.5,11,6,3,20,3,30,0,0,0
4888,2017,12,2017-11-25,Purdue,,Indiana,W (31-24),16,30,53.3,181,2,43,272,6.3,2,73,453,6.2,6,13,3,22,4,17,1,0,1
4889,2017,13,2017-12-27,Purdue,N,Arizona*,W (38-35),33,53,62.3,396,4,40,159,4.0,1,93,555,6.0,15,11,1,27,5,50,0,1,1
4890,2017,,13 Games,Purdue,,,,292,491,59.5,3270,27,447,1970,4.4,12,938,5240,5.6,144,114,24,282,77,658,6,11,17
4891,2014,1,2014-08-30,Rice,@,Notre Dame,L (17-48),15,26,57.7,226,2,40,141,3.5,0,66,367,5.6,9,7,0,16,5,30,1,1,2
4892,2014,2,2014-09-13,Rice,@,Texas A&M,L (10-38),24,36,66.7,241,1,55,240,4.4,0,91,481,5.3,15,11,2,28,8,66,0,0,0
4893,2014,3,2014-09-20,Rice,,Old Dominion,L (42-45),22,34,64.7,242,2,54,284,5.3,4,88,526,6.0,11,18,1,30,5,50,0,0,0
4894,2014,4,2014-09-27,Rice,@,Southern Mississippi,W (41-23),14,22,63.6,178,2,48,217,4.5,3,70,395,5.6,7,12,1,20,6,65,0,1,1
4895,2014,5,2014-10-04,Rice,,Hawaii,W (28-14),10,23,43.5,248,2,44,143,3.3,2,67,391,5.8,7,9,1,17,3,40,2,1,3
4896,2014,6,2014-10-11,Rice,@,Army,W (41-21),15,21,71.4,209,3,41,182,4.4,2,62,391,6.3,9,7,1,17,5,41,0,0,0
4897,2014,7,2014-10-25,Rice,,North Texas,W (41-21),13,26,50.0,233,1,46,188,4.1,3,72,421,5.8,9,9,2,20,4,50,0,0,0
4898,2014,8,2014-11-01,Rice,@,Florida International,W (31-17),11,25,44.0,230,2,38,169,4.4,2,63,399,6.3,8,8,1,17,2,15,0,0,0
4899,2014,9,2014-11-08,Rice,,Texas-San Antonio,W (17-7),18,28,64.3,213,1,56,200,3.6,1,84,413,4.9,9,11,2,22,8,69,0,1,1
4900,2014,10,2014-11-15,Rice,@,Marshall,L (14-41),11,23,47.8,99,0,35,81,2.3,2,58,180,3.1,7,5,3,15,2,19,0,0,0
4901,2014,11,2014-11-21,Rice,,Texas-El Paso,W (31-13),10,22,45.5,227,2,42,165,3.9,2,64,392,6.1,8,9,0,17,12,95,0,1,1
4902,2014,12,2014-11-29,Rice,@,Louisiana Tech,L (31-76),25,40,62.5,337,4,32,34,1.1,0,72,371,5.2,13,4,0,17,5,55,1,3,4
4903,2014,13,2014-12-24,Rice,N,Fresno State*,W (30-6),16,26,61.5,326,3,40,137,3.4,1,66,463,7.0,8,7,1,16,12,100,0,0,0
4904,2014,,13 Games,Rice,,,,204,352,58.0,3009,25,571,2181,3.8,22,923,5190,5.6,120,117,15,252,77,695,4,8,12
4905,2015,1,2015-09-05,Rice,,Wagner,W (56-16),12,21,57.1,142,1,54,401,7.4,7,75,543,7.2,6,21,1,28,4,49,1,1,2
4906,2015,2,2015-09-12,Rice,@,Texas,L (28-42),23,38,60.5,234,2,58,228,3.9,2,96,462,4.8,14,15,1,30,6,55,2,3,5
4907,2015,3,2015-09-19,Rice,@,North Texas,W (38-24),29,39,74.4,373,3,51,189,3.7,2,90,562,6.2,15,12,1,28,7,60,0,0,0
4908,2015,4,2015-09-26,Rice,@,Baylor,L (17-70),11,21,52.4,152,1,45,94,2.1,1,66,246,3.7,6,8,6,20,9,70,2,0,2
4909,2015,5,2015-10-03,Rice,,Western Kentucky,L (10-49),16,30,53.3,237,0,34,85,2.5,1,64,322,5.0,10,4,1,15,8,70,3,2,5
4910,2015,6,2015-10-10,Rice,@,Florida Atlantic,W (27-26),22,35,62.9,284,3,50,203,4.1,1,85,487,5.7,13,15,1,29,10,88,1,0,1
4911,2015,7,2015-10-24,Rice,,Army,W (38-31),20,30,66.7,267,2,35,165,4.7,3,65,432,6.6,14,6,1,21,8,64,2,0,2
4912,2015,8,2015-10-30,Rice,,Louisiana Tech,L (17-42),14,28,50.0,180,2,33,101,3.1,0,61,281,4.6,9,5,1,15,8,62,0,0,0
4913,2015,9,2015-11-06,Rice,@,Texas-El Paso,L (21-24),14,28,50.0,230,2,30,96,3.2,1,58,326,5.6,9,6,1,16,5,42,0,0,0
4914,2015,10,2015-11-14,Rice,,Southern Mississippi,L (10-65),13,36,36.1,107,1,35,107,3.1,0,71,214,3.0,7,6,2,15,7,67,1,0,1
4915,2015,11,2015-11-21,Rice,@,Texas-San Antonio,L (24-34),23,41,56.1,359,2,46,161,3.5,1,87,520,6.0,19,8,1,28,7,70,1,2,3
4916,2015,12,2015-11-28,Rice,,UNC Charlotte,W (27-7),15,26,57.7,126,1,61,307,5.0,2,87,433,5.0,7,17,4,28,5,55,0,1,1
4917,2015,,12 Games,Rice,,,,212,373,56.8,2691,20,532,2137,4.0,21,905,4828,5.3,129,123,21,273,84,752,13,9,22
4918,2016,1,2016-09-01,Rice,@,Western Kentucky,L (14-46),23,38,60.5,186,0,33,105,3.2,2,71,291,4.1,10,7,3,20,10,62,0,2,2
4919,2016,2,2016-09-10,Rice,@,Army,L (14-31),16,30,53.3,197,1,21,92,4.4,1,51,289,5.7,8,4,0,12,6,55,1,1,2
4920,2016,3,2016-09-16,Rice,,Baylor,L (10-38),9,27,33.3,31,0,42,234,5.6,1,69,265,3.8,3,8,3,14,3,21,1,0,1
4921,2016,4,2016-09-24,Rice,,North Texas,L (35-42),24,40,60.0,236,1,60,255,4.3,3,100,491,4.9,8,16,4,28,8,65,2,1,3
4922,2016,5,2016-10-01,Rice,@,Southern Mississippi,L (28-44),16,20,80.0,166,2,45,180,4.0,2,65,346,5.3,7,12,0,19,8,81,0,0,0
4923,2016,6,2016-10-15,Rice,,Texas-San Antonio,L (13-14),23,37,62.2,237,1,32,114,3.6,1,69,351,5.1,11,9,2,22,3,20,1,0,1
4924,2016,7,2016-10-22,Rice,,Prairie View A&M,W (65-44),23,32,71.9,434,6,36,203,5.6,3,68,637,9.4,14,9,5,28,10,86,0,0,0
4925,2016,8,2016-10-29,Rice,@,Louisiana Tech,L (16-61),15,27,55.6,152,0,43,153,3.6,2,70,305,4.4,7,10,1,18,1,6,1,1,2
4926,2016,9,2016-11-05,Rice,,Florida Atlantic,L (25-42),20,33,60.6,281,1,45,159,3.5,2,78,440,5.6,10,10,3,23,6,61,1,2,3
4927,2016,10,2016-11-12,Rice,@,UNC Charlotte,W (22-21),36,52,69.2,292,1,42,141,3.4,2,94,433,4.6,18,9,1,28,6,57,0,2,2
4928,2016,11,2016-11-19,Rice,,Texas-El Paso,W (44-24),21,28,75.0,246,3,44,236,5.4,2,72,482,6.7,10,15,2,27,3,17,1,1,2
4929,2016,12,2016-11-26,Rice,@,Stanford,L (17-41),15,48,31.3,124,0,39,167,4.3,2,87,291,3.3,6,14,1,21,5,35,0,0,0
4930,2016,,12 Games,Rice,,,,241,412,58.5,2582,16,482,2039,4.2,23,894,4621,5.2,112,123,25,260,69,566,8,10,18
4931,2017,1,2017-08-26,Rice,N,Stanford,L (7-62),10,24,41.7,95,0,38,146,3.8,1,62,241,3.9,5,8,1,14,6,45,1,1,2
4932,2017,2,2017-09-09,Rice,@,Texas-El Paso,W (31-14),10,18,55.6,131,1,49,306,6.2,3,67,437,6.5,6,16,0,22,4,31,1,0,1
4933,2017,3,2017-09-16,Rice,@,Houston,L (3-38),11,25,44.0,113,0,35,129,3.7,0,60,242,4.0,7,7,0,14,2,15,2,1,3
4934,2017,4,2017-09-23,Rice,,Florida International,L (7-13),16,27,59.3,148,0,41,100,2.4,1,68,248,3.6,11,6,2,19,4,30,0,1,1
4935,2017,5,2017-09-30,Rice,@,Pittsburgh,L (10-42),15,32,46.9,222,1,23,55,2.4,0,55,277,5.0,9,4,1,14,4,37,0,3,3
4936,2017,6,2017-10-07,Rice,,Army,L (12-49),9,21,42.9,146,1,37,200,5.4,1,58,346,6.0,5,12,0,17,3,33,5,1,6
4937,2017,7,2017-10-21,Rice,@,Texas-San Antonio,L (7-20),6,14,42.9,145,1,41,155,3.8,0,55,300,5.5,4,8,1,13,7,70,1,2,3
4938,2017,8,2017-10-28,Rice,,Louisiana Tech,L (28-42),7,17,41.2,187,1,46,247,5.4,3,63,434,6.9,5,14,0,19,5,49,1,3,4
4939,2017,9,2017-11-04,Rice,@,Alabama-Birmingham,L (21-52),14,24,58.3,227,1,35,236,6.7,2,59,463,7.8,9,8,0,17,6,50,1,2,3
4940,2017,10,2017-11-11,Rice,,Southern Mississippi,L (34-43),10,16,62.5,127,0,49,254,5.2,5,65,381,5.9,7,14,5,26,3,30,0,0,0
4941,2017,11,2017-11-18,Rice,@,Old Dominion,L (21-24),8,12,66.7,90,0,50,241,4.8,3,62,331,5.3,5,13,0,18,4,30,1,1,2
4942,2017,12,2017-11-25,Rice,,North Texas,L (14-30),6,16,37.5,107,0,42,175,4.2,1,58,282,4.9,3,10,0,13,5,40,0,1,1
4943,2017,,12 Games,Rice,,,,122,246,49.6,1738,6,486,2244,4.6,20,732,3982,5.4,76,120,10,206,53,460,13,16,29
4944,2016,1,2016-09-03,Richmond,@,Virginia,W (37-20),24,35,68.6,337,3,41,187,4.6,1,76,524,6.9,16,8,0,24,8,70,0,0,0
4945,2014,1,2014-08-28,Rutgers,N,Washington State,W (41-38),16,27,59.3,281,2,43,215,5.0,3,70,496,7.1,10,11,1,22,8,78,0,1,1
4946,2014,2,2014-09-06,Rutgers,,Howard,W (38-25),16,22,72.7,288,4,38,109,2.9,1,60,397,6.6,10,8,2,20,3,41,1,0,1
4947,2014,3,2014-09-13,Rutgers,,Penn State,L (10-13),15,31,48.4,192,0,31,102,3.3,1,62,294,4.7,8,7,0,15,9,75,0,5,5
4948,2014,4,2014-09-20,Rutgers,@,Navy,W (31-24),11,14,78.6,151,0,56,284,5.1,4,70,435,6.2,7,16,1,24,2,24,1,0,1
4949,2014,5,2014-09-27,Rutgers,,Tulane,W (31-6),14,21,66.7,291,4,40,171,4.3,0,61,462,7.6,8,11,1,20,4,30,0,1,1
4950,2014,6,2014-10-04,Rutgers,,Michigan,W (26-24),23,40,57.5,402,3,30,74,2.5,0,70,476,6.8,13,5,0,18,9,85,0,0,0
4951,2014,7,2014-10-18,Rutgers,@,Ohio State,L (17-56),18,29,62.1,196,0,38,149,3.9,2,67,345,5.1,10,7,1,18,0,0,2,1,3
4952,2014,8,2014-10-25,Rutgers,@,Nebraska,L (24-42),12,26,46.2,205,1,38,143,3.8,2,64,348,5.4,8,7,0,15,4,26,0,1,1
4953,2014,9,2014-11-01,Rutgers,,Wisconsin,L (0-37),7,27,25.9,63,0,29,76,2.6,0,56,139,2.5,3,5,0,8,4,35,0,1,1
4954,2014,10,2014-11-15,Rutgers,,Indiana,W (45-23),16,27,59.3,217,2,40,212,5.3,4,67,429,6.4,8,9,2,19,5,41,1,0,1
4955,2014,11,2014-11-22,Rutgers,@,Michigan State,L (3-45),14,31,45.2,139,0,29,95,3.3,0,60,234,3.9,6,8,1,15,3,25,0,3,3
4956,2014,12,2014-11-29,Rutgers,@,Maryland,W (41-38),28,42,66.7,347,4,35,144,4.1,1,77,491,6.4,15,8,1,24,7,60,2,0,2
4957,2014,13,2014-12-26,Rutgers,N,North Carolina*,W (40-21),9,20,45.0,184,2,42,340,8.1,3,62,524,8.5,8,15,0,23,3,25,0,0,0
4958,2014,,13 Games,Rutgers,,,,199,357,55.7,2956,22,489,2114,4.3,21,846,5070,6.0,114,117,10,241,61,545,7,13,20
4959,2015,1,2015-09-05,Rutgers,,Norfolk State,W (63-13),13,15,86.7,248,4,47,291,6.2,4,62,539,8.7,8,17,1,26,9,60,1,0,1
4960,2015,2,2015-09-12,Rutgers,,Washington State,L (34-37),23,29,79.3,204,1,37,198,5.4,1,66,402,6.1,12,12,2,26,11,100,2,1,3
4961,2015,3,2015-09-19,Rutgers,@,Penn State,L (3-28),27,42,64.3,251,0,32,43,1.3,0,74,294,4.0,14,5,1,20,8,29,1,2,3
4962,2015,4,2015-09-26,Rutgers,,Kansas,W (27-14),18,25,72.0,201,2,58,312,5.4,2,83,513,6.2,13,15,3,31,10,80,1,2,3
4963,2015,5,2015-10-10,Rutgers,,Michigan State,L (24-31),15,26,57.7,208,3,32,141,4.4,0,58,349,6.0,7,8,0,15,3,20,0,0,0
4964,2015,6,2015-10-17,Rutgers,@,Indiana,W (55-52),28,43,65.1,386,3,40,210,5.3,4,83,596,7.2,15,10,0,25,1,10,0,1,1
4965,2015,7,2015-10-24,Rutgers,,Ohio State,L (7-49),13,27,48.1,189,1,29,104,3.6,0,56,293,5.2,6,6,0,12,7,55,0,1,1
4966,2015,8,2015-10-31,Rutgers,@,Wisconsin,L (10-48),6,20,30.0,82,0,38,83,2.2,0,58,165,2.8,3,5,0,8,6,40,1,1,2
4967,2015,9,2015-11-07,Rutgers,@,Michigan,L (16-49),11,27,40.7,97,0,32,128,4.0,0,59,225,3.8,6,7,4,17,7,80,0,1,1
4968,2015,10,2015-11-14,Rutgers,,Nebraska,L (14-31),14,28,50.0,170,1,39,89,2.3,1,67,259,3.9,8,7,0,15,4,23,0,2,2
4969,2015,11,2015-11-21,Rutgers,@,Army,W (31-21),13,21,61.9,105,0,39,254,6.5,4,60,359,6.0,6,11,1,18,4,35,0,0,0
4970,2015,12,2015-11-28,Rutgers,,Maryland,L (41-46),21,33,63.6,344,4,47,186,4.0,1,80,530,6.6,14,8,1,23,9,92,0,1,1
4971,2015,,12 Games,Rutgers,,,,202,336,60.1,2485,19,470,2039,4.3,17,806,4524,5.6,112,111,13,236,79,624,6,12,18
4972,2016,1,2016-09-03,Rutgers,@,Washington,L (13-48),24,40,60.0,168,0,48,136,2.8,1,88,304,3.5,9,9,3,21,4,35,2,1,3
4973,2016,2,2016-09-10,Rutgers,,Howard,W (52-14),11,23,47.8,137,3,52,379,7.3,3,75,516,6.9,8,18,0,26,6,61,0,1,1
4974,2016,3,2016-09-17,Rutgers,,New Mexico,W (37-28),12,30,40.0,173,2,32,177,5.5,1,62,350,5.6,7,6,1,14,5,37,1,0,1
4975,2016,4,2016-09-24,Rutgers,,Iowa,L (7-14),13,24,54.2,190,1,53,193,3.6,0,77,383,5.0,8,13,0,21,4,50,1,0,1
4976,2016,5,2016-10-01,Rutgers,@,Ohio State,L (0-58),3,16,18.8,33,0,38,83,2.2,0,54,116,2.1,2,6,1,9,4,21,0,0,0
4977,2016,6,2016-10-08,Rutgers,,Michigan,L (0-78),2,18,11.1,5,0,36,34,0.9,0,54,39,0.7,0,2,0,2,7,41,1,0,1
4978,2016,7,2016-10-15,Rutgers,,Illinois,L (7-24),17,30,56.7,182,1,50,203,4.1,0,80,385,4.8,11,11,1,23,4,36,4,1,5
4979,2016,8,2016-10-22,Rutgers,@,Minnesota,L (32-34),23,40,57.5,222,3,36,150,4.2,0,76,372,4.9,13,8,1,22,6,30,1,2,3
4980,2016,9,2016-11-05,Rutgers,,Indiana,L (27-33),19,36,52.8,258,1,34,93,2.7,1,70,351,5.0,8,5,0,13,8,80,1,0,1
4981,2016,10,2016-11-12,Rutgers,@,Michigan State,L (0-49),6,18,33.3,40,0,36,109,3.0,0,54,149,2.8,3,5,0,8,6,50,0,2,2
4982,2016,11,2016-11-19,Rutgers,,Penn State,L (0-39),7,17,41.2,48,0,33,39,1.2,0,50,87,1.7,2,3,0,5,6,50,0,0,0
4983,2016,12,2016-11-26,Rutgers,@,Maryland,L (13-31),22,40,55.0,203,0,40,147,3.7,2,80,350,4.4,10,10,2,22,3,25,1,0,1
4984,2016,,12 Games,Rutgers,,,,159,332,47.9,1659,11,488,1743,3.6,8,820,3402,4.1,81,96,9,186,63,516,12,7,19
4985,2017,1,2017-09-01,Rutgers,,Washington,L (14-30),24,35,68.6,178,2,42,131,3.1,0,77,309,4.0,9,9,1,19,4,25,0,2,2
4986,2017,2,2017-09-09,Rutgers,,Eastern Michigan,L (13-16),17,38,44.7,198,0,30,128,4.3,1,68,326,4.8,7,5,3,15,9,88,0,2,2
4987,2017,3,2017-09-16,Rutgers,,Morgan State,W (65-0),13,19,68.4,152,2,54,326,6.0,7,73,478,6.5,6,15,4,25,8,60,1,0,1
4988,2017,4,2017-09-23,Rutgers,@,Nebraska,L (17-27),15,29,51.7,126,0,24,68,2.8,1,53,194,3.7,7,4,1,12,4,35,0,2,2
4989,2017,5,2017-09-30,Rutgers,,Ohio State,L (0-56),11,27,40.7,92,0,41,117,2.9,0,68,209,3.1,7,4,2,13,10,80,0,2,2
4990,2017,6,2017-10-14,Rutgers,@,Illinois,W (35-24),6,12,50.0,102,0,47,274,5.8,5,59,376,6.4,4,10,3,17,8,75,3,0,3
4991,2017,7,2017-10-21,Rutgers,,Purdue,W (14-12),9,18,50.0,87,1,37,130,3.5,1,55,217,3.9,3,5,0,8,4,35,0,0,0
4992,2017,8,2017-10-28,Rutgers,@,Michigan,L (14-35),8,16,50.0,101,0,31,94,3.0,2,47,195,4.1,4,4,1,9,3,20,0,0,0
4993,2017,9,2017-11-04,Rutgers,N,Maryland,W (31-24),8,18,44.4,107,1,46,239,5.2,2,64,346,5.4,4,16,1,21,6,49,1,1,2
4994,2017,10,2017-11-11,Rutgers,@,Penn State,L (6-35),7,20,35.0,43,0,40,175,4.4,0,60,218,3.6,2,8,0,10,4,41,1,0,1
4995,2017,11,2017-11-18,Rutgers,@,Indiana,L (0-41),11,24,45.8,103,0,33,87,2.6,0,57,190,3.3,4,6,1,11,6,49,2,0,2
4996,2017,12,2017-11-25,Rutgers,,Michigan State,L (7-40),6,19,31.6,98,1,12,14,1.2,0,31,112,3.6,2,1,2,5,5,44,1,2,3
4997,2017,,12 Games,Rutgers,,,,135,275,49.1,1387,7,437,1783,4.1,19,712,3170,4.5,59,87,19,165,71,601,9,11,20
4998,2016,1,2016-10-29,Samford,@,Mississippi State,L (41-56),42,70,60.0,468,4,34,159,4.7,1,104,627,6.0,20,7,0,27,9,77,0,3,3
4999,2017,1,2017-09-16,Samford,@,Georgia,L (14-42),26,35,74.3,227,2,23,22,1.0,0,58,249,4.3,11,4,1,16,3,17,1,0,1
5000,2014,1,2014-08-30,San Diego State,,Northern Arizona,W (38-7),18,29,62.1,205,1,37,194,5.2,3,66,399,6.0,11,11,3,25,5,29,0,1,1
5001,2014,2,2014-09-06,San Diego State,@,North Carolina,L (27-31),23,39,59.0,341,1,35,168,4.8,2,74,509,6.9,13,7,3,23,9,65,0,3,3
5002,2014,3,2014-09-20,San Diego State,@,Oregon State,L (7-28),14,26,53.8,106,0,23,109,4.7,1,49,215,4.4,6,5,0,11,9,65,0,2,2
5003,2014,4,2014-09-27,San Diego State,,Nevada-Las Vegas,W (34-17),16,28,57.1,209,0,43,257,6.0,4,71,466,6.6,10,10,5,25,6,66,0,0,0
5004,2014,5,2014-10-03,San Diego State,@,Fresno State,L (13-24),9,24,37.5,84,1,45,186,4.1,0,69,270,3.9,6,11,0,17,7,64,1,2,3
5005,2014,6,2014-10-10,San Diego State,@,New Mexico,W (24-14),5,17,29.4,73,0,46,397,8.6,3,63,470,7.5,3,14,2,19,10,102,2,2,4
5006,2014,7,2014-10-18,San Diego State,,Hawaii,W (20-10),13,24,54.2,174,1,47,283,6.0,1,71,457,6.4,4,15,0,19,4,44,1,0,1
5007,2014,8,2014-11-01,San Diego State,@,Nevada,L (14-30),21,36,58.3,189,1,29,135,4.7,1,65,324,5.0,9,8,0,17,4,55,2,1,3
5008,2014,9,2014-11-08,San Diego State,,Idaho,W (35-21),14,22,63.6,249,3,39,156,4.0,2,61,405,6.6,11,6,1,18,4,51,0,0,0
5009,2014,10,2014-11-15,San Diego State,@,Boise State,L (29-38),18,30,60.0,188,1,36,169,4.7,2,66,357,5.4,7,7,2,16,8,75,0,1,1
5010,2014,11,2014-11-21,San Diego State,,Air Force,W (30-14),17,31,54.8,326,1,44,176,4.0,1,75,502,6.7,15,8,0,23,5,39,0,1,1
5011,2014,12,2014-11-29,San Diego State,,San Jose State,W (38-7),4,16,25.0,34,0,60,393,6.6,5,76,427,5.6,3,17,1,21,1,5,0,0,0
5012,2014,13,2014-12-23,San Diego State,N,Navy*,L (16-17),11,27,40.7,141,0,33,186,5.6,1,60,327,5.5,7,10,1,18,5,34,1,2,3
5013,2014,,13 Games,San Diego State,,,,183,349,52.4,2319,10,517,2809,5.4,26,866,5128,5.9,105,129,18,252,77,694,7,15,22
5014,2015,1,2015-09-05,San Diego State,,San Diego,W (37-3),11,23,47.8,139,0,36,166,4.6,1,59,305,5.2,5,10,0,15,8,58,0,1,1
5015,2015,2,2015-09-12,San Diego State,@,California,L (7-35),14,32,43.8,173,1,43,152,3.5,0,75,325,4.3,9,7,0,16,12,136,0,2,2
5016,2015,3,2015-09-19,San Diego State,,South Alabama,L (27-34),13,27,48.1,165,2,38,140,3.7,1,65,305,4.7,7,6,1,14,4,35,1,0,1
5017,2015,4,2015-09-26,San Diego State,@,Penn State,L (21-37),10,29,34.5,141,1,34,101,3.0,1,63,242,3.8,7,5,1,13,4,32,3,0,3
5018,2015,5,2015-10-03,San Diego State,,Fresno State,W (21-7),5,12,41.7,104,2,60,305,5.1,1,72,409,5.7,2,16,1,19,5,50,1,0,1
5019,2015,6,2015-10-10,San Diego State,@,Hawaii,W (28-14),11,15,73.3,184,1,57,218,3.8,3,72,402,5.6,8,8,3,19,11,70,1,0,1
5020,2015,7,2015-10-17,San Diego State,@,San Jose State,W (30-7),10,14,71.4,144,1,48,233,4.9,2,62,377,6.1,6,15,2,23,9,76,0,0,0
5021,2015,8,2015-10-23,San Diego State,,Utah State,W (48-14),6,10,60.0,93,1,61,336,5.5,5,71,429,6.0,4,12,3,19,6,60,0,0,0
5022,2015,9,2015-10-31,San Diego State,@,Colorado State,W (41-17),11,14,78.6,180,1,47,276,5.9,3,61,456,7.5,9,9,3,21,5,61,0,0,0
5023,2015,10,2015-11-14,San Diego State,,Wyoming,W (38-3),12,19,63.2,138,3,53,293,5.5,2,72,431,6.0,4,17,4,25,3,40,2,0,2
5024,2015,11,2015-11-21,San Diego State,@,Nevada-Las Vegas,W (52-14),11,18,61.1,107,1,48,286,6.0,5,66,393,6.0,8,11,1,20,6,70,0,0,0
5025,2015,12,2015-11-28,San Diego State,,Nevada,W (31-14),9,12,75.0,88,0,53,320,6.0,4,65,408,6.3,3,13,1,17,7,55,0,0,0
5026,2015,13,2015-12-05,San Diego State,,Air Force,W (27-24),9,14,64.3,203,1,46,233,5.1,2,60,436,7.3,6,11,0,17,5,39,1,0,1
5027,2015,14,2015-12-24,San Diego State,N,Cincinnati*,W (42-7),9,12,75.0,129,2,52,207,4.0,2,64,336,5.3,7,10,5,22,4,31,0,0,0
5028,2015,,14 Games,San Diego State,,,,141,251,56.2,1988,17,676,3266,4.8,32,927,5254,5.7,85,150,25,260,89,813,9,3,12
5029,2016,1,2016-09-03,San Diego State,,New Hampshire,W (31-0),17,26,65.4,291,2,41,170,4.1,2,67,461,6.9,11,7,1,19,9,70,0,0,0
5030,2016,2,2016-09-10,San Diego State,,California,W (45-40),14,23,60.9,129,1,47,334,7.1,3,70,463,6.6,8,13,1,22,14,105,1,1,2
5031,2016,3,2016-09-17,San Diego State,@,Northern Illinois,W (42-28),11,19,57.9,126,3,45,278,6.2,3,64,404,6.3,6,11,5,22,11,107,0,1,1
5032,2016,4,2016-10-01,San Diego State,@,South Alabama,L (24-42),13,22,59.1,159,1,41,157,3.8,2,63,316,5.0,8,12,0,20,10,85,2,0,2
5033,2016,5,2016-10-08,San Diego State,,Nevada-Las Vegas,W (26-7),15,20,75.0,215,1,54,245,4.5,2,74,460,6.2,8,14,0,22,7,75,1,0,1
5034,2016,6,2016-10-14,San Diego State,@,Fresno State,W (17-3),7,12,58.3,72,0,61,292,4.8,2,73,364,5.0,5,20,0,25,6,65,0,0,0
5035,2016,7,2016-10-21,San Diego State,,San Jose State,W (42-3),13,18,72.2,167,1,44,293,6.7,5,62,460,7.4,7,12,3,22,5,37,0,1,1
5036,2016,8,2016-10-28,San Diego State,@,Utah State,W (40-13),4,10,40.0,14,1,57,400,7.0,2,67,414,6.2,0,18,2,20,4,40,0,0,0
5037,2016,9,2016-11-05,San Diego State,,Hawaii,W (55-0),8,16,50.0,97,3,42,296,7.0,2,58,393,6.8,4,14,1,19,3,20,0,1,1
5038,2016,10,2016-11-12,San Diego State,@,Nevada,W (46-16),11,17,64.7,146,2,44,474,10.8,4,61,620,10.2,9,16,0,25,6,49,1,0,1
5039,2016,11,2016-11-19,San Diego State,@,Wyoming,L (33-34),15,27,55.6,211,2,31,178,5.7,0,58,389,6.7,9,7,1,17,7,53,1,0,1
5040,2016,12,2016-11-26,San Diego State,,Colorado State,L (31-63),11,19,57.9,183,2,38,195,5.1,2,57,378,6.6,9,4,3,16,6,50,1,1,2
5041,2016,13,2016-12-03,San Diego State,@,Wyoming,W (27-24),6,13,46.2,85,0,53,242,4.6,3,66,327,5.0,4,11,1,16,7,62,2,1,3
5042,2016,14,2016-12-17,San Diego State,N,Houston*,W (34-10),10,14,71.4,128,1,37,127,3.4,2,51,255,5.0,6,6,1,13,3,25,0,0,0
5043,2016,,14 Games,San Diego State,,,,155,256,60.5,2023,20,635,3681,5.8,34,891,5704,6.4,94,165,19,278,98,843,9,6,15
5044,2017,1,2017-09-02,San Diego State,,California-Davis,W (38-17),17,23,73.9,237,2,52,276,5.3,3,75,513,6.8,9,15,3,27,10,87,1,1,2
5045,2017,2,2017-09-09,San Diego State,@,Arizona State,W (30-20),9,18,50.0,73,1,43,279,6.5,1,61,352,5.8,3,10,1,14,12,95,0,0,0
5046,2017,3,2017-09-16,San Diego State,,Stanford,W (20-17),21,29,72.4,187,1,48,172,3.6,1,77,359,4.7,11,9,1,21,7,81,0,0,0
5047,2017,4,2017-09-23,San Diego State,@,Air Force,W (28-24),10,16,62.5,180,1,41,187,4.6,3,57,367,6.4,8,7,4,19,0,0,1,0,1
5048,2017,5,2017-09-30,San Diego State,,Northern Illinois,W (34-28),10,20,50.0,136,2,36,127,3.5,0,56,263,4.7,6,3,1,10,10,126,0,0,0
5049,2017,6,2017-10-07,San Diego State,@,Nevada-Las Vegas,W (41-10),14,24,58.3,172,0,46,302,6.6,5,70,474,6.8,10,15,2,27,4,19,1,0,1
5050,2017,7,2017-10-14,San Diego State,,Boise State,L (14-31),12,27,44.4,240,1,39,83,2.1,1,66,323,4.9,8,6,2,16,3,24,1,0,1
5051,2017,8,2017-10-21,San Diego State,,Fresno State,L (3-27),11,23,47.8,90,0,39,165,4.2,0,62,255,4.1,5,8,1,14,5,40,1,0,1
5052,2017,9,2017-10-28,San Diego State,@,Hawaii,W (28-7),5,11,45.5,83,1,53,334,6.3,3,64,417,6.5,4,14,3,21,8,90,0,1,1
5053,2017,10,2017-11-04,San Diego State,@,San Jose State,W (52-7),6,7,85.7,94,1,71,554,7.8,6,78,648,8.3,6,24,1,31,4,25,1,0,1
5054,2017,11,2017-11-18,San Diego State,,Nevada,W (42-23),15,23,65.2,205,1,48,289,6.0,3,71,494,7.0,11,13,1,25,7,75,1,0,1
5055,2017,12,2017-11-24,San Diego State,,New Mexico,W (35-10),14,21,66.7,198,2,37,265,7.2,3,58,463,8.0,8,9,2,19,5,35,1,1,2
5056,2017,13,2017-12-23,San Diego State,N,Army*,L (35-42),6,10,60.0,25,0,21,255,12.1,4,31,280,9.0,3,7,1,11,10,82,1,1,2
5057,2017,,13 Games,San Diego State,,,,150,252,59.5,1920,13,574,3288,5.7,33,826,5208,6.3,92,140,23,255,85,779,9,4,13
5058,2014,1,2014-08-28,San Jose State,,North Dakota,W (42-10),23,26,88.5,256,3,40,150,3.8,2,66,406,6.2,11,10,2,23,4,40,0,0,0
5059,2014,2,2014-09-06,San Jose State,@,Auburn,L (13-59),19,32,59.4,254,1,45,65,1.4,0,77,319,4.1,10,8,2,20,7,66,0,3,3
5060,2014,3,2014-09-20,San Jose State,@,Minnesota,L (7-24),16,33,48.5,186,1,32,68,2.1,0,65,254,3.9,8,6,3,17,0,0,3,2,5
5061,2014,4,2014-09-27,San Jose State,,Nevada,L (10-21),32,46,69.6,276,0,37,170,4.6,1,83,446,5.4,13,10,1,24,9,95,1,2,3
5062,2014,5,2014-10-04,San Jose State,,Nevada-Las Vegas,W (33-10),20,30,66.7,265,1,56,277,4.9,2,86,542,6.3,11,12,0,23,4,45,1,0,1
5063,2014,6,2014-10-18,San Jose State,@,Wyoming,W (27-20),33,45,73.3,322,2,41,149,3.6,1,86,471,5.5,18,10,3,31,5,40,2,0,2
5064,2014,7,2014-10-25,San Jose State,@,Navy,L (31-41),33,46,71.7,322,3,25,100,4.0,1,71,422,5.9,20,6,0,26,2,20,0,1,1
5065,2014,8,2014-11-01,San Jose State,,Colorado State,L (31-38),26,51,51.0,308,2,32,185,5.8,2,83,493,5.9,15,8,1,24,1,5,1,2,3
5066,2014,9,2014-11-08,San Jose State,@,Fresno State,L (24-38),26,44,59.1,350,2,23,86,3.7,1,67,436,6.5,12,4,0,16,7,30,1,2,3
5067,2014,10,2014-11-15,San Jose State,,Hawaii,L (0-13),25,45,55.6,305,0,41,157,3.8,0,86,462,5.4,15,9,0,24,3,20,2,1,3
5068,2014,11,2014-11-21,San Jose State,@,Utah State,L (7-41),13,21,61.9,61,0,51,191,3.7,1,72,252,3.5,3,9,2,14,7,43,0,0,0
5069,2014,12,2014-11-29,San Jose State,@,San Diego State,L (7-38),17,30,56.7,133,1,31,98,3.2,0,61,231,3.8,7,5,0,12,3,35,1,1,2
5070,2014,,12 Games,San Jose State,,,,283,449,63.0,3038,16,454,1696,3.7,11,903,4734,5.2,143,97,14,254,52,439,12,14,26
5071,2015,1,2015-09-03,San Jose State,,New Hampshire,W (43-13),30,35,85.7,422,1,53,285,5.4,5,88,707,8.0,18,16,0,34,5,43,0,0,0
5072,2015,2,2015-09-12,San Jose State,@,Air Force,L (16-37),18,33,54.5,140,1,20,150,7.5,1,53,290,5.5,0,0,0,13,8,51,0,2,2
5073,2015,3,2015-09-19,San Jose State,@,Oregon State,L (21-35),20,33,60.6,149,1,36,104,2.9,2,69,253,3.7,6,8,0,14,2,20,0,2,2
5074,2015,4,2015-09-26,San Jose State,,Fresno State,W (49-23),20,23,87.0,252,3,58,291,5.0,3,81,543,6.7,10,21,2,33,4,30,1,0,1
5075,2015,5,2015-10-03,San Jose State,@,Auburn,L (21-35),21,33,63.6,224,1,38,182,4.8,2,71,406,5.7,12,9,1,22,2,15,2,2,4
5076,2015,6,2015-10-10,San Jose State,@,Nevada-Las Vegas,W (33-27),30,48,62.5,329,2,24,115,4.8,2,72,444,6.2,17,4,1,22,3,22,1,1,2
5077,2015,7,2015-10-17,San Jose State,,San Diego State,L (7-30),14,24,58.3,113,0,35,35,1.0,1,59,148,2.5,5,6,3,14,4,29,0,2,2
5078,2015,8,2015-10-24,San Jose State,,New Mexico,W (31-21),16,20,80.0,181,2,57,317,5.6,2,77,498,6.5,8,15,2,25,5,50,0,0,0
5079,2015,9,2015-11-06,San Jose State,,Brigham Young,L (16-17),18,26,69.2,147,0,38,122,3.2,1,64,269,4.2,9,6,3,18,2,10,1,0,1
5080,2015,10,2015-11-14,San Jose State,@,Nevada,L (34-37),15,23,65.2,186,3,45,247,5.5,0,68,433,6.4,10,11,0,21,4,40,0,0,0
5081,2015,11,2015-11-21,San Jose State,@,Hawaii,W (42-23),24,33,72.7,314,3,40,195,4.9,3,73,509,7.0,14,8,1,23,7,50,0,0,0
5082,2015,12,2015-11-27,San Jose State,,Boise State,L (23-40),28,41,68.3,336,3,33,138,4.2,0,74,474,6.4,16,7,1,24,6,56,0,2,2
5083,2015,13,2015-12-19,San Jose State,N,Georgia State*,W (27-16),10,19,52.6,89,1,54,197,3.6,1,73,286,3.9,6,12,2,20,5,48,0,1,1
5084,2015,,13 Games,San Jose State,,,,264,391,67.5,2882,21,531,2378,4.5,23,922,5260,5.7,131,123,16,283,57,464,5,12,17
5085,2016,1,2016-09-03,San Jose State,@,Tulsa,L (10-45),16,29,55.2,234,1,32,53,1.7,0,61,287,4.7,10,2,1,13,4,30,2,1,3
5086,2016,2,2016-09-10,San Jose State,,Portland State,W (66-35),14,21,66.7,233,3,57,409,7.2,6,78,642,8.2,8,16,4,28,6,60,0,0,0
5087,2016,3,2016-09-17,San Jose State,,Utah,L (17-34),21,39,53.8,249,2,32,56,1.8,0,71,305,4.3,10,6,2,18,2,10,1,2,3
5088,2016,4,2016-09-24,San Jose State,@,Iowa State,L (10-44),13,27,48.1,155,1,47,177,3.8,0,74,332,4.5,9,14,1,24,4,30,0,4,4
5089,2016,5,2016-10-01,San Jose State,@,New Mexico,L (41-48),16,30,53.3,314,3,26,129,5.0,3,56,443,7.9,12,3,5,20,2,25,0,1,1
5090,2016,6,2016-10-08,San Jose State,,Hawaii,L (17-34),18,33,54.5,175,1,40,164,4.1,0,73,339,4.6,5,10,1,16,4,25,0,3,3
5091,2016,7,2016-10-15,San Jose State,,Nevada,W (14-10),11,17,64.7,142,0,54,137,2.5,2,71,279,3.9,8,11,1,20,4,43,0,0,0
5092,2016,8,2016-10-21,San Jose State,@,San Diego State,L (3-42),18,37,48.6,142,0,28,67,2.4,0,65,209,3.2,10,3,1,14,7,69,0,0,0
5093,2016,9,2016-10-29,San Jose State,,Nevada-Las Vegas,W (30-24),24,40,60.0,292,2,42,132,3.1,1,82,424,5.2,14,9,1,24,4,50,0,0,0
5094,2016,10,2016-11-04,San Jose State,@,Boise State,L (31-45),23,35,65.7,278,2,31,209,6.7,1,66,487,7.4,15,12,0,27,5,44,0,1,1
5095,2016,11,2016-11-19,San Jose State,,Air Force,L (38-41),25,37,67.6,340,2,41,117,2.9,3,78,457,5.9,16,9,3,28,7,41,1,2,3
5096,2016,12,2016-11-26,San Jose State,@,Fresno State,W (16-14),15,25,60.0,111,1,48,211,4.4,0,73,322,4.4,6,14,0,20,3,12,1,1,2
5097,2016,,12 Games,San Jose State,,,,214,370,57.8,2665,18,478,1861,3.9,16,848,4526,5.3,123,109,20,252,52,439,5,15,20
5098,2017,1,2017-08-26,San Jose State,,South Florida,L (22-42),25,50,50.0,278,3,38,109,2.9,0,88,387,4.4,11,5,2,18,9,64,0,3,3
5099,2017,2,2017-09-02,San Jose State,,Cal Poly,W (34-13),15,26,57.7,211,3,52,271,5.2,1,78,482,6.2,8,15,0,23,7,57,2,0,2
5100,2017,3,2017-09-09,San Jose State,@,Texas,L (0-56),15,29,51.7,129,0,23,42,1.8,0,52,171,3.3,4,3,1,8,7,49,1,1,2
5101,2017,4,2017-09-16,San Jose State,@,Utah,L (16-54),17,35,48.6,233,1,37,30,0.8,0,72,263,3.7,11,4,1,16,6,58,3,2,5
5102,2017,5,2017-09-23,San Jose State,,Utah State,L (10-61),8,22,36.4,54,0,37,108,2.9,0,59,162,2.7,2,8,0,10,9,52,4,1,5
5103,2017,6,2017-09-30,San Jose State,@,Nevada-Las Vegas,L (13-41),30,49,61.2,315,1,33,147,4.5,0,82,462,5.6,20,7,3,30,7,60,1,2,3
5104,2017,7,2017-10-07,San Jose State,,Fresno State,L (10-27),15,26,57.7,97,1,33,108,3.3,0,59,205,3.5,4,7,1,12,9,78,2,2,4
5105,2017,8,2017-10-14,San Jose State,@,Hawaii,L (26-37),21,33,63.6,381,2,37,123,3.3,0,70,504,7.2,12,7,4,23,11,104,1,1,2
5106,2017,9,2017-10-28,San Jose State,@,Brigham Young,L (20-41),25,39,64.1,198,2,41,140,3.4,0,80,338,4.2,12,9,2,23,2,10,4,1,5
5107,2017,10,2017-11-04,San Jose State,,San Diego State,L (7-52),12,22,54.5,167,1,21,33,1.6,0,43,200,4.7,5,3,0,8,4,30,1,2,3
5108,2017,11,2017-11-11,San Jose State,@,Nevada,L (14-59),11,22,50.0,129,1,55,173,3.1,1,77,302,3.9,7,13,3,23,6,67,2,3,5
5109,2017,12,2017-11-18,San Jose State,@,Colorado State,L (14-42),17,33,51.5,208,0,33,131,4.0,2,66,339,5.1,8,6,2,16,2,10,0,1,1
5110,2017,13,2017-11-25,San Jose State,,Wyoming,W (20-17),15,29,51.7,174,0,43,146,3.4,2,72,320,4.4,6,7,1,14,5,55,1,1,2
5111,2017,,13 Games,San Jose State,,,,226,415,54.5,2574,15,483,1561,3.2,6,898,4135,4.6,110,94,20,224,84,694,22,20,42
5112,2014,1,2014-08-31,SMU,@,Baylor,L (0-45),21,40,52.5,91,0,25,-24,-1.0,0,65,67,1.0,4,2,1,7,4,40,2,1,3
5113,2014,2,2014-09-06,SMU,@,North Texas,L (6-43),24,45,53.3,266,1,14,8,0.6,0,59,274,4.6,11,1,5,17,7,60,3,2,5
5114,2014,3,2014-09-20,SMU,,Texas A&M,L (6-58),14,29,48.3,139,0,42,102,2.4,0,71,241,3.4,6,6,1,13,7,75,0,0,0
5115,2014,4,2014-09-27,SMU,,Texas Christian,L (0-56),16,33,48.5,156,0,45,89,2.0,0,78,245,3.1,8,8,1,17,6,50,2,1,3
5116,2014,5,2014-10-04,SMU,@,East Carolina,L (24-45),42,67,62.7,339,2,18,51,2.8,1,85,390,4.6,19,3,3,25,2,15,0,1,1
5117,2014,6,2014-10-18,SMU,,Cincinnati,L (3-41),20,37,54.1,178,0,24,98,4.1,0,61,276,4.5,8,6,0,14,7,74,2,2,4
5118,2014,7,2014-10-25,SMU,,Memphis,L (10-48),13,33,39.4,114,0,31,137,4.4,1,64,251,3.9,5,7,3,15,7,60,0,2,2
5119,2014,8,2014-11-08,SMU,@,Tulsa,L (28-38),21,32,65.6,212,1,43,252,5.9,3,75,464,6.2,7,14,0,21,9,58,1,2,3
5120,2014,9,2014-11-15,SMU,,South Florida,L (13-14),22,31,71.0,189,1,22,68,3.1,0,53,257,4.8,7,5,1,13,3,17,0,0,0
5121,2014,10,2014-11-22,SMU,@,Central Florida,L (7-53),9,22,40.9,50,0,20,66,3.3,1,42,116,2.8,1,3,0,4,8,39,3,2,5
5122,2014,11,2014-11-28,SMU,,Houston,L (9-35),13,28,46.4,145,1,31,78,2.5,0,59,223,3.8,3,6,1,10,8,94,1,0,1
5123,2014,12,2014-12-06,SMU,@,Connecticut,W (27-20),15,33,45.5,145,0,47,277,5.9,3,80,422,5.3,6,13,1,20,6,50,2,1,3
5124,2014,,12 Games,SMU,,,,230,430,53.5,2024,6,362,1202,3.3,9,792,3226,4.1,85,74,17,176,74,632,16,14,30
5125,2015,1,2015-09-04,SMU,,Baylor,L (21-56),16,24,66.7,166,2,54,203,3.8,1,78,369,4.7,7,13,2,22,5,40,0,2,2
5126,2015,2,2015-09-12,SMU,,North Texas,W (31-13),17,24,70.8,171,2,53,273,5.2,2,77,444,5.8,9,14,4,27,6,50,3,0,3
5127,2015,3,2015-09-19,SMU,@,Texas Christian,L (37-56),17,31,54.8,330,1,48,178,3.7,3,79,508,6.4,10,8,5,23,4,39,0,0,0
5128,2015,4,2015-09-26,SMU,,James Madison,L (45-48),18,30,60.0,262,1,44,232,5.3,5,74,494,6.7,9,11,4,24,5,41,2,0,2
5129,2015,5,2015-10-03,SMU,,East Carolina,L (23-49),20,38,52.6,289,3,30,40,1.3,0,68,329,4.8,13,7,1,21,4,35,0,0,0
5130,2015,6,2015-10-08,SMU,@,Houston,L (28-49),21,35,60.0,248,3,39,151,3.9,1,74,399,5.4,12,7,2,21,7,51,3,0,3
5131,2015,7,2015-10-24,SMU,@,South Florida,L (14-38),20,37,54.1,233,1,43,132,3.1,1,80,365,4.6,10,8,1,19,5,55,3,1,4
5132,2015,8,2015-10-31,SMU,,Tulsa,L (31-40),23,46,50.0,322,4,32,84,2.6,0,78,406,5.2,14,7,2,23,1,10,1,1,2
5133,2015,9,2015-11-06,SMU,,Temple,L (40-60),18,30,60.0,212,1,38,185,4.9,3,68,397,5.8,10,6,4,20,5,53,1,1,2
5134,2015,10,2015-11-14,SMU,@,Navy,L (14-55),9,24,37.5,124,1,31,144,4.6,1,55,268,4.9,4,11,0,15,4,45,0,2,2
5135,2015,11,2015-11-21,SMU,,Tulane,W (49-21),18,25,72.0,195,0,44,323,7.3,6,69,518,7.5,10,11,0,21,14,123,0,0,0
5136,2015,12,2015-11-28,SMU,@,Memphis,L (0-63),5,22,22.7,64,0,47,33,0.7,0,69,97,1.4,1,6,3,10,4,60,4,1,5
5137,2015,,12 Games,SMU,,,,202,366,55.2,2616,19,503,1978,3.9,23,869,4594,5.3,109,109,28,246,64,602,17,8,25
5138,2016,1,2016-09-03,SMU,@,North Texas,W (34-21),13,27,48.1,300,3,46,272,5.9,1,73,572,7.8,11,11,1,23,7,60,0,1,1
5139,2016,2,2016-09-10,SMU,@,Baylor,L (13-40),17,44,38.6,229,1,38,176,4.6,0,82,405,4.9,12,7,2,21,4,40,1,3,4
5140,2016,3,2016-09-17,SMU,,Liberty,W (29-14),19,32,59.4,209,0,47,286,6.1,2,79,495,6.3,8,12,5,25,5,60,0,2,2
5141,2016,4,2016-09-23,SMU,,Texas Christian,L (3-33),19,35,54.3,244,0,34,76,2.2,0,69,320,4.6,11,3,1,15,6,31,0,2,2
5142,2016,5,2016-10-01,SMU,@,Temple,L (20-45),22,44,50.0,199,2,32,89,2.8,0,76,288,3.8,7,8,1,16,8,63,2,2,4
5143,2016,6,2016-10-07,SMU,@,Tulsa,L (40-43),29,52,55.8,258,2,35,154,4.4,2,87,412,4.7,14,4,4,22,6,81,0,0,0
5144,2016,7,2016-10-22,SMU,,Houston,W (38-16),16,31,51.6,228,3,40,178,4.5,2,71,406,5.7,9,8,2,19,6,62,1,0,1
5145,2016,8,2016-10-29,SMU,@,Tulane,W (35-31),16,31,51.6,302,2,43,137,3.2,3,74,439,5.9,12,7,3,22,6,57,0,2,2
5146,2016,9,2016-11-05,SMU,,Memphis,L (7-51),21,40,52.5,208,1,32,100,3.1,0,72,308,4.3,11,7,1,19,6,46,2,1,3
5147,2016,10,2016-11-12,SMU,@,East Carolina,W (55-31),19,32,59.4,237,3,47,240,5.1,2,79,477,6.0,12,11,2,25,6,60,0,0,0
5148,2016,11,2016-11-19,SMU,,South Florida,L (27-35),26,42,61.9,423,3,47,155,3.3,0,89,578,6.5,17,10,1,28,4,24,1,2,3
5149,2016,12,2016-11-26,SMU,,Navy,L (31-75),31,46,67.4,331,2,37,96,2.6,2,83,427,5.1,21,4,2,27,5,40,0,2,2
5150,2016,,12 Games,SMU,,,,248,456,54.4,3168,22,478,1959,4.1,14,934,5127,5.5,145,92,25,262,69,624,7,17,24
5151,2017,1,2017-09-02,SMU,,Stephen F. Austin,W (58-14),12,23,52.2,222,3,48,243,5.1,3,71,465,6.5,8,17,2,25,4,30,0,0,0
5152,2017,2,2017-09-09,SMU,,North Texas,W (54-32),22,41,53.7,394,5,34,99,2.9,2,75,493,6.6,14,4,2,20,4,50,0,1,1
5153,2017,3,2017-09-16,SMU,@,Texas Christian,L (36-56),18,38,47.4,339,2,30,124,4.1,2,68,463,6.8,12,4,3,19,5,53,0,2,2
5154,2017,4,2017-09-23,SMU,,Arkansas State,W (44-21),16,32,50.0,266,2,54,311,5.8,4,86,577,6.7,12,15,4,31,10,90,0,0,0
5155,2017,5,2017-09-30,SMU,,Connecticut,W (49-28),27,39,69.2,280,4,41,218,5.3,3,80,498,6.2,13,12,3,28,11,94,0,0,0
5156,2017,6,2017-10-07,SMU,@,Houston,L (22-35),41,59,69.5,397,1,26,147,5.7,1,85,544,6.4,17,11,2,30,9,95,0,2,2
5157,2017,7,2017-10-21,SMU,@,Cincinnati,W (31-28),26,37,70.3,295,2,44,140,3.2,2,81,435,5.4,17,7,2,26,7,74,0,1,1
5158,2017,8,2017-10-27,SMU,,Tulsa,W (38-34),20,34,58.8,366,2,30,215,7.2,3,64,581,9.1,13,5,1,19,7,90,0,0,0
5159,2017,9,2017-11-04,SMU,,Central Florida,L (24-31),27,52,51.9,283,1,37,206,5.6,1,89,489,5.5,12,8,1,21,4,30,1,0,1
5160,2017,10,2017-11-11,SMU,@,Navy,L (40-43),16,30,53.3,261,4,31,165,5.3,1,61,426,7.0,11,7,3,21,7,65,0,2,2
5161,2017,11,2017-11-18,SMU,@,Memphis,L (45-66),15,35,42.9,218,4,37,259,7.0,2,72,477,6.6,11,11,6,28,5,39,1,0,1
5162,2017,12,2017-11-25,SMU,,Tulane,W (41-38),24,33,72.7,375,4,33,103,3.1,2,66,478,7.2,15,8,1,24,5,24,1,2,3
5163,2017,13,2017-12-20,SMU,N,Louisiana Tech*,L (10-51),19,34,55.9,127,1,41,167,4.1,0,75,294,3.9,6,14,0,20,5,35,3,3,6
5164,2017,,13 Games,SMU,,,,283,487,58.1,3823,35,486,2397,4.9,26,973,6220,6.4,161,123,30,312,83,769,6,13,19
5165,2014,1,2014-09-06,South Alabama,@,Kent State,W (23-13),15,25,60.0,161,1,50,186,3.7,2,75,347,4.6,7,10,3,20,6,30,0,0,0
5166,2014,2,2014-09-13,South Alabama,,Mississippi State,L (3-35),28,55,50.9,288,0,27,57,2.1,0,82,345,4.2,16,5,1,22,3,12,2,2,4
5167,2014,3,2014-09-20,South Alabama,,Georgia Southern,L (6-28),13,34,38.2,149,1,42,147,3.5,0,76,296,3.9,9,11,0,20,6,50,0,2,2
5168,2014,4,2014-09-27,South Alabama,@,Idaho,W (34-10),15,25,60.0,196,1,38,233,6.1,2,63,429,6.8,7,11,1,19,8,65,1,1,2
5169,2014,5,2014-10-04,South Alabama,@,Appalachian State,W (47-21),19,28,67.9,339,3,46,243,5.3,3,74,582,7.9,16,12,0,28,10,124,0,0,0
5170,2014,6,2014-10-18,South Alabama,,Georgia State,W (30-27),11,32,34.4,126,2,54,321,5.9,1,86,447,5.2,7,19,0,26,8,82,0,0,0
5171,2014,7,2014-10-24,South Alabama,,Troy,W (27-13),9,21,42.9,106,1,45,296,6.6,2,66,402,6.1,5,14,4,23,8,78,0,0,0
5172,2014,8,2014-11-01,South Alabama,@,Louisiana,L (9-19),20,35,57.1,270,1,35,66,1.9,0,70,336,4.8,11,5,2,18,8,76,1,0,1
5173,2014,9,2014-11-08,South Alabama,@,Arkansas State,L (10-45),9,25,36.0,90,0,36,111,3.1,1,61,201,3.3,4,6,4,14,3,25,1,3,4
5174,2014,10,2014-11-15,South Alabama,,Texas State,W (24-20),21,29,72.4,210,2,35,174,5.0,1,64,384,6.0,8,8,1,17,6,46,3,1,4
5175,2014,11,2014-11-22,South Alabama,@,South Carolina,L (12-37),17,34,50.0,170,0,44,119,2.7,0,78,289,3.7,12,6,2,20,5,30,1,4,5
5176,2014,12,2014-11-28,South Alabama,,Navy,L (40-42),21,32,65.6,177,4,47,238,5.1,1,79,415,5.3,8,13,1,22,5,51,0,2,2
5177,2014,13,2014-12-20,South Alabama,N,Bowling Green State*,L (28-33),20,37,54.1,279,1,38,136,3.6,3,75,415,5.5,13,9,1,23,5,48,2,2,4
5178,2014,,13 Games,South Alabama,,,,218,412,52.9,2561,17,537,2327,4.3,16,949,4888,5.2,123,129,20,272,81,717,11,17,28
5179,2015,1,2015-09-05,South Alabama,,Gardner-Webb,W (33-23),14,25,56.0,184,2,31,224,7.2,2,56,408,7.3,2,10,1,13,7,55,1,2,3
5180,2015,2,2015-09-12,South Alabama,@,Nebraska,L (9-48),26,45,57.8,313,1,24,19,0.8,0,69,332,4.8,15,1,2,18,7,67,2,1,3
5181,2015,3,2015-09-19,South Alabama,@,San Diego State,W (34-27),18,36,50.0,270,2,47,241,5.1,2,83,511,6.2,12,9,2,23,5,22,0,0,0
5182,2015,4,2015-09-26,South Alabama,,North Carolina State,L (13-63),16,35,45.7,213,1,26,45,1.7,0,61,258,4.2,9,3,2,14,2,25,1,2,3
5183,2015,5,2015-10-03,South Alabama,@,Troy,W (24-18),11,21,52.4,205,2,51,160,3.1,1,72,365,5.1,7,12,2,21,4,55,1,1,2
5184,2015,6,2015-10-13,South Alabama,,Arkansas State,L (31-49),18,33,54.5,273,3,32,29,0.9,1,65,302,4.6,8,3,1,12,7,52,2,3,5
5185,2015,7,2015-10-24,South Alabama,@,Texas State,L (18-36),16,27,59.3,196,0,47,272,5.8,2,74,468,6.3,7,12,3,22,16,127,0,0,0
5186,2015,8,2015-11-07,South Alabama,,Idaho,W (52-45),11,19,57.9,114,2,45,286,6.4,3,64,400,6.3,6,13,0,19,7,71,2,0,2
5187,2015,9,2015-11-12,South Alabama,,Louisiana,W (32-25),18,31,58.1,288,2,52,207,4.0,2,83,495,6.0,12,13,1,26,7,59,0,1,1
5188,2015,10,2015-11-21,South Alabama,@,Georgia State,L (10-24),14,34,41.2,125,0,34,159,4.7,1,68,284,4.2,6,10,3,19,8,70,0,1,1
5189,2015,11,2015-11-28,South Alabama,@,Georgia Southern,L (17-55),7,19,36.8,62,0,36,74,2.1,1,55,136,2.5,3,4,2,9,4,25,0,2,2
5190,2015,12,2015-12-05,South Alabama,,Appalachian State,L (27-34),15,27,55.6,151,0,56,214,3.8,3,83,365,4.4,10,11,0,21,7,65,0,3,3
5191,2015,,12 Games,South Alabama,,,,184,352,52.3,2394,15,481,1930,4.0,18,833,4324,5.2,97,101,19,217,81,693,9,16,25
5192,2016,1,2016-09-03,South Alabama,@,Mississippi State,W (21-20),24,34,70.6,285,2,29,94,3.2,1,63,379,6.0,12,6,1,19,8,57,0,0,0
5193,2016,2,2016-09-10,South Alabama,,Georgia Southern,L (9-24),21,43,48.8,279,0,27,73,2.7,0,70,352,5.0,11,6,2,19,6,65,0,1,1
5194,2016,3,2016-09-17,South Alabama,@,Louisiana,L (23-28),21,29,72.4,264,2,37,74,2.0,1,66,338,5.1,13,5,2,20,3,20,1,0,1
5195,2016,4,2016-09-24,South Alabama,,Nicholls State,W (41-40),24,50,48.0,302,1,42,208,5.0,3,92,510,5.5,16,8,0,24,6,70,0,4,4
5196,2016,5,2016-10-01,South Alabama,,San Diego State,W (42-24),16,21,76.2,242,3,40,89,2.2,2,61,331,5.4,9,7,2,18,10,93,0,1,1
5197,2016,6,2016-10-15,South Alabama,@,Arkansas State,L (7-17),12,27,44.4,194,0,31,61,2.0,1,58,255,4.4,7,6,0,13,9,67,1,1,2
5198,2016,7,2016-10-20,South Alabama,,Troy,L (21-28),11,20,55.0,195,1,39,145,3.7,2,59,340,5.8,7,4,1,12,13,100,1,0,1
5199,2016,8,2016-10-29,South Alabama,,Georgia State,W (13-10),15,27,55.6,124,0,43,182,4.2,1,70,306,4.4,7,11,1,19,5,44,1,1,2
5200,2016,9,2016-11-05,South Alabama,@,Louisiana-Monroe,L (35-42),23,37,62.2,307,1,41,209,5.1,4,78,516,6.6,17,11,2,30,12,83,0,1,1
5201,2016,10,2016-11-19,South Alabama,,Presbyterian,W (31-7),15,28,53.6,167,0,35,251,7.2,3,63,418,6.6,9,8,0,17,4,58,1,0,1
5202,2016,11,2016-11-26,South Alabama,@,Idaho,L (31-38),25,45,55.6,326,3,35,157,4.5,1,80,483,6.0,14,9,2,25,10,73,0,2,2
5203,2016,12,2016-12-03,South Alabama,,New Mexico State,W (35-28),16,28,57.1,239,1,49,282,5.8,4,77,521,6.8,9,13,0,22,4,50,1,2,3
5204,2016,13,2016-12-30,South Alabama,N,Air Force*,L (21-45),10,26,38.5,245,1,21,68,3.2,2,47,313,6.7,7,6,0,13,9,71,2,1,3
5205,2016,,13 Games,South Alabama,,,,233,415,56.1,3169,15,469,1893,4.0,25,884,5062,5.7,138,100,13,251,99,851,8,14,22
5206,2017,1,2017-09-02,South Alabama,@,Mississippi,L (27-47),19,31,61.3,204,1,37,170,4.6,2,68,374,5.5,13,11,1,25,3,22,0,0,0
5207,2017,2,2017-09-08,South Alabama,,Oklahoma State,L (7-44),14,24,58.3,134,1,27,41,1.5,0,51,175,3.4,9,2,1,12,3,40,1,1,2
5208,2017,3,2017-09-16,South Alabama,,Alabama A&M,W (45-0),9,13,69.2,255,2,39,158,4.1,2,52,413,7.9,8,9,1,18,9,83,0,0,0
5209,2017,4,2017-09-23,South Alabama,,Idaho,L (23-29),11,26,42.3,106,0,48,244,5.1,2,74,350,4.7,5,10,2,17,12,109,0,1,1
5210,2017,5,2017-09-30,South Alabama,@,Louisiana Tech,L (16-34),21,45,46.7,235,1,22,98,4.5,0,67,333,5.0,13,3,0,16,7,45,0,2,2
5211,2017,6,2017-10-11,South Alabama,@,Troy,W (19-8),11,20,55.0,176,1,44,48,1.1,1,64,224,3.5,8,3,1,12,8,90,0,1,1
5212,2017,7,2017-10-21,South Alabama,,Louisiana-Monroe,W (33-23),20,33,60.6,317,3,35,232,6.6,1,68,549,8.1,12,14,0,26,7,65,0,1,1
5213,2017,8,2017-10-26,South Alabama,@,Georgia State,L (13-21),27,48,56.3,297,1,23,41,1.8,0,71,338,4.8,12,2,1,15,3,32,0,2,2
5214,2017,9,2017-11-04,South Alabama,,Louisiana,L (14-19),23,42,54.8,281,2,28,87,3.1,0,70,368,5.3,13,8,2,23,6,49,0,2,2
5215,2017,10,2017-11-11,South Alabama,,Arkansas State,W (24-19),25,46,54.3,343,2,32,-3,-0.1,1,78,340,4.4,14,2,2,18,9,81,1,0,1
5216,2017,11,2017-11-18,South Alabama,@,Georgia Southern,L (0-52),16,37,43.2,166,0,16,29,1.8,0,53,195,3.7,7,2,1,10,4,37,1,2,3
5217,2017,12,2017-12-02,South Alabama,@,New Mexico State,L (17-22),26,46,56.5,331,1,24,22,0.9,1,70,353,5.0,17,3,1,21,2,26,1,2,3
5218,2017,,12 Games,South Alabama,,,,222,411,54.0,2845,15,375,1167,3.1,10,786,4012,5.1,131,69,13,213,73,679,4,14,18
5219,2014,1,2014-08-28,South Carolina,,Texas A&M,L (28-52),20,40,50.0,366,4,22,67,3.0,0,62,433,7.0,14,5,4,23,4,21,0,1,1
5220,2014,2,2014-09-06,South Carolina,,East Carolina,W (33-23),25,38,65.8,266,1,38,175,4.6,2,76,441,5.8,15,10,1,26,5,60,0,1,1
5221,2014,3,2014-09-13,South Carolina,,Georgia,W (38-35),21,30,70.0,271,3,42,176,4.2,2,72,447,6.2,13,13,1,27,7,69,1,1,2
5222,2014,4,2014-09-20,South Carolina,@,Vanderbilt,W (48-34),22,34,64.7,237,3,34,212,6.2,2,68,449,6.6,10,12,2,24,5,35,1,0,1
5223,2014,5,2014-09-27,South Carolina,,Missouri,L (20-21),21,37,56.8,219,1,42,119,2.8,1,79,338,4.3,7,9,2,18,8,71,0,0,0
5224,2014,6,2014-10-04,South Carolina,@,Kentucky,L (38-45),23,37,62.2,218,1,48,282,5.9,4,85,500,5.9,13,16,3,32,4,35,0,3,3
5225,2014,7,2014-10-18,South Carolina,,Furman,W (41-10),16,28,57.1,281,2,43,267,6.2,3,71,548,7.7,11,14,1,26,7,53,2,0,2
5226,2014,8,2014-10-25,South Carolina,@,Auburn,L (35-42),30,53,56.6,416,5,33,119,3.6,0,86,535,6.2,20,7,3,30,4,20,0,3,3
5227,2014,9,2014-11-01,South Carolina,,Tennessee,L (42-45),21,34,61.8,377,3,39,248,6.4,3,73,625,8.6,14,12,0,26,7,51,0,1,1
5228,2014,10,2014-11-15,South Carolina,@,Florida,W (23-20),22,42,52.4,206,0,38,95,2.5,3,80,301,3.8,8,8,3,19,6,67,1,0,1
5229,2014,11,2014-11-22,South Carolina,,South Alabama,W (37-12),11,20,55.0,244,2,37,210,5.7,1,57,454,8.0,7,12,1,20,6,57,4,1,5
5230,2014,12,2014-11-29,South Carolina,@,Clemson,L (17-35),23,41,56.1,276,1,33,63,1.9,1,74,339,4.6,8,8,2,18,2,6,1,0,1
5231,2014,13,2014-12-27,South Carolina,N,Miami (FL)*,W (24-21),22,34,64.7,294,2,30,60,2.0,1,64,354,5.5,10,5,1,16,5,61,0,0,0
5232,2014,,13 Games,South Carolina,,,,277,468,59.2,3671,28,479,2093,4.4,23,947,5764,6.1,150,131,24,305,70,606,10,11,21
5233,2015,1,2015-09-03,South Carolina,N,North Carolina,W (17-13),12,27,44.4,140,1,47,254,5.4,1,74,394,5.3,7,15,0,22,8,60,0,0,0
5234,2015,2,2015-09-12,South Carolina,,Kentucky,L (22-26),17,27,63.0,222,1,34,195,5.7,1,61,417,6.8,10,9,3,22,5,50,0,1,1
5235,2015,3,2015-09-19,South Carolina,@,Georgia,L (20-52),10,22,45.5,84,0,39,174,4.5,2,61,258,4.2,7,8,1,16,4,40,0,1,1
5236,2015,4,2015-09-26,South Carolina,,Central Florida,W (31-14),12,25,48.0,184,2,43,216,5.0,1,68,400,5.9,9,10,1,20,2,20,1,0,1
5237,2015,5,2015-10-03,South Carolina,@,Missouri,L (10-24),17,30,56.7,186,1,34,112,3.3,0,64,298,4.7,9,7,1,17,4,35,0,3,3
5238,2015,6,2015-10-10,South Carolina,,Louisiana State,L (24-45),15,30,50.0,209,2,20,74,3.7,0,50,283,5.7,6,6,0,12,5,32,0,1,1
5239,2015,7,2015-10-17,South Carolina,,Vanderbilt,W (19-10),17,29,58.6,272,1,37,152,4.1,0,66,424,6.4,10,6,1,17,6,39,1,1,2
5240,2015,8,2015-10-31,South Carolina,@,Texas A&M,L (28-35),15,24,62.5,192,0,43,253,5.9,4,67,445,6.6,8,11,0,19,5,26,0,2,2
5241,2015,9,2015-11-07,South Carolina,@,Tennessee,L (24-27),20,39,51.3,233,3,40,152,3.8,0,79,385,4.9,11,10,2,23,6,40,1,0,1
5242,2015,10,2015-11-14,South Carolina,,Florida,L (14-24),14,25,56.0,180,2,23,21,0.9,0,48,201,4.2,9,1,3,13,4,45,0,2,2
5243,2015,11,2015-11-21,South Carolina,,Citadel,L (22-23),28,43,65.1,367,1,25,72,2.9,1,68,439,6.5,14,4,0,18,7,51,0,0,0
5244,2015,12,2015-11-28,South Carolina,,Clemson,L (32-37),14,30,46.7,221,3,38,181,4.8,1,68,402,5.9,7,10,0,17,4,30,0,1,1
5245,2015,,12 Games,South Carolina,,,,191,351,54.4,2490,17,423,1856,4.4,11,774,4346,5.6,107,97,12,216,60,468,3,12,15
5246,2016,1,2016-09-01,South Carolina,@,Vanderbilt,W (13-10),16,30,53.3,187,0,32,121,3.8,1,62,308,5.0,10,4,0,14,7,51,2,0,2
5247,2016,2,2016-09-10,South Carolina,@,Mississippi State,L (14-27),20,39,51.3,209,2,31,34,1.1,0,70,243,3.5,12,5,1,18,6,70,1,1,2
5248,2016,3,2016-09-17,South Carolina,,East Carolina,W (20-15),16,28,57.1,195,0,25,117,4.7,2,53,312,5.9,8,3,2,13,7,65,0,0,0
5249,2016,4,2016-09-24,South Carolina,@,Kentucky,L (10-17),15,30,50.0,177,0,35,91,2.6,1,65,268,4.1,10,5,1,16,5,45,0,0,0
5250,2016,5,2016-10-01,South Carolina,,Texas A&M,L (13-24),22,35,62.9,217,0,35,161,4.6,1,70,378,5.4,11,8,2,21,3,20,1,1,2
5251,2016,6,2016-10-09,South Carolina,,Georgia,L (14-28),26,36,72.2,288,0,26,30,1.2,2,62,318,5.1,9,4,0,13,5,42,2,1,3
5252,2016,7,2016-10-22,South Carolina,,Massachusetts,W (34-28),17,26,65.4,201,2,44,194,4.4,3,70,395,5.6,6,11,4,21,6,67,2,0,2
5253,2016,8,2016-10-29,South Carolina,,Tennessee,W (24-21),15,21,71.4,167,2,49,158,3.2,1,70,325,4.6,8,9,2,19,7,77,0,0,0
5254,2016,9,2016-11-05,South Carolina,,Missouri,W (31-21),22,28,78.6,254,2,49,174,3.6,2,77,428,5.6,10,11,1,22,6,45,0,0,0
5255,2016,10,2016-11-12,South Carolina,@,Florida,L (7-20),18,33,54.5,213,0,30,43,1.4,1,63,256,4.1,10,4,1,15,2,10,1,1,2
5256,2016,11,2016-11-19,South Carolina,,Western Carolina,W (44-31),15,24,62.5,166,0,56,422,7.5,4,80,588,7.4,8,19,1,28,3,25,1,0,1
5257,2016,12,2016-11-26,South Carolina,@,Clemson,L (7-56),14,29,48.3,107,1,29,111,3.8,0,58,218,3.8,5,6,3,14,5,54,0,1,1
5258,2016,13,2016-12-29,South Carolina,N,South Florida*,L (39-46),32,43,74.4,390,3,34,91,2.7,2,77,481,6.2,20,4,3,27,3,35,3,2,5
5259,2016,,13 Games,South Carolina,,,,248,402,61.7,2771,12,475,1747,3.7,20,877,4518,5.2,127,93,21,241,65,606,13,7,20
5260,2017,1,2017-09-02,South Carolina,N,North Carolina State,W (35-28),17,29,58.6,215,3,21,31,1.5,1,50,246,4.9,8,4,0,12,6,45,0,1,1
5261,2017,2,2017-09-09,South Carolina,@,Missouri,W (31-13),18,28,64.3,187,1,40,172,4.3,2,68,359,5.3,9,9,2,20,4,29,0,0,0
5262,2017,3,2017-09-16,South Carolina,,Kentucky,L (13-23),24,37,64.9,304,2,20,54,2.7,0,57,358,6.3,11,3,0,14,7,45,0,2,2
5263,2017,4,2017-09-23,South Carolina,,Louisiana Tech,W (17-16),22,35,62.9,295,1,31,154,5.0,1,66,449,6.8,12,11,0,23,1,15,1,1,2
5264,2017,5,2017-09-30,South Carolina,@,Texas A&M,L (17-24),17,30,56.7,256,2,26,23,0.9,0,56,279,5.0,11,2,1,14,2,10,1,0,1
5265,2017,6,2017-10-07,South Carolina,,Arkansas,W (48-22),16,31,51.6,199,3,36,159,4.4,0,67,358,5.3,9,9,1,19,3,25,0,0,0
5266,2017,7,2017-10-14,South Carolina,@,Tennessee,W (15-9),15,24,62.5,129,0,40,194,4.9,1,64,323,5.0,8,11,0,19,8,59,0,0,0
5267,2017,8,2017-10-28,South Carolina,,Vanderbilt,W (34-27),19,29,65.5,174,1,37,212,5.7,3,66,386,5.8,8,14,4,26,7,50,0,0,0
5268,2017,9,2017-11-04,South Carolina,@,Georgia,L (10-24),21,36,58.3,227,1,17,43,2.5,0,53,270,5.1,11,1,2,14,2,15,0,2,2
5269,2017,10,2017-11-11,South Carolina,,Florida,W (28-20),19,29,65.5,249,0,47,220,4.7,4,76,469,6.2,13,9,2,24,3,26,1,3,4
5270,2017,11,2017-11-18,South Carolina,,Wofford,W (31-10),22,28,78.6,194,1,38,195,5.1,3,66,389,5.9,9,13,1,23,3,31,0,0,0
5271,2017,12,2017-11-25,South Carolina,,Clemson,L (10-34),16,29,55.2,126,1,25,81,3.2,0,54,207,3.8,6,4,0,10,9,76,0,2,2
5272,2017,13,2018-01-01,South Carolina,N,Michigan*,W (26-19),19,32,59.4,239,2,26,61,2.3,1,58,300,5.2,10,2,1,13,7,68,2,1,3
5273,2017,,13 Games,South Carolina,,,,245,397,61.7,2794,18,404,1599,4.0,16,801,4393,5.5,125,92,14,231,62,494,5,12,17
5274,2014,1,2014-08-30,South Florida,,Western Carolina,W (36-31),10,27,37.0,191,0,33,294,8.9,4,60,485,8.1,6,6,1,13,6,38,1,1,2
5275,2014,2,2014-09-06,South Florida,,Maryland,L (17-24),15,37,40.5,174,0,37,83,2.2,1,74,257,3.5,9,6,1,16,6,39,0,1,1
5276,2014,3,2014-09-13,South Florida,,North Carolina State,L (17-49),5,20,25.0,89,1,27,70,2.6,0,47,159,3.4,3,4,1,8,5,40,1,2,3
5277,2014,4,2014-09-19,South Florida,,Connecticut,W (17-14),10,18,55.6,113,1,53,158,3.0,1,71,271,3.8,6,10,1,17,5,45,0,1,1
5278,2014,5,2014-09-27,South Florida,@,Wisconsin,L (10-27),8,19,42.1,173,0,19,72,3.8,1,38,245,6.4,5,3,0,8,11,90,1,1,2
5279,2014,6,2014-10-11,South Florida,,East Carolina,L (17-28),21,42,50.0,257,1,27,93,3.4,1,69,350,5.1,12,6,5,23,8,59,0,1,1
5280,2014,7,2014-10-18,South Florida,@,Tulsa,W (38-30),17,26,65.4,272,3,32,140,4.4,2,58,412,7.1,12,5,2,19,7,77,1,1,2
5281,2014,8,2014-10-24,South Florida,N,Cincinnati,L (17-34),20,33,60.6,239,2,22,42,1.9,0,55,281,5.1,9,3,0,12,7,95,2,2,4
5282,2014,9,2014-11-01,South Florida,,Houston,L (3-27),13,26,50.0,146,0,29,76,2.6,0,55,222,4.0,8,5,0,13,5,45,0,1,1
5283,2014,10,2014-11-15,South Florida,@,Southern Methodist,W (14-13),15,31,48.4,211,2,40,167,4.2,0,71,378,5.3,10,8,0,18,8,96,2,0,2
5284,2014,11,2014-11-22,South Florida,@,Memphis,L (20-31),27,46,58.7,301,1,35,95,2.7,1,81,396,4.9,15,3,2,20,2,29,1,0,1
5285,2014,12,2014-11-28,South Florida,,Central Florida,L (0-16),18,39,46.2,195,0,22,5,0.2,0,61,200,3.3,9,3,3,15,5,75,0,0,0
5286,2014,,12 Games,South Florida,,,,179,364,49.2,2361,11,376,1295,3.4,11,740,3656,4.9,104,62,16,182,75,728,9,11,20
5287,2015,1,2015-09-05,South Florida,,Florida A&M,W (51-3),20,26,76.9,281,3,46,275,6.0,4,72,556,7.7,9,15,3,27,11,97,0,1,1
5288,2015,2,2015-09-12,South Florida,@,Florida State,L (14-34),12,24,50.0,125,2,36,149,4.1,0,60,274,4.6,5,6,0,11,2,21,0,1,1
5289,2015,3,2015-09-19,South Florida,@,Maryland,L (17-35),10,22,45.5,60,1,50,240,4.8,1,72,300,4.2,3,12,3,18,10,105,0,2,2
5290,2015,4,2015-10-02,South Florida,,Memphis,L (17-24),17,26,65.4,199,1,43,178,4.1,1,69,377,5.5,8,7,4,19,6,40,0,1,1
5291,2015,5,2015-10-10,South Florida,,Syracuse,W (45-24),15,22,68.2,259,2,47,281,6.0,4,69,540,7.8,10,15,1,26,9,85,1,0,1
5292,2015,6,2015-10-17,South Florida,@,Connecticut,W (28-20),12,16,75.0,186,3,44,275,6.3,1,60,461,7.7,6,11,0,17,3,30,0,2,2
5293,2015,7,2015-10-24,South Florida,,Southern Methodist,W (38-14),9,21,42.9,97,0,44,255,5.8,5,65,352,5.4,3,10,2,15,4,40,1,0,1
5294,2015,8,2015-10-31,South Florida,@,Navy,L (17-29),12,20,60.0,208,0,24,62,2.6,1,44,270,6.1,7,1,1,9,6,54,1,0,1
5295,2015,9,2015-11-07,South Florida,@,East Carolina,W (22-17),12,23,52.2,200,2,60,242,4.0,0,83,442,5.3,10,10,2,22,6,58,1,0,1
5296,2015,10,2015-11-14,South Florida,,Temple,W (44-23),15,22,68.2,230,2,48,326,6.8,3,70,556,7.9,8,13,1,22,8,86,1,0,1
5297,2015,11,2015-11-20,South Florida,,Cincinnati,W (65-27),13,20,65.0,200,5,53,361,6.8,3,73,561,7.7,7,18,0,25,1,11,1,2,3
5298,2015,12,2015-11-26,South Florida,@,Central Florida,W (44-3),15,23,65.2,174,3,54,281,5.2,2,77,455,5.9,8,16,1,25,4,20,0,0,0
5299,2015,13,2015-12-21,South Florida,N,Western Kentucky*,L (35-45),15,34,44.1,307,2,45,290,6.4,3,79,597,7.6,11,16,1,28,9,67,0,0,0
5300,2015,,13 Games,South Florida,,,,177,299,59.2,2526,26,594,3215,5.4,28,893,5741,6.4,95,150,19,264,79,714,6,9,15
5301,2016,1,2016-09-03,South Florida,,Towson,W (56-20),13,25,52.0,230,4,41,214,5.2,4,66,444,6.7,9,10,3,22,4,42,1,1,2
5302,2016,2,2016-09-10,South Florida,,Northern Illinois,W (48-17),25,39,64.1,365,4,50,293,5.9,2,89,658,7.4,15,15,4,34,8,77,1,0,1
5303,2016,3,2016-09-17,South Florida,@,Syracuse,W (45-20),14,29,48.3,220,1,32,240,7.5,4,61,460,7.5,9,10,1,20,4,50,0,0,0
5304,2016,4,2016-09-24,South Florida,,Florida State,L (35-55),5,14,35.7,160,1,41,290,7.1,4,55,450,8.2,3,12,2,17,8,68,0,2,2
5305,2016,5,2016-10-01,South Florida,@,Cincinnati,W (45-20),22,33,66.7,228,0,48,226,4.7,5,81,454,5.6,12,13,0,25,2,21,0,0,0
5306,2016,6,2016-10-08,South Florida,,East Carolina,W (38-22),21,29,72.4,250,3,42,306,7.3,2,71,556,7.8,8,14,1,23,9,101,1,0,1
5307,2016,7,2016-10-15,South Florida,,Connecticut,W (42-27),23,37,62.2,213,2,47,316,6.7,4,84,529,6.3,11,15,0,26,4,36,2,2,4
5308,2016,8,2016-10-21,South Florida,@,Temple,L (30-46),11,20,55.0,187,2,33,165,5.0,2,53,352,6.6,9,8,1,18,11,88,0,1,1
5309,2016,9,2016-10-28,South Florida,,Navy,W (52-45),20,30,66.7,217,2,44,412,9.4,5,74,629,8.5,11,14,0,25,8,50,1,0,1
5310,2016,10,2016-11-12,South Florida,@,Memphis,W (49-42),24,29,82.8,263,2,50,416,8.3,5,79,679,8.6,11,17,2,30,7,75,0,0,0
5311,2016,11,2016-11-19,South Florida,@,Southern Methodist,W (35-27),7,15,46.7,195,3,43,278,6.5,2,58,473,8.2,4,12,0,16,7,55,1,1,2
5312,2016,12,2016-11-26,South Florida,,Central Florida,W (48-31),17,26,65.4,152,0,48,351,7.3,5,74,503,6.8,6,14,0,20,6,50,1,0,1
5313,2016,13,2016-12-29,South Florida,N,South Carolina*,W (46-39),23,32,71.9,261,2,48,208,4.3,3,80,469,5.9,13,10,1,24,5,50,1,1,2
5314,2016,,13 Games,South Florida,,,,225,358,62.8,2941,26,567,3715,6.6,47,925,6656,7.2,121,164,15,300,83,763,9,8,17
5315,2017,1,2017-08-26,South Florida,@,San Jose State,W (42-22),13,26,50.0,233,2,74,315,4.3,4,100,548,5.5,10,17,2,29,10,57,0,0,0
5316,2017,2,2017-09-02,South Florida,,Stony Brook,W (31-17),19,32,59.4,186,2,49,153,3.1,2,81,339,4.2,6,13,2,21,5,40,0,1,1
5317,2017,3,2017-09-15,South Florida,,Illinois,W (47-23),17,32,53.1,304,4,66,376,5.7,2,98,680,6.9,14,21,3,38,16,140,0,1,1
5318,2017,4,2017-09-21,South Florida,,Temple,W (43-7),8,20,40.0,96,0,63,312,5.0,4,83,408,4.9,4,15,3,22,9,70,2,0,2
5319,2017,5,2017-09-30,South Florida,@,East Carolina,W (61-31),13,21,61.9,185,2,50,390,7.8,5,71,575,8.1,8,15,2,25,8,102,1,0,1
5320,2017,6,2017-10-14,South Florida,,Cincinnati,W (33-3),17,30,56.7,190,0,53,212,4.0,2,83,402,4.8,9,14,2,25,14,137,0,0,0
5321,2017,7,2017-10-21,South Florida,@,Tulane,W (34-28),10,24,41.7,127,2,52,378,7.3,3,76,505,6.6,6,18,1,25,7,89,0,1,1
5322,2017,8,2017-10-28,South Florida,,Houston,L (24-28),23,38,60.5,325,0,55,137,2.5,3,93,462,5.0,14,6,1,21,5,35,0,0,0
5323,2017,9,2017-11-04,South Florida,@,Connecticut,W (37-20),24,37,64.9,385,3,40,217,5.4,1,77,602,7.8,15,12,1,28,11,100,1,1,2
5324,2017,10,2017-11-16,South Florida,,Tulsa,W (27-20),11,28,39.3,142,2,45,279,6.2,1,73,421,5.8,6,14,1,21,6,60,1,1,2
5325,2017,11,2017-11-24,South Florida,@,Central Florida,L (42-49),24,45,53.3,503,4,39,150,3.8,2,84,653,7.8,16,10,1,27,10,102,1,1,2
5326,2017,12,2017-12-23,South Florida,N,Texas Tech*,W (38-34),17,34,50.0,311,4,48,250,5.2,1,82,561,6.8,12,11,4,27,10,100,2,0,2
5327,2017,,12 Games,South Florida,,,,196,367,53.4,2987,25,634,3169,5.0,30,1001,6156,6.1,120,166,23,309,111,1032,8,6,14
5328,2016,1,2016-09-03,Southern,@,Louisiana-Monroe,L (21-38),17,32,53.1,137,1,46,239,5.2,1,78,376,4.8,9,13,3,25,4,40,0,1,1
5329,2016,2,2016-09-10,Southern,@,Tulane,L (21-66),18,31,58.1,281,2,23,54,2.3,0,54,335,6.2,10,1,2,13,6,62,2,2,4
5330,2016,,2 Games,Southern,,,,35,63,55.6,418,3,69,293,4.2,1,132,711,5.4,19,14,5,38,10,102,2,3,5
5331,2017,1,2017-09-09,Southern,@,Southern Mississippi,L (0-45),10,26,38.5,78,0,26,62,2.4,0,52,140,2.7,3,4,0,7,8,68,1,2,3
5332,2017,2,2017-09-16,Southern,@,Texas-San Antonio,L (17-51),9,26,34.6,65,0,33,84,2.5,1,59,149,2.5,1,8,1,10,4,25,0,3,3
5333,2017,,2 Games,Southern,,,,19,52,36.5,143,0,59,146,2.5,1,111,289,2.6,4,12,1,17,12,93,1,5,6
5334,2016,1,2016-09-03,Southern Illinois,@,Florida Atlantic,L (30-38),37,52,71.2,387,2,34,143,4.2,2,86,530,6.2,19,7,0,26,5,50,1,0,1
5335,2017,1,2017-09-23,Southern Illinois,@,Memphis,L (31-44),30,49,61.2,290,4,37,103,2.8,0,86,393,4.6,15,5,3,23,7,56,0,1,1
5336,2014,1,2014-08-30,Southern Mississippi,@,Mississippi State,L (0-49),20,42,47.6,212,0,33,71,2.2,0,75,283,3.8,6,8,1,15,6,37,1,2,3
5337,2014,2,2014-09-06,Southern Mississippi,,Alcorn State,W (26-20),21,33,63.6,208,2,42,207,4.9,0,75,415,5.5,7,11,4,22,4,40,0,0,0
5338,2014,3,2014-09-13,Southern Mississippi,@,Alabama,L (12-52),19,37,51.4,207,0,18,56,3.1,0,55,263,4.8,9,3,1,13,6,50,0,0,0
5339,2014,4,2014-09-20,Southern Mississippi,,Appalachian State,W (21-20),22,36,61.1,268,1,25,61,2.4,2,61,329,5.4,9,5,2,16,9,103,0,2,2
5340,2014,5,2014-09-27,Southern Mississippi,,Rice,L (23-41),24,46,52.2,283,2,23,40,1.7,1,69,323,4.7,12,2,4,18,6,55,1,2,3
5341,2014,6,2014-10-04,Southern Mississippi,@,Middle Tennessee State,L (31-37),36,55,65.5,426,3,34,111,3.3,1,89,537,6.0,23,7,0,30,6,48,1,1,2
5342,2014,7,2014-10-18,Southern Mississippi,@,North Texas,W (30-20),27,41,65.9,305,2,41,201,4.9,1,82,506,6.2,16,12,2,30,6,70,0,2,2
5343,2014,8,2014-10-25,Southern Mississippi,,Louisiana Tech,L (20-31),32,49,65.3,379,1,26,-31,-1.2,1,75,348,4.6,19,2,1,22,9,83,0,2,2
5344,2014,9,2014-11-01,Southern Mississippi,@,Texas-El Paso,L (14-35),20,47,42.6,309,1,27,93,3.4,0,74,402,5.4,11,6,0,17,9,95,3,2,5
5345,2014,10,2014-11-08,Southern Mississippi,,Marshall,L (17-63),11,20,55.0,114,0,54,186,3.4,2,74,300,4.1,7,11,5,23,7,68,2,1,3
5346,2014,11,2014-11-13,Southern Mississippi,@,Texas-San Antonio,L (10-12),21,34,61.8,257,1,25,57,2.3,0,59,314,5.3,10,4,3,17,7,62,2,1,3
5347,2014,12,2014-11-29,Southern Mississippi,,Alabama-Birmingham,L (24-45),24,42,57.1,263,1,28,97,3.5,1,70,360,5.1,13,6,7,26,2,20,1,0,1
5348,2014,,12 Games,Southern Mississippi,,,,277,482,57.5,3231,14,376,1149,3.1,9,858,4380,5.1,142,77,30,249,77,731,11,15,26
5349,2015,1,2015-09-05,Southern Mississippi,,Mississippi State,L (16-34),30,44,68.2,311,1,36,102,2.8,0,80,413,5.2,15,4,1,20,7,59,0,2,2
5350,2015,2,2015-09-12,Southern Mississippi,,Austin Peay,W (52-6),22,40,55.0,275,3,30,239,8.0,3,70,514,7.3,12,9,3,24,6,70,0,1,1
5351,2015,3,2015-09-19,Southern Mississippi,@,Texas State,W (56-50),19,27,70.4,333,4,46,280,6.1,4,73,613,8.4,14,6,2,22,15,130,1,0,1
5352,2015,4,2015-09-26,Southern Mississippi,@,Nebraska,L (28-36),26,42,61.9,447,2,23,11,0.5,2,65,458,7.0,15,1,3,19,9,80,1,0,1
5353,2015,5,2015-10-03,Southern Mississippi,,North Texas,W (49-14),27,36,75.0,325,4,33,248,7.5,3,69,573,8.3,11,11,2,24,8,87,0,0,0
5354,2015,6,2015-10-09,Southern Mississippi,@,Marshall,L (10-31),29,58,50.0,314,1,35,125,3.6,0,93,439,4.7,13,8,5,26,8,55,4,1,5
5355,2015,7,2015-10-17,Southern Mississippi,,Texas-San Antonio,W (32-10),23,31,74.2,343,2,44,213,4.8,1,75,556,7.4,11,9,3,23,8,85,1,3,4
5356,2015,8,2015-10-24,Southern Mississippi,@,UNC Charlotte,W (44-10),25,40,62.5,268,4,38,212,5.6,1,78,480,6.2,10,10,2,22,7,63,2,0,2
5357,2015,9,2015-10-31,Southern Mississippi,,Texas-El Paso,W (34-13),23,33,69.7,277,4,36,246,6.8,1,69,523,7.6,14,7,3,24,4,41,1,0,1
5358,2015,10,2015-11-14,Southern Mississippi,@,Rice,W (65-10),28,37,75.7,501,7,35,181,5.2,2,72,682,9.5,18,7,1,26,6,59,1,0,1
5359,2015,11,2015-11-21,Southern Mississippi,,Old Dominion,W (56-31),21,37,56.8,302,2,48,310,6.5,6,85,612,7.2,15,15,3,33,4,40,1,1,2
5360,2015,12,2015-11-28,Southern Mississippi,@,Louisiana Tech,W (58-24),24,37,64.9,386,3,36,169,4.7,4,73,555,7.6,18,6,1,25,6,65,0,1,1
5361,2015,13,2015-12-05,Southern Mississippi,@,Western Kentucky,L (28-45),15,30,50.0,181,1,32,159,5.0,2,62,340,5.5,8,6,0,14,5,52,1,3,4
5362,2015,14,2015-12-26,Southern Mississippi,N,Washington*,L (31-44),26,39,66.7,353,2,30,22,0.7,2,69,375,5.4,14,5,3,22,4,45,0,0,0
5363,2015,,14 Games,Southern Mississippi,,,,338,531,63.7,4616,40,502,2517,5.0,31,1033,7133,6.9,188,104,32,324,97,931,13,12,25
5364,2016,1,2016-09-03,Southern Mississippi,@,Kentucky,W (44-35),18,28,64.3,258,2,67,296,4.4,3,95,554,5.8,10,18,4,32,7,50,0,3,3
5365,2016,2,2016-09-10,Southern Mississippi,,Savannah State,W (56-0),21,29,72.4,246,4,48,371,7.7,3,77,617,8.0,10,18,0,28,5,40,0,1,1
5366,2016,3,2016-09-17,Southern Mississippi,,Troy,L (31-37),24,52,46.2,263,1,29,158,5.4,2,81,421,5.2,13,5,2,20,16,135,1,2,3
5367,2016,4,2016-09-24,Southern Mississippi,@,Texas-El Paso,W (34-7),16,27,59.3,176,3,39,202,5.2,0,66,378,5.7,9,8,1,18,4,30,2,0,2
5368,2016,5,2016-10-01,Southern Mississippi,,Rice,W (44-28),25,36,69.4,591,4,34,111,3.3,1,70,702,10.0,15,6,2,23,7,52,2,1,3
5369,2016,6,2016-10-08,Southern Mississippi,@,Texas-San Antonio,L (32-55),25,50,50.0,378,3,39,179,4.6,1,89,557,6.3,18,10,3,31,5,57,2,1,3
5370,2016,7,2016-10-15,Southern Mississippi,@,Louisiana State,L (10-45),25,37,67.6,161,0,36,81,2.3,1,73,242,3.3,9,4,3,16,6,42,1,0,1
5371,2016,8,2016-10-29,Southern Mississippi,,Marshall,W (24-14),22,40,55.0,300,1,45,174,3.9,2,85,474,5.6,14,10,2,26,4,44,1,0,1
5372,2016,9,2016-11-05,Southern Mississippi,,UNC Charlotte,L (27-38),32,53,60.4,404,2,29,94,3.2,2,82,498,6.1,15,7,3,25,8,60,0,3,3
5373,2016,10,2016-11-12,Southern Mississippi,@,Old Dominion,L (35-51),12,24,50.0,230,1,55,222,4.0,4,79,452,5.7,9,12,0,21,4,34,4,1,5
5374,2016,11,2016-11-19,Southern Mississippi,@,North Texas,L (23-29),11,27,40.7,182,0,43,203,4.7,3,70,385,5.5,6,9,4,19,9,79,1,3,4
5375,2016,12,2016-11-25,Southern Mississippi,,Louisiana Tech,W (39-24),29,33,87.9,342,3,44,84,1.9,2,77,426,5.5,17,6,3,26,9,85,1,0,1
5376,2016,13,2016-12-17,Southern Mississippi,N,Louisiana*,W (28-21),25,42,59.5,346,2,32,135,4.2,2,74,481,6.5,12,8,2,22,13,131,1,1,2
5377,2016,,13 Games,Southern Mississippi,,,,285,478,59.6,3877,26,540,2310,4.3,26,1018,6187,6.1,157,121,29,307,97,839,16,16,32
5378,2017,1,2017-09-02,Southern Mississippi,,Kentucky,L (17-24),22,40,55.0,309,2,38,55,1.4,0,78,364,4.7,10,7,2,19,8,69,3,0,3
5379,2017,2,2017-09-09,Southern Mississippi,,Southern,W (45-0),20,32,62.5,280,2,44,197,4.5,2,76,477,6.3,15,9,3,27,5,35,2,0,2
5380,2017,3,2017-09-16,Southern Mississippi,@,Louisiana-Monroe,W (28-17),17,32,53.1,250,3,48,284,5.9,1,80,534,6.7,8,12,3,23,12,125,0,1,1
5381,2017,4,2017-09-30,Southern Mississippi,,North Texas,L (28-43),19,42,45.2,270,1,29,145,5.0,3,71,415,5.8,10,7,1,18,6,64,0,0,0
5382,2017,5,2017-10-07,Southern Mississippi,@,Texas-San Antonio,W (31-29),15,21,71.4,212,3,30,246,8.2,1,51,458,9.0,9,9,0,18,3,35,2,0,2
5383,2017,6,2017-10-14,Southern Mississippi,,Texas-El Paso,W (24-0),16,27,59.3,221,1,45,202,4.5,2,72,423,5.9,8,11,1,20,10,94,1,2,3
5384,2017,7,2017-10-21,Southern Mississippi,@,Louisiana Tech,W (34-27),32,53,60.4,301,3,45,190,4.2,0,98,491,5.0,16,10,1,30,6,40,1,2,3
5385,2017,8,2017-10-28,Southern Mississippi,,Alabama-Birmingham,L (12-30),19,38,50.0,266,1,26,81,3.1,0,64,347,5.4,7,5,2,14,5,41,0,1,1
5386,2017,9,2017-11-04,Southern Mississippi,@,Tennessee,L (10-24),13,34,38.2,161,0,42,118,2.8,1,76,279,3.7,7,8,3,18,14,120,1,1,2
5387,2017,10,2017-11-11,Southern Mississippi,@,Rice,W (43-34),22,31,71.0,331,3,36,186,5.2,2,67,517,7.7,16,12,0,28,10,86,0,0,0
5388,2017,11,2017-11-18,Southern Mississippi,,UNC Charlotte,W (66-21),20,27,74.1,221,1,42,363,8.6,5,69,584,8.5,11,13,3,27,5,34,0,0,0
5389,2017,12,2017-11-25,Southern Mississippi,@,Marshall,W (28-27),16,35,45.7,170,3,45,201,4.5,1,80,371,4.6,8,10,4,22,8,85,1,0,1
5390,2017,13,2017-12-27,Southern Mississippi,N,Florida State*,L (13-42),15,27,55.6,129,1,28,131,4.7,1,55,260,4.7,7,4,1,12,7,44,1,0,1
5391,2017,,13 Games,Southern Mississippi,,,,246,439,56.0,3121,24,498,2399,4.8,19,937,5520,5.9,132,117,24,276,99,872,12,7,19
5392,2014,1,2014-08-30,Stanford,,California-Davis,W (45-0),21,30,70.0,312,4,32,149,4.7,1,62,461,7.4,13,8,0,21,4,40,2,1,3
5393,2014,2,2014-09-06,Stanford,,Southern California,L (10-13),22,30,73.3,285,0,38,128,3.4,1,68,413,6.1,12,7,2,21,8,68,2,0,2
5394,2014,3,2014-09-13,Stanford,,Army,W (35-0),20,28,71.4,216,4,32,199,6.2,1,60,415,6.9,12,9,0,21,3,30,1,0,1
5395,2014,4,2014-09-27,Stanford,@,Washington,W (20-13),17,26,65.4,178,1,39,187,4.8,1,65,365,5.6,12,7,3,22,8,85,2,1,3
5396,2014,5,2014-10-04,Stanford,@,Notre Dame,L (14-17),18,36,50.0,158,0,32,47,1.5,2,68,205,3.0,10,4,0,14,9,66,0,2,2
5397,2014,6,2014-10-10,Stanford,,Washington State,W (34-17),23,35,65.7,284,3,33,193,5.8,1,68,477,7.0,14,4,2,20,9,80,1,0,1
5398,2014,7,2014-10-18,Stanford,@,Arizona State,L (10-26),19,39,48.7,212,0,22,76,3.5,1,61,288,4.7,11,3,0,14,5,35,2,0,2
5399,2014,8,2014-10-25,Stanford,,Oregon State,W (38-14),19,30,63.3,287,2,35,151,4.3,2,65,438,6.7,13,7,2,22,3,20,0,2,2
5400,2014,9,2014-11-01,Stanford,@,Oregon,L (16-45),23,33,69.7,296,0,39,132,3.4,1,72,428,5.9,15,7,2,24,7,53,1,1,2
5401,2014,10,2014-11-15,Stanford,,Utah,L (17-20),17,28,60.7,104,2,38,190,5.0,0,66,294,4.5,6,11,1,18,6,60,1,0,1
5402,2014,11,2014-11-22,Stanford,@,California,W (38-17),15,21,71.4,214,0,47,204,4.3,5,68,418,6.1,12,8,5,25,4,21,0,1,1
5403,2014,12,2014-11-28,Stanford,@,UCLA,W (31-10),16,19,84.2,234,2,45,202,4.5,2,64,436,6.8,10,10,2,22,7,65,0,0,0
5404,2014,13,2014-12-30,Stanford,N,Maryland*,W (45-21),18,26,69.2,208,2,45,206,4.6,4,71,414,5.8,9,10,3,22,2,7,1,0,1
5405,2014,,13 Games,Stanford,,,,248,381,65.1,2988,20,477,2064,4.3,22,858,5052,5.9,149,95,22,266,75,630,13,8,21
5406,2015,1,2015-09-05,Stanford,@,Northwestern,L (6-16),20,35,57.1,155,0,27,85,3.1,0,62,240,3.9,8,6,3,17,5,25,1,1,2
5407,2015,2,2015-09-12,Stanford,,Central Florida,W (31-7),18,30,60.0,361,3,41,130,3.2,1,71,491,6.9,13,7,1,21,12,137,0,0,0
5408,2015,3,2015-09-19,Stanford,@,Southern California,W (41-31),18,24,75.0,279,2,49,195,4.0,3,73,474,6.5,14,10,2,26,5,40,0,0,0
5409,2015,4,2015-09-25,Stanford,@,Oregon State,W (42-24),9,14,64.3,163,2,48,325,6.8,4,62,488,7.9,7,13,4,24,4,25,1,1,2
5410,2015,5,2015-10-03,Stanford,,Arizona,W (55-17),21,23,91.3,256,3,46,314,6.8,4,69,570,8.3,10,17,3,30,3,20,0,0,0
5411,2015,6,2015-10-15,Stanford,,UCLA,W (56-35),8,16,50.0,131,3,48,310,6.5,4,64,441,6.9,5,13,1,19,5,40,0,1,1
5412,2015,7,2015-10-24,Stanford,,Washington,W (31-14),17,24,70.8,290,2,48,188,3.9,2,72,478,6.6,14,9,2,25,6,53,0,1,1
5413,2015,8,2015-10-31,Stanford,@,Washington State,W (30-28),10,19,52.6,86,0,40,226,5.7,3,59,312,5.3,5,9,1,15,4,35,1,1,2
5414,2015,9,2015-11-07,Stanford,@,Colorado,W (42-10),18,27,66.7,197,3,48,275,5.7,3,75,472,6.3,9,14,2,25,7,55,0,1,1
5415,2015,10,2015-11-14,Stanford,,Oregon,L (36-38),28,39,71.8,304,2,47,202,4.3,2,86,506,5.9,18,12,2,32,7,55,2,1,3
5416,2015,11,2015-11-21,Stanford,,California,W (35-22),7,12,58.3,96,1,40,260,6.5,3,52,356,6.8,2,14,0,16,2,30,0,0,0
5417,2015,12,2015-11-28,Stanford,,Notre Dame,W (38-36),17,21,81.0,269,4,43,153,3.6,1,64,422,6.6,10,8,4,22,1,5,0,0,0
5418,2015,13,2015-12-05,Stanford,N,Southern California,W (41-22),10,13,76.9,155,2,51,262,5.1,2,64,417,6.5,6,13,1,20,7,58,0,0,0
5419,2015,14,2016-01-01,Stanford,N,Iowa*,W (45-16),12,21,57.1,223,3,34,206,6.1,1,55,429,7.8,8,10,1,19,10,70,0,1,1
5420,2015,,14 Games,Stanford,,,,213,318,67.0,2965,30,610,3131,5.1,33,928,6096,6.6,129,155,27,311,78,648,5,8,13
5421,2016,1,2016-09-02,Stanford,,Kansas State,W (26-13),15,19,78.9,167,1,30,105,3.5,2,49,272,5.6,10,3,0,13,4,26,1,0,1
5422,2016,2,2016-09-17,Stanford,,Southern California,W (27-10),8,14,57.1,102,1,48,302,6.3,2,62,404,6.5,4,13,0,17,3,35,0,1,1
5423,2016,3,2016-09-24,Stanford,@,UCLA,W (22-13),14,28,50.0,143,1,37,207,5.6,0,65,350,5.4,9,9,2,20,6,35,1,1,2
5424,2016,4,2016-09-30,Stanford,@,Washington,L (6-44),18,27,66.7,184,1,30,29,1.0,0,57,213,3.7,9,2,3,14,11,100,2,0,2
5425,2016,5,2016-10-08,Stanford,,Washington State,L (16-42),21,34,61.8,235,1,26,61,2.3,0,60,296,4.9,11,3,2,16,4,34,1,2,3
5426,2016,6,2016-10-15,Stanford,@,Notre Dame,W (17-10),10,20,50.0,120,0,40,176,4.4,1,60,296,4.9,9,8,1,18,5,40,2,1,3
5427,2016,7,2016-10-22,Stanford,,Colorado,L (5-10),16,29,55.2,170,0,33,93,2.8,0,62,263,4.2,8,6,1,15,7,60,1,3,4
5428,2016,8,2016-10-29,Stanford,@,Arizona,W (34-10),14,31,45.2,104,2,42,237,5.6,2,73,341,4.7,4,12,1,17,6,55,0,1,1
5429,2016,9,2016-11-05,Stanford,,Oregon State,W (26-15),10,17,58.8,60,0,58,365,6.3,2,75,425,5.7,4,15,1,20,4,43,1,0,1
5430,2016,10,2016-11-12,Stanford,@,Oregon,W (52-27),19,27,70.4,258,3,42,282,6.7,4,69,540,7.8,11,14,1,26,8,85,0,0,0
5431,2016,11,2016-11-19,Stanford,@,California,W (45-31),13,23,56.5,198,2,50,357,7.1,4,73,555,7.6,7,16,1,24,7,50,0,0,0
5432,2016,12,2016-11-26,Stanford,,Rice,W (41-17),12,18,66.7,161,2,43,373,8.7,3,61,534,8.8,6,13,0,19,8,59,0,0,0
5433,2016,13,2016-12-30,Stanford,N,North Carolina*,W (25-23),9,18,50.0,154,1,43,129,3.0,0,61,283,4.6,6,8,2,16,12,85,0,0,0
5434,2016,,13 Games,Stanford,,,,179,305,58.7,2056,15,522,2716,5.2,20,827,4772,5.8,98,122,15,235,85,707,9,9,18
5435,2017,1,2017-08-26,Stanford,N,Rice,W (62-7),21,37,56.8,369,3,36,287,8.0,5,73,656,9.0,12,12,3,27,4,35,0,0,0
5436,2017,2,2017-09-09,Stanford,@,Southern California,L (24-42),15,28,53.6,172,2,26,170,6.5,1,54,342,6.3,8,5,3,16,7,35,0,0,0
5437,2017,3,2017-09-16,Stanford,@,San Diego State,L (17-20),10,21,47.6,80,0,22,174,7.9,2,43,254,5.9,2,6,1,9,4,20,1,2,3
5438,2017,4,2017-09-23,Stanford,,UCLA,W (58-34),16,24,66.7,148,2,45,405,9.0,5,69,553,8.0,7,12,4,23,12,86,1,0,1
5439,2017,5,2017-09-30,Stanford,,Arizona State,W (34-24),15,24,62.5,173,1,32,334,10.4,3,56,507,9.1,6,10,1,17,8,78,1,0,1
5440,2017,6,2017-10-07,Stanford,@,Utah,W (23-20),13,24,54.2,188,0,31,196,6.3,2,55,384,7.0,7,5,2,14,9,84,0,0,0
5441,2017,7,2017-10-14,Stanford,,Oregon,W (49-7),21,28,75.0,256,4,41,248,6.0,2,69,504,7.3,13,9,3,25,2,15,1,1,2
5442,2017,8,2017-10-26,Stanford,@,Oregon State,W (15-14),16,33,48.5,141,1,27,81,3.0,0,60,222,3.7,6,5,1,12,8,81,0,1,1
5443,2017,9,2017-11-04,Stanford,@,Washington State,L (21-24),9,20,45.0,105,0,27,93,3.4,2,47,198,4.2,5,4,0,9,4,20,0,1,1
5444,2017,10,2017-11-10,Stanford,,Washington,W (30-22),16,27,59.3,211,0,44,195,4.4,3,71,406,5.7,10,9,2,21,5,50,0,0,0
5445,2017,11,2017-11-18,Stanford,,California,W (17-14),17,26,65.4,185,1,38,193,5.1,1,64,378,5.9,11,9,1,21,5,40,0,1,1
5446,2017,12,2017-11-25,Stanford,,Notre Dame,W (38-20),14,22,63.6,176,4,38,152,4.0,1,60,328,5.5,8,7,3,18,3,30,0,0,0
5447,2017,13,2017-12-01,Stanford,N,Southern California,L (28-31),10,22,45.5,192,2,38,151,4.0,2,60,343,5.7,7,8,3,18,7,73,0,0,0
5448,2017,14,2017-12-28,Stanford,N,Texas Christian*,L (37-39),15,27,55.6,212,3,34,157,4.6,2,61,369,6.0,8,9,0,17,3,15,0,2,2
5449,2017,,14 Games,Stanford,,,,208,363,57.3,2608,23,479,2836,5.9,31,842,5444,6.5,110,110,27,247,81,662,4,8,12
5450,2014,1,2014-08-29,Syracuse,,Villanova,W (27-26),22,35,62.9,184,1,34,136,4.0,2,69,320,4.6,12,4,5,21,7,55,0,0,0
5451,2014,2,2014-09-13,Syracuse,@,Central Michigan,W (40-3),20,30,66.7,175,1,49,289,5.9,3,79,464,5.9,9,15,1,25,9,41,0,0,0
5452,2014,3,2014-09-20,Syracuse,,Maryland,L (20-34),14,28,50.0,219,0,51,370,7.3,2,79,589,7.5,9,15,2,26,8,69,1,1,2
5453,2014,4,2014-09-27,Syracuse,N,Notre Dame,L (15-31),22,38,57.9,294,0,30,135,4.5,1,68,429,6.3,9,6,2,17,10,85,0,1,1
5454,2014,5,2014-10-03,Syracuse,,Louisville,L (6-28),17,37,45.9,201,0,26,44,1.7,0,63,245,3.9,7,6,1,14,7,60,0,2,2
5455,2014,6,2014-10-11,Syracuse,,Florida State,L (20-38),21,36,58.3,256,2,31,156,5.0,0,67,412,6.1,11,8,1,20,7,64,0,3,3
5456,2014,7,2014-10-18,Syracuse,@,Wake Forest,W (30-7),22,32,68.8,171,0,38,199,5.2,1,70,370,5.3,9,7,1,17,6,55,0,0,0
5457,2014,8,2014-10-25,Syracuse,@,Clemson,L (6-16),12,28,42.9,82,0,34,88,2.6,0,62,170,2.7,4,6,0,10,5,30,1,2,3
5458,2014,9,2014-11-01,Syracuse,,North Carolina State,L (17-24),22,42,52.4,307,2,37,38,1.0,0,79,345,4.4,10,8,2,20,6,61,1,2,3
5459,2014,10,2014-11-08,Syracuse,,Duke,L (10-27),17,32,53.1,105,0,37,119,3.2,1,69,224,3.2,4,7,1,12,7,55,0,2,2
5460,2014,11,2014-11-22,Syracuse,@,Pittsburgh,L (7-30),10,25,40.0,149,0,29,106,3.7,1,54,255,4.7,7,5,0,12,6,67,1,2,3
5461,2014,12,2014-11-29,Syracuse,@,Boston College,L (7-28),8,20,40.0,66,0,28,62,2.2,1,48,128,2.7,2,5,1,8,8,67,0,2,2
5462,2014,,12 Games,Syracuse,,,,207,383,54.0,2209,6,424,1742,4.1,12,807,3951,4.9,93,92,17,202,86,709,4,17,21
5463,2015,1,2015-09-04,Syracuse,,Rhode Island,W (47-0),10,20,50.0,114,2,58,312,5.4,2,78,426,5.5,6,16,1,23,3,36,0,1,1
5464,2015,2,2015-09-12,Syracuse,,Wake Forest,W (30-17),8,14,57.1,221,2,37,149,4.0,0,51,370,7.3,5,9,1,15,4,30,0,0,0
5465,2015,3,2015-09-19,Syracuse,,Central Michigan,W (30-27),11,17,64.7,161,2,30,165,5.5,2,47,326,6.9,6,5,0,11,6,60,0,1,1
5466,2015,4,2015-09-26,Syracuse,,Louisiana State,L (24-34),16,38,42.1,154,3,31,127,4.1,0,69,281,4.1,8,8,5,21,4,36,0,1,1
5467,2015,5,2015-10-10,Syracuse,@,South Florida,L (24-45),21,34,61.8,232,2,33,73,2.2,1,67,305,4.6,12,7,4,23,6,64,2,1,3
5468,2015,6,2015-10-17,Syracuse,@,Virginia,L (38-44),16,22,72.7,150,2,43,184,4.3,2,65,334,5.1,8,10,3,21,4,32,2,0,2
5469,2015,7,2015-10-24,Syracuse,,Pittsburgh,L (20-23),22,31,71.0,217,2,23,136,5.9,0,54,353,6.5,10,5,1,16,4,39,0,2,2
5470,2015,8,2015-10-31,Syracuse,@,Florida State,L (21-45),12,25,48.0,130,0,42,173,4.1,2,67,303,4.5,3,11,0,14,5,45,1,0,1
5471,2015,9,2015-11-07,Syracuse,@,Louisville,L (17-41),19,37,51.4,184,1,36,102,2.8,1,73,286,3.9,6,5,2,13,4,20,1,2,3
5472,2015,10,2015-11-14,Syracuse,,Clemson,L (27-37),8,21,38.1,80,0,34,242,7.1,3,55,322,5.9,4,10,2,16,9,83,1,0,1
5473,2015,11,2015-11-21,Syracuse,@,North Carolina State,L (29-42),10,21,47.6,152,2,32,140,4.4,1,53,292,5.5,6,5,4,15,9,77,1,1,2
5474,2015,12,2015-11-28,Syracuse,,Boston College,W (20-17),12,27,44.4,88,1,45,155,3.4,1,72,243,3.4,5,8,4,17,6,55,1,0,1
5475,2015,,12 Games,Syracuse,,,,165,307,53.7,1883,19,444,1958,4.4,15,751,3841,5.1,79,99,27,205,64,577,9,9,18
5476,2016,1,2016-09-02,Syracuse,,Colgate,W (33-7),40,46,87.0,437,2,35,117,3.3,1,81,554,6.8,18,5,2,25,6,55,1,0,1
5477,2016,2,2016-09-09,Syracuse,,Louisville,L (28-62),27,53,50.9,293,3,40,121,3.0,1,93,414,4.5,12,9,3,24,8,55,1,1,2
5478,2016,3,2016-09-17,Syracuse,,South Florida,L (20-45),32,50,64.0,350,2,55,199,3.6,0,105,549,5.2,16,11,3,30,10,69,1,2,3
5479,2016,4,2016-09-24,Syracuse,@,Connecticut,W (31-24),26,40,65.0,407,2,26,62,2.4,1,66,469,7.1,16,3,0,19,4,25,0,0,0
5480,2016,5,2016-10-01,Syracuse,N,Notre Dame,L (33-50),31,51,60.8,363,2,37,126,3.4,3,88,489,5.6,16,6,3,25,5,45,0,0,0
5481,2016,6,2016-10-08,Syracuse,@,Wake Forest,L (9-28),17,26,65.4,168,0,40,158,4.0,1,66,326,4.9,8,6,0,14,7,63,1,1,2
5482,2016,7,2016-10-15,Syracuse,,Virginia Tech,W (31-17),30,55,54.5,405,2,45,156,3.5,2,100,561,5.6,18,11,3,32,8,55,0,1,1
5483,2016,8,2016-10-22,Syracuse,@,Boston College,W (28-20),32,38,84.2,434,3,33,99,3.0,1,71,533,7.5,14,5,4,23,16,135,2,1,3
5484,2016,9,2016-11-05,Syracuse,@,Clemson,L (0-54),24,40,60.0,172,0,28,105,3.8,0,68,277,4.1,10,4,1,15,10,55,0,3,3
5485,2016,10,2016-11-12,Syracuse,,North Carolina State,L (20-35),14,25,56.0,190,1,28,28,1.0,1,53,218,4.1,5,4,1,10,5,45,1,1,2
5486,2016,11,2016-11-19,Syracuse,,Florida State,L (14-45),16,37,43.2,196,2,35,37,1.1,0,72,233,3.2,9,1,3,13,10,77,0,2,2
5487,2016,12,2016-11-26,Syracuse,@,Pittsburgh,L (61-76),43,61,70.5,440,5,45,228,5.1,4,106,668,6.3,21,14,3,38,7,50,0,1,1
5488,2016,,12 Games,Syracuse,,,,332,522,63.6,3855,24,447,1436,3.2,15,969,5291,5.5,163,79,26,268,96,729,7,13,20
5489,2017,1,2017-09-01,Syracuse,,Central Connecticut State,W (50-7),37,52,71.2,431,3,41,155,3.8,3,93,586,6.3,21,10,3,34,4,28,2,0,2
5490,2017,2,2017-09-09,Syracuse,,Middle Tennessee State,L (23-30),27,44,61.4,182,0,49,126,2.6,2,93,308,3.3,9,10,6,25,4,40,1,1,2
5491,2017,3,2017-09-16,Syracuse,,Central Michigan,W (41-17),19,35,54.3,279,2,44,300,6.8,2,79,579,7.3,9,7,2,18,9,104,2,1,3
5492,2017,4,2017-09-23,Syracuse,@,Louisiana State,L (26-35),34,55,61.8,308,2,27,76,2.8,1,82,384,4.7,17,6,1,24,7,38,0,1,1
5493,2017,5,2017-09-30,Syracuse,@,North Carolina State,L (25-33),30,48,62.5,385,1,30,59,2.0,2,78,444,5.7,13,5,2,20,12,93,0,1,1
5494,2017,6,2017-10-07,Syracuse,,Pittsburgh,W (27-24),33,49,67.3,365,2,42,135,3.2,1,91,500,5.5,14,9,3,26,9,58,0,0,0
5495,2017,7,2017-10-13,Syracuse,,Clemson,W (27-24),20,33,60.6,278,3,50,162,3.2,0,83,440,5.3,12,11,5,28,12,100,1,0,1
5496,2017,8,2017-10-21,Syracuse,@,Miami (FL),L (19-27),14,42,33.3,135,0,51,264,5.2,1,93,399,4.3,7,15,1,23,3,22,0,4,4
5497,2017,9,2017-11-04,Syracuse,@,Florida State,L (24-27),31,55,56.4,314,2,40,149,3.7,1,95,463,4.9,14,6,1,21,2,20,0,1,1
5498,2017,10,2017-11-11,Syracuse,,Wake Forest,L (43-64),38,67,56.7,443,3,32,178,5.6,2,99,621,6.3,22,9,2,33,3,25,0,2,2
5499,2017,11,2017-11-18,Syracuse,@,Louisville,L (10-56),13,34,38.2,138,0,45,197,4.4,1,79,335,4.2,8,12,2,22,7,52,0,4,4
5500,2017,12,2017-11-25,Syracuse,,Boston College,L (14-42),24,34,70.6,280,2,28,137,4.9,0,62,417,6.7,11,8,0,19,2,13,2,1,3
5501,2017,,12 Games,Syracuse,,,,320,548,58.4,3538,20,479,1938,4.0,16,1027,5476,5.3,157,108,28,293,74,593,8,16,24
5502,2014,1,2014-08-28,Temple,@,Vanderbilt,W (37-7),23,36,63.9,207,2,45,144,3.2,1,81,351,4.3,9,9,0,17,3,23,2,0,2
5503,2014,2,2014-09-06,Temple,,Navy,L (24-31),29,50,58.0,240,2,34,156,4.6,0,84,396,4.7,10,14,1,25,6,56,1,1,2
5504,2014,3,2014-09-20,Temple,,Delaware State,W (59-0),16,21,76.2,179,2,40,172,4.3,3,61,351,5.8,8,11,0,19,8,69,0,2,2
5505,2014,4,2014-09-27,Temple,@,Connecticut,W (36-10),20,31,64.5,231,1,24,41,1.7,1,55,272,4.9,13,2,0,15,5,57,1,0,1
5506,2014,5,2014-10-11,Temple,,Tulsa,W (35-24),15,31,48.4,294,2,35,203,5.8,3,66,497,7.5,10,6,5,21,5,30,1,1,2
5507,2014,6,2014-10-17,Temple,@,Houston,L (10-31),12,29,41.4,259,1,20,98,4.9,0,49,357,7.3,6,4,1,11,11,93,1,3,4
5508,2014,7,2014-10-25,Temple,@,Central Florida,L (14-34),20,38,52.6,150,1,20,32,1.6,0,58,182,3.1,5,4,2,11,8,68,1,3,4
5509,2014,8,2014-11-01,Temple,,East Carolina,W (20-10),7,19,36.8,70,0,37,65,1.8,2,56,135,2.4,4,2,4,10,7,65,0,0,0
5510,2014,9,2014-11-07,Temple,,Memphis,L (13-16),16,37,43.2,140,0,32,158,4.9,1,69,298,4.3,6,8,2,16,4,36,1,1,2
5511,2014,10,2014-11-15,Temple,@,Penn State,L (13-30),17,38,44.7,187,1,20,61,3.1,0,58,248,4.3,4,4,0,8,10,69,1,4,5
5512,2014,11,2014-11-29,Temple,,Cincinnati,L (6-14),19,35,54.3,196,0,32,71,2.2,0,67,267,4.0,8,6,0,14,3,26,2,0,2
5513,2014,12,2014-12-06,Temple,@,Tulane,W (10-3),20,38,52.6,255,1,30,92,3.1,0,68,347,5.1,10,6,0,16,8,67,0,1,1
5514,2014,,12 Games,Temple,,,,214,403,53.1,2408,13,369,1293,3.5,11,772,3701,4.8,93,76,15,183,78,659,11,16,27
5515,2015,1,2015-09-05,Temple,,Penn State,W (27-10),16,21,76.2,168,0,43,149,3.5,3,64,317,5.0,7,6,2,15,5,35,1,0,1
5516,2015,2,2015-09-12,Temple,@,Cincinnati,W (34-26),13,20,65.0,81,2,36,215,6.0,1,56,296,5.3,5,8,0,13,12,112,1,0,1
5517,2015,3,2015-09-19,Temple,@,Massachusetts,W (25-23),28,49,57.1,391,1,37,67,1.8,1,86,458,5.3,19,4,1,24,7,70,1,2,3
5518,2015,4,2015-10-02,Temple,@,UNC Charlotte,W (37-3),11,23,47.8,116,2,45,206,4.6,2,68,322,4.7,6,11,2,19,2,25,1,0,1
5519,2015,5,2015-10-10,Temple,,Tulane,W (49-10),14,18,77.8,223,3,46,122,2.7,3,64,345,5.4,12,7,4,23,7,55,2,0,2
5520,2015,6,2015-10-17,Temple,,Central Florida,W (30-16),15,27,55.6,149,1,41,212,5.2,3,68,361,5.3,8,10,2,20,8,84,3,1,4
5521,2015,7,2015-10-22,Temple,@,East Carolina,W (24-14),19,36,52.8,250,1,25,72,2.9,2,61,322,5.3,9,5,3,17,12,114,0,0,0
5522,2015,8,2015-10-31,Temple,,Notre Dame,L (20-24),13,30,43.3,188,1,32,107,3.3,1,62,295,4.8,7,7,2,16,6,79,0,1,1
5523,2015,9,2015-11-06,Temple,@,Southern Methodist,W (60-40),18,25,72.0,268,4,37,268,7.2,3,62,536,8.6,9,9,2,20,7,81,0,0,0
5524,2015,10,2015-11-14,Temple,@,South Florida,L (23-44),20,48,41.7,259,1,31,121,3.9,1,79,380,4.8,12,7,3,22,5,48,0,1,1
5525,2015,11,2015-11-21,Temple,,Memphis,W (31-12),14,26,53.8,261,2,46,200,4.3,2,72,461,6.4,11,10,4,25,1,10,1,1,2
5526,2015,12,2015-11-28,Temple,,Connecticut,W (27-3),19,29,65.5,160,1,39,161,4.1,2,68,321,4.7,9,6,3,18,3,15,0,0,0
5527,2015,13,2015-12-05,Temple,@,Houston,L (13-24),26,44,59.1,287,1,27,98,3.6,0,71,385,5.4,13,5,1,19,2,15,1,1,2
5528,2015,14,2015-12-22,Temple,N,Toledo*,L (17-32),23,42,54.8,236,0,33,99,3.0,1,75,335,4.5,9,9,3,21,4,30,0,1,1
5529,2015,,14 Games,Temple,,,,249,438,56.8,3037,20,518,2097,4.0,25,956,5134,5.4,136,104,32,272,81,773,11,8,19
5530,2016,1,2016-09-02,Temple,,Army,L (13-28),12,26,46.2,168,0,28,83,3.0,1,54,251,4.6,10,5,1,16,5,35,0,3,3
5531,2016,2,2016-09-10,Temple,,Stony Brook,W (38-0),11,25,44.0,124,3,39,177,4.5,2,64,301,4.7,6,8,0,14,2,20,0,1,1
5532,2016,3,2016-09-17,Temple,@,Penn State,L (27-34),25,34,73.5,286,0,28,38,1.4,3,62,324,5.2,9,2,2,13,13,118,0,1,1
5533,2016,4,2016-09-24,Temple,,UNC Charlotte,W (48-20),17,32,53.1,297,2,34,210,6.2,4,66,507,7.7,11,12,3,26,5,31,0,0,0
5534,2016,5,2016-10-01,Temple,,Southern Methodist,W (45-20),7,18,38.9,124,1,45,244,5.4,4,63,368,5.8,5,11,1,17,3,25,1,2,3
5535,2016,6,2016-10-06,Temple,@,Memphis,L (27-34),36,59,61.0,445,2,29,86,3.0,1,88,531,6.0,19,6,2,27,7,61,1,2,3
5536,2016,7,2016-10-15,Temple,@,Central Florida,W (26-25),12,24,50.0,167,2,51,197,3.9,1,75,364,4.9,9,11,4,24,10,69,1,1,2
5537,2016,8,2016-10-21,Temple,,South Florida,W (46-30),14,21,66.7,209,1,48,322,6.7,4,69,531,7.7,8,16,2,26,8,75,0,0,0
5538,2016,9,2016-10-29,Temple,,Cincinnati,W (34-13),12,19,63.2,199,2,60,275,4.6,2,79,474,6.0,7,16,2,25,3,25,1,0,1
5539,2016,10,2016-11-04,Temple,@,Connecticut,W (21-0),12,18,66.7,215,3,46,216,4.7,0,64,431,6.7,9,13,0,22,4,25,1,2,3
5540,2016,11,2016-11-19,Temple,@,Tulane,W (31-0),18,33,54.5,337,2,48,196,4.1,2,81,533,6.6,12,12,2,26,7,55,0,0,0
5541,2016,12,2016-11-26,Temple,,East Carolina,W (37-10),12,20,60.0,158,0,46,256,5.6,5,66,414,6.3,9,12,2,23,0,0,0,0,0
5542,2016,13,2016-12-03,Temple,@,Navy,W (34-10),16,25,64.0,199,2,36,189,5.3,2,61,388,6.4,8,10,0,18,4,30,0,0,0
5543,2016,14,2016-12-27,Temple,N,Wake Forest*,L (26-34),28,49,57.1,396,2,23,-20,-0.9,0,72,376,5.2,14,5,2,21,4,35,1,1,2
5544,2016,,14 Games,Temple,,,,232,403,57.6,3324,22,561,2469,4.4,31,964,5793,6.0,136,139,23,298,75,604,6,13,19
5545,2017,1,2017-09-02,Temple,@,Notre Dame,L (16-49),19,35,54.3,245,2,37,85,2.3,0,72,330,4.6,13,4,1,18,6,42,1,0,1
5546,2017,2,2017-09-09,Temple,,Villanova,W (16-13),20,34,58.8,274,0,27,79,2.9,1,61,353,5.8,10,5,2,17,8,59,0,0,0
5547,2017,3,2017-09-15,Temple,,Massachusetts,W (29-21),24,39,61.5,268,3,34,119,3.5,0,73,387,5.3,14,5,1,20,7,74,0,0,0
5548,2017,4,2017-09-21,Temple,@,South Florida,L (7-43),7,25,28.0,89,0,33,-4,-0.1,0,58,85,1.5,4,2,1,7,6,51,2,4,6
5549,2017,5,2017-09-30,Temple,,Houston,L (13-20),20,42,47.6,182,1,37,142,3.8,0,79,324,4.1,9,11,2,22,10,83,0,3,3
5550,2017,6,2017-10-07,Temple,@,East Carolina,W (34-10),21,33,63.6,344,2,46,179,3.9,2,79,523,6.6,14,6,4,24,8,65,0,1,1
5551,2017,7,2017-10-14,Temple,,Connecticut,L (24-28),33,55,60.0,356,1,29,117,4.0,2,84,473,5.6,18,7,3,28,12,117,1,1,2
5552,2017,8,2017-10-21,Temple,@,Army,L (28-31),21,31,67.7,289,1,37,217,5.9,3,68,506,7.4,13,10,1,24,8,45,0,0,0
5553,2017,9,2017-11-02,Temple,,Navy,W (34-26),22,30,73.3,289,4,28,104,3.7,0,58,393,6.8,14,4,2,20,6,50,0,1,1
5554,2017,10,2017-11-10,Temple,@,Cincinnati,W (35-24),19,30,63.3,224,1,43,205,4.8,2,73,429,5.9,11,12,2,25,4,50,1,1,2
5555,2017,11,2017-11-18,Temple,,Central Florida,L (19-45),17,42,40.5,201,2,35,196,5.6,0,77,397,5.2,8,10,1,19,6,57,1,4,5
5556,2017,12,2017-11-25,Temple,@,Tulsa,W (43-22),21,29,72.4,258,3,34,193,5.7,2,63,451,7.2,13,6,1,20,10,123,0,0,0
5557,2017,13,2017-12-21,Temple,N,Florida International*,W (28-3),18,28,64.3,254,1,41,141,3.4,3,69,395,5.7,11,7,2,20,10,86,1,0,1
5558,2017,,13 Games,Temple,,,,262,453,57.8,3273,21,461,1773,3.8,15,914,5046,5.5,152,89,23,264,101,902,7,15,22
5559,2014,1,2014-08-31,Tennessee,,Utah State,W (38-7),28,40,70.0,273,3,39,110,2.8,2,79,383,4.8,13,8,3,24,6,40,0,0,0
5560,2014,2,2014-09-06,Tennessee,,Arkansas State,W (34-19),22,38,57.9,247,2,45,168,3.7,2,83,415,5.0,12,9,2,23,2,14,0,1,1
5561,2014,3,2014-09-13,Tennessee,@,Oklahoma,L (10-34),21,44,47.7,201,1,33,112,3.4,0,77,313,4.1,12,5,1,18,1,10,1,2,3
5562,2014,4,2014-09-27,Tennessee,@,Georgia,L (32-35),27,44,61.4,284,3,34,117,3.4,1,78,401,5.1,11,9,2,22,7,49,2,0,2
5563,2014,5,2014-10-04,Tennessee,,Florida,L (9-10),26,39,66.7,205,0,29,28,1.0,0,68,233,3.4,10,2,0,12,8,49,1,2,3
5564,2014,6,2014-10-11,Tennessee,,Chattanooga,W (45-10),22,29,75.9,217,3,42,123,2.9,3,71,340,4.8,11,9,0,20,1,5,1,0,1
5565,2014,7,2014-10-18,Tennessee,@,Mississippi,L (3-34),19,34,55.9,191,0,28,0,0.0,0,62,191,3.1,8,2,0,10,3,23,1,3,4
5566,2014,8,2014-10-25,Tennessee,,Alabama,L (20-34),21,36,58.3,202,2,43,181,4.2,0,79,383,4.8,10,10,1,21,4,33,1,1,2
5567,2014,9,2014-11-01,Tennessee,@,South Carolina,W (45-42),23,40,57.5,301,2,55,344,6.3,4,95,645,6.8,13,18,4,35,4,31,0,1,1
5568,2014,10,2014-11-15,Tennessee,,Kentucky,W (50-16),19,29,65.5,297,3,51,214,4.2,2,80,511,6.4,14,13,1,28,3,40,0,0,0
5569,2014,11,2014-11-22,Tennessee,,Missouri,L (21-29),25,38,65.8,226,2,29,53,1.8,0,67,279,4.2,11,6,1,18,5,40,1,1,2
5570,2014,12,2014-11-29,Tennessee,@,Vanderbilt,W (24-17),11,20,55.0,92,0,45,170,3.8,2,65,262,4.0,4,12,3,19,6,55,0,2,2
5571,2014,13,2015-01-02,Tennessee,N,Iowa*,W (45-28),17,22,77.3,178,2,51,283,5.5,4,73,461,6.3,10,15,2,27,4,55,0,1,1
5572,2014,,13 Games,Tennessee,,,,281,453,62.0,2914,23,524,1903,3.6,20,977,4817,4.9,139,118,20,277,54,444,8,14,22
5573,2015,1,2015-09-05,Tennessee,N,Bowling Green State,W (59-30),15,23,65.2,205,2,64,399,6.2,6,87,604,6.9,10,17,2,29,4,40,0,0,0
5574,2015,2,2015-09-12,Tennessee,,Oklahoma,L (24-31),13,31,41.9,125,1,45,129,2.9,2,76,254,3.3,7,11,1,19,10,80,0,1,1
5575,2015,3,2015-09-19,Tennessee,,Western Carolina,W (55-10),21,29,72.4,237,3,49,210,4.3,2,78,447,5.7,10,13,2,25,3,15,0,0,0
5576,2015,4,2015-09-26,Tennessee,@,Florida,L (27-28),12,19,63.2,165,1,51,254,5.0,2,70,419,6.0,7,13,0,20,4,25,1,0,1
5577,2015,5,2015-10-03,Tennessee,,Arkansas,L (20-24),20,37,54.1,232,0,33,133,4.0,1,70,365,5.2,11,8,0,19,4,39,0,0,0
5578,2015,6,2015-10-10,Tennessee,,Georgia,W (38-31),25,42,59.5,312,3,48,207,4.3,2,90,519,5.8,15,10,1,26,3,15,1,1,2
5579,2015,7,2015-10-24,Tennessee,@,Alabama,L (14-19),13,22,59.1,171,1,39,132,3.4,1,61,303,5.0,9,11,1,21,6,30,1,0,1
5580,2015,8,2015-10-31,Tennessee,@,Kentucky,W (52-21),16,26,61.5,233,2,43,249,5.8,3,69,482,7.0,11,10,0,21,6,65,1,1,2
5581,2015,9,2015-11-07,Tennessee,,South Carolina,W (27-24),20,34,58.8,255,2,41,153,3.7,1,75,408,5.4,12,6,1,19,6,47,2,1,3
5582,2015,10,2015-11-14,Tennessee,,North Texas,W (24-0),18,28,64.3,172,0,48,237,4.9,3,76,409,5.4,11,13,0,24,2,10,0,1,1
5583,2015,11,2015-11-21,Tennessee,@,Missouri,W (19-8),16,25,64.0,89,0,51,248,4.9,1,76,337,4.4,7,11,1,19,4,27,0,0,0
5584,2015,12,2015-11-28,Tennessee,,Vanderbilt,W (53-28),15,25,60.0,192,2,52,331,6.4,3,77,523,6.8,12,13,2,27,6,47,0,0,0
5585,2015,13,2016-01-01,Tennessee,N,Northwestern*,W (45-6),16,30,53.3,194,0,53,226,4.3,5,83,420,5.1,8,14,2,24,8,90,0,0,0
5586,2015,,13 Games,Tennessee,,,,220,371,59.3,2582,17,617,2908,4.7,32,988,5490,5.6,130,150,13,293,66,530,6,5,11
5587,2016,1,2016-09-01,Tennessee,,Appalachian State,W (20-13),16,29,55.2,192,1,43,127,3.0,1,72,319,4.4,10,9,0,19,6,55,1,1,2
5588,2016,2,2016-09-10,Tennessee,N,Virginia Tech,W (45-24),10,19,52.6,91,3,46,239,5.2,3,65,330,5.1,4,9,3,16,6,60,0,1,1
5589,2016,3,2016-09-17,Tennessee,,Ohio,W (28-19),19,27,70.4,203,2,42,201,4.8,2,69,404,5.9,10,13,0,23,9,94,0,1,1
5590,2016,4,2016-09-24,Tennessee,,Florida,W (38-28),16,33,48.5,319,4,46,179,3.9,1,79,498,6.3,13,7,2,22,5,40,0,2,2
5591,2016,5,2016-10-01,Tennessee,@,Georgia,W (34-31),16,26,61.5,230,3,38,127,3.3,1,64,357,5.6,8,10,0,18,2,25,2,1,3
5592,2016,6,2016-10-08,Tennessee,@,Texas A&M,L (38-45),29,48,60.4,402,2,51,282,5.5,3,99,684,6.9,16,12,1,29,12,84,5,2,7
5593,2016,7,2016-10-15,Tennessee,,Alabama,L (10-49),18,31,58.1,131,0,32,32,1.0,1,63,163,2.6,8,2,1,11,1,10,0,1,1
5594,2016,8,2016-10-29,Tennessee,@,South Carolina,L (21-24),12,27,44.4,161,1,37,136,3.7,1,64,297,4.6,5,9,2,16,9,87,1,2,3
5595,2016,9,2016-11-05,Tennessee,,Tennessee Tech,W (55-0),22,27,81.5,294,3,25,177,7.1,3,52,471,9.1,14,4,3,21,6,71,0,0,0
5596,2016,10,2016-11-12,Tennessee,,Kentucky,W (49-36),11,18,61.1,223,3,41,376,9.2,4,59,599,10.2,10,17,2,29,9,64,2,1,3
5597,2016,11,2016-11-19,Tennessee,,Missouri,W (63-37),15,22,68.2,223,3,45,386,8.6,5,67,609,9.1,10,12,2,24,5,45,0,0,0
5598,2016,12,2016-11-26,Tennessee,@,Vanderbilt,L (34-45),31,34,91.2,340,2,33,176,5.3,2,67,516,7.7,16,10,1,27,4,35,2,0,2
5599,2016,13,2016-12-30,Tennessee,N,Nebraska*,W (38-24),23,38,60.5,291,1,38,230,6.1,4,76,521,6.9,12,12,1,25,6,65,1,0,1
5600,2016,,13 Games,Tennessee,,,,238,379,62.8,3100,28,517,2668,5.2,31,896,5768,6.4,136,126,18,280,80,735,14,12,26
5601,2017,1,2017-09-04,Tennessee,N,Georgia Tech,W (42-41),20,37,54.1,221,2,22,148,6.7,4,59,369,6.3,10,6,2,18,2,20,0,0,0
5602,2017,2,2017-09-09,Tennessee,,Indiana State,W (42-7),17,30,56.7,235,3,37,160,4.3,2,67,395,5.9,11,11,2,24,6,53,1,1,2
5603,2017,3,2017-09-16,Tennessee,@,Florida,L (20-26),21,39,53.8,259,1,33,183,5.5,1,72,442,6.1,12,9,2,23,7,54,0,3,3
5604,2017,4,2017-09-23,Tennessee,,Massachusetts,W (17-13),19,32,59.4,184,1,39,135,3.5,1,71,319,4.5,9,8,1,18,5,51,1,0,1
5605,2017,5,2017-09-30,Tennessee,,Georgia,L (0-41),11,23,47.8,80,0,29,62,2.1,0,52,142,2.7,2,3,2,7,5,26,2,2,4
5606,2017,6,2017-10-14,Tennessee,,South Carolina,L (9-15),11,19,57.9,133,0,39,120,3.1,0,58,253,4.4,6,6,4,16,7,40,0,0,0
5607,2017,7,2017-10-21,Tennessee,@,Alabama,L (7-45),9,16,56.3,44,0,30,64,2.1,0,46,108,2.3,2,3,2,7,9,81,0,1,1
5608,2017,8,2017-10-28,Tennessee,@,Kentucky,L (26-29),18,23,78.3,242,0,55,203,3.7,2,78,445,5.7,12,13,2,27,9,54,0,0,0
5609,2017,9,2017-11-04,Tennessee,,Southern Mississippi,W (24-10),10,21,47.6,115,0,38,95,2.5,3,59,210,3.6,7,3,4,14,3,29,0,0,0
5610,2017,10,2017-11-11,Tennessee,@,Missouri,L (17-50),16,32,50.0,139,1,36,146,4.1,0,68,285,4.2,6,10,0,16,4,36,2,2,4
5611,2017,11,2017-11-18,Tennessee,,Louisiana State,L (10-30),14,25,56.0,249,1,33,44,1.3,0,58,293,5.1,9,2,1,12,5,26,2,0,2
5612,2017,12,2017-11-25,Tennessee,,Vanderbilt,L (24-42),14,22,63.6,183,2,21,55,2.6,1,43,238,5.5,9,3,3,15,5,27,0,1,1
5613,2017,,12 Games,Tennessee,,,,180,319,56.4,2084,11,412,1415,3.4,14,731,3499,4.8,95,77,25,197,67,497,8,10,18
5614,2016,1,2016-10-22,Tennessee State,@,Vanderbilt,L (17-35),19,30,63.3,285,2,23,125,5.4,0,53,410,7.7,10,7,2,19,9,63,1,1,2
5615,2017,1,2017-08-31,Tennessee State,@,Georgia State,W (17-10),12,25,48.0,145,0,42,238,5.7,2,67,383,5.7,8,11,2,21,12,101,0,0,0
5616,2014,1,2014-08-30,Texas,,North Texas,W (38-7),19,34,55.9,190,1,40,163,4.1,3,74,353,4.8,10,6,2,18,7,65,2,0,2
5617,2014,2,2014-09-06,Texas,,Brigham Young,L (7-41),20,31,64.5,176,1,35,82,2.3,0,66,258,3.9,9,6,0,15,6,64,3,1,4
5618,2014,3,2014-09-13,Texas,N,UCLA,L (17-20),24,34,70.6,196,2,30,126,4.2,0,64,322,5.0,8,6,0,14,7,50,0,0,0
5619,2014,4,2014-09-27,Texas,@,Kansas,W (23-0),19,34,55.9,218,2,36,111,3.1,1,70,329,4.7,9,8,2,19,6,46,1,0,1
5620,2014,5,2014-10-04,Texas,,Baylor,L (7-28),16,34,47.1,144,0,40,190,4.8,1,74,334,4.5,6,9,5,20,5,45,1,2,3
5621,2014,6,2014-10-11,Texas,N,Oklahoma,L (26-31),27,44,61.4,334,2,40,148,3.7,1,84,482,5.7,12,12,0,24,11,85,0,1,1
5622,2014,7,2014-10-18,Texas,,Iowa State,W (48-45),24,36,66.7,321,1,39,191,4.9,4,75,512,6.8,13,11,3,27,4,33,1,1,2
5623,2014,8,2014-10-25,Texas,@,Kansas State,L (0-23),13,25,52.0,106,0,27,90,3.3,0,52,196,3.8,6,6,0,12,7,66,1,0,1
5624,2014,9,2014-11-01,Texas,@,Texas Tech,W (34-13),13,25,52.0,228,1,51,241,4.7,3,76,469,6.2,7,13,1,21,5,50,2,0,2
5625,2014,10,2014-11-08,Texas,,West Virginia,W (33-16),11,29,37.9,124,1,39,227,5.8,3,68,351,5.2,7,10,2,19,5,60,0,1,1
5626,2014,11,2014-11-15,Texas,@,Oklahoma State,W (28-7),24,33,72.7,305,2,43,125,2.9,1,76,430,5.7,15,7,2,24,6,49,0,0,0
5627,2014,12,2014-11-27,Texas,,Texas Christian,L (10-48),20,34,58.8,200,1,36,90,2.5,0,70,290,4.1,7,5,0,12,3,17,2,4,6
5628,2014,13,2014-12-29,Texas,N,Arkansas*,L (7-31),13,25,52.0,57,0,18,2,0.1,1,43,59,1.4,6,1,0,7,5,34,1,1,2
5629,2014,,13 Games,Texas,,,,243,418,58.1,2599,14,474,1786,3.8,18,892,4385,4.9,115,100,17,232,77,664,14,11,25
5630,2015,1,2015-09-05,Texas,@,Notre Dame,L (3-38),8,23,34.8,103,0,29,60,2.1,0,52,163,3.1,5,2,1,8,4,50,0,0,0
5631,2015,2,2015-09-12,Texas,,Rice,W (42-28),5,10,50.0,128,2,28,149,5.3,2,38,277,7.3,4,7,0,11,4,42,1,0,1
5632,2015,3,2015-09-19,Texas,,California,L (44-45),20,31,64.5,364,0,52,286,5.5,6,83,650,7.8,13,12,3,28,10,93,1,1,2
5633,2015,4,2015-09-26,Texas,,Oklahoma State,L (27-30),9,17,52.9,119,0,42,171,4.1,1,59,290,4.9,3,8,0,11,16,128,0,1,1
5634,2015,5,2015-10-03,Texas,@,Texas Christian,L (7-50),13,28,46.4,122,1,51,191,3.7,0,79,313,4.0,5,13,2,20,4,40,1,0,1
5635,2015,6,2015-10-10,Texas,N,Oklahoma,W (24-17),9,12,75.0,55,2,58,313,5.4,1,70,368,5.3,4,15,1,20,5,67,0,0,0
5636,2015,7,2015-10-24,Texas,,Kansas State,W (23-9),10,16,62.5,99,0,53,274,5.2,3,69,373,5.4,5,15,0,20,3,35,0,0,0
5637,2015,8,2015-10-31,Texas,@,Iowa State,L (0-24),12,22,54.5,85,0,32,119,3.7,0,54,204,3.8,4,7,0,11,3,39,0,1,1
5638,2015,9,2015-11-07,Texas,,Kansas,W (59-20),19,30,63.3,299,2,40,299,7.5,6,70,598,8.5,11,9,0,20,6,36,1,0,1
5639,2015,10,2015-11-14,Texas,@,West Virginia,L (20-38),11,19,57.9,162,1,54,277,5.1,1,73,439,6.0,7,12,0,19,7,55,3,2,5
5640,2015,11,2015-11-26,Texas,,Texas Tech,L (45-48),11,23,47.8,64,0,48,403,8.4,6,71,467,6.6,1,16,2,19,8,64,1,1,2
5641,2015,12,2015-12-05,Texas,@,Baylor,W (23-17),12,21,57.1,151,1,42,156,3.7,1,63,307,4.9,7,7,1,15,7,60,0,0,0
5642,2015,,12 Games,Texas,,,,139,252,55.2,1751,9,529,2698,5.1,27,781,4449,5.7,69,123,10,202,77,709,8,6,14
5643,2016,1,2016-09-04,Texas,,Notre Dame,W (50-47),16,27,59.3,280,2,59,237,4.0,5,86,517,6.0,10,14,2,26,11,104,0,1,1
5644,2016,2,2016-09-10,Texas,,Texas-El Paso,W (41-7),23,28,82.1,245,4,47,171,3.6,1,75,416,5.5,10,11,2,23,10,115,1,0,1
5645,2016,3,2016-09-17,Texas,@,California,L (43-50),23,39,59.0,261,1,51,307,6.0,4,90,568,6.3,11,19,4,34,7,50,0,2,2
5646,2016,4,2016-10-01,Texas,@,Oklahoma State,L (31-49),21,33,63.6,239,1,49,329,6.7,4,82,568,6.9,8,16,2,26,5,39,0,1,1
5647,2016,5,2016-10-08,Texas,N,Oklahoma,L (40-45),19,36,52.8,245,3,46,180,3.9,2,82,425,5.2,10,10,3,23,2,10,1,1,2
5648,2016,6,2016-10-15,Texas,,Iowa State,W (27-6),26,38,68.4,296,2,47,209,4.4,1,85,505,5.9,12,14,2,28,9,100,1,1,2
5649,2016,7,2016-10-22,Texas,@,Kansas State,L (21-24),17,24,70.8,222,2,36,133,3.7,1,60,355,5.9,9,8,3,20,10,72,0,0,0
5650,2016,8,2016-10-29,Texas,,Baylor,W (35-34),12,21,57.1,291,2,51,257,5.0,2,72,548,7.6,8,11,0,19,4,23,1,1,2
5651,2016,9,2016-11-05,Texas,@,Texas Tech,W (45-37),20,40,50.0,244,2,50,414,8.3,4,90,658,7.3,13,16,0,29,9,99,2,0,2
5652,2016,10,2016-11-12,Texas,,West Virginia,L (20-24),31,50,62.0,318,1,50,218,4.4,1,100,536,5.4,15,16,1,33,5,50,2,1,3
5653,2016,11,2016-11-19,Texas,@,Kansas,L (21-24),17,27,63.0,165,1,63,238,3.8,2,90,403,4.5,5,15,2,22,7,65,3,3,6
5654,2016,12,2016-11-25,Texas,,Texas Christian,L (9-31),16,39,41.0,218,0,46,189,4.1,0,85,407,4.8,11,7,1,19,6,42,0,1,1
5655,2016,,12 Games,Texas,,,,241,402,60.0,3024,21,595,2882,4.8,27,997,5906,5.9,122,157,22,302,85,769,11,12,23
5656,2017,1,2017-09-02,Texas,,Maryland,L (41-51),34,53,64.2,375,2,31,98,3.2,1,84,473,5.6,19,8,2,26,11,117,1,1,2
5657,2017,2,2017-09-09,Texas,,San Jose State,W (56-0),16,29,55.2,217,1,59,406,6.9,6,88,623,7.1,10,21,1,32,6,68,0,0,0
5658,2017,3,2017-09-16,Texas,@,Southern California,L (24-27),21,40,52.5,298,2,35,68,1.9,0,75,366,4.9,13,3,1,17,10,73,2,2,4
5659,2017,4,2017-09-28,Texas,@,Iowa State,W (17-7),19,26,73.1,171,1,52,141,2.7,1,78,312,4.0,7,10,2,19,10,76,1,1,2
5660,2017,5,2017-10-07,Texas,,Kansas State,W (40-34),30,51,58.8,380,2,40,166,4.2,3,91,546,6.0,21,10,1,32,3,30,0,1,1
5661,2017,6,2017-10-14,Texas,N,Oklahoma,L (24-29),21,41,51.2,289,1,39,139,3.6,2,80,428,5.4,13,7,3,23,5,33,0,0,0
5662,2017,7,2017-10-21,Texas,,Oklahoma State,L (10-13),22,36,61.1,241,0,33,42,1.3,1,69,283,4.1,5,7,1,13,8,73,0,1,1
5663,2017,8,2017-10-28,Texas,@,Baylor,W (38-7),27,36,75.0,256,1,35,171,4.9,3,71,427,6.0,11,8,0,19,7,72,0,1,1
5664,2017,9,2017-11-04,Texas,@,Texas Christian,L (7-24),21,44,47.7,254,1,26,9,0.3,0,70,263,3.8,10,3,1,14,6,65,0,0,0
5665,2017,10,2017-11-11,Texas,,Kansas,W (42-27),24,34,70.6,258,2,40,113,2.8,3,74,371,5.0,9,8,1,18,8,68,1,1,2
5666,2017,11,2017-11-18,Texas,@,West Virginia,W (28-14),17,27,63.0,187,2,42,233,5.5,2,69,420,6.1,7,10,1,18,6,75,0,1,1
5667,2017,12,2017-11-24,Texas,,Texas Tech,L (23-27),29,51,56.9,272,1,33,116,3.5,1,84,388,4.6,11,6,1,18,5,37,2,2,4
5668,2017,13,2017-12-27,Texas,N,Missouri*,W (33-16),17,29,58.6,167,2,41,118,2.9,1,70,285,4.1,7,6,4,17,7,82,0,0,0
5669,2017,,13 Games,Texas,,,,298,497,60.0,3365,18,506,1820,3.6,24,1003,5185,5.2,143,107,19,266,92,869,7,11,18
5670,2014,1,2014-08-28,Texas A&M,@,South Carolina,W (52-28),44,60,73.3,511,3,39,169,4.3,4,99,680,6.9,28,10,1,39,8,95,0,0,0
5671,2014,2,2014-09-06,Texas A&M,,Lamar,W (73-3),29,42,69.0,405,6,36,225,6.3,4,78,630,8.1,15,13,2,30,4,45,2,1,3
5672,2014,3,2014-09-13,Texas A&M,,Rice,W (38-10),21,33,63.6,309,4,26,168,6.5,1,59,477,8.1,15,8,0,23,6,60,0,1,1
5673,2014,4,2014-09-20,Texas A&M,@,Southern Methodist,W (58-6),24,37,64.9,395,3,31,268,8.6,4,68,663,9.8,14,11,3,28,6,53,0,1,1
5674,2014,5,2014-09-27,Texas A&M,N,Arkansas,W (35-28),21,41,51.2,386,4,27,137,5.1,1,68,523,7.7,13,7,1,21,9,70,0,1,1
5675,2014,6,2014-10-04,Texas A&M,@,Mississippi State,L (31-48),37,62,59.7,365,4,31,161,5.2,0,93,526,5.7,17,10,1,28,5,38,0,3,3
5676,2014,7,2014-10-11,Texas A&M,,Mississippi,L (20-35),42,53,79.2,401,2,35,54,1.5,1,88,455,5.2,21,6,0,27,6,52,1,2,3
5677,2014,8,2014-10-18,Texas A&M,@,Alabama,L (0-59),19,31,61.3,141,0,24,31,1.3,0,55,172,3.1,7,1,0,8,2,6,0,1,1
5678,2014,9,2014-11-01,Texas A&M,,Louisiana-Monroe,W (21-16),13,28,46.4,106,1,41,137,3.3,2,69,243,3.5,6,10,0,16,2,26,1,1,2
5679,2014,10,2014-11-08,Texas A&M,@,Auburn,W (41-38),19,29,65.5,277,4,35,176,5.0,0,64,453,7.1,12,8,2,22,4,42,0,1,1
5680,2014,11,2014-11-15,Texas A&M,,Missouri,L (27-34),24,36,66.7,237,3,27,104,3.9,0,63,341,5.4,11,5,2,18,4,44,0,1,1
5681,2014,12,2014-11-27,Texas A&M,,Louisiana State,L (17-23),17,27,63.0,144,1,21,84,4.0,1,48,228,4.8,7,3,2,12,3,25,1,1,2
5682,2014,13,2014-12-29,Texas A&M,N,West Virginia*,W (45-37),22,35,62.9,294,4,48,235,4.9,2,83,529,6.4,13,14,1,28,8,102,0,1,1
5683,2014,,13 Games,Texas A&M,,,,332,514,64.6,3971,39,421,1949,4.6,20,935,5920,6.3,179,106,15,300,67,658,5,15,20
5684,2015,1,2015-09-05,Texas A&M,N,Arizona State,W (38-17),19,35,54.3,247,2,45,178,4.0,2,80,425,5.3,10,10,2,22,5,50,1,2,3
5685,2015,2,2015-09-12,Texas A&M,,Ball State,W (56-23),21,29,72.4,233,4,49,270,5.5,2,78,503,6.4,12,13,0,25,7,79,1,0,1
5686,2015,3,2015-09-19,Texas A&M,,Nevada,W (44-27),20,36,55.6,302,4,40,233,5.8,1,76,535,7.0,11,17,2,30,5,35,1,1,2
5687,2015,4,2015-09-26,Texas A&M,N,Arkansas,W (28-21),21,28,75.0,358,2,20,65,3.3,1,48,423,8.8,11,3,3,17,7,52,0,0,0
5688,2015,5,2015-10-03,Texas A&M,,Mississippi State,W (30-17),25,41,61.0,322,2,45,194,4.3,1,86,516,6.0,13,10,0,23,5,53,0,0,0
5689,2015,6,2015-10-17,Texas A&M,,Alabama,L (23-41),22,45,48.9,284,1,25,32,1.3,0,70,316,4.5,13,2,1,16,1,5,0,4,4
5690,2015,7,2015-10-24,Texas A&M,@,Mississippi,L (3-23),18,45,40.0,134,0,27,58,2.1,0,72,192,2.7,5,4,3,12,13,100,2,1,3
5691,2015,8,2015-10-31,Texas A&M,,South Carolina,W (35-28),20,28,71.4,223,1,54,321,5.9,3,82,544,6.6,14,14,1,29,3,35,0,0,0
5692,2015,9,2015-11-07,Texas A&M,,Auburn,L (10-26),18,35,51.4,137,1,38,166,4.4,0,73,303,4.2,8,10,3,21,3,20,0,3,3
5693,2015,10,2015-11-14,Texas A&M,,Western Carolina,W (41-17),28,45,62.2,316,4,52,304,5.8,1,97,620,6.4,15,19,2,36,4,45,1,2,3
5694,2015,11,2015-11-21,Texas A&M,@,Vanderbilt,W (25-0),18,36,50.0,336,1,38,150,3.9,0,74,486,6.6,12,7,3,22,10,70,0,0,0
5695,2015,12,2015-11-28,Texas A&M,@,Louisiana State,L (7-19),15,31,48.4,161,1,33,89,2.7,0,64,250,3.9,6,7,2,15,11,84,2,1,3
5696,2015,13,2015-12-30,Texas A&M,N,Louisville*,L (21-27),28,48,58.3,307,2,39,138,3.5,1,87,445,5.1,14,7,4,25,9,85,1,1,2
5697,2015,,13 Games,Texas A&M,,,,273,482,56.6,3360,25,505,2198,4.4,12,987,5558,5.6,144,123,26,293,83,713,9,15,24
5698,2016,1,2016-09-03,Texas A&M,,UCLA,W (31-24),22,42,52.4,239,1,41,203,5.0,3,83,442,5.3,11,10,2,23,6,67,1,1,2
5699,2016,2,2016-09-10,Texas A&M,,Prairie View A&M,W (67-0),27,49,55.1,395,3,38,277,7.3,4,87,672,7.7,14,18,3,35,4,35,1,1,2
5700,2016,3,2016-09-17,Texas A&M,@,Auburn,W (29-16),20,40,50.0,247,1,37,231,6.2,1,77,478,6.2,9,9,1,19,9,70,0,0,0
5701,2016,4,2016-09-24,Texas A&M,N,Arkansas,W (45-24),12,22,54.5,225,2,37,366,9.9,4,59,591,10.0,7,13,2,22,7,55,2,0,2
5702,2016,5,2016-10-01,Texas A&M,@,South Carolina,W (24-13),23,40,57.5,206,0,39,216,5.5,3,79,422,5.3,11,11,0,22,5,40,1,1,2
5703,2016,6,2016-10-08,Texas A&M,,Tennessee,W (45-38),17,34,50.0,239,2,50,353,7.1,4,84,592,7.0,9,10,2,21,7,45,1,2,3
5704,2016,7,2016-10-22,Texas A&M,@,Alabama,L (14-33),14,31,45.2,164,2,38,114,3.0,0,69,278,4.0,7,9,1,17,9,81,1,1,2
5705,2016,8,2016-10-29,Texas A&M,,New Mexico State,W (52-10),22,34,64.7,282,3,39,233,6.0,2,73,515,7.1,15,13,0,28,5,53,1,0,1
5706,2016,9,2016-11-05,Texas A&M,@,Mississippi State,L (28-35),16,31,51.6,265,2,32,117,3.7,1,63,382,6.1,11,3,0,14,5,27,1,1,2
5707,2016,10,2016-11-12,Texas A&M,,Mississippi,L (28-29),16,28,57.1,213,2,34,129,3.8,2,62,342,5.5,8,4,1,13,8,67,0,1,1
5708,2016,11,2016-11-19,Texas A&M,,Texas-San Antonio,W (23-10),19,32,59.4,248,1,38,183,4.8,1,70,431,6.2,13,8,2,23,2,15,1,0,1
5709,2016,12,2016-11-24,Texas A&M,,Louisiana State,L (39-54),17,38,44.7,284,3,33,188,5.7,2,71,472,6.6,11,8,0,19,6,55,1,0,1
5710,2016,13,2016-12-28,Texas A&M,N,Kansas State*,L (28-33),30,48,62.5,310,3,28,144,5.1,1,76,454,6.0,16,7,2,25,8,75,1,1,2
5711,2016,,13 Games,Texas A&M,,,,255,469,54.4,3317,25,484,2754,5.7,28,953,6071,6.4,142,123,16,281,81,685,12,9,21
5712,2017,1,2017-09-03,Texas A&M,@,UCLA,L (44-45),9,30,30.0,89,0,63,382,6.1,5,93,471,5.1,5,15,3,23,5,39,0,0,0
5713,2017,2,2017-09-09,Texas A&M,,Nicholls State,W (24-14),24,36,66.7,198,1,47,195,4.1,2,83,393,4.7,11,13,3,27,4,45,0,0,0
5714,2017,3,2017-09-16,Texas A&M,,Louisiana,W (45-21),21,34,61.8,301,3,40,179,4.5,2,74,480,6.5,14,12,1,27,3,17,1,1,2
5715,2017,4,2017-09-23,Texas A&M,N,Arkansas,W (50-43),14,27,51.9,216,2,42,285,6.8,3,69,501,7.3,7,11,2,20,6,36,0,1,1
5716,2017,5,2017-09-30,Texas A&M,,South Carolina,W (24-17),19,27,70.4,159,0,49,237,4.8,3,76,396,5.2,8,12,0,20,5,47,1,0,1
5717,2017,6,2017-10-07,Texas A&M,,Alabama,L (19-27),19,29,65.5,237,1,40,71,1.8,1,69,308,4.5,9,4,3,16,6,45,2,1,3
5718,2017,7,2017-10-14,Texas A&M,@,Florida,W (19-17),8,24,33.3,180,0,38,83,2.2,1,62,263,4.2,5,5,0,10,7,46,0,1,1
5719,2017,8,2017-10-28,Texas A&M,,Mississippi State,L (14-35),16,41,39.0,189,1,28,96,3.4,1,69,285,4.1,7,6,2,15,4,30,0,3,3
5720,2017,9,2017-11-04,Texas A&M,,Auburn,L (27-42),16,33,48.5,200,2,34,143,4.2,1,67,343,5.1,8,4,1,13,2,20,0,0,0
5721,2017,10,2017-11-11,Texas A&M,,New Mexico,W (55-14),30,43,69.8,499,5,23,63,2.7,2,66,562,8.5,20,4,1,25,6,69,0,0,0
5722,2017,11,2017-11-18,Texas A&M,@,Mississippi,W (31-24),19,32,59.4,272,1,44,119,2.7,2,76,391,5.1,11,2,5,18,7,65,0,1,1
5723,2017,12,2017-11-25,Texas A&M,@,Louisiana State,L (21-45),16,30,53.3,227,2,27,55,2.0,1,57,282,4.9,10,2,2,14,5,54,1,3,4
5724,2017,13,2017-12-29,Texas A&M,N,Wake Forest*,L (52-55),42,63,66.7,499,4,31,115,3.7,2,94,614,6.5,24,6,2,32,7,75,2,1,3
5725,2017,,13 Games,Texas A&M,,,,253,449,56.3,3266,22,506,2023,4.0,26,955,5289,5.5,139,96,25,260,67,588,7,12,19
5726,2014,1,2014-08-30,Texas Christian,,Samford,W (48-14),33,50,66.0,355,3,46,200,4.3,3,96,555,5.8,17,15,1,33,4,60,1,1,2
5727,2014,2,2014-09-13,Texas Christian,,Minnesota,W (30-7),27,46,58.7,258,2,27,169,6.3,1,73,427,5.8,13,8,1,22,8,72,1,1,2
5728,2014,3,2014-09-27,Texas Christian,@,Southern Methodist,W (56-0),28,43,65.1,349,5,38,265,7.0,3,81,614,7.6,18,12,1,31,5,48,0,0,0
5729,2014,4,2014-10-04,Texas Christian,,Oklahoma,W (37-33),20,39,51.3,318,2,39,151,3.9,2,78,469,6.0,12,8,3,23,12,90,2,1,3
5730,2014,5,2014-10-11,Texas Christian,@,Baylor,L (58-61),22,48,45.8,346,1,41,139,3.4,4,89,485,5.4,12,7,4,23,8,110,1,0,1
5731,2014,6,2014-10-18,Texas Christian,,Oklahoma State,W (42-9),27,42,64.3,415,3,40,261,6.5,3,82,676,8.2,12,13,1,26,5,45,0,1,1
5732,2014,7,2014-10-25,Texas Christian,,Texas Tech,W (82-27),27,45,60.0,480,7,41,305,7.4,3,86,785,9.1,16,13,3,32,10,77,0,0,0
5733,2014,8,2014-11-01,Texas Christian,@,West Virginia,W (31-30),12,30,40.0,166,1,42,223,5.3,3,72,389,5.4,5,11,0,16,5,40,1,1,2
5734,2014,9,2014-11-08,Texas Christian,,Kansas State,W (41-20),23,34,67.6,219,1,48,334,7.0,4,82,553,6.7,12,14,2,28,4,35,0,0,0
5735,2014,10,2014-11-15,Texas Christian,@,Kansas,W (34-30),26,36,72.2,330,1,36,133,3.7,2,72,463,6.4,13,10,1,24,5,40,2,1,3
5736,2014,11,2014-11-27,Texas Christian,@,Texas,W (48-10),20,34,58.8,233,2,31,135,4.4,2,65,368,5.7,10,5,1,16,6,45,1,1,2
5737,2014,12,2014-12-06,Texas Christian,,Iowa State,W (55-3),33,45,73.3,525,5,38,197,5.2,1,83,722,8.7,20,12,1,33,5,50,1,1,2
5738,2014,13,2014-12-31,Texas Christian,N,Mississippi*,W (42-3),27,37,73.0,246,4,42,177,4.2,1,79,423,5.4,13,11,0,24,5,55,1,3,4
5739,2014,,13 Games,Texas Christian,,,,325,529,61.4,4240,37,509,2689,5.3,32,1038,6929,6.7,173,139,19,331,82,767,11,11,22
5740,2015,1,2015-09-03,Texas Christian,@,Minnesota,W (23-17),26,42,61.9,246,1,44,203,4.6,1,86,449,5.2,13,10,2,25,9,50,1,1,2
5741,2015,2,2015-09-12,Texas Christian,,Stephen F. Austin,W (70-7),26,37,70.3,403,5,45,224,5.0,4,82,627,7.6,14,16,0,30,3,43,0,1,1
5742,2015,3,2015-09-19,Texas Christian,,Southern Methodist,W (56-37),21,30,70.0,454,5,41,266,6.5,3,71,720,10.1,16,12,0,28,9,115,0,1,1
5743,2015,4,2015-09-26,Texas Christian,@,Texas Tech,W (55-52),35,56,62.5,503,4,47,247,5.3,3,103,750,7.3,24,13,1,38,10,110,0,0,0
5744,2015,5,2015-10-03,Texas Christian,,Texas,W (50-7),22,38,57.9,376,6,42,228,5.4,0,80,604,7.6,18,12,1,31,8,84,0,0,0
5745,2015,6,2015-10-10,Texas Christian,@,Kansas State,W (52-45),20,30,66.7,301,2,23,242,10.5,4,53,543,10.2,13,7,2,22,11,81,0,2,2
5746,2015,7,2015-10-17,Texas Christian,@,Iowa State,W (45-21),28,34,82.4,444,4,41,177,4.3,2,75,621,8.3,20,7,3,30,7,75,1,0,1
5747,2015,8,2015-10-29,Texas Christian,,West Virginia,W (40-10),32,48,66.7,388,3,40,228,5.7,1,88,616,7.0,18,12,5,35,9,100,0,0,0
5748,2015,9,2015-11-07,Texas Christian,@,Oklahoma State,L (29-49),35,58,60.3,445,1,52,218,4.2,3,110,663,6.0,21,12,3,36,7,70,0,4,4
5749,2015,10,2015-11-14,Texas Christian,,Kansas,W (23-17),19,34,55.9,208,1,58,279,4.8,0,92,487,5.3,9,15,1,25,3,27,0,1,1
5750,2015,11,2015-11-21,Texas Christian,@,Oklahoma,L (29-30),13,29,44.8,229,3,36,161,4.5,1,65,390,6.0,5,9,2,16,2,19,1,3,4
5751,2015,12,2015-11-27,Texas Christian,,Baylor,W (28-21),18,33,54.5,148,2,46,154,3.3,1,79,302,3.8,5,8,2,15,8,65,1,1,2
5752,2015,13,2016-01-02,Texas Christian,N,Oregon*,W (47-41),30,47,63.8,371,2,47,174,3.7,3,94,545,5.8,14,12,1,27,8,83,0,1,1
5753,2015,,13 Games,Texas Christian,,,,325,516,63.0,4516,39,562,2801,5.0,26,1078,7317,6.8,190,145,23,358,94,922,4,15,19
5754,2016,1,2016-09-03,Texas Christian,,South Dakota State,W (59-41),33,50,66.0,439,2,37,223,6.0,5,87,662,7.6,22,11,2,35,12,125,0,2,2
5755,2016,2,2016-09-10,Texas Christian,,Arkansas,L (38-41),36,58,62.1,377,1,32,195,6.1,4,90,572,6.4,19,6,0,25,9,95,1,1,2
5756,2016,3,2016-09-17,Texas Christian,,Iowa State,W (41-20),22,35,62.9,252,1,37,229,6.2,4,72,481,6.7,12,8,2,22,5,50,0,0,0
5757,2016,4,2016-09-23,Texas Christian,@,Southern Methodist,W (33-3),32,47,68.1,452,2,31,137,4.4,1,78,589,7.6,16,8,1,25,8,65,0,1,1
5758,2016,5,2016-10-01,Texas Christian,,Oklahoma,L (46-52),26,45,57.8,449,5,29,65,2.2,1,74,514,6.9,14,4,1,19,9,64,0,1,1
5759,2016,6,2016-10-08,Texas Christian,@,Kansas,W (24-23),17,32,53.1,206,1,34,160,4.7,2,66,366,5.5,7,9,2,18,7,79,1,3,4
5760,2016,7,2016-10-22,Texas Christian,@,West Virginia,L (10-34),18,31,58.1,148,1,29,152,5.2,0,60,300,5.0,6,11,1,18,10,67,2,1,3
5761,2016,8,2016-10-29,Texas Christian,,Texas Tech,L (24-27),22,47,46.8,246,1,39,172,4.4,2,86,418,4.9,14,11,0,25,4,25,0,1,1
5762,2016,9,2016-11-05,Texas Christian,@,Baylor,W (62-22),18,31,58.1,257,1,59,431,7.3,6,90,688,7.6,9,21,4,34,7,55,0,0,0
5763,2016,10,2016-11-19,Texas Christian,,Oklahoma State,L (6-31),20,33,60.6,198,1,39,145,3.7,0,72,343,4.8,9,7,2,18,4,49,0,2,2
5764,2016,11,2016-11-25,Texas Christian,@,Texas,W (31-9),16,30,53.3,178,0,46,309,6.7,4,76,487,6.4,10,13,2,25,7,68,0,1,1
5765,2016,12,2016-12-03,Texas Christian,,Kansas State,L (6-30),17,36,47.2,138,0,37,142,3.8,0,73,280,3.8,5,8,2,15,4,45,0,1,1
5766,2016,13,2016-12-30,Texas Christian,N,Georgia*,L (23-31),18,28,64.3,146,2,39,175,4.5,1,67,321,4.8,7,8,2,17,2,10,2,0,2
5767,2016,,13 Games,Texas Christian,,,,295,503,58.6,3486,18,488,2535,5.2,30,991,6021,6.1,150,125,21,296,88,797,6,14,20
5768,2017,1,2017-09-02,Texas Christian,,Jackson State,W (63-0),23,30,76.7,300,6,36,242,6.7,1,66,542,8.2,11,13,0,24,5,51,0,1,1
5769,2017,2,2017-09-09,Texas Christian,@,Arkansas,W (28-7),21,31,67.7,166,0,42,195,4.6,4,73,361,4.9,8,15,1,24,6,60,1,1,2
5770,2017,3,2017-09-16,Texas Christian,,Southern Methodist,W (56-36),24,30,80.0,365,4,49,254,5.2,3,79,619,7.8,16,13,1,30,11,94,3,0,3
5771,2017,4,2017-09-23,Texas Christian,@,Oklahoma State,W (44-31),22,33,66.7,228,1,52,238,4.6,4,85,466,5.5,12,14,6,32,4,23,0,1,1
5772,2017,5,2017-10-07,Texas Christian,,West Virginia,W (31-24),16,29,55.2,236,2,36,170,4.7,2,65,406,6.2,9,7,0,16,5,51,0,0,0
5773,2017,6,2017-10-14,Texas Christian,@,Kansas State,W (26-6),27,37,73.0,297,0,36,98,2.7,3,73,395,5.4,11,5,1,17,7,51,1,0,1
5774,2017,7,2017-10-21,Texas Christian,,Kansas,W (43-0),20,28,71.4,284,5,42,191,4.5,0,70,475,6.8,11,10,1,22,7,55,0,0,0
5775,2017,8,2017-10-28,Texas Christian,@,Iowa State,L (7-14),12,25,48.0,135,0,34,172,5.1,0,59,307,5.2,7,6,1,14,11,104,1,2,3
5776,2017,9,2017-11-04,Texas Christian,,Texas,W (24-7),19,27,70.4,166,0,46,177,3.8,3,73,343,4.7,7,8,2,17,9,49,0,0,0
5777,2017,10,2017-11-11,Texas Christian,@,Oklahoma,L (20-38),14,29,48.3,269,1,32,155,4.8,2,61,424,7.0,7,10,2,19,7,60,0,0,0
5778,2017,11,2017-11-18,Texas Christian,@,Texas Tech,W (27-3),6,17,35.3,85,1,42,204,4.9,1,59,289,4.9,4,10,3,17,6,55,1,0,1
5779,2017,12,2017-11-24,Texas Christian,,Baylor,W (45-22),26,36,72.2,325,3,36,112,3.1,3,72,437,6.1,13,9,3,25,3,23,0,0,0
5780,2017,13,2017-12-02,Texas Christian,N,Oklahoma,L (17-41),27,37,73.0,234,2,24,83,3.5,0,61,317,5.2,14,5,1,20,7,70,1,1,2
5781,2017,14,2017-12-28,Texas Christian,N,Stanford*,W (39-37),28,41,68.3,341,3,26,147,5.7,1,67,488,7.3,13,8,0,21,1,4,1,2,3
5782,2017,,14 Games,Texas Christian,,,,285,430,66.3,3431,28,533,2438,4.6,27,963,5869,6.1,143,133,22,298,89,750,9,8,17
5783,2014,1,2014-08-30,Texas State,,Arkansas-Pine Bluff,W (65-0),25,30,83.3,319,4,50,378,7.6,5,80,697,8.7,18,19,2,39,8,90,1,0,1
5784,2014,2,2014-09-13,Texas State,,Navy,L (21-35),24,36,66.7,231,1,44,211,4.8,2,80,442,5.5,9,13,1,23,11,124,0,1,1
5785,2014,3,2014-09-20,Texas State,@,Illinois,L (35-42),29,43,67.4,336,4,52,139,2.7,1,95,475,5.0,15,10,1,26,8,63,0,1,1
5786,2014,4,2014-09-27,Texas State,@,Tulsa,W (37-34),21,31,67.7,228,2,49,181,3.7,3,80,409,5.1,10,10,1,21,7,77,0,0,0
5787,2014,5,2014-10-04,Texas State,,Idaho,W (35-30),11,20,55.0,76,1,38,390,10.3,4,58,466,8.0,2,12,0,14,3,18,2,2,4
5788,2014,6,2014-10-14,Texas State,,Louisiana,L (10-34),14,23,60.9,176,1,35,94,2.7,0,58,270,4.7,8,4,0,12,4,20,1,1,2
5789,2014,7,2014-10-25,Texas State,@,Louisiana-Monroe,W (22-18),14,20,70.0,141,1,46,229,5.0,2,66,370,5.6,5,12,0,17,6,55,0,0,0
5790,2014,8,2014-11-01,Texas State,@,New Mexico State,W (37-29),17,30,56.7,143,1,43,287,6.7,3,73,430,5.9,6,13,2,21,7,55,0,0,0
5791,2014,9,2014-11-08,Texas State,,Georgia Southern,L (25-28),30,51,58.8,302,2,42,137,3.3,1,93,439,4.7,18,5,3,26,4,41,0,2,2
5792,2014,10,2014-11-15,Texas State,@,South Alabama,L (20-24),25,44,56.8,300,1,40,106,2.7,1,84,406,4.8,14,7,1,22,7,72,0,0,0
5793,2014,11,2014-11-20,Texas State,,Arkansas State,W (45-27),14,22,63.6,192,2,57,370,6.5,4,79,562,7.1,5,21,2,28,5,55,1,0,1
5794,2014,12,2014-11-29,Texas State,@,Georgia State,W (54-31),26,32,81.3,267,2,43,340,7.9,3,75,607,8.1,13,16,0,29,5,38,0,0,0
5795,2014,,12 Games,Texas State,,,,250,382,65.4,2711,22,539,2862,5.3,29,921,5573,6.1,123,142,13,278,75,708,5,7,12
5796,2015,1,2015-09-05,Texas State,@,Florida State,L (16-59),26,42,61.9,168,1,33,132,4.0,1,75,300,4.0,12,5,0,17,1,5,1,0,1
5797,2015,2,2015-09-12,Texas State,,Prairie View A&M,W (63-24),18,22,81.8,333,3,50,316,6.3,5,72,649,9.0,9,18,2,29,9,113,2,0,2
5798,2015,3,2015-09-19,Texas State,,Southern Mississippi,L (50-56),31,46,67.4,310,3,37,281,7.6,1,83,591,7.1,16,8,5,29,7,74,0,0,0
5799,2015,4,2015-09-26,Texas State,@,Houston,L (14-59),31,50,62.0,302,0,32,99,3.1,2,82,401,4.9,14,5,2,21,5,38,2,2,4
5800,2015,5,2015-10-10,Texas State,@,Louisiana,L (27-49),13,33,39.4,178,1,37,173,4.7,2,70,351,5.0,7,9,0,16,9,71,1,0,1
5801,2015,6,2015-10-24,Texas State,,South Alabama,W (36-18),13,23,56.5,105,0,43,319,7.4,4,66,424,6.4,4,13,2,19,11,111,0,1,1
5802,2015,7,2015-10-29,Texas State,@,Georgia Southern,L (13-37),10,27,37.0,87,1,31,126,4.1,0,58,213,3.7,5,7,1,13,2,20,0,2,2
5803,2015,8,2015-11-07,Texas State,,New Mexico State,L (21-31),21,36,58.3,287,1,37,113,3.1,2,73,400,5.5,11,7,2,20,4,30,1,2,3
5804,2015,9,2015-11-14,Texas State,,Georgia State,L (19-41),29,52,55.8,267,1,32,186,5.8,1,84,453,5.4,13,14,1,28,4,29,0,2,2
5805,2015,10,2015-11-19,Texas State,,Louisiana-Monroe,W (16-3),14,25,56.0,176,2,55,158,2.9,0,80,334,4.2,8,10,2,20,9,78,0,0,0
5806,2015,11,2015-11-28,Texas State,@,Idaho,L (31-38),24,43,55.8,312,2,40,191,4.8,2,83,503,6.1,14,9,0,23,6,57,1,1,2
5807,2015,12,2015-12-05,Texas State,@,Arkansas State,L (17-55),19,32,59.4,227,0,43,174,4.0,2,75,401,5.3,11,9,1,21,6,45,1,2,3
5808,2015,,12 Games,Texas State,,,,249,431,57.8,2752,15,470,2268,4.8,22,901,5020,5.6,124,114,18,256,73,671,9,12,21
5809,2016,1,2016-09-03,Texas State,@,Ohio,W (56-54),41,56,73.2,440,5,42,106,2.5,2,98,546,5.6,20,6,3,29,6,55,1,2,3
5810,2016,2,2016-09-17,Texas State,@,Arkansas,L (3-42),11,26,42.3,83,0,26,22,0.8,0,52,105,2.0,3,5,0,8,5,45,0,1,1
5811,2016,3,2016-09-24,Texas State,,Houston,L (3-64),20,33,60.6,109,0,23,33,1.4,0,56,142,2.5,7,1,0,8,8,87,0,1,1
5812,2016,4,2016-10-01,Texas State,,Incarnate Word,W (48-17),32,42,76.2,540,6,50,130,2.6,1,92,670,7.3,25,7,2,34,7,40,0,0,0
5813,2016,5,2016-10-08,Texas State,@,Georgia State,L (21-41),27,47,57.4,300,1,41,120,2.9,2,88,420,4.8,17,8,2,27,6,56,1,2,3
5814,2016,6,2016-10-15,Texas State,@,Louisiana-Monroe,L (34-40),19,36,52.8,193,0,26,124,4.8,3,62,317,5.1,10,8,1,19,11,103,1,2,3
5815,2016,7,2016-10-22,Texas State,,Louisiana,L (3-27),20,28,71.4,142,0,36,79,2.2,0,64,221,3.5,7,6,0,13,8,64,1,1,2
5816,2016,8,2016-11-05,Texas State,@,Appalachian State,L (10-35),28,38,73.7,183,0,28,14,0.5,1,66,197,3.0,10,1,3,14,5,35,0,1,1
5817,2016,9,2016-11-12,Texas State,,Idaho,L (14-47),15,19,78.9,193,1,28,-18,-0.6,1,47,175,3.7,8,1,4,13,5,25,2,0,2
5818,2016,10,2016-11-19,Texas State,@,New Mexico State,L (10-50),18,34,52.9,189,0,41,153,3.7,1,75,342,4.6,9,7,1,17,4,34,2,3,5
5819,2016,11,2016-11-26,Texas State,,Troy,L (7-40),12,29,41.4,147,0,39,109,2.8,1,68,256,3.8,7,9,0,15,8,82,0,2,2
5820,2016,12,2016-12-03,Texas State,,Arkansas State,L (14-36),14,27,51.9,120,1,46,117,2.5,1,73,237,3.2,6,7,2,15,9,61,0,2,2
5821,2016,,12 Games,Texas State,,,,257,415,61.9,2639,14,426,989,2.3,13,841,3628,4.3,129,66,18,212,82,687,8,17,25
5822,2017,1,2017-09-02,Texas State,,,W (20-11),18,28,64.3,135,0,41,155,3.8,2,69,290,4.2,7,7,4,18,7,70,1,1,2
5823,2017,2,2017-09-09,Texas State,@,Colorado,L (3-37),8,18,44.4,127,0,47,156,3.3,0,65,283,4.4,6,6,0,12,2,16,1,1,2
5824,2017,3,2017-09-16,Texas State,,Appalachian State,L (13-20),23,35,65.7,260,1,37,125,3.4,0,72,385,5.3,10,9,2,21,7,67,0,1,1
5825,2017,4,2017-09-23,Texas State,,Texas-San Antonio,L (14-44),10,27,37.0,161,1,32,37,1.2,1,59,198,3.4,7,4,6,17,4,51,1,0,1
5826,2017,5,2017-09-30,Texas State,@,Wyoming,L (10-45),11,23,47.8,127,1,52,135,2.6,0,75,262,3.5,4,10,2,16,3,22,1,1,2
5827,2017,6,2017-10-07,Texas State,,Louisiana-Monroe,L (27-45),14,25,56.0,205,2,39,181,4.6,2,64,386,6.0,7,9,2,18,7,39,1,0,1
5828,2017,7,2017-10-12,Texas State,@,Louisiana,L (7-24),14,25,56.0,219,0,44,106,2.4,1,69,325,4.7,9,9,1,19,1,0,2,1,3
5829,2017,8,2017-10-28,Texas State,@,Coastal Carolina,W (27-7),27,39,69.2,269,2,52,238,4.6,1,91,507,5.6,10,18,4,32,6,60,1,1,2
5830,2017,9,2017-11-04,Texas State,,New Mexico State,L (35-45),33,53,62.3,400,4,36,163,4.5,1,89,563,6.3,19,9,2,30,4,47,3,1,4
5831,2017,10,2017-11-11,Texas State,,Georgia State,L (30-33),35,55,63.6,315,3,25,75,3.0,1,80,390,4.9,15,5,3,23,2,10,0,1,1
5832,2017,11,2017-11-18,Texas State,@,Arkansas State,L (12-30),8,25,32.0,103,1,30,85,2.8,1,55,188,3.4,5,5,1,11,5,31,1,0,1
5833,2017,12,2017-11-24,Texas State,@,Troy,L (9-62),14,21,66.7,147,0,45,153,3.4,1,66,300,4.5,7,7,0,14,5,45,2,2,4
5834,2017,,12 Games,Texas State,,,,215,374,57.5,2468,15,480,1609,3.4,11,854,4077,4.8,106,98,27,231,53,458,14,10,24
5835,2014,1,2014-08-30,Texas Tech,,Central Arkansas,W (42-35),39,53,73.6,452,4,36,184,5.1,2,89,636,7.1,25,10,0,35,15,114,0,2,2
5836,2014,2,2014-09-06,Texas Tech,@,Texas-El Paso,W (30-26),17,31,54.8,278,3,28,226,8.1,1,59,504,8.5,9,9,2,20,10,90,1,0,1
5837,2014,3,2014-09-13,Texas Tech,,Arkansas,L (28-49),27,45,60.0,252,3,22,101,4.6,1,67,353,5.3,11,9,0,20,5,60,1,2,3
5838,2014,4,2014-09-25,Texas Tech,@,Oklahoma State,L (35-45),37,60,61.7,394,5,30,118,3.9,0,90,512,5.7,20,8,4,32,16,158,0,3,3
5839,2014,5,2014-10-04,Texas Tech,@,Kansas State,L (13-45),27,50,54.0,301,2,14,46,3.3,0,64,347,5.4,16,4,0,20,9,89,0,4,4
5840,2014,6,2014-10-11,Texas Tech,,West Virginia,L (34-37),28,46,60.9,348,3,38,217,5.7,1,84,565,6.7,14,7,2,23,12,115,0,1,1
5841,2014,7,2014-10-18,Texas Tech,,Kansas,W (34-21),28,44,63.6,288,3,37,219,5.9,1,81,507,6.3,12,13,1,26,4,22,1,1,2
5842,2014,8,2014-10-25,Texas Tech,@,Texas Christian,L (27-82),20,41,48.8,345,3,28,101,3.6,0,69,446,6.5,14,5,2,21,6,69,2,2,4
5843,2014,9,2014-11-01,Texas Tech,,Texas,L (13-34),28,47,59.6,225,0,32,156,4.9,1,79,381,4.8,10,5,3,18,6,70,1,1,2
5844,2014,10,2014-11-15,Texas Tech,,Oklahoma,L (30-42),27,50,54.0,393,4,24,93,3.9,0,74,486,6.6,15,5,3,23,9,85,0,0,0
5845,2014,11,2014-11-22,Texas Tech,@,Iowa State,W (34-31),23,35,65.7,328,4,40,272,6.8,1,75,600,8.0,12,14,1,27,9,73,1,1,2
5846,2014,12,2014-11-29,Texas Tech,N,Baylor,L (46-48),31,57,54.4,609,6,26,103,4.0,0,83,712,8.6,20,6,5,31,11,125,3,1,4
5847,2014,,12 Games,Texas Tech,,,,332,559,59.4,4213,40,355,1836,5.2,8,914,6049,6.6,178,95,23,296,112,1070,10,18,28
5848,2015,1,2015-09-05,Texas Tech,,Sam Houston State,W (59-45),34,57,59.6,437,4,31,174,5.6,2,88,611,6.9,18,10,1,29,10,69,0,1,1
5849,2015,2,2015-09-12,Texas Tech,,Texas-El Paso,W (69-20),23,42,54.8,445,4,30,229,7.6,5,72,674,9.4,17,11,1,29,4,38,0,0,0
5850,2015,3,2015-09-19,Texas Tech,@,Arkansas,W (35-24),27,31,87.1,315,2,27,171,6.3,3,58,486,8.4,14,9,1,24,4,31,0,2,2
5851,2015,4,2015-09-26,Texas Tech,,Texas Christian,L (52-55),25,45,55.6,392,2,39,215,5.5,5,84,607,7.2,14,12,6,32,3,32,0,0,0
5852,2015,5,2015-10-03,Texas Tech,N,Baylor,L (35-63),40,65,61.5,530,4,24,106,4.4,1,89,636,7.1,19,6,2,27,17,142,2,2,4
5853,2015,6,2015-10-10,Texas Tech,,Iowa State,W (66-31),39,56,69.6,515,6,31,261,8.4,3,87,776,8.9,21,11,1,33,7,50,0,0,0
5854,2015,7,2015-10-17,Texas Tech,@,Kansas,W (30-20),29,50,58.0,354,1,44,222,5.0,1,94,576,6.1,15,13,1,29,6,70,1,1,2
5855,2015,8,2015-10-24,Texas Tech,@,Oklahoma,L (27-63),29,45,64.4,253,1,40,172,4.3,2,85,425,5.0,11,14,3,28,7,57,0,4,4
5856,2015,9,2015-10-31,Texas Tech,,Oklahoma State,L (53-70),38,55,69.1,480,4,39,162,4.2,2,94,642,6.8,21,8,3,32,7,66,1,2,3
5857,2015,10,2015-11-07,Texas Tech,@,West Virginia,L (26-31),22,36,61.1,199,3,42,179,4.3,0,78,378,4.8,9,12,2,23,8,75,0,1,1
5858,2015,11,2015-11-14,Texas Tech,,Kansas State,W (59-44),33,43,76.7,384,3,40,274,6.9,5,83,658,7.9,16,15,1,32,7,73,1,0,1
5859,2015,12,2015-11-26,Texas Tech,@,Texas,W (48-45),22,39,56.4,372,1,51,293,5.7,5,90,665,7.4,12,16,0,28,6,70,3,1,4
5860,2015,13,2015-12-29,Texas Tech,N,Louisiana State*,L (27-56),28,56,50.0,370,4,26,29,1.1,0,82,399,4.9,16,4,2,22,6,63,0,1,1
5861,2015,,13 Games,Texas Tech,,,,389,620,62.7,5046,39,464,2487,5.4,34,1084,7533,6.9,203,141,24,368,92,836,8,15,23
5862,2016,1,2016-09-03,Texas Tech,,Stephen F. Austin,W (69-17),48,71,67.6,633,5,28,125,4.5,4,99,758,7.7,25,11,1,37,7,42,0,1,1
5863,2016,2,2016-09-10,Texas Tech,@,Arizona State,L (55-68),38,53,71.7,540,5,22,72,3.3,3,75,612,8.2,22,3,3,28,9,94,0,2,2
5864,2016,3,2016-09-17,Texas Tech,,Louisiana Tech,W (59-45),26,36,72.2,470,5,43,196,4.6,3,79,666,8.4,18,13,4,35,11,95,0,0,0
5865,2016,4,2016-09-29,Texas Tech,,Kansas,W (55-19),42,55,76.4,548,8,24,73,3.0,0,79,621,7.9,26,6,2,34,12,70,1,1,2
5866,2016,5,2016-10-08,Texas Tech,@,Kansas State,L (38-44),46,63,73.0,529,2,28,63,2.3,3,91,592,6.5,26,4,3,33,9,100,0,1,1
5867,2016,6,2016-10-15,Texas Tech,,West Virginia,L (17-48),32,50,64.0,345,2,27,34,1.3,0,77,379,4.9,12,6,3,21,10,103,0,1,1
5868,2016,7,2016-10-22,Texas Tech,,Oklahoma,L (59-66),52,88,59.1,734,5,21,120,5.7,3,109,854,7.8,32,9,1,42,11,92,1,1,2
5869,2016,8,2016-10-29,Texas Tech,@,Texas Christian,W (27-24),24,40,60.0,206,2,49,139,2.8,1,89,345,3.9,8,15,0,23,1,5,1,1,2
5870,2016,9,2016-11-05,Texas Tech,,Texas,L (37-45),36,59,61.0,367,3,41,115,2.8,1,100,482,4.8,17,9,5,31,4,14,1,1,2
5871,2016,10,2016-11-12,Texas Tech,@,Oklahoma State,L (44-45),35,52,67.3,376,3,44,142,3.2,3,96,518,5.4,20,9,5,34,3,15,1,0,1
5872,2016,11,2016-11-19,Texas Tech,@,Iowa State,L (10-66),19,39,48.7,222,1,30,84,2.8,0,69,306,4.4,11,5,1,17,2,7,1,2,3
5873,2016,12,2016-11-25,Texas Tech,N,Baylor,W (54-35),30,47,63.8,586,6,32,80,2.5,1,79,666,8.4,20,2,2,24,15,107,0,0,0
5874,2016,,12 Games,Texas Tech,,,,428,653,65.5,5556,47,389,1243,3.2,22,1042,6799,6.5,237,92,30,359,94,744,6,11,17
5875,2017,1,2017-09-02,Texas Tech,,Eastern Washington,W (56-10),31,35,88.6,449,4,40,177,4.4,3,75,626,8.3,17,12,3,32,11,120,0,0,0
5876,2017,2,2017-09-16,Texas Tech,,Arizona State,W (52-45),37,50,74.0,543,6,29,72,2.5,1,79,615,7.8,27,5,1,33,6,67,1,0,1
5877,2017,3,2017-09-23,Texas Tech,@,Houston,W (27-24),29,45,64.4,321,2,33,200,6.1,1,78,521,6.7,11,5,1,17,15,117,0,1,1
5878,2017,4,2017-09-30,Texas Tech,,Oklahoma State,L (34-41),29,46,63.0,330,1,26,54,2.1,2,72,384,5.3,15,4,6,25,8,63,0,1,1
5879,2017,5,2017-10-07,Texas Tech,@,Kansas,W (65-19),22,27,81.5,290,3,52,313,6.0,5,79,603,7.6,12,17,1,30,2,21,1,1,2
5880,2017,6,2017-10-14,Texas Tech,@,West Virginia,L (35-46),24,39,61.5,323,4,33,190,5.8,1,72,513,7.1,14,10,3,27,16,159,0,1,1
5881,2017,7,2017-10-21,Texas Tech,,Iowa State,L (13-31),31,41,75.6,207,0,41,129,3.1,2,82,336,4.1,13,11,0,24,3,30,2,1,3
5882,2017,8,2017-10-28,Texas Tech,@,Oklahoma,L (27-49),22,36,61.1,322,4,34,115,3.4,0,70,437,6.2,12,9,3,24,6,63,0,1,1
5883,2017,9,2017-11-04,Texas Tech,,Kansas State,L (35-42),34,53,64.2,405,4,31,122,3.9,1,84,527,6.3,18,7,1,26,8,79,0,1,1
5884,2017,10,2017-11-11,Texas Tech,N,Baylor,W (38-24),24,29,82.8,246,2,30,91,3.0,1,59,337,5.7,10,7,1,18,6,64,1,0,1
5885,2017,11,2017-11-18,Texas Tech,,Texas Christian,L (3-27),18,36,50.0,153,0,41,174,4.2,0,77,327,4.2,8,10,3,21,5,55,1,1,2
5886,2017,12,2017-11-24,Texas Tech,@,Texas,W (27-23),20,45,44.4,333,2,34,62,1.8,1,79,395,5.0,12,3,1,16,8,51,0,2,2
5887,2017,13,2017-12-23,Texas Tech,N,South Florida*,L (34-38),32,59,54.2,416,3,35,133,3.8,1,94,549,5.8,19,6,1,26,10,107,0,2,2
5888,2017,,13 Games,Texas Tech,,,,353,541,65.2,4338,35,459,1832,4.0,19,1000,6170,6.2,188,106,25,319,104,996,6,12,18
5889,2014,1,2014-08-30,Toledo,,New Hampshire,W (54-20),25,35,71.4,360,4,45,306,6.8,3,80,666,8.3,18,15,1,34,3,37,0,0,0
5890,2014,2,2014-09-06,Toledo,,Missouri,L (24-49),23,44,52.3,256,0,32,154,4.8,3,76,410,5.4,11,7,0,18,9,60,1,1,2
5891,2014,3,2014-09-12,Toledo,@,Cincinnati,L (34-58),28,43,65.1,323,3,39,240,6.2,1,82,563,6.9,16,10,1,27,7,65,1,0,1
5892,2014,4,2014-09-20,Toledo,,Ball State,W (34-23),13,22,59.1,152,1,47,318,6.8,4,69,470,6.8,7,15,1,23,4,37,1,1,2
5893,2014,5,2014-09-27,Toledo,,Central Michigan,W (42-28),23,34,67.6,339,2,38,204,5.4,3,72,543,7.5,16,11,2,29,6,47,1,1,2
5894,2014,6,2014-10-04,Toledo,@,Western Michigan,W (20-19),13,27,48.1,210,1,36,234,6.5,1,63,444,7.0,10,9,0,19,4,26,2,1,3
5895,2014,7,2014-10-11,Toledo,@,Iowa State,L (30-37),22,36,61.1,189,1,41,236,5.8,2,77,425,5.5,9,12,4,25,6,56,0,0,0
5896,2014,8,2014-10-25,Toledo,,Massachusetts,W (42-35),20,34,58.8,225,3,49,295,6.0,3,83,520,6.3,11,14,5,30,9,81,0,2,2
5897,2014,9,2014-11-04,Toledo,@,Kent State,W (30-20),18,32,56.3,201,3,47,221,4.7,0,79,422,5.3,10,10,4,24,7,73,1,0,1
5898,2014,10,2014-11-11,Toledo,@,Northern Illinois,L (24-27),12,23,52.2,209,1,49,263,5.4,2,72,472,6.6,6,14,0,20,3,20,0,0,0
5899,2014,11,2014-11-19,Toledo,,Bowling Green State,W (27-20),9,20,45.0,63,0,53,325,6.1,4,73,388,5.3,5,13,1,19,8,59,1,2,3
5900,2014,12,2014-11-28,Toledo,@,Eastern Michigan,W (52-16),16,20,80.0,341,5,47,172,3.7,2,67,513,7.7,11,12,0,23,7,63,0,0,0
5901,2014,13,2015-01-04,Toledo,N,Arkansas State*,W (63-44),21,27,77.8,176,0,53,365,6.9,7,80,541,6.8,7,20,3,30,5,45,0,1,1
5902,2014,,13 Games,Toledo,,,,243,397,61.2,3044,24,576,3333,5.8,35,973,6377,6.6,137,162,22,321,78,669,8,9,17
5903,2015,1,2015-09-12,Toledo,N,Arkansas,W (16-12),21,38,55.3,237,1,24,81,3.4,1,62,318,5.1,10,4,1,15,8,55,0,0,0
5904,2015,2,2015-09-19,Toledo,,Iowa State,W (30-23),11,28,39.3,138,1,34,171,5.0,1,62,309,5.0,6,6,4,16,8,57,0,1,1
5905,2015,3,2015-09-26,Toledo,,Arkansas State,W (37-7),25,52,48.1,308,0,46,169,3.7,3,98,477,4.9,15,11,3,29,8,80,0,1,1
5906,2015,4,2015-10-03,Toledo,@,Ball State,W (24-10),16,22,72.7,164,2,48,280,5.8,1,70,444,6.3,8,12,1,21,14,135,0,2,2
5907,2015,5,2015-10-10,Toledo,,Kent State,W (38-7),20,33,60.6,230,2,46,288,6.3,3,79,518,6.6,12,11,4,27,9,84,1,0,1
5908,2015,6,2015-10-17,Toledo,,Eastern Michigan,W (63-20),22,33,66.7,373,5,29,238,8.2,3,62,611,9.9,14,9,0,23,6,46,1,0,1
5909,2015,7,2015-10-24,Toledo,@,Massachusetts,W (51-35),26,47,55.3,355,5,58,265,4.6,1,105,620,5.9,16,14,3,33,10,81,0,3,3
5910,2015,8,2015-11-03,Toledo,,Northern Illinois,L (27-32),15,33,45.5,136,1,50,291,5.8,2,83,427,5.1,7,12,2,21,4,33,1,2,3
5911,2015,9,2015-11-10,Toledo,@,Central Michigan,W (28-23),23,39,59.0,322,2,34,169,5.0,2,73,491,6.7,16,7,0,23,7,65,0,0,0
5912,2015,10,2015-11-17,Toledo,@,Bowling Green State,W (44-28),16,24,66.7,208,1,50,198,4.0,4,74,406,5.5,11,9,0,20,8,84,0,1,1
5913,2015,11,2015-11-27,Toledo,,Western Michigan,L (30-35),16,33,48.5,280,2,39,201,5.2,2,72,481,6.7,10,10,2,22,5,35,1,0,1
5914,2015,12,2015-12-22,Toledo,N,Temple*,W (32-17),20,29,69.0,285,2,33,150,4.5,2,62,435,7.0,13,5,0,18,9,63,0,0,0
5915,2015,,12 Games,Toledo,,,,231,411,56.2,3036,24,491,2501,5.1,25,902,5537,6.1,138,110,20,268,96,818,4,10,14
5916,2016,1,2016-09-02,Toledo,@,Arkansas State,W (31-10),23,31,74.2,371,3,45,185,4.1,1,76,556,7.3,14,9,1,24,6,58,2,0,2
5917,2016,2,2016-09-10,Toledo,,Maine,W (45-3),13,27,48.1,329,4,33,187,5.7,1,60,516,8.6,8,9,0,17,8,68,1,1,2
5918,2016,3,2016-09-17,Toledo,,Fresno State,W (52-17),16,28,57.1,301,5,55,318,5.8,2,83,619,7.5,10,15,2,27,6,45,0,0,0
5919,2016,4,2016-09-30,Toledo,@,Brigham Young,L (53-55),30,38,78.9,505,5,41,187,4.6,2,79,692,8.8,19,10,4,33,8,81,0,2,2
5920,2016,5,2016-10-08,Toledo,@,Eastern Michigan,W (35-20),25,31,80.6,247,4,51,220,4.3,1,82,467,5.7,15,13,2,30,6,60,0,0,0
5921,2016,6,2016-10-15,Toledo,,Bowling Green State,W (42-35),23,30,76.7,322,4,43,219,5.1,2,73,541,7.4,14,8,3,25,7,73,0,1,1
5922,2016,7,2016-10-22,Toledo,,Central Michigan,W (31-17),23,32,71.9,264,4,37,140,3.8,0,69,404,5.9,13,6,4,23,7,67,0,0,0
5923,2016,8,2016-10-27,Toledo,,Ohio,L (26-31),32,46,69.6,438,3,29,122,4.2,0,75,560,7.5,15,8,1,24,9,66,1,1,2
5924,2016,9,2016-11-02,Toledo,@,Akron,W (48-17),27,38,71.1,332,3,48,290,6.0,3,86,622,7.2,16,15,2,33,8,63,0,0,0
5925,2016,10,2016-11-09,Toledo,N,Northern Illinois,W (31-24),23,33,69.7,286,3,40,134,3.4,1,73,420,5.8,14,7,1,22,6,48,0,1,1
5926,2016,11,2016-11-16,Toledo,,Ball State,W (37-19),25,39,64.1,325,3,32,179,5.6,0,71,504,7.1,13,8,2,23,4,34,0,1,1
5927,2016,12,2016-11-25,Toledo,@,Western Michigan,L (35-55),13,24,54.2,229,3,30,227,7.6,2,54,456,8.4,8,9,3,20,9,71,1,2,3
5928,2016,13,2016-12-17,Toledo,N,Appalachian State*,L (28-31),18,26,69.2,247,2,28,127,4.5,2,54,374,6.9,9,5,0,14,7,62,0,0,0
5929,2016,,13 Games,Toledo,,,,291,423,68.8,4196,46,512,2535,5.0,17,935,6731,7.2,168,122,25,315,91,796,5,9,14
5930,2017,1,2017-08-31,Toledo,,Elon,W (47-13),19,34,55.9,314,0,41,239,5.8,4,75,553,7.4,13,11,1,25,2,20,1,1,2
5931,2017,2,2017-09-09,Toledo,@,Nevada,W (37-24),19,27,70.4,232,2,60,194,3.2,2,87,426,4.9,11,12,5,28,14,110,0,0,0
5932,2017,3,2017-09-16,Toledo,,Tulsa,W (54-51),22,33,66.7,458,6,33,221,6.7,1,66,679,10.3,16,9,4,29,15,150,0,1,1
5933,2017,4,2017-09-23,Toledo,@,Miami (FL),L (30-52),29,50,58.0,344,3,34,102,3.0,0,84,446,5.3,16,6,1,23,10,77,1,0,1
5934,2017,5,2017-10-07,Toledo,,Eastern Michigan,W (20-15),23,34,67.6,289,0,42,130,3.1,2,76,419,5.5,15,5,4,24,9,85,0,0,0
5935,2017,6,2017-10-14,Toledo,@,Central Michigan,W (30-10),10,18,55.6,89,0,56,310,5.5,4,74,399,5.4,5,12,0,17,4,30,0,0,0
5936,2017,7,2017-10-21,Toledo,,Akron,W (48-21),18,28,64.3,323,5,43,303,7.0,1,71,626,8.8,15,20,0,35,11,104,0,1,1
5937,2017,8,2017-10-26,Toledo,@,Ball State,W (58-17),8,18,44.4,267,3,33,335,10.2,4,51,602,11.8,6,10,0,16,8,90,1,0,1
5938,2017,9,2017-11-02,Toledo,,Northern Illinois,W (27-17),23,31,74.2,361,0,40,166,4.2,3,71,527,7.4,14,7,2,23,4,35,1,0,1
5939,2017,10,2017-11-08,Toledo,@,Ohio,L (10-38),24,35,68.6,263,1,23,53,2.3,0,58,316,5.4,11,2,1,14,6,48,2,0,2
5940,2017,11,2017-11-15,Toledo,@,Bowling Green State,W (66-37),14,20,70.0,248,2,53,389,7.3,7,73,637,8.7,12,17,3,32,8,74,0,0,0
5941,2017,12,2017-11-24,Toledo,,Western Michigan,W (37-10),19,29,65.5,300,2,38,155,4.1,2,67,455,6.8,12,9,1,22,6,50,0,1,1
5942,2017,13,2017-12-02,Toledo,N,Akron,W (45-28),23,37,62.2,307,4,39,254,6.5,2,76,561,7.4,14,11,1,26,4,43,3,2,5
5943,2017,14,2017-12-23,Toledo,N,Appalachian State*,L (0-34),16,29,55.2,124,0,21,22,1.0,0,50,146,2.9,6,2,0,8,5,35,1,3,4
5944,2017,,14 Games,Toledo,,,,267,423,63.1,3919,28,556,2873,5.2,32,979,6792,6.9,166,133,23,322,106,951,10,9,19
5945,2014,1,2014-08-30,Troy,@,Alabama-Birmingham,L (10-48),21,31,67.7,201,0,37,71,1.9,1,68,272,4.0,8,6,1,15,5,57,1,0,1
5946,2014,2,2014-09-06,Troy,,Duke,L (17-34),22,34,64.7,238,0,43,158,3.7,2,77,396,5.1,11,8,1,20,7,55,0,0,0
5947,2014,3,2014-09-13,Troy,,Abilene Christian,L (35-38),21,38,55.3,286,1,29,131,4.5,4,67,417,6.2,8,9,0,17,10,108,0,0,0
5948,2014,4,2014-09-20,Troy,@,Georgia,L (0-66),18,33,54.5,169,0,28,47,1.7,0,61,216,3.5,5,5,1,11,4,35,1,1,2
5949,2014,5,2014-09-27,Troy,@,Louisiana-Monroe,L (20-22),23,34,67.6,270,3,32,81,2.5,0,66,351,5.3,10,7,0,17,3,45,1,0,1
5950,2014,6,2014-10-11,Troy,,New Mexico State,W (41-24),23,30,76.7,211,1,53,360,6.8,3,83,571,6.9,10,17,0,27,5,49,1,1,2
5951,2014,7,2014-10-18,Troy,,Appalachian State,L (14-53),27,40,67.5,229,0,32,79,2.5,1,72,308,4.3,8,7,2,17,11,89,2,2,4
5952,2014,8,2014-10-24,Troy,@,South Alabama,L (13-27),13,24,54.2,145,1,40,164,4.1,0,64,309,4.8,5,10,4,19,10,100,0,0,0
5953,2014,9,2014-10-30,Troy,@,Georgia Southern,L (10-42),4,11,36.4,13,0,33,141,4.3,1,44,154,3.5,0,9,0,9,4,45,1,0,1
5954,2014,10,2014-11-08,Troy,,Georgia State,W (45-21),18,22,81.8,116,1,45,324,7.2,5,67,440,6.6,4,16,1,21,3,23,0,0,0
5955,2014,11,2014-11-15,Troy,@,Idaho,W (34-17),19,26,73.1,231,2,57,293,5.1,1,83,524,6.3,7,15,1,23,8,92,1,0,1
5956,2014,12,2014-11-29,Troy,,Louisiana,L (23-42),29,34,85.3,272,3,32,122,3.8,0,66,394,6.0,14,7,3,24,4,40,2,0,2
5957,2014,,12 Games,Troy,,,,238,357,66.7,2381,12,461,1971,4.3,18,818,4352,5.3,90,116,14,220,74,738,10,4,14
5958,2015,1,2015-09-05,Troy,@,North Carolina State,L (21-49),14,21,66.7,184,1,25,121,4.8,2,46,305,6.6,7,5,1,13,5,54,1,1,2
5959,2015,2,2015-09-12,Troy,,Charleston Southern,W (44-16),19,28,67.9,249,2,28,125,4.5,3,56,374,6.7,10,7,1,18,7,62,0,0,0
5960,2015,3,2015-09-19,Troy,@,Wisconsin,L (3-28),23,35,65.7,174,0,33,81,2.5,0,68,255,3.8,10,6,3,19,7,59,1,0,1
5961,2015,4,2015-10-03,Troy,,South Alabama,L (18-24),16,35,45.7,146,1,33,119,3.6,1,68,265,3.9,9,7,2,18,7,66,0,3,3
5962,2015,5,2015-10-10,Troy,@,Mississippi State,L (17-45),20,36,55.6,142,0,46,112,2.4,2,82,254,3.1,8,9,2,19,3,20,1,1,2
5963,2015,6,2015-10-17,Troy,,Idaho,L (16-19),20,38,52.6,238,1,37,143,3.9,0,75,381,5.1,13,6,3,22,7,47,2,2,4
5964,2015,7,2015-10-24,Troy,@,New Mexico State,W (52-7),26,42,61.9,316,5,24,166,6.9,1,66,482,7.3,16,4,3,23,5,27,0,0,0
5965,2015,8,2015-10-31,Troy,@,Appalachian State,L (41-44),29,43,67.4,310,1,45,140,3.1,4,88,450,5.1,16,8,1,25,8,73,0,2,2
5966,2015,9,2015-11-07,Troy,,Louisiana-Monroe,W (51-14),24,36,66.7,345,4,35,148,4.2,0,71,493,6.9,13,7,0,20,5,30,0,0,0
5967,2015,10,2015-11-14,Troy,,Georgia Southern,L (10-45),15,29,51.7,170,0,18,68,3.8,0,47,238,5.1,8,3,0,11,4,41,2,1,3
5968,2015,11,2015-11-27,Troy,@,Georgia State,L (21-31),21,46,45.7,293,2,25,81,3.2,1,71,374,5.3,11,7,2,20,12,117,1,1,2
5969,2015,12,2015-12-05,Troy,@,Louisiana,W (41-17),22,28,78.6,320,4,33,128,3.9,0,61,448,7.3,12,6,0,18,10,95,0,0,0
5970,2015,,12 Games,Troy,,,,249,417,59.7,2887,21,382,1432,3.7,14,799,4319,5.4,133,75,18,226,80,691,8,11,19
5971,2016,1,2016-09-03,Troy,,Austin Peay,W (57-17),29,36,80.6,323,3,43,383,8.9,5,79,706,8.9,11,18,0,29,14,153,1,0,1
5972,2016,2,2016-09-10,Troy,@,Clemson,L (24-30),26,45,57.8,245,2,33,141,4.3,1,78,386,4.9,11,6,4,21,11,95,0,3,3
5973,2016,3,2016-09-17,Troy,@,Southern Mississippi,W (37-31),10,28,35.7,123,3,49,186,3.8,1,77,309,4.0,5,11,3,19,10,70,0,1,1
5974,2016,4,2016-09-24,Troy,,New Mexico State,W (52-6),27,37,73.0,285,2,41,207,5.0,3,78,492,6.3,16,9,2,27,2,26,0,0,0
5975,2016,5,2016-10-01,Troy,@,Idaho,W (34-13),31,42,73.8,373,3,33,157,4.8,1,75,530,7.1,15,11,1,27,7,58,1,2,3
5976,2016,6,2016-10-15,Troy,,Georgia State,W (31-21),20,36,55.6,235,2,43,128,3.0,1,79,363,4.6,10,7,3,20,10,95,0,1,1
5977,2016,7,2016-10-20,Troy,@,South Alabama,W (28-21),28,42,66.7,395,1,38,190,5.0,2,80,585,7.3,15,11,2,28,7,55,2,0,2
5978,2016,8,2016-11-05,Troy,,Massachusetts,W (52-31),29,39,74.4,287,4,38,198,5.2,3,77,485,6.3,16,11,1,28,5,35,0,1,1
5979,2016,9,2016-11-12,Troy,,Appalachian State,W (28-24),20,36,55.6,223,1,38,187,4.9,3,74,410,5.5,8,11,3,22,8,70,1,1,2
5980,2016,10,2016-11-17,Troy,,Arkansas State,L (3-35),20,39,51.3,207,0,24,55,2.3,0,63,262,4.2,10,4,3,17,3,16,3,2,5
5981,2016,11,2016-11-26,Troy,@,Texas State,W (40-7),24,37,64.9,237,2,42,154,3.7,3,79,391,4.9,10,11,4,25,2,15,0,0,0
5982,2016,12,2016-12-03,Troy,@,Georgia Southern,L (24-28),27,34,79.4,218,1,32,126,3.9,2,66,344,5.2,14,6,0,20,3,25,0,0,0
5983,2016,13,2016-12-23,Troy,N,Ohio*,W (28-23),24,41,58.5,235,1,31,87,2.8,3,72,322,4.5,13,3,1,17,6,90,0,2,2
5984,2016,,13 Games,Troy,,,,315,492,64.0,3386,25,485,2199,4.5,28,977,5585,5.7,154,119,27,300,88,803,8,13,21
5985,2017,1,2017-09-02,Troy,@,Boise State,L (13-24),17,34,50.0,139,0,29,76,2.6,0,63,215,3.4,4,5,2,11,8,60,2,1,3
5986,2017,2,2017-09-09,Troy,,Alabama State,W (34-7),33,42,78.6,354,0,35,251,7.2,5,77,605,7.9,18,12,2,32,10,110,0,1,1
5987,2017,3,2017-09-16,Troy,@,New Mexico State,W (27-24),25,40,62.5,286,1,37,192,5.2,3,77,478,6.2,13,9,4,26,9,61,0,0,0
5988,2017,4,2017-09-23,Troy,,Akron,W (22-17),28,42,66.7,314,1,28,181,6.5,2,70,495,7.1,15,6,3,24,16,159,1,0,1
5989,2017,5,2017-09-30,Troy,@,Louisiana State,W (24-21),16,28,57.1,157,0,42,206,4.9,3,70,363,5.2,8,8,0,16,5,35,2,0,2
5990,2017,6,2017-10-11,Troy,,South Alabama,L (8-19),25,47,53.2,269,0,20,30,1.5,1,67,299,4.5,11,4,3,18,6,33,3,1,4
5991,2017,7,2017-10-21,Troy,@,Georgia State,W (34-10),25,36,69.4,335,2,22,122,5.5,2,58,457,7.9,14,5,1,20,1,5,1,1,2
5992,2017,8,2017-10-28,Troy,,Georgia Southern,W (38-16),10,20,50.0,142,2,30,241,8.0,3,50,383,7.7,6,8,2,16,4,18,0,0,0
5993,2017,9,2017-11-02,Troy,,Idaho,W (24-21),20,31,64.5,212,1,36,183,5.1,2,67,395,5.9,8,11,1,20,10,91,1,1,2
5994,2017,10,2017-11-11,Troy,@,Coastal Carolina,W (42-17),21,33,63.6,259,1,36,122,3.4,3,69,381,5.5,12,11,1,24,4,29,0,1,1
5995,2017,11,2017-11-24,Troy,,Texas State,W (62-9),26,35,74.3,487,5,31,154,5.0,3,66,641,9.7,17,5,0,22,3,15,0,0,0
5996,2017,12,2017-12-02,Troy,@,Arkansas State,W (32-25),23,41,56.1,246,2,25,47,1.9,0,66,293,4.4,12,0,2,14,7,46,1,0,1
5997,2017,13,2017-12-16,Troy,N,North Texas*,W (50-30),24,31,77.4,305,4,38,130,3.4,3,69,435,6.3,13,5,3,21,8,80,1,1,2
5998,2017,,13 Games,Troy,,,,293,460,63.7,3505,19,409,1935,4.7,30,869,5440,6.3,151,89,24,264,91,742,12,7,19
5999,2014,1,2014-08-28,Tulane,@,Tulsa,L (31-38),22,44,50.0,262,3,30,254,8.5,1,74,516,7.0,13,6,3,22,9,96,1,1,2
6000,2014,2,2014-09-06,Tulane,,Georgia Tech,L (21-38),17,35,48.6,231,2,25,96,3.8,1,60,327,5.5,10,6,1,17,10,69,0,3,3
6001,2014,3,2014-09-13,Tulane,,Southeastern Louisiana,W (35-20),14,30,46.7,238,3,40,122,3.1,2,70,360,5.1,10,5,6,21,12,115,1,2,3
6002,2014,4,2014-09-20,Tulane,@,Duke,L (13-47),14,36,38.9,160,0,58,231,4.0,2,94,391,4.2,7,17,4,28,13,92,1,4,5
6003,2014,5,2014-09-27,Tulane,@,Rutgers,L (6-31),18,29,62.1,152,0,31,152,4.9,1,60,304,5.1,4,7,2,13,7,62,0,0,0
6004,2014,6,2014-10-11,Tulane,,Connecticut,W (12-3),19,26,73.1,135,1,33,167,5.1,0,59,302,5.1,6,8,0,14,7,64,0,0,0
6005,2014,7,2014-10-18,Tulane,@,Central Florida,L (13-20),18,42,42.9,147,0,36,131,3.6,1,78,278,3.6,6,9,3,18,9,84,0,2,2
6006,2014,8,2014-10-31,Tulane,,Cincinnati,L (14-38),24,35,68.6,205,1,33,175,5.3,1,68,380,5.6,12,9,0,21,4,51,1,0,1
6007,2014,9,2014-11-08,Tulane,@,Houston,W (31-24),24,35,68.6,237,3,36,124,3.4,1,71,361,5.1,11,9,2,22,5,64,1,1,2
6008,2014,10,2014-11-15,Tulane,,Memphis,L (7-38),26,48,54.2,196,0,39,155,4.0,1,87,351,4.0,10,9,2,21,3,30,2,3,5
6009,2014,11,2014-11-22,Tulane,@,East Carolina,L (6-34),25,43,58.1,301,0,27,24,0.9,0,70,325,4.6,11,2,2,15,7,79,0,1,1
6010,2014,12,2014-12-06,Tulane,,Temple,L (3-10),19,40,47.5,151,0,31,115,3.7,0,71,266,3.7,5,6,3,14,4,35,0,1,1
6011,2014,,12 Games,Tulane,,,,240,443,54.2,2415,13,419,1746,4.2,11,862,4161,4.8,105,93,28,226,90,841,7,18,25
6012,2015,1,2015-09-03,Tulane,,Duke,L (7-37),24,42,57.1,246,1,23,25,1.1,0,65,271,4.2,8,3,3,14,5,25,0,1,1
6013,2015,2,2015-09-12,Tulane,@,Georgia Tech,L (10-65),15,33,45.5,177,1,33,71,2.2,0,66,248,3.8,9,8,1,18,4,34,1,1,2
6014,2015,3,2015-09-19,Tulane,,Maine,W (38-7),18,31,58.1,292,1,42,205,4.9,4,73,497,6.8,14,6,0,20,7,65,1,1,2
6015,2015,4,2015-10-03,Tulane,,Central Florida,W (45-31),17,29,58.6,225,5,44,170,3.9,1,73,395,5.4,7,8,2,17,7,67,1,0,1
6016,2015,5,2015-10-10,Tulane,@,Temple,L (10-49),17,30,56.7,102,1,27,8,0.3,0,57,110,1.9,5,2,1,8,9,102,0,2,2
6017,2015,6,2015-10-16,Tulane,,Houston,L (7-42),14,33,42.4,150,0,32,112,3.5,1,65,262,4.0,6,4,1,11,12,133,0,0,0
6018,2015,7,2015-10-24,Tulane,@,Navy,L (14-31),27,38,71.1,263,1,27,123,4.6,1,65,386,5.9,18,2,1,21,9,80,2,1,3
6019,2015,8,2015-10-31,Tulane,@,Memphis,L (13-41),10,24,41.7,131,0,42,139,3.3,2,66,270,4.1,6,8,3,17,6,50,0,0,0
6020,2015,9,2015-11-07,Tulane,,Connecticut,L (3-7),13,40,32.5,106,0,25,34,1.4,0,65,140,2.2,6,3,0,9,2,10,0,1,1
6021,2015,10,2015-11-14,Tulane,@,Army,W (34-31),14,29,48.3,252,2,28,115,4.1,1,57,367,6.4,11,7,0,18,2,10,0,1,1
6022,2015,11,2015-11-21,Tulane,@,Southern Methodist,L (21-49),13,33,39.4,128,2,33,200,6.1,1,66,328,5.0,7,8,2,17,4,40,0,0,0
6023,2015,12,2015-11-27,Tulane,,Tulsa,L (34-45),23,41,56.1,343,4,41,187,4.6,0,82,530,6.5,15,9,1,25,3,25,0,2,2
6024,2015,,12 Games,Tulane,,,,205,403,50.9,2415,18,397,1389,3.5,11,800,3804,4.8,112,68,15,195,70,641,5,10,15
6025,2016,1,2016-09-01,Tulane,@,Wake Forest,L (3-7),12,23,52.2,134,0,47,146,3.1,0,70,280,4.0,6,7,1,14,4,30,1,0,1
6026,2016,2,2016-09-10,Tulane,,Southern,W (66-21),2,6,33.3,12,0,57,437,7.7,7,63,449,7.1,0,20,2,22,4,35,0,1,1
6027,2016,3,2016-09-17,Tulane,,Navy,L (14-21),3,12,25.0,21,0,47,240,5.1,2,59,261,4.4,0,14,0,14,9,71,0,0,0
6028,2016,4,2016-09-24,Tulane,,Louisiana,W (41-39),13,26,50.0,181,4,48,130,2.7,0,74,311,4.2,7,7,0,14,6,40,0,1,1
6029,2016,5,2016-10-01,Tulane,@,Massachusetts,W (31-24),11,21,52.4,168,1,64,280,4.4,3,85,448,5.3,8,16,3,27,6,50,1,0,1
6030,2016,6,2016-10-14,Tulane,,Memphis,L (14-24),11,30,36.7,144,1,44,169,3.8,1,74,313,4.2,7,9,4,20,7,62,2,1,3
6031,2016,7,2016-10-22,Tulane,@,Tulsa,L (27-50),3,19,15.8,37,0,49,355,7.2,4,68,392,5.8,2,12,1,15,9,85,1,0,1
6032,2016,8,2016-10-29,Tulane,,Southern Methodist,L (31-35),13,26,50.0,164,2,46,227,4.9,2,72,391,5.4,7,9,2,18,10,100,0,1,1
6033,2016,9,2016-11-05,Tulane,@,Central Florida,L (6-37),5,21,23.8,68,0,64,280,4.4,1,85,348,4.1,3,16,3,22,6,65,2,3,5
6034,2016,10,2016-11-12,Tulane,@,Houston,L (18-30),21,42,50.0,241,2,36,100,2.8,0,78,341,4.4,11,5,1,17,5,33,1,0,1
6035,2016,11,2016-11-19,Tulane,,Temple,L (0-31),4,13,30.8,24,0,33,118,3.6,0,46,142,3.1,0,8,0,8,6,50,2,0,2
6036,2016,12,2016-11-26,Tulane,@,Connecticut,W (38-13),11,19,57.9,166,0,55,257,4.7,5,74,423,5.7,8,8,1,17,5,40,0,1,1
6037,2016,,12 Games,Tulane,,,,109,258,42.2,1360,10,590,2739,4.6,25,848,4099,4.8,59,131,18,208,77,661,10,8,18
6038,2017,1,2017-09-02,Tulane,,Grambling State,W (43-14),10,15,66.7,185,3,51,296,5.8,3,66,481,7.3,9,15,2,26,8,75,0,0,0
6039,2017,2,2017-09-09,Tulane,@,Navy,L (21-23),8,13,61.5,71,0,46,191,4.2,2,59,262,4.4,1,10,0,11,7,41,0,0,0
6040,2017,3,2017-09-16,Tulane,@,Oklahoma,L (14-56),6,12,50.0,54,0,62,237,3.8,2,74,291,3.9,3,16,1,20,2,20,1,1,2
6041,2017,4,2017-09-23,Tulane,,Army,W (21-17),10,22,45.5,103,0,30,253,8.4,3,52,356,6.8,5,8,2,15,6,59,0,0,0
6042,2017,5,2017-10-07,Tulane,,Tulsa,W (62-28),9,13,69.2,165,1,70,488,7.0,8,83,653,7.9,7,22,2,31,6,60,0,0,0
6043,2017,6,2017-10-14,Tulane,@,Florida International,L (10-23),5,16,31.3,36,0,40,203,5.1,1,56,239,4.3,1,14,3,18,1,15,1,1,2
6044,2017,7,2017-10-21,Tulane,,South Florida,L (28-34),9,19,47.4,221,2,47,194,4.1,2,66,415,6.3,8,12,3,23,12,137,0,1,1
6045,2017,8,2017-10-27,Tulane,@,Memphis,L (26-56),15,31,48.4,203,3,52,122,2.3,1,83,325,3.9,6,11,1,18,4,27,1,0,1
6046,2017,9,2017-11-04,Tulane,,Cincinnati,L (16-17),17,24,70.8,196,0,35,132,3.8,1,59,328,5.6,8,5,3,16,6,39,0,0,0
6047,2017,10,2017-11-11,Tulane,@,East Carolina,W (31-24),12,20,60.0,121,0,52,325,6.3,4,72,446,6.2,5,17,0,22,8,70,1,2,3
6048,2017,11,2017-11-18,Tulane,,Houston,W (20-17),17,25,68.0,251,1,47,166,3.5,1,72,417,5.8,12,11,0,23,5,42,0,1,1
6049,2017,12,2017-11-25,Tulane,@,Southern Methodist,L (38-41),18,31,58.1,314,2,43,171,4.0,3,74,485,6.6,13,12,2,27,5,40,1,0,1
6050,2017,,12 Games,Tulane,,,,136,241,56.4,1920,12,575,2778,4.8,31,816,4698,5.8,78,153,19,250,70,625,5,6,11
6051,2014,1,2014-08-28,Tulsa,,Tulane,W (38-31),31,53,58.5,438,4,36,154,4.3,0,89,592,6.7,20,7,3,30,9,90,0,2,2
6052,2014,2,2014-09-06,Tulsa,,Oklahoma,L (7-52),27,50,54.0,234,1,34,94,2.8,0,84,328,3.9,14,8,1,23,6,62,1,3,4
6053,2014,3,2014-09-13,Tulsa,@,Florida Atlantic,L (21-50),24,52,46.2,269,1,27,94,3.5,2,79,363,4.6,12,9,3,24,5,25,1,2,3
6054,2014,4,2014-09-27,Tulsa,,Texas State,L (34-37),23,40,57.5,234,2,56,200,3.6,2,96,434,4.5,10,13,2,25,4,34,0,1,1
6055,2014,5,2014-10-04,Tulsa,@,Colorado State,L (17-42),18,35,51.4,263,1,45,127,2.8,1,80,390,4.9,9,8,2,19,4,30,1,2,3
6056,2014,6,2014-10-11,Tulsa,@,Temple,L (24-35),21,36,58.3,260,2,50,178,3.6,1,86,438,5.1,12,11,1,24,8,108,0,0,0
6057,2014,7,2014-10-18,Tulsa,,South Florida,L (30-38),22,34,64.7,314,1,41,174,4.2,1,75,488,6.5,11,7,2,20,11,114,1,0,1
6058,2014,8,2014-10-31,Tulsa,@,Memphis,L (20-40),28,54,51.9,349,2,34,62,1.8,0,88,411,4.7,19,2,1,22,11,111,0,0,0
6059,2014,9,2014-11-08,Tulsa,,Southern Methodist,W (38-28),16,25,64.0,286,5,47,215,4.6,0,72,501,7.0,10,13,3,26,5,40,1,0,1
6060,2014,10,2014-11-14,Tulsa,@,Central Florida,L (7-31),10,29,34.5,72,1,27,129,4.8,0,56,201,3.6,4,7,0,11,6,64,0,3,3
6061,2014,11,2014-11-22,Tulsa,@,Houston,L (28-38),28,41,68.3,258,2,35,158,4.5,2,76,416,5.5,12,12,1,25,4,35,0,3,3
6062,2014,12,2014-11-28,Tulsa,,East Carolina,L (32-49),15,32,46.9,199,1,45,189,4.2,2,77,388,5.0,7,10,4,21,5,55,0,2,2
6063,2014,,12 Games,Tulsa,,,,263,481,54.7,3176,23,477,1774,3.7,11,958,4950,5.2,140,107,23,270,78,768,5,18,23
6064,2015,1,2015-09-05,Tulsa,,Florida Atlantic,W (47-44),21,35,60.0,424,2,51,194,3.8,4,86,618,7.2,14,13,4,31,4,26,2,2,4
6065,2015,2,2015-09-12,Tulsa,@,New Mexico,W (40-21),16,30,53.3,321,2,59,279,4.7,2,89,600,6.7,0,0,0,31,7,56,1,0,1
6066,2015,3,2015-09-19,Tulsa,@,Oklahoma,L (38-52),34,51,66.7,427,4,40,176,4.4,1,91,603,6.6,21,7,3,31,8,60,0,0,0
6067,2015,4,2015-10-03,Tulsa,,Houston,L (24-38),26,45,57.8,326,0,43,130,3.0,3,88,456,5.2,14,6,3,23,10,71,1,1,2
6068,2015,5,2015-10-10,Tulsa,,Louisiana-Monroe,W (34-24),28,45,62.2,341,2,62,222,3.6,2,107,563,5.3,16,13,2,31,10,82,0,0,0
6069,2015,6,2015-10-17,Tulsa,@,East Carolina,L (17-30),19,41,46.3,288,1,45,175,3.9,1,86,463,5.4,11,8,3,22,7,53,1,1,2
6070,2015,7,2015-10-23,Tulsa,,Memphis,L (42-66),24,36,66.7,421,4,45,113,2.5,2,81,534,6.6,13,8,6,27,11,76,2,1,3
6071,2015,8,2015-10-31,Tulsa,@,Southern Methodist,W (40-31),19,27,70.4,240,0,57,179,3.1,4,84,419,5.0,10,12,0,22,7,70,0,0,0
6072,2015,9,2015-11-07,Tulsa,,Central Florida,W (45-30),10,18,55.6,150,2,46,275,6.0,3,64,425,6.6,5,13,3,21,3,38,2,2,4
6073,2015,10,2015-11-14,Tulsa,@,Cincinnati,L (38-49),30,50,60.0,375,2,39,213,5.5,3,89,588,6.6,14,10,2,26,7,53,1,0,1
6074,2015,11,2015-11-21,Tulsa,,Navy,L (21-44),32,37,86.5,278,0,34,78,2.3,3,71,356,5.0,13,5,2,20,5,50,2,0,2
6075,2015,12,2015-11-27,Tulsa,@,Tulane,W (45-34),19,33,57.6,367,3,31,41,1.3,1,64,408,6.4,17,2,1,20,6,51,0,1,1
6076,2015,13,2015-12-26,Tulsa,N,Virginia Tech*,L (52-55),27,44,61.4,374,3,39,189,4.8,4,83,563,6.8,15,11,1,27,6,44,0,0,0
6077,2015,,13 Games,Tulsa,,,,305,492,62.0,4332,25,591,2264,3.8,33,1083,6596,6.1,163,108,30,332,91,730,12,8,20
6078,2016,1,2016-09-03,Tulsa,,San Jose State,W (45-10),13,25,52.0,207,1,58,305,5.3,3,83,512,6.2,9,19,0,28,2,25,0,0,0
6079,2016,2,2016-09-10,Tulsa,@,Ohio State,L (3-48),15,32,46.9,127,0,37,61,1.6,0,69,188,2.7,9,4,1,14,5,46,2,4,6
6080,2016,3,2016-09-17,Tulsa,,North Carolina A&T,W (58-21),25,39,64.1,358,4,38,136,3.6,2,77,494,6.4,16,8,4,28,6,60,1,1,2
6081,2016,4,2016-09-24,Tulsa,@,Fresno State,W (48-41),24,34,70.6,281,4,68,344,5.1,2,102,625,6.1,10,22,2,34,8,71,1,1,2
6082,2016,5,2016-10-07,Tulsa,,Southern Methodist,W (43-40),25,44,56.8,247,1,59,315,5.3,4,103,562,5.5,17,15,2,34,17,149,0,1,1
6083,2016,6,2016-10-15,Tulsa,@,Houston,L (31-38),27,51,52.9,365,1,35,94,2.7,3,86,459,5.3,18,6,3,27,5,25,1,1,2
6084,2016,7,2016-10-22,Tulsa,,Tulane,W (50-27),14,23,60.9,236,3,58,330,5.7,3,81,566,7.0,9,17,3,29,6,36,2,0,2
6085,2016,8,2016-10-29,Tulsa,@,Memphis,W (59-30),20,33,60.6,234,2,54,362,6.7,6,87,596,6.9,13,14,2,29,7,63,1,0,1
6086,2016,9,2016-11-05,Tulsa,,East Carolina,W (45-24),22,38,57.9,274,3,54,342,6.3,3,92,616,6.7,14,18,5,37,10,86,0,0,0
6087,2016,10,2016-11-12,Tulsa,@,Navy,L (40-42),16,27,59.3,369,4,38,207,5.4,1,65,576,8.9,13,10,0,23,3,35,0,1,1
6088,2016,11,2016-11-19,Tulsa,@,Central Florida,W (35-20),12,25,48.0,126,2,56,348,6.2,3,81,474,5.9,5,15,1,21,3,26,0,1,1
6089,2016,12,2016-11-25,Tulsa,,Cincinnati,W (40-37),25,39,64.1,305,3,65,306,4.7,2,104,611,5.9,18,14,3,35,3,37,1,2,3
6090,2016,13,2016-12-19,Tulsa,N,Central Michigan*,W (55-10),29,39,74.4,320,5,46,261,5.7,1,85,581,6.8,14,20,0,34,3,25,0,0,0
6091,2016,,13 Games,Tulsa,,,,267,449,59.5,3449,33,666,3411,5.1,33,1115,6860,6.2,165,182,26,373,78,684,9,12,21
6092,2017,1,2017-08-31,Tulsa,@,Oklahoma State,L (24-59),20,38,52.6,188,0,60,244,4.1,2,98,432,4.4,10,14,2,26,6,48,2,0,2
6093,2017,2,2017-09-09,Tulsa,,Louisiana,W (66-42),14,20,70.0,243,1,72,424,5.9,8,92,667,7.3,9,21,3,33,5,46,1,0,1
6094,2017,3,2017-09-16,Tulsa,@,Toledo,L (51-54),12,20,60.0,125,0,68,423,6.2,6,88,548,6.2,4,21,4,29,9,97,0,0,0
6095,2017,4,2017-09-23,Tulsa,,New Mexico,L (13-16),13,27,48.1,131,0,31,155,5.0,1,58,286,4.9,8,6,1,15,6,59,0,1,1
6096,2017,5,2017-09-30,Tulsa,,Navy,L (21-31),12,18,66.7,115,1,39,229,5.9,2,57,344,6.0,4,6,2,12,5,40,0,0,0
6097,2017,6,2017-10-07,Tulsa,@,Tulane,L (28-62),12,20,60.0,273,1,28,139,5.0,3,48,412,8.6,6,9,1,16,4,36,1,1,2
6098,2017,7,2017-10-14,Tulsa,,Houston,W (45-17),9,18,50.0,128,1,53,288,5.4,4,71,416,5.9,3,16,1,20,9,70,0,1,1
6099,2017,8,2017-10-21,Tulsa,@,Connecticut,L (14-20),17,28,60.7,259,0,44,194,4.4,2,72,453,6.3,11,9,3,23,5,47,0,1,1
6100,2017,9,2017-10-27,Tulsa,@,Southern Methodist,L (34-38),9,25,36.0,212,1,53,246,4.6,3,78,458,5.9,6,12,4,22,8,73,0,1,1
6101,2017,10,2017-11-03,Tulsa,,Memphis,L (14-41),18,31,58.1,157,0,35,145,4.1,2,66,302,4.6,7,8,2,17,14,103,0,1,1
6102,2017,11,2017-11-16,Tulsa,@,South Florida,L (20-27),14,28,50.0,191,0,55,166,3.0,2,83,357,4.3,7,13,2,22,7,46,0,0,0
6103,2017,12,2017-11-25,Tulsa,,Temple,L (22-43),6,19,31.6,55,1,54,314,5.8,1,73,369,5.1,2,18,5,25,6,55,1,2,3
6104,2017,,12 Games,Tulsa,,,,156,292,53.4,2077,6,592,2967,5.0,36,884,5044,5.7,77,153,30,260,84,720,5,8,13
6105,2014,1,2014-08-30,UAB,,Troy,W (48-10),12,19,63.2,150,2,55,339,6.2,4,74,489,6.6,5,19,2,26,3,35,1,1,2
6106,2014,2,2014-09-06,UAB,@,Mississippi State,L (34-47),16,34,47.1,435,3,43,113,2.6,1,77,548,7.1,12,6,1,19,5,27,0,1,1
6107,2014,3,2014-09-13,UAB,,Alabama A&M,W (41-14),22,32,68.8,288,0,51,195,3.8,6,83,483,5.8,12,12,3,27,6,60,0,1,1
6108,2014,4,2014-09-27,UAB,,Florida International,L (20-34),18,35,51.4,196,1,47,184,3.9,2,82,380,4.6,7,13,1,21,5,40,2,4,6
6109,2014,5,2014-10-04,UAB,@,Western Kentucky,W (42-39),22,25,88.0,300,2,64,291,4.5,3,89,591,6.6,13,18,1,32,7,55,2,1,3
6110,2014,6,2014-10-11,UAB,,North Texas,W (56-21),17,22,77.3,316,2,50,132,2.6,3,72,448,6.2,9,9,1,19,2,15,0,0,0
6111,2014,7,2014-10-18,UAB,@,Middle Tennessee State,L (22-34),19,30,63.3,185,1,60,220,3.7,1,90,405,4.5,10,13,2,25,10,90,1,2,3
6112,2014,8,2014-10-25,UAB,@,Arkansas,L (17-45),6,18,33.3,62,1,42,133,3.2,0,60,195,3.3,2,10,0,12,2,10,0,1,1
6113,2014,9,2014-11-01,UAB,@,Florida Atlantic,W (31-28),16,26,61.5,184,1,54,239,4.4,3,80,423,5.3,7,11,0,18,11,90,0,0,0
6114,2014,10,2014-11-08,UAB,,Louisiana Tech,L (24-40),23,37,62.2,198,0,38,128,3.4,1,75,326,4.3,10,9,0,19,8,85,2,1,3
6115,2014,11,2014-11-22,UAB,,Marshall,L (18-23),15,26,57.7,141,0,56,205,3.7,2,82,346,4.2,6,15,2,23,8,70,1,0,1
6116,2014,12,2014-11-29,UAB,@,Southern Mississippi,W (45-24),15,22,68.2,176,3,54,371,6.9,2,76,547,7.2,9,16,0,25,10,97,0,0,0
6117,2014,,12 Games,UAB,,,,201,326,61.7,2631,16,614,2550,4.2,28,940,5181,5.5,102,151,13,266,77,674,9,12,21
6118,2017,1,2017-09-02,UAB,,Alabama A&M,W (38-7),12,22,54.5,165,2,58,259,4.5,2,80,424,5.3,8,14,1,23,8,85,1,0,1
6119,2017,2,2017-09-09,UAB,@,Ball State,L (31-51),15,24,62.5,168,0,49,336,6.9,4,73,504,6.9,7,16,1,24,9,81,2,0,2
6120,2017,3,2017-09-16,UAB,,Coastal Carolina,W (30-23),8,15,53.3,105,0,47,169,3.6,4,62,274,4.4,5,11,2,18,5,70,1,0,1
6121,2017,4,2017-09-23,UAB,@,North Texas,L (43-46),17,36,47.2,321,4,36,74,2.1,2,72,395,5.5,10,5,1,16,7,49,1,1,2
6122,2017,5,2017-10-07,UAB,,Louisiana Tech,W (23-22),21,32,65.6,188,0,36,178,4.9,3,68,366,5.4,10,10,2,22,8,57,0,0,0
6123,2017,6,2017-10-14,UAB,,Middle Tennessee State,W (25-23),16,31,51.6,174,1,44,260,5.9,2,75,434,5.8,7,11,3,21,8,73,0,1,1
6124,2017,7,2017-10-21,UAB,@,UNC Charlotte,L (24-25),21,29,72.4,182,1,33,162,4.9,2,62,344,5.5,6,9,3,18,4,30,2,0,2
6125,2017,8,2017-10-28,UAB,@,Southern Mississippi,W (30-12),16,29,55.2,208,1,49,209,4.3,2,78,417,5.3,9,10,2,21,5,50,0,0,0
6126,2017,9,2017-11-04,UAB,,Rice,W (52-21),20,21,95.2,197,3,36,242,6.7,3,57,439,7.7,9,11,1,21,1,15,0,0,0
6127,2017,10,2017-11-11,UAB,@,Texas-San Antonio,W (24-19),8,13,61.5,49,1,53,216,4.1,2,66,265,4.0,4,12,0,16,6,61,1,1,2
6128,2017,11,2017-11-18,UAB,@,Florida,L (7-36),14,20,70.0,177,1,18,3,0.2,0,38,180,4.7,7,1,0,8,3,15,2,2,4
6129,2017,12,2017-11-25,UAB,,Texas-El Paso,W (28-7),15,25,60.0,159,2,45,175,3.9,1,70,334,4.8,8,13,2,23,3,40,0,0,0
6130,2017,13,2017-12-22,UAB,N,Ohio*,L (6-41),24,45,53.3,254,0,25,99,4.0,0,70,353,5.0,11,5,4,20,8,56,0,0,0
6131,2017,,13 Games,UAB,,,,207,342,60.5,2347,16,529,2382,4.5,27,871,4729,5.4,101,128,22,251,75,682,10,5,15
6132,2014,1,2014-08-30,UCF,N,Penn State,L (24-26),12,22,54.5,222,1,29,24,0.8,2,51,246,4.8,8,1,2,11,8,47,1,0,1
6133,2014,2,2014-09-13,UCF,@,Missouri,L (10-38),22,36,61.1,209,1,39,90,2.3,0,75,299,4.0,10,9,3,22,6,53,2,2,4
6134,2014,3,2014-09-20,UCF,,Bethune-Cookman,W (41-7),8,13,61.5,182,2,41,169,4.1,3,54,351,6.5,6,9,2,17,6,75,0,0,0
6135,2014,4,2014-10-02,UCF,@,Houston,W (17-12),6,18,33.3,101,2,37,127,3.4,0,55,228,4.1,4,6,0,10,10,90,1,0,1
6136,2014,5,2014-10-09,UCF,,Brigham Young,W (31-24),30,52,57.7,326,2,33,63,1.9,2,85,389,4.6,16,4,2,22,4,44,2,2,4
6137,2014,6,2014-10-18,UCF,,Tulane,W (20-13),12,24,50.0,139,1,38,94,2.5,1,62,233,3.8,5,7,2,14,8,67,2,2,4
6138,2014,7,2014-10-25,UCF,,Temple,W (34-14),25,39,64.1,336,2,47,130,2.8,2,86,466,5.4,15,10,2,27,5,58,2,0,2
6139,2014,8,2014-11-01,UCF,@,Connecticut,L (29-37),22,42,52.4,284,2,37,145,3.9,2,79,429,5.4,8,10,5,23,8,89,0,4,4
6140,2014,9,2014-11-14,UCF,,Tulsa,W (31-7),16,29,55.2,291,3,53,215,4.1,1,82,506,6.2,7,16,3,26,1,5,1,1,2
6141,2014,10,2014-11-22,UCF,,Southern Methodist,W (53-7),17,26,65.4,254,2,59,236,4.0,3,85,490,5.8,11,16,0,27,6,66,0,2,2
6142,2014,11,2014-11-28,UCF,@,South Florida,W (16-0),20,29,69.0,150,1,45,145,3.2,1,74,295,4.0,11,9,3,23,5,42,2,1,3
6143,2014,12,2014-12-04,UCF,@,East Carolina,W (32-30),20,33,60.6,274,1,40,148,3.7,2,73,422,5.8,10,7,6,23,6,40,1,0,1
6144,2014,13,2014-12-26,UCF,N,North Carolina State*,L (27-34),23,53,43.4,291,3,28,82,2.9,0,81,373,4.6,14,6,1,21,3,30,0,1,1
6145,2014,,13 Games,UCF,,,,233,416,56.0,3059,23,526,1668,3.2,19,942,4727,5.0,125,110,31,266,76,706,14,15,29
6146,2015,1,2015-09-03,UCF,,Florida International,L (14-15),23,34,67.6,249,2,29,46,1.6,0,63,295,4.7,12,5,1,18,3,20,0,0,0
6147,2015,2,2015-09-12,UCF,@,Stanford,L (7-31),14,36,38.9,151,1,29,30,1.0,0,65,181,2.8,8,2,5,15,2,19,1,1,2
6148,2015,3,2015-09-19,UCF,,Furman,L (15-16),14,30,46.7,98,0,42,171,4.1,1,72,269,3.7,5,9,2,16,3,30,1,3,4
6149,2015,4,2015-09-26,UCF,@,South Carolina,L (14-31),23,38,60.5,204,1,23,26,1.1,1,61,230,3.8,11,3,1,15,5,31,0,2,2
6150,2015,5,2015-10-03,UCF,@,Tulane,L (31-45),30,52,57.7,392,4,22,-35,-1.6,0,74,357,4.8,17,2,1,20,7,65,2,3,5
6151,2015,6,2015-10-10,UCF,,Connecticut,L (13-40),27,50,54.0,255,1,14,60,4.3,0,64,315,4.9,16,4,1,21,5,52,1,3,4
6152,2015,7,2015-10-17,UCF,@,Temple,L (16-30),10,31,32.3,67,0,29,67,2.3,0,60,134,2.2,3,4,3,10,9,64,0,2,2
6153,2015,8,2015-10-24,UCF,,Houston,L (10-59),14,29,48.3,183,1,30,97,3.2,0,59,280,4.7,7,5,2,14,6,60,1,3,4
6154,2015,9,2015-10-31,UCF,@,Cincinnati,L (7-52),12,23,52.2,101,0,41,212,5.2,1,64,313,4.9,6,9,1,16,6,70,0,1,1
6155,2015,10,2015-11-07,UCF,@,Tulsa,L (30-45),23,43,53.5,303,2,40,109,2.7,1,83,412,5.0,15,5,2,22,8,60,2,2,4
6156,2015,11,2015-11-19,UCF,,East Carolina,L (7-44),11,32,34.4,131,1,29,101,3.5,0,61,232,3.8,6,5,1,12,5,36,2,1,3
6157,2015,12,2015-11-26,UCF,,South Florida,L (3-44),10,27,37.0,116,0,27,87,3.2,0,54,203,3.8,4,6,0,10,5,42,0,2,2
6158,2015,,12 Games,UCF,,,,211,425,49.6,2250,13,355,971,2.7,4,780,3221,4.1,110,59,20,189,64,549,10,23,33
6159,2016,1,2016-09-03,UCF,,South Carolina State,W (38-0),20,36,55.6,265,2,55,197,3.6,2,91,462,5.1,10,12,5,27,5,40,2,0,2
6160,2016,2,2016-09-10,UCF,@,Michigan,L (14-51),6,22,27.3,56,0,46,275,6.0,2,68,331,4.9,2,12,1,15,9,76,2,0,2
6161,2016,3,2016-09-17,UCF,,Maryland,L (24-30),21,37,56.8,260,2,54,195,3.6,1,91,455,5.0,10,12,2,24,7,56,3,1,4
6162,2016,4,2016-09-24,UCF,@,Florida International,W (53-14),12,20,60.0,225,1,56,276,4.9,6,76,501,6.6,8,16,2,26,8,60,0,0,0
6163,2016,5,2016-10-01,UCF,@,East Carolina,W (47-29),11,29,37.9,156,0,44,217,4.9,4,73,373,5.1,5,10,1,16,10,92,0,2,2
6164,2016,6,2016-10-15,UCF,,Temple,L (25-26),13,22,59.1,210,2,36,86,2.4,1,58,296,5.1,7,4,3,14,12,110,0,1,1
6165,2016,7,2016-10-22,UCF,@,Connecticut,W (24-16),29,45,64.4,317,3,30,83,2.8,0,75,400,5.3,17,4,1,22,5,24,0,0,0
6166,2016,8,2016-10-29,UCF,@,Houston,L (24-31),19,33,57.6,155,0,33,40,1.2,3,66,195,3.0,6,6,3,15,4,25,2,2,4
6167,2016,9,2016-11-05,UCF,,Tulane,W (37-6),12,23,52.2,150,0,32,147,4.6,2,55,297,5.4,5,9,2,16,6,68,1,1,2
6168,2016,10,2016-11-12,UCF,,Cincinnati,W (24-3),22,34,64.7,150,1,43,155,3.6,1,77,305,4.0,9,10,0,19,4,36,0,0,0
6169,2016,11,2016-11-19,UCF,,Tulsa,L (20-35),25,52,48.1,233,0,33,88,2.7,1,85,321,3.8,11,4,1,16,5,30,2,0,2
6170,2016,12,2016-11-26,UCF,@,South Florida,L (31-48),28,47,59.6,338,2,35,64,1.8,2,82,402,4.9,14,7,1,22,5,30,1,2,3
6171,2016,13,2016-12-17,UCF,N,Arkansas State*,L (13-31),26,48,54.2,211,1,30,12,0.4,0,78,223,2.9,9,1,7,17,11,82,3,0,3
6172,2016,,13 Games,UCF,,,,244,448,54.5,2726,14,527,1835,3.5,25,975,4561,4.7,113,107,29,249,91,729,16,9,25
6173,2017,1,2017-08-31,UCF,,Florida International,W (61-17),26,33,78.8,439,4,45,157,3.5,4,78,596,7.6,14,9,8,31,9,65,1,1,2
6174,2017,2,2017-09-23,UCF,@,Maryland,W (38-10),18,30,60.0,178,1,39,250,6.4,3,69,428,6.2,8,8,2,18,11,106,0,0,0
6175,2017,3,2017-09-30,UCF,,Memphis,W (40-13),19,31,61.3,253,3,49,350,7.1,2,80,603,7.5,10,16,1,27,12,109,0,1,1
6176,2017,4,2017-10-07,UCF,@,Cincinnati,W (51-23),16,19,84.2,374,5,21,141,6.7,2,40,515,12.9,14,5,4,23,8,44,0,0,0
6177,2017,5,2017-10-14,UCF,,East Carolina,W (63-21),25,31,80.6,365,2,41,235,5.7,5,72,600,8.3,16,14,3,33,10,74,1,0,1
6178,2017,6,2017-10-21,UCF,@,Navy,W (31-21),16,24,66.7,236,1,42,247,5.9,3,66,483,7.3,11,10,1,22,7,55,0,1,1
6179,2017,7,2017-10-28,UCF,,Austin Peay,W (73-33),28,31,90.3,347,3,36,142,3.9,5,67,489,7.3,16,8,3,27,8,81,0,0,0
6180,2017,8,2017-11-04,UCF,@,Southern Methodist,W (31-24),23,40,57.5,412,1,36,203,5.6,3,76,615,8.1,14,8,1,23,5,32,1,2,3
6181,2017,9,2017-11-11,UCF,,Connecticut,W (49-24),25,38,65.8,346,3,35,173,4.9,4,73,519,7.1,12,7,3,22,10,84,1,0,1
6182,2017,10,2017-11-18,UCF,@,Temple,W (45-19),18,28,64.3,254,4,40,130,3.3,2,68,384,5.6,9,7,1,17,7,55,0,0,0
6183,2017,11,2017-11-24,UCF,,South Florida,W (49-42),29,44,65.9,373,4,41,160,3.9,2,85,533,6.3,17,10,5,32,6,38,0,1,1
6184,2017,12,2017-12-02,UCF,,Memphis,W (62-55),28,40,70.0,494,5,39,232,5.9,3,79,726,9.2,18,9,5,32,8,68,1,3,4
6185,2017,13,2018-01-01,UCF,N,Auburn*,W (34-27),16,35,45.7,242,2,36,169,4.7,1,71,411,5.8,11,9,0,20,8,74,1,0,1
6186,2017,,13 Games,UCF,,,,287,424,67.7,4313,38,500,2589,5.2,39,924,6902,7.5,170,120,37,327,109,885,6,9,15
6187,2014,1,2014-08-30,UCLA,@,Virginia,W (28-20),20,34,58.8,242,0,39,116,3.0,1,73,358,4.9,9,7,0,16,12,87,2,0,2
6188,2014,2,2014-09-06,UCLA,,Memphis,W (42-35),33,44,75.0,396,3,41,144,3.5,3,85,540,6.4,16,11,3,30,9,85,0,1,1
6189,2014,3,2014-09-13,UCLA,N,Texas,W (20-17),27,34,79.4,226,2,47,217,4.6,0,81,443,5.5,9,13,2,24,4,51,1,0,1
6190,2014,4,2014-09-25,UCLA,@,Arizona State,W (62-27),18,23,78.3,355,4,35,225,6.4,2,58,580,10.0,8,8,3,19,8,78,0,0,0
6191,2014,5,2014-10-04,UCLA,,Utah,L (28-30),16,22,72.7,269,2,50,137,2.7,2,72,406,5.6,9,12,3,24,3,29,0,1,1
6192,2014,6,2014-10-11,UCLA,,Oregon,L (30-42),27,38,71.1,225,2,54,328,6.1,2,92,553,6.0,12,19,0,31,7,81,1,1,2
6193,2014,7,2014-10-18,UCLA,@,California,W (36-34),31,42,73.8,330,2,47,237,5.0,2,89,567,6.4,19,13,1,33,6,63,2,1,3
6194,2014,8,2014-10-25,UCLA,@,Colorado,W (40-37),24,39,61.5,200,1,37,309,8.4,4,76,509,6.7,8,11,2,21,14,121,1,0,1
6195,2014,9,2014-11-01,UCLA,,Arizona,W (17-7),19,26,73.1,189,1,59,271,4.6,1,85,460,5.4,7,13,1,21,11,118,1,0,1
6196,2014,10,2014-11-08,UCLA,@,Washington,W (44-30),29,37,78.4,302,2,40,174,4.4,3,77,476,6.2,18,9,1,28,4,37,0,0,0
6197,2014,11,2014-11-22,UCLA,,Southern California,W (38-20),22,31,71.0,326,3,43,135,3.1,2,74,461,6.2,13,9,2,24,7,63,1,1,2
6198,2014,12,2014-11-28,UCLA,,Stanford,L (10-31),20,41,48.8,162,1,26,100,3.8,0,67,262,3.9,8,9,0,17,4,38,0,1,1
6199,2014,13,2015-01-02,UCLA,N,Kansas State*,W (40-35),12,24,50.0,136,1,39,331,8.5,4,63,467,7.4,6,10,0,16,15,128,1,0,1
6200,2014,,13 Games,UCLA,,,,298,435,68.5,3358,24,557,2724,4.9,26,992,6082,6.1,142,144,18,304,104,979,10,6,16
6201,2015,1,2015-09-05,UCLA,,Virginia,W (34-16),28,37,75.7,351,3,34,152,4.5,1,71,503,7.1,12,11,2,25,7,75,0,0,0
6202,2015,2,2015-09-12,UCLA,@,Nevada-Las Vegas,W (37-3),24,51,47.1,253,1,47,273,5.8,2,98,526,5.4,13,15,2,30,9,80,0,3,3
6203,2015,3,2015-09-19,UCLA,,Brigham Young,W (24-23),11,23,47.8,106,1,38,296,7.8,2,61,402,6.6,6,12,0,18,6,75,0,3,3
6204,2015,4,2015-09-26,UCLA,@,Arizona,W (56-30),19,28,67.9,284,2,47,213,4.5,6,75,497,6.6,12,11,0,23,9,76,0,0,0
6205,2015,5,2015-10-03,UCLA,,Arizona State,L (23-38),22,40,55.0,280,2,28,62,2.2,1,68,342,5.0,12,4,1,17,6,49,0,1,1
6206,2015,6,2015-10-15,UCLA,@,Stanford,L (35-56),22,42,52.4,325,3,31,181,5.8,1,73,506,6.9,13,5,1,19,10,93,0,2,2
6207,2015,7,2015-10-22,UCLA,,California,W (40-24),34,48,70.8,399,3,42,174,4.1,1,90,573,6.4,17,13,1,31,9,74,1,0,1
6208,2015,8,2015-10-31,UCLA,,Colorado,W (35-31),19,33,57.6,262,1,26,138,5.3,3,59,400,6.8,10,4,2,16,10,101,2,0,2
6209,2015,9,2015-11-07,UCLA,@,Oregon State,W (41-0),28,43,65.1,390,2,52,284,5.5,3,95,674,7.1,16,16,1,33,10,71,0,0,0
6210,2015,10,2015-11-14,UCLA,,Washington State,L (27-31),33,57,57.9,340,0,32,214,6.7,2,89,554,6.2,15,14,1,30,13,75,2,0,2
6211,2015,11,2015-11-21,UCLA,@,Utah,W (17-9),15,30,50.0,220,1,38,105,2.8,1,68,325,4.8,12,5,1,18,6,59,0,0,0
6212,2015,12,2015-11-28,UCLA,@,Southern California,L (21-40),19,37,51.4,227,1,29,140,4.8,2,66,367,5.6,12,7,4,23,6,30,1,2,3
6213,2015,13,2015-12-26,UCLA,N,Nebraska*,L (29-37),26,41,63.4,319,3,16,67,4.2,1,57,386,6.8,14,2,1,17,7,56,0,2,2
6214,2015,,13 Games,UCLA,,,,300,510,58.8,3756,23,460,2299,5.0,26,970,6055,6.2,164,119,17,300,108,914,6,13,19
6215,2016,1,2016-09-03,UCLA,@,Texas A&M,L (24-31),26,47,55.3,343,1,40,125,3.1,1,87,468,5.4,16,8,4,28,4,17,0,3,3
6216,2016,2,2016-09-10,UCLA,,Nevada-Las Vegas,W (42-21),24,39,61.5,280,1,40,219,5.5,5,79,499,6.3,15,13,2,30,9,74,1,0,1
6217,2016,3,2016-09-17,UCLA,@,Brigham Young,W (17-14),26,40,65.0,307,2,34,50,1.5,0,74,357,4.8,14,3,1,18,5,49,0,1,1
6218,2016,4,2016-09-24,UCLA,,Stanford,L (13-22),18,27,66.7,248,1,33,77,2.3,0,60,325,5.4,11,5,0,16,5,45,1,0,1
6219,2016,5,2016-10-01,UCLA,,Arizona,W (45-24),20,37,54.1,350,3,32,125,3.9,3,69,475,6.9,15,4,1,20,5,60,0,0,0
6220,2016,6,2016-10-08,UCLA,@,Arizona State,L (20-23),27,54,50.0,444,2,23,-1,0.0,0,77,443,5.8,14,2,2,18,5,50,1,3,4
6221,2016,7,2016-10-15,UCLA,@,Washington State,L (21-27),24,40,60.0,258,3,25,43,1.7,0,65,301,4.6,12,4,2,18,7,69,2,2,4
6222,2016,8,2016-10-22,UCLA,,Utah,L (45-52),40,71,56.3,464,5,16,46,2.9,1,87,510,5.9,21,3,5,29,3,35,1,4,5
6223,2016,9,2016-11-03,UCLA,@,Colorado,L (10-20),15,29,51.7,185,1,30,25,0.8,0,59,210,3.6,7,3,4,14,13,96,0,1,1
6224,2016,10,2016-11-12,UCLA,,Oregon State,W (38-24),25,48,52.1,281,0,29,163,5.6,3,77,444,5.8,12,8,5,25,9,82,2,1,3
6225,2016,11,2016-11-19,UCLA,,Southern California,L (14-36),16,32,50.0,211,2,19,55,2.9,0,51,266,5.2,7,3,0,10,3,44,0,0,0
6226,2016,12,2016-11-26,UCLA,@,California,L (10-36),12,30,40.0,176,1,24,84,3.5,0,54,260,4.8,8,3,0,11,11,95,1,1,2
6227,2016,,12 Games,UCLA,,,,273,494,55.3,3547,22,345,1011,2.9,13,839,4558,5.4,152,59,26,237,79,716,9,16,25
6228,2017,1,2017-09-03,UCLA,,Texas A&M,W (45-44),35,59,59.3,491,4,25,63,2.5,2,84,554,6.6,24,3,2,29,7,56,3,0,3
6229,2017,2,2017-09-09,UCLA,,Hawaii,W (56-23),24,29,82.8,373,5,26,132,5.1,2,55,505,9.2,17,6,2,25,10,83,0,0,0
6230,2017,3,2017-09-16,UCLA,@,Memphis,L (45-48),34,56,60.7,463,4,35,170,4.9,2,91,633,7.0,20,9,2,31,10,99,1,2,3
6231,2017,4,2017-09-23,UCLA,@,Stanford,L (34-58),40,60,66.7,480,3,15,115,7.7,1,75,595,7.9,19,6,2,27,13,132,2,2,4
6232,2017,5,2017-09-30,UCLA,,Colorado,W (27-23),28,45,62.2,372,1,35,95,2.7,2,80,467,5.8,16,9,0,25,9,85,0,1,1
6233,2017,6,2017-10-14,UCLA,@,Arizona,L (30-47),20,34,58.8,219,0,38,190,5.0,4,72,409,5.7,11,11,6,28,7,80,1,3,4
6234,2017,7,2017-10-21,UCLA,,Oregon,W (31-14),21,36,58.3,266,2,37,142,3.8,2,73,408,5.6,11,11,0,22,7,67,0,0,0
6235,2017,8,2017-10-28,UCLA,@,Washington,L (23-44),19,33,57.6,170,2,28,62,2.2,0,61,232,3.8,9,4,2,15,6,59,1,0,1
6236,2017,9,2017-11-03,UCLA,@,Utah,L (17-48),11,16,68.8,115,2,32,134,4.2,0,48,249,5.2,3,7,2,12,5,40,1,0,1
6237,2017,10,2017-11-11,UCLA,,Arizona State,W (44-37),26,46,56.5,420,1,29,161,5.6,3,75,581,7.7,12,11,2,25,5,39,0,1,1
6238,2017,11,2017-11-18,UCLA,@,Southern California,L (23-28),32,52,61.5,421,3,31,80,2.6,0,83,501,6.0,16,10,2,28,12,100,1,1,2
6239,2017,12,2017-11-24,UCLA,,California,W (30-27),27,36,75.0,393,2,37,69,1.9,1,73,462,6.3,16,7,1,24,7,64,1,0,1
6240,2017,13,2017-12-26,UCLA,N,Kansas State*,L (17-35),21,34,61.8,295,2,25,69,2.8,0,59,364,6.2,9,5,0,14,8,73,1,0,1
6241,2017,,13 Games,UCLA,,,,338,536,63.1,4478,31,393,1482,3.8,19,929,5960,6.4,183,99,23,305,106,977,12,10,22
6242,2014,1,2014-08-30,USC,,Fresno State,W (52-13),28,41,68.3,424,4,64,277,4.3,3,105,701,6.7,17,19,1,37,9,76,2,0,2
6243,2014,2,2014-09-06,USC,@,Stanford,W (13-10),15,22,68.2,135,0,37,156,4.2,1,59,291,4.9,7,8,1,16,10,87,0,0,0
6244,2014,3,2014-09-13,USC,@,Boston College,L (31-37),31,41,75.6,317,4,29,20,0.7,0,70,337,4.8,15,3,0,18,3,20,0,0,0
6245,2014,4,2014-09-27,USC,,Oregon State,W (35-10),24,33,72.7,261,2,48,200,4.2,2,81,461,5.7,10,12,4,26,14,124,0,0,0
6246,2014,5,2014-10-04,USC,,Arizona State,L (34-38),28,45,62.2,273,0,50,220,4.4,3,95,493,5.2,13,13,2,28,9,60,0,0,0
6247,2014,6,2014-10-11,USC,@,Arizona,W (28-26),20,30,66.7,185,1,38,240,6.3,3,68,425,6.3,9,12,1,22,13,103,1,1,2
6248,2014,7,2014-10-18,USC,,Colorado,W (56-28),19,28,67.9,319,7,33,213,6.5,1,61,532,8.7,11,7,3,21,7,85,1,0,1
6249,2014,8,2014-10-25,USC,@,Utah,L (21-24),24,33,72.7,264,2,37,100,2.7,0,70,364,5.2,11,6,0,17,6,48,1,1,2
6250,2014,9,2014-11-01,USC,@,Washington State,W (44-17),21,32,65.6,400,5,32,127,4.0,0,64,527,8.2,14,6,1,21,7,70,1,0,1
6251,2014,10,2014-11-13,USC,,California,W (38-30),31,42,73.8,371,4,35,79,2.3,1,77,450,5.8,17,8,4,29,14,159,0,1,1
6252,2014,11,2014-11-22,USC,@,UCLA,L (20-38),22,34,64.7,214,1,33,62,1.9,1,67,276,4.1,10,4,2,16,5,49,1,1,2
6253,2014,12,2014-11-29,USC,,Notre Dame,W (49-14),32,40,80.0,372,6,53,205,3.9,1,93,577,6.2,18,15,2,35,6,45,0,0,0
6254,2014,13,2014-12-27,USC,N,Nebraska*,W (45-42),23,39,59.0,321,3,34,194,5.7,2,73,515,7.1,13,9,0,22,12,97,0,1,1
6255,2014,,13 Games,USC,,,,318,460,69.1,3856,39,523,2093,4.0,18,983,5949,6.1,165,122,21,308,115,1023,7,5,12
6256,2015,1,2015-09-05,USC,,Arkansas State,W (55-6),23,32,71.9,324,4,32,185,5.8,3,64,509,8.0,11,8,3,22,3,25,0,0,0
6257,2015,2,2015-09-12,USC,,Idaho,W (59-9),30,37,81.1,453,3,37,284,7.7,5,74,737,10.0,22,13,0,35,6,67,0,0,0
6258,2015,3,2015-09-19,USC,,Stanford,L (31-41),25,32,78.1,272,3,28,155,5.5,1,60,427,7.1,9,9,2,20,8,87,0,0,0
6259,2015,4,2015-09-26,USC,@,Arizona State,W (42-14),20,34,58.8,379,5,32,76,2.4,0,66,455,6.9,12,5,1,18,10,91,1,1,2
6260,2015,5,2015-10-08,USC,,Washington,L (12-17),16,29,55.2,156,0,39,190,4.9,1,68,346,5.1,8,9,3,20,8,62,1,2,3
6261,2015,6,2015-10-17,USC,@,Notre Dame,L (31-41),31,47,66.0,440,3,30,150,5.0,1,77,590,7.7,12,6,1,19,10,105,0,2,2
6262,2015,7,2015-10-24,USC,,Utah,W (42-24),21,29,72.4,264,1,45,116,2.6,4,74,380,5.1,11,8,2,21,5,49,0,0,0
6263,2015,8,2015-10-31,USC,@,California,W (27-21),19,23,82.6,220,0,50,185,3.7,2,73,405,5.5,11,11,0,22,6,65,0,0,0
6264,2015,9,2015-11-07,USC,,Arizona,W (38-30),22,36,61.1,243,2,40,229,5.7,3,76,472,6.2,10,10,3,23,8,70,1,0,1
6265,2015,10,2015-11-13,USC,@,Colorado,W (27-24),17,27,63.0,204,3,37,129,3.5,0,64,333,5.2,11,7,1,19,8,40,0,1,1
6266,2015,11,2015-11-21,USC,@,Oregon,L (28-48),30,41,73.2,238,2,38,186,4.9,1,79,424,5.4,10,12,2,24,12,124,1,0,1
6267,2015,12,2015-11-28,USC,,UCLA,W (40-21),15,26,57.7,175,2,59,235,4.0,1,85,410,4.8,9,15,0,24,7,56,0,0,0
6268,2015,13,2015-12-05,USC,N,Stanford,L (22-41),22,37,59.5,187,1,32,170,5.3,2,69,357,5.2,10,13,2,25,7,62,1,0,1
6269,2015,14,2015-12-30,USC,N,Wisconsin*,L (21-23),18,33,54.5,221,1,28,65,2.3,2,61,286,4.7,12,4,0,16,6,58,0,1,1
6270,2015,,14 Games,USC,,,,309,463,66.7,3776,30,527,2355,4.5,26,990,6131,6.2,158,130,20,308,104,961,5,7,12
6271,2016,1,2016-09-03,USC,N,Alabama,L (6-52),18,37,48.6,130,0,30,64,2.1,0,67,194,2.9,4,5,2,11,6,46,0,1,1
6272,2016,2,2016-09-10,USC,,Utah State,W (45-7),28,37,75.7,244,4,44,178,4.0,1,81,422,5.2,12,15,2,29,5,51,0,1,1
6273,2016,3,2016-09-17,USC,@,Stanford,L (10-27),23,35,65.7,236,0,26,117,4.5,1,61,353,5.8,11,6,0,17,8,56,0,1,1
6274,2016,4,2016-09-23,USC,@,Utah,L (27-31),18,26,69.2,253,0,33,213,6.5,2,59,466,7.9,13,7,2,22,7,49,3,0,3
6275,2016,5,2016-10-01,USC,,Arizona State,W (41-20),24,36,66.7,366,3,33,157,4.8,2,69,523,7.6,12,7,4,23,7,68,0,0,0
6276,2016,6,2016-10-08,USC,,Colorado,W (21-17),25,37,67.6,358,3,39,195,5.0,0,76,553,7.3,18,10,0,28,2,22,3,1,4
6277,2016,7,2016-10-15,USC,@,Arizona,W (48-14),22,35,62.9,254,5,43,320,7.4,2,78,574,7.4,9,15,1,25,8,98,0,0,0
6278,2016,8,2016-10-27,USC,,California,W (45-24),18,25,72.0,231,5,48,398,8.3,1,73,629,8.6,13,17,1,31,13,125,2,1,3
6279,2016,9,2016-11-05,USC,,Oregon,W (45-20),28,41,68.3,309,2,40,270,6.8,4,81,579,7.1,12,14,2,28,13,129,0,1,1
6280,2016,10,2016-11-12,USC,@,Washington,W (26-13),23,33,69.7,287,2,36,113,3.1,1,69,400,5.8,14,5,2,21,6,40,0,2,2
6281,2016,11,2016-11-19,USC,@,UCLA,W (36-14),25,37,67.6,267,2,58,260,4.5,2,95,527,5.5,14,16,1,31,7,39,0,2,2
6282,2016,12,2016-11-26,USC,,Notre Dame,W (45-27),19,30,63.3,205,2,38,207,5.4,1,68,412,6.1,9,12,2,23,7,65,1,0,1
6283,2016,13,2017-01-02,USC,N,Penn State*,W (52-49),33,54,61.1,453,5,34,122,3.6,1,88,575,6.5,23,6,4,33,10,85,0,1,1
6284,2016,,13 Games,USC,,,,304,463,65.7,3593,33,502,2614,5.2,18,965,6207,6.4,164,135,23,322,99,873,9,11,20
6285,2017,1,2017-09-02,USC,,Western Michigan,W (49-31),23,33,69.7,289,0,34,232,6.8,6,67,521,7.8,13,12,0,25,9,94,0,2,2
6286,2017,2,2017-09-09,USC,,Stanford,W (42-24),21,26,80.8,316,4,48,307,6.4,2,74,623,8.4,14,14,0,28,8,90,0,2,2
6287,2017,3,2017-09-16,USC,,Texas,W (27-24),28,51,54.9,397,3,37,71,1.9,0,88,468,5.3,19,6,0,25,8,49,0,2,2
6288,2017,4,2017-09-23,USC,@,California,W (30-20),26,38,68.4,223,2,38,133,3.5,1,76,356,4.7,14,8,0,22,5,53,1,1,2
6289,2017,5,2017-09-29,USC,@,Washington State,L (27-30),15,29,51.7,164,0,29,163,5.6,3,58,327,5.6,8,6,1,15,9,80,1,1,2
6290,2017,6,2017-10-07,USC,,Oregon State,W (38-10),24,36,66.7,328,3,37,184,5.0,2,73,512,7.0,15,10,1,26,4,46,2,1,3
6291,2017,7,2017-10-14,USC,,Utah,W (28-27),27,50,54.0,358,3,30,184,6.1,1,80,542,6.8,19,10,1,30,3,35,3,0,3
6292,2017,8,2017-10-21,USC,@,Notre Dame,L (14-49),25,36,69.4,260,2,31,76,2.5,0,67,336,5.0,13,5,0,18,7,40,2,1,3
6293,2017,9,2017-10-28,USC,@,Arizona State,W (48-17),19,35,54.3,266,3,45,347,7.7,2,80,613,7.7,10,16,3,29,8,60,1,0,1
6294,2017,10,2017-11-04,USC,,Arizona,W (49-35),20,26,76.9,311,2,52,331,6.4,4,78,642,8.2,15,14,1,30,14,123,0,1,1
6295,2017,11,2017-11-11,USC,@,Colorado,W (38-24),21,34,61.8,329,2,38,193,5.1,2,72,522,7.3,13,9,1,23,9,79,0,0,0
6296,2017,12,2017-11-18,USC,,UCLA,W (28-23),17,28,60.7,264,0,41,153,3.7,3,69,417,6.0,13,10,1,24,11,115,0,1,1
6297,2017,13,2017-12-01,USC,N,Stanford,W (31-28),17,24,70.8,325,2,43,176,4.1,2,67,501,7.5,10,9,3,22,9,76,1,0,1
6298,2017,14,2017-12-29,USC,N,Ohio State*,L (7-24),26,45,57.8,356,0,36,57,1.6,1,81,413,5.1,16,5,2,23,3,35,3,1,4
6299,2017,,14 Games,USC,,,,309,491,62.9,4186,26,539,2607,4.8,29,1030,6793,6.6,192,134,14,340,107,975,14,13,27
6300,2014,1,2014-08-28,Utah,,Idaho State,W (56-14),22,32,68.8,351,1,46,238,5.2,5,78,589,7.6,16,11,0,27,7,54,1,0,1
6301,2014,2,2014-09-06,Utah,,Fresno State,W (59-27),15,27,55.6,268,6,54,258,4.8,2,81,526,6.5,10,14,2,26,12,118,0,0,0
6302,2014,3,2014-09-20,Utah,@,Michigan,W (26-10),18,27,66.7,205,1,37,81,2.2,0,64,286,4.5,7,6,0,13,6,50,0,1,1
6303,2014,4,2014-09-27,Utah,,Washington State,L (27-28),18,40,45.0,165,0,40,192,4.8,1,80,357,4.5,7,10,1,18,8,78,1,0,1
6304,2014,5,2014-10-04,Utah,@,UCLA,W (30-28),12,18,66.7,100,1,55,242,4.4,1,73,342,4.7,3,14,1,18,4,40,0,0,0
6305,2014,6,2014-10-16,Utah,@,Oregon State,W (29-23),9,18,50.0,62,0,46,253,5.5,3,64,315,4.9,3,10,3,16,6,67,1,1,2
6306,2014,7,2014-10-25,Utah,,Southern California,W (24-21),18,32,56.3,194,1,42,137,3.3,1,74,331,4.5,11,9,1,21,4,25,2,0,2
6307,2014,8,2014-11-01,Utah,@,Arizona State,L (16-19),12,22,54.5,57,1,52,184,3.5,0,74,241,3.3,4,8,1,13,6,45,0,0,0
6308,2014,9,2014-11-08,Utah,,Oregon,L (27-51),22,33,66.7,320,2,35,120,3.4,1,68,440,6.5,10,6,1,17,3,31,2,2,4
6309,2014,10,2014-11-15,Utah,@,Stanford,W (20-17),21,28,75.0,177,2,32,70,2.2,1,60,247,4.1,9,4,1,14,5,55,0,0,0
6310,2014,11,2014-11-22,Utah,,Arizona,L (10-42),18,35,51.4,171,1,43,213,5.0,0,78,384,4.9,8,10,2,20,3,26,1,3,4
6311,2014,12,2014-11-29,Utah,@,Colorado,W (38-34),25,37,67.6,311,3,35,128,3.7,1,72,439,6.1,11,9,1,21,6,45,0,0,0
6312,2014,13,2014-12-20,Utah,N,Colorado State*,W (45-10),19,29,65.5,189,1,48,359,7.5,5,77,548,7.1,13,15,1,29,7,68,0,1,1
6313,2014,,13 Games,Utah,,,,229,378,60.6,2570,20,565,2475,4.4,21,943,5045,5.3,112,126,15,253,77,702,8,8,16
6314,2015,1,2015-09-03,Utah,,Michigan,W (24-17),24,33,72.7,208,0,37,129,3.5,2,70,337,4.8,10,9,1,20,6,55,0,1,1
6315,2015,2,2015-09-11,Utah,,Utah State,W (24-14),17,22,77.3,132,0,44,195,4.4,3,66,327,5.0,8,10,3,21,5,43,0,0,0
6316,2015,3,2015-09-19,Utah,@,Fresno State,W (45-24),19,26,73.1,159,1,48,221,4.6,2,74,380,5.1,9,12,2,23,1,10,2,1,3
6317,2015,4,2015-09-26,Utah,@,Oregon,W (62-20),20,32,62.5,257,5,42,273,6.5,2,74,530,7.2,12,11,1,24,6,54,0,0,0
6318,2015,5,2015-10-10,Utah,,California,W (30-24),16,26,61.5,170,1,51,265,5.2,2,77,435,5.6,6,14,1,21,5,48,1,2,3
6319,2015,6,2015-10-17,Utah,,Arizona State,W (34-18),26,36,72.2,297,2,31,72,2.3,2,67,369,5.5,11,4,1,16,4,19,0,0,0
6320,2015,7,2015-10-24,Utah,@,Southern California,L (24-42),24,36,66.7,254,2,28,99,3.5,1,64,353,5.5,9,8,3,20,4,34,0,4,4
6321,2015,8,2015-10-31,Utah,,Oregon State,W (27-12),14,17,82.4,198,1,44,174,4.0,2,61,372,6.1,9,10,1,20,5,45,0,0,0
6322,2015,9,2015-11-07,Utah,@,Washington,W (34-23),12,25,48.0,155,0,45,191,4.2,3,70,346,4.9,6,12,1,19,6,60,2,1,3
6323,2015,10,2015-11-14,Utah,@,Arizona,L (30-37),20,31,64.5,219,2,55,223,4.1,1,86,442,5.1,7,15,2,24,10,112,1,1,2
6324,2015,11,2015-11-21,Utah,,UCLA,L (9-17),13,26,50.0,110,0,49,197,4.0,0,75,307,4.1,5,14,4,23,4,45,2,0,2
6325,2015,12,2015-11-28,Utah,,Colorado,W (20-14),10,26,38.5,108,1,50,216,4.3,1,76,324,4.3,7,9,2,18,9,92,2,1,3
6326,2015,13,2015-12-19,Utah,N,Brigham Young*,W (35-28),9,16,56.3,71,0,47,126,2.7,3,63,197,3.1,3,8,3,14,7,76,0,0,0
6327,2015,,13 Games,Utah,,,,224,352,63.6,2338,15,571,2381,4.2,24,923,4719,5.1,102,136,25,263,72,693,10,11,21
6328,2016,1,2016-09-01,Utah,,Southern Utah,W (24-0),23,39,59.0,298,2,37,138,3.7,1,76,436,5.7,11,8,0,19,6,40,1,0,1
6329,2016,2,2016-09-10,Utah,,Brigham Young,W (20-19),14,23,60.9,194,1,42,169,4.0,0,65,363,5.6,8,9,3,20,9,85,3,3,6
6330,2016,3,2016-09-17,Utah,@,San Jose State,W (34-17),21,30,70.0,255,1,37,201,5.4,3,67,456,6.8,8,11,0,19,7,69,1,1,2
6331,2016,4,2016-09-23,Utah,,Southern California,W (31-27),21,34,61.8,270,2,47,186,4.0,1,81,456,5.6,12,16,2,30,5,43,1,0,1
6332,2016,5,2016-10-01,Utah,@,California,L (23-28),24,43,55.8,266,0,54,176,3.3,3,97,442,4.6,13,14,3,30,3,30,0,0,0
6333,2016,6,2016-10-08,Utah,,Arizona,W (36-23),13,29,44.8,245,1,45,210,4.7,3,74,455,6.1,7,12,4,23,14,98,0,0,0
6334,2016,7,2016-10-15,Utah,@,Oregon State,W (19-14),4,13,30.8,42,0,60,275,4.6,2,73,317,4.3,2,14,1,17,5,40,2,0,2
6335,2016,8,2016-10-22,Utah,@,UCLA,W (52-45),12,24,50.0,179,0,49,360,7.3,5,73,539,7.4,7,12,1,20,9,103,1,1,2
6336,2016,9,2016-10-29,Utah,,Washington,L (24-31),14,33,42.4,163,2,47,213,4.5,1,80,376,4.7,8,13,4,25,10,65,0,0,0
6337,2016,10,2016-11-10,Utah,@,Arizona State,W (49-26),21,37,56.8,296,4,22,201,9.1,2,59,497,8.4,12,6,4,22,7,60,2,0,2
6338,2016,11,2016-11-19,Utah,,Oregon,L (28-30),20,30,66.7,235,1,37,218,5.9,2,67,453,6.8,14,10,0,24,3,30,1,0,1
6339,2016,12,2016-11-26,Utah,@,Colorado,L (22-27),13,40,32.5,160,1,41,179,4.4,0,81,339,4.2,8,7,0,15,3,36,2,2,4
6340,2016,13,2016-12-28,Utah,N,Indiana*,W (26-24),12,24,50.0,214,0,52,256,4.9,2,76,470,6.2,8,12,1,21,9,86,3,1,4
6341,2016,,13 Games,Utah,,,,212,399,53.1,2817,15,570,2782,4.9,25,969,5599,5.8,118,144,23,285,90,785,17,8,25
6342,2017,1,2017-08-31,Utah,,North Dakota,W (37-16),23,32,71.9,227,1,47,272,5.8,3,79,499,6.3,10,15,2,27,11,139,0,1,1
6343,2017,2,2017-09-09,Utah,@,Brigham Young,W (19-13),28,37,75.7,314,0,36,116,3.2,1,73,430,5.9,11,6,1,18,11,97,2,0,2
6344,2017,3,2017-09-16,Utah,,San Jose State,W (54-16),30,44,68.2,341,4,40,160,4.0,2,84,501,6.0,15,12,2,29,6,50,2,1,3
6345,2017,4,2017-09-22,Utah,@,Arizona,W (30-24),17,28,60.7,229,1,38,112,2.9,1,66,341,5.2,8,9,4,21,9,83,2,0,2
6346,2017,5,2017-10-07,Utah,,Stanford,L (20-23),20,40,50.0,238,1,33,144,4.4,1,73,382,5.2,12,9,4,25,7,62,0,2,2
6347,2017,6,2017-10-14,Utah,@,Southern California,L (27-28),17,28,60.7,267,2,41,169,4.1,1,69,436,6.3,8,9,3,20,6,40,0,1,1
6348,2017,7,2017-10-21,Utah,,Arizona State,L (10-30),19,35,54.3,155,0,25,110,4.4,1,60,265,4.4,9,9,1,19,6,50,0,4,4
6349,2017,8,2017-10-28,Utah,@,Oregon,L (20-41),25,43,58.1,293,2,30,91,3.0,0,73,384,5.3,14,4,2,20,5,49,1,0,1
6350,2017,9,2017-11-03,Utah,,UCLA,W (48-17),15,22,68.2,234,4,50,272,5.4,2,72,506,7.0,7,15,2,24,10,70,0,0,0
6351,2017,10,2017-11-11,Utah,,Washington State,L (25-33),21,40,52.5,305,1,36,62,1.7,2,76,367,4.8,13,9,5,27,7,69,3,4,7
6352,2017,11,2017-11-18,Utah,@,Washington,L (30-33),19,27,70.4,293,2,45,117,2.6,1,72,410,5.7,13,9,0,22,3,30,0,1,1
6353,2017,12,2017-11-25,Utah,,Colorado,W (34-13),15,24,62.5,181,0,52,310,6.0,4,76,491,6.5,9,18,2,29,2,22,0,0,0
6354,2017,13,2017-12-26,Utah,N,West Virginia*,W (30-14),12,27,44.4,165,0,53,197,3.7,3,80,362,4.5,7,10,2,19,5,32,2,0,2
6355,2017,,13 Games,Utah,,,,261,427,61.1,3242,18,526,2132,4.1,22,953,5374,5.6,136,134,30,300,88,793,12,14,26
6356,2014,1,2014-08-31,Utah State,@,Tennessee,L (7-38),18,35,51.4,144,1,24,100,4.2,0,59,244,4.1,6,4,1,11,5,42,1,2,3
6357,2014,2,2014-09-06,Utah State,,Idaho State,W (40-20),13,30,43.3,116,0,45,311,6.9,3,75,427,5.7,5,14,2,21,14,160,1,1,2
6358,2014,3,2014-09-13,Utah State,,Wake Forest,W (36-24),32,44,72.7,331,3,35,60,1.7,0,79,391,4.9,13,5,5,23,8,65,1,2,3
6359,2014,4,2014-09-20,Utah State,@,Arkansas State,L (14-21),27,47,57.4,268,2,37,145,3.9,0,84,413,4.9,6,12,1,19,11,100,0,1,1
6360,2014,5,2014-10-03,Utah State,@,Brigham Young,W (35-20),19,25,76.0,321,3,46,136,3.0,2,71,457,6.4,12,7,3,22,12,105,1,0,1
6361,2014,6,2014-10-11,Utah State,,Air Force,W (34-16),22,31,71.0,311,2,28,77,2.8,2,59,388,6.6,9,5,0,14,3,43,1,0,1
6362,2014,7,2014-10-18,Utah State,@,Colorado State,L (13-16),19,31,61.3,160,0,19,100,5.3,1,50,260,5.2,6,3,2,11,6,45,0,1,1
6363,2014,8,2014-10-25,Utah State,,Nevada-Las Vegas,W (34-20),16,29,55.2,266,3,47,178,3.8,1,76,444,5.8,7,10,1,18,7,60,1,0,1
6364,2014,9,2014-11-01,Utah State,@,Hawaii,W (35-14),15,16,93.8,230,4,50,235,4.7,0,66,465,7.0,6,13,2,21,12,96,0,0,0
6365,2014,10,2014-11-07,Utah State,@,Wyoming,W (20-3),13,17,76.5,150,0,33,206,6.2,1,50,356,7.1,3,8,1,12,6,75,1,0,1
6366,2014,11,2014-11-15,Utah State,,New Mexico,W (28-21),13,21,61.9,150,1,36,272,7.6,3,57,422,7.4,9,10,0,19,3,25,0,1,1
6367,2014,12,2014-11-21,Utah State,,San Jose State,W (41-7),15,23,65.2,108,1,42,313,7.5,5,65,421,6.5,8,10,2,20,5,40,0,1,1
6368,2014,13,2014-11-29,Utah State,@,Boise State,L (19-50),16,28,57.1,159,0,30,109,3.6,1,58,268,4.6,7,7,2,16,7,52,2,1,3
6369,2014,14,2014-12-20,Utah State,N,Texas-El Paso*,W (21-6),5,12,41.7,68,0,40,279,7.0,3,52,347,6.7,2,12,2,16,2,10,1,1,2
6370,2014,,14 Games,Utah State,,,,243,389,62.5,2782,20,512,2521,4.9,22,901,5303,5.9,99,120,24,243,101,918,10,11,21
6371,2015,1,2015-09-03,Utah State,,Southern Utah,W (12-9),16,33,48.5,110,0,35,140,4.0,0,68,250,3.7,5,7,3,15,11,123,0,1,1
6372,2015,2,2015-09-11,Utah State,@,Utah,L (14-24),22,35,62.9,256,2,32,117,3.7,0,67,373,5.6,12,8,1,21,6,61,1,2,3
6373,2015,3,2015-09-19,Utah State,@,Washington,L (17-31),17,33,51.5,171,0,30,83,2.8,1,63,254,4.0,8,4,1,13,5,25,0,2,2
6374,2015,4,2015-10-03,Utah State,,Colorado State,W (33-18),12,21,57.1,137,1,45,298,6.6,2,66,435,6.6,6,11,4,21,12,125,0,0,0
6375,2015,5,2015-10-10,Utah State,@,Fresno State,W (56-14),19,27,70.4,281,1,43,201,4.7,7,70,482,6.9,11,9,1,21,7,59,1,0,1
6376,2015,6,2015-10-16,Utah State,,Boise State,W (52-26),17,24,70.8,157,3,43,177,4.1,3,67,334,5.0,9,5,1,15,11,104,1,0,1
6377,2015,7,2015-10-23,Utah State,@,San Diego State,L (14-48),9,20,45.0,95,1,36,144,4.0,1,56,239,4.3,4,8,4,16,5,55,3,1,4
6378,2015,8,2015-10-30,Utah State,,Wyoming,W (58-27),16,19,84.2,296,4,43,296,6.9,3,62,592,9.5,13,18,3,34,3,25,1,0,1
6379,2015,9,2015-11-07,Utah State,@,New Mexico,L (13-14),14,25,56.0,216,1,37,78,2.1,0,62,294,4.7,8,3,2,13,2,8,2,0,2
6380,2015,10,2015-11-14,Utah State,@,Air Force,L (28-35),25,47,53.2,364,4,23,75,3.3,0,70,439,6.3,14,5,0,19,2,21,0,1,1
6381,2015,11,2015-11-21,Utah State,,Nevada,W (31-27),14,29,48.3,109,0,42,204,4.9,2,71,313,4.4,5,12,2,19,3,30,1,2,3
6382,2015,12,2015-11-28,Utah State,,Brigham Young,L (28-51),20,45,44.4,243,1,43,202,4.7,3,88,445,5.1,10,12,1,23,8,70,2,0,2
6383,2015,13,2015-12-22,Utah State,N,Akron*,L (21-23),28,45,62.2,237,3,29,131,4.5,0,74,368,5.0,13,7,2,22,8,60,2,1,3
6384,2015,,13 Games,Utah State,,,,229,403,56.8,2672,21,481,2146,4.5,22,884,4818,5.5,118,109,25,252,83,766,14,10,24
6385,2016,1,2016-09-01,Utah State,,Weber State,W (45-6),11,17,64.7,100,0,44,428,9.7,6,61,528,8.7,7,16,0,23,4,30,0,0,0
6386,2016,2,2016-09-10,Utah State,@,Southern California,L (7-45),25,39,64.1,204,1,26,49,1.9,0,65,253,3.9,10,1,2,13,5,38,0,1,1
6387,2016,3,2016-09-16,Utah State,,Arkansas State,W (34-20),11,25,44.0,136,1,47,198,4.2,3,72,334,4.6,7,9,2,18,6,54,0,1,1
6388,2016,4,2016-09-24,Utah State,,Air Force,L (20-27),30,48,62.5,372,1,32,42,1.3,1,80,414,5.2,15,4,3,22,7,46,1,1,2
6389,2016,5,2016-10-01,Utah State,@,Boise State,L (10-21),29,51,56.9,287,1,25,71,2.8,0,76,358,4.7,10,4,4,18,12,90,0,0,0
6390,2016,6,2016-10-08,Utah State,@,Colorado State,L (24-31),20,35,57.1,210,0,39,251,6.4,3,74,461,6.2,8,11,4,23,9,71,1,1,2
6391,2016,7,2016-10-22,Utah State,,Fresno State,W (38-20),17,29,58.6,188,3,38,208,5.5,1,67,396,5.9,9,13,2,24,5,40,0,0,0
6392,2016,8,2016-10-28,Utah State,,San Diego State,L (13-40),11,26,42.3,181,1,28,71,2.5,1,54,252,4.7,6,4,2,12,4,39,1,1,2
6393,2016,9,2016-11-05,Utah State,@,Wyoming,L (28-52),24,45,53.3,303,1,24,111,4.6,3,69,414,6.0,11,4,6,21,7,58,1,1,2
6394,2016,10,2016-11-12,Utah State,,New Mexico,L (21-24),21,27,77.8,263,1,28,128,4.6,2,55,391,7.1,10,7,4,21,7,75,0,1,1
6395,2016,11,2016-11-19,Utah State,@,Nevada,L (37-38),10,18,55.6,127,0,50,396,7.9,4,68,523,7.7,6,15,0,21,9,74,1,1,2
6396,2016,12,2016-11-26,Utah State,@,Brigham Young,L (10-28),12,23,52.2,103,0,28,97,3.5,1,51,200,3.9,6,4,1,11,11,94,1,1,2
6397,2016,,12 Games,Utah State,,,,221,383,57.7,2474,10,409,2050,5.0,25,792,4524,5.7,105,92,30,227,86,709,6,9,15
6398,2017,1,2017-09-01,Utah State,@,Wisconsin,L (10-59),25,41,61.0,219,0,27,85,3.1,1,68,304,4.5,11,3,2,16,9,93,1,3,4
6399,2017,2,2017-09-07,Utah State,,Idaho State,W (51-13),27,32,84.4,341,2,49,255,5.2,3,81,596,7.4,17,12,1,30,9,48,1,1,2
6400,2017,3,2017-09-16,Utah State,@,Wake Forest,L (10-46),15,37,40.5,225,1,31,42,1.4,0,68,267,3.9,7,4,0,11,4,39,0,1,1
6401,2017,4,2017-09-23,Utah State,@,San Jose State,W (61-10),28,41,68.3,271,3,57,318,5.6,3,98,589,6.0,16,12,1,29,7,60,1,2,3
6402,2017,5,2017-09-29,Utah State,,Brigham Young,W (40-24),16,30,53.3,176,2,44,112,2.5,1,74,288,3.9,6,7,1,14,4,38,0,1,1
6403,2017,6,2017-10-07,Utah State,,Colorado State,L (14-27),18,34,52.9,149,1,29,63,2.2,0,63,212,3.4,5,5,3,14,7,73,0,0,0
6404,2017,7,2017-10-14,Utah State,,Wyoming,L (23-28),20,39,51.3,232,1,37,131,3.5,1,76,363,4.8,12,9,2,23,4,50,2,3,5
6405,2017,8,2017-10-21,Utah State,@,Nevada-Las Vegas,W (52-28),20,29,69.0,323,2,47,265,5.6,5,76,588,7.7,10,15,0,25,6,55,2,0,2
6406,2017,9,2017-10-28,Utah State,,Boise State,L (14-41),18,34,52.9,186,1,27,93,3.4,1,61,279,4.6,7,4,2,13,7,72,0,0,0
6407,2017,10,2017-11-04,Utah State,@,New Mexico,W (24-10),13,24,54.2,114,0,24,129,5.4,2,48,243,5.1,7,4,1,12,5,50,1,1,2
6408,2017,11,2017-11-18,Utah State,,Hawaii,W (38-0),12,20,60.0,164,2,39,311,8.0,3,59,475,8.1,8,12,0,20,2,10,0,1,1
6409,2017,12,2017-11-25,Utah State,@,Air Force,L (35-38),17,30,56.7,284,2,29,237,8.2,3,59,521,8.8,13,6,0,19,8,67,1,0,1
6410,2017,13,2017-12-29,Utah State,N,New Mexico State*,L (20-26),25,44,56.8,254,0,45,187,4.2,1,89,441,5.0,12,8,2,22,8,73,2,0,2
6411,2017,,13 Games,Utah State,,,,254,435,58.4,2938,17,485,2228,4.6,24,920,5166,5.6,131,101,15,248,80,728,11,13,24
6412,2014,1,2014-08-30,UTEP,@,New Mexico,W (31-24),11,22,50.0,116,1,44,330,7.5,3,66,446,6.8,5,14,1,20,2,10,0,0,0
6413,2014,2,2014-09-06,UTEP,,Texas Tech,L (26-30),9,26,34.6,116,0,52,277,5.3,3,78,393,5.0,4,17,3,24,5,43,0,0,0
6414,2014,3,2014-09-13,UTEP,,New Mexico State,W (42-24),13,16,81.3,126,1,58,344,5.9,5,74,470,6.4,9,16,1,26,5,43,0,1,1
6415,2014,4,2014-09-27,UTEP,@,Kansas State,L (28-58),18,28,64.3,201,4,31,59,1.9,0,59,260,4.4,6,3,1,10,5,40,0,0,0
6416,2014,5,2014-10-04,UTEP,@,Louisiana Tech,L (3-55),15,28,53.6,143,0,36,81,2.3,0,64,224,3.5,6,5,1,12,5,22,2,3,5
6417,2014,6,2014-10-11,UTEP,,Old Dominion,W (42-35),17,26,65.4,152,2,52,313,6.0,4,78,465,6.0,5,17,1,23,8,58,0,0,0
6418,2014,7,2014-10-25,UTEP,@,Texas-San Antonio,W (34-0),12,18,66.7,191,2,46,160,3.5,1,64,351,5.5,6,8,1,15,6,50,0,0,0
6419,2014,8,2014-11-01,UTEP,,Southern Mississippi,W (35-14),10,23,43.5,127,1,42,107,2.5,1,65,234,3.6,5,7,3,15,4,20,1,0,1
6420,2014,9,2014-11-08,UTEP,@,Western Kentucky,L (27-35),9,22,40.9,158,0,46,236,5.1,2,68,394,5.8,7,12,0,19,5,37,0,1,1
6421,2014,10,2014-11-15,UTEP,,North Texas,W (35-17),8,11,72.7,87,0,46,351,7.6,5,57,438,7.7,4,14,0,18,6,67,1,0,1
6422,2014,11,2014-11-21,UTEP,@,Rice,L (13-31),17,30,56.7,209,0,25,53,2.1,1,55,262,4.8,8,1,3,12,3,20,2,0,2
6423,2014,12,2014-11-29,UTEP,,Middle Tennessee State,W (24-21),7,13,53.8,106,1,48,250,5.2,2,61,356,5.8,2,17,1,20,3,32,0,0,0
6424,2014,13,2014-12-20,UTEP,N,Utah State*,L (6-21),13,24,54.2,126,0,46,149,3.2,0,70,275,3.9,5,7,0,12,8,75,0,1,1
6425,2014,,13 Games,UTEP,,,,159,287,55.4,1858,12,572,2710,4.7,27,859,4568,5.3,72,138,16,226,65,517,6,6,12
6426,2015,1,2015-09-05,UTEP,@,Arkansas,L (13-48),14,19,73.7,146,0,34,58,1.7,1,53,204,3.8,9,4,0,13,2,15,2,1,3
6427,2015,2,2015-09-12,UTEP,@,Texas Tech,L (20-69),19,31,61.3,187,1,46,227,4.9,1,77,414,5.4,7,10,1,18,8,80,2,0,2
6428,2015,3,2015-09-19,UTEP,@,New Mexico State,W (50-47),25,34,73.5,273,3,44,269,6.1,3,78,542,6.9,12,9,6,27,11,90,1,1,2
6429,2015,4,2015-09-26,UTEP,,Incarnate Word,W (27-17),20,28,71.4,275,2,31,81,2.6,0,59,356,6.0,10,6,0,16,7,68,0,0,0
6430,2015,5,2015-10-03,UTEP,,Texas-San Antonio,L (6-25),23,49,46.9,216,1,22,59,2.7,0,71,275,3.9,12,1,1,14,2,26,1,4,5
6431,2015,6,2015-10-10,UTEP,@,Florida International,L (12-52),12,24,50.0,117,1,47,155,3.3,0,71,272,3.8,3,10,0,13,3,25,0,1,1
6432,2015,7,2015-10-24,UTEP,,Florida Atlantic,W (27-17),20,39,51.3,271,3,38,139,3.7,0,77,410,5.3,8,9,3,20,6,57,1,0,1
6433,2015,8,2015-10-31,UTEP,@,Southern Mississippi,L (13-34),16,32,50.0,197,0,32,101,3.2,1,64,298,4.7,10,5,1,16,6,55,0,0,0
6434,2015,9,2015-11-06,UTEP,,Rice,W (24-21),18,36,50.0,231,2,34,161,4.7,1,70,392,5.6,9,9,1,19,3,16,1,0,1
6435,2015,10,2015-11-14,UTEP,@,Old Dominion,L (21-31),21,38,55.3,193,3,30,112,3.7,0,68,305,4.5,12,6,1,19,3,27,0,2,2
6436,2015,11,2015-11-21,UTEP,,Louisiana Tech,L (15-17),17,38,44.7,166,1,42,226,5.4,0,80,392,4.9,9,10,2,21,4,36,0,1,1
6437,2015,12,2015-11-28,UTEP,@,North Texas,W (20-17),8,16,50.0,69,1,48,187,3.9,1,64,256,4.0,3,9,3,15,2,20,5,0,5
6438,2015,,12 Games,UTEP,,,,213,384,55.5,2341,18,448,1775,4.0,8,832,4116,4.9,104,88,19,211,57,515,13,10,23
6439,2016,1,2016-09-03,UTEP,,New Mexico State,W (38-22),15,28,53.6,229,3,49,289,5.9,2,77,518,6.7,11,13,4,28,7,56,1,0,1
6440,2016,2,2016-09-10,UTEP,@,Texas,L (7-41),14,21,66.7,73,0,40,135,3.4,1,61,208,3.4,2,4,4,10,8,78,1,0,1
6441,2016,3,2016-09-17,UTEP,,Army,L (14-66),12,23,52.2,166,1,19,88,4.6,1,42,254,6.0,6,4,0,10,7,58,1,1,2
6442,2016,4,2016-09-24,UTEP,,Southern Mississippi,L (7-34),14,28,50.0,113,0,26,145,5.6,1,54,258,4.8,5,4,1,10,6,57,1,2,3
6443,2016,5,2016-10-01,UTEP,@,Louisiana Tech,L (7-28),25,34,73.5,293,1,35,122,3.5,0,69,415,6.0,13,9,0,22,6,55,1,1,2
6444,2016,6,2016-10-08,UTEP,,Florida International,L (21-35),17,39,43.6,191,1,25,149,6.0,2,64,340,5.3,10,4,2,16,3,30,0,1,1
6445,2016,7,2016-10-22,UTEP,@,Texas-San Antonio,W (52-49),16,24,66.7,285,4,38,159,4.2,3,62,444,7.2,10,8,1,19,13,72,1,0,1
6446,2016,8,2016-10-29,UTEP,,Old Dominion,L (21-31),22,37,59.5,205,2,35,132,3.8,1,72,337,4.7,12,9,3,24,2,10,1,1,2
6447,2016,9,2016-11-05,UTEP,,,W (42-10),16,22,72.7,191,3,44,323,7.3,3,66,514,7.8,10,15,2,27,1,5,0,0,0
6448,2016,10,2016-11-12,UTEP,@,Florida Atlantic,L (31-35),13,19,68.4,118,2,40,237,5.9,2,59,355,6.0,9,11,1,21,7,59,0,1,1
6449,2016,11,2016-11-19,UTEP,@,Rice,L (24-44),19,34,55.9,169,2,18,63,3.5,0,52,232,4.5,9,3,1,13,5,51,0,1,1
6450,2016,12,2016-11-26,UTEP,,North Texas,W (52-24),12,18,66.7,171,2,40,384,9.6,4,58,555,9.6,6,12,1,19,3,36,1,0,1
6451,2016,,12 Games,UTEP,,,,195,327,59.6,2204,21,409,2226,5.4,20,736,4430,6.0,103,96,20,219,68,567,8,8,16
6452,2017,1,2017-09-02,UTEP,@,Oklahoma,L (7-56),16,27,59.3,94,0,21,73,3.5,1,48,167,3.5,3,5,3,11,5,50,1,0,1
6453,2017,2,2017-09-09,UTEP,,Rice,L (14-31),18,33,54.5,203,1,24,26,1.1,1,57,229,4.0,9,3,0,12,2,15,1,0,1
6454,2017,3,2017-09-15,UTEP,,Arizona,L (16-63),18,39,46.2,201,1,14,17,1.2,1,53,218,4.1,10,1,1,12,4,35,1,1,2
6455,2017,4,2017-09-23,UTEP,@,New Mexico State,L (14-41),10,34,29.4,92,0,36,135,3.8,1,70,227,3.2,5,9,1,15,9,67,0,5,5
6456,2017,5,2017-09-30,UTEP,@,Army,L (21-35),9,18,50.0,110,1,37,152,4.1,1,55,262,4.8,4,10,2,16,5,50,0,0,0
6457,2017,6,2017-10-07,UTEP,,Western Kentucky,L (14-15),12,22,54.5,124,1,36,163,4.5,1,58,287,4.9,5,9,1,15,7,68,0,0,0
6458,2017,7,2017-10-14,UTEP,@,Southern Mississippi,L (0-24),14,28,50.0,130,0,22,17,0.8,0,50,147,2.9,5,1,0,6,5,45,2,1,3
6459,2017,8,2017-10-28,UTEP,,Texas-San Antonio,L (14-31),8,29,27.6,133,0,26,110,4.2,2,55,243,4.4,5,5,0,10,4,51,0,2,2
6460,2017,9,2017-11-04,UTEP,@,Middle Tennessee State,L (3-30),10,23,43.5,48,0,32,89,2.8,0,55,137,2.5,0,6,0,6,6,60,0,0,0
6461,2017,10,2017-11-11,UTEP,@,North Texas,L (10-45),16,32,50.0,131,0,32,100,3.1,0,64,231,3.6,6,7,2,15,7,59,0,1,1
6462,2017,11,2017-11-18,UTEP,,Louisiana Tech,L (21-42),12,26,46.2,261,2,35,163,4.7,1,61,424,7.0,7,8,4,19,9,79,1,2,3
6463,2017,12,2017-11-25,UTEP,@,Alabama-Birmingham,L (7-28),8,20,40.0,107,1,30,101,3.4,0,50,208,4.2,3,5,2,10,7,60,0,2,2
6464,2017,,12 Games,UTEP,,,,151,331,45.6,1634,7,345,1146,3.3,9,676,2780,4.1,62,69,16,147,70,639,6,14,20
6465,2014,1,2014-08-29,UTSA,@,Houston,W (27-7),15,24,62.5,121,0,50,142,2.8,3,74,263,3.6,5,12,0,17,14,115,1,0,1
6466,2014,2,2014-09-04,UTSA,,Arizona,L (23-26),22,33,66.7,228,1,39,121,3.1,2,72,349,4.8,14,6,3,23,6,53,0,1,1
6467,2014,3,2014-09-13,UTSA,@,Oklahoma State,L (13-43),15,29,51.7,133,0,35,73,2.1,1,64,206,3.2,6,5,0,11,5,74,0,1,1
6468,2014,4,2014-09-27,UTSA,@,Florida Atlantic,L (37-41),20,39,51.3,272,1,40,140,3.5,3,79,412,5.2,12,10,1,23,6,50,0,2,2
6469,2014,5,2014-10-04,UTSA,,New Mexico,L (9-21),14,24,58.3,229,0,38,112,2.9,1,62,341,5.5,10,7,1,18,4,35,0,2,2
6470,2014,6,2014-10-11,UTSA,,Florida International,W (16-13),18,26,69.2,175,0,41,142,3.5,1,67,317,4.7,9,8,0,17,8,71,3,0,3
6471,2014,7,2014-10-18,UTSA,@,Louisiana Tech,L (20-27),20,33,60.6,190,1,39,134,3.4,1,72,324,4.5,10,6,1,17,8,85,1,3,4
6472,2014,8,2014-10-25,UTSA,,Texas-El Paso,L (0-34),6,20,30.0,32,0,26,38,1.5,0,46,70,1.5,1,1,0,2,4,29,1,1,2
6473,2014,9,2014-11-08,UTSA,@,Rice,L (7-17),17,32,53.1,153,1,23,104,4.5,0,55,257,4.7,8,8,2,18,7,70,1,0,1
6474,2014,10,2014-11-13,UTSA,,Southern Mississippi,W (12-10),27,44,61.4,175,0,37,169,4.6,0,81,344,4.2,11,9,3,23,8,58,0,1,1
6475,2014,11,2014-11-22,UTSA,@,Western Kentucky,L (7-45),11,23,47.8,119,1,39,115,2.9,0,62,234,3.8,5,5,2,12,12,124,1,1,2
6476,2014,12,2014-11-29,UTSA,,North Texas,W (34-27),18,29,62.1,277,2,33,175,5.3,3,62,452,7.3,11,7,1,19,3,25,2,0,2
6477,2014,,12 Games,UTSA,,,,203,356,57.0,2104,7,440,1465,3.3,15,796,3569,4.5,102,84,14,200,85,789,10,12,22
6478,2015,1,2015-09-03,UTSA,@,Arizona,L (32-42),25,45,55.6,332,2,50,193,3.9,2,95,525,5.5,16,10,3,29,10,114,1,1,2
6479,2015,2,2015-09-12,UTSA,,Kansas State,L (3-30),23,37,62.2,192,0,25,37,1.5,0,62,229,3.7,9,3,2,14,12,92,0,0,0
6480,2015,3,2015-09-19,UTSA,@,Oklahoma State,L (14-69),16,30,53.3,170,1,51,176,3.5,1,81,346,4.3,8,12,0,20,7,77,5,2,7
6481,2015,4,2015-09-26,UTSA,,Colorado State,L (31-33),9,18,50.0,153,1,34,279,8.2,3,52,432,8.3,6,11,1,18,8,47,0,1,1
6482,2015,5,2015-10-03,UTSA,@,Texas-El Paso,W (25-6),19,32,59.4,198,0,48,137,2.9,1,80,335,4.2,10,10,2,22,6,58,1,0,1
6483,2015,6,2015-10-10,UTSA,,Louisiana Tech,L (31-34),18,27,66.7,227,4,39,73,1.9,0,66,300,4.5,11,4,0,15,6,32,0,2,2
6484,2015,7,2015-10-17,UTSA,@,Southern Mississippi,L (10-32),6,22,27.3,66,1,41,139,3.4,0,63,205,3.3,4,7,1,12,7,78,2,0,2
6485,2015,8,2015-10-31,UTSA,@,North Texas,L (23-30),27,41,65.9,245,1,50,230,4.6,2,91,475,5.2,12,15,4,31,7,72,1,0,1
6486,2015,9,2015-11-07,UTSA,,Old Dominion,L (31-36),26,38,68.4,283,2,38,141,3.7,2,76,424,5.6,17,7,0,24,3,34,1,0,1
6487,2015,10,2015-11-14,UTSA,@,UNC Charlotte,W (30-27),18,33,54.5,133,2,47,218,4.6,2,80,351,4.4,5,13,5,23,6,80,0,3,3
6488,2015,11,2015-11-21,UTSA,,Rice,W (34-24),9,13,69.2,189,2,45,242,5.4,3,58,431,7.4,8,9,1,18,7,50,0,0,0
6489,2015,12,2015-11-28,UTSA,,Middle Tennessee State,L (7-42),14,23,60.9,140,1,43,152,3.5,0,66,292,4.4,8,10,0,18,5,59,1,2,3
6490,2015,,12 Games,UTSA,,,,210,359,58.5,2328,17,511,2017,3.9,16,870,4345,5.0,114,111,19,244,84,793,12,11,23
6491,2016,1,2016-09-03,UTSA,,Alabama State,W (26-13),22,33,66.7,287,2,34,162,4.8,2,67,449,6.7,12,7,1,20,8,80,3,1,4
6492,2016,2,2016-09-10,UTSA,@,Colorado State,L (14-23),20,30,66.7,236,2,34,-1,0.0,0,64,235,3.7,12,0,1,13,9,56,0,1,1
6493,2016,3,2016-09-16,UTSA,,Arizona State,L (28-32),19,37,51.4,229,3,30,93,3.1,1,67,322,4.8,11,5,0,16,5,21,0,0,0
6494,2016,4,2016-09-24,UTSA,@,Old Dominion,L (19-33),15,30,50.0,211,1,39,131,3.4,1,69,342,5.0,10,9,2,21,8,69,1,1,2
6495,2016,5,2016-10-08,UTSA,,Southern Mississippi,W (55-32),10,12,83.3,193,1,35,339,9.7,6,47,532,11.3,2,12,3,17,10,81,0,0,0
6496,2016,6,2016-10-15,UTSA,@,Rice,W (14-13),17,25,68.0,209,2,38,125,3.3,0,63,334,5.3,8,8,0,16,8,60,1,0,1
6497,2016,7,2016-10-22,UTSA,,Texas-El Paso,L (49-52),21,37,56.8,247,4,52,278,5.3,2,89,525,5.9,12,14,3,29,7,65,0,1,1
6498,2016,8,2016-10-29,UTSA,,North Texas,W (31-17),10,19,52.6,142,2,41,176,4.3,2,60,318,5.3,7,12,0,19,4,39,0,0,0
6499,2016,9,2016-11-05,UTSA,@,Middle Tennessee State,W (45-25),9,21,42.9,108,1,58,271,4.7,5,79,379,4.8,7,16,1,24,3,25,0,2,2
6500,2016,10,2016-11-12,UTSA,@,Louisiana Tech,L (35-63),22,42,52.4,179,2,42,131,3.1,2,84,310,3.7,12,7,1,20,9,92,0,1,1
6501,2016,11,2016-11-19,UTSA,@,Texas A&M,L (10-23),18,31,58.1,204,1,37,48,1.3,0,68,252,3.7,10,5,0,15,3,35,1,0,1
6502,2016,12,2016-11-26,UTSA,,UNC Charlotte,W (33-14),23,40,57.5,414,3,45,106,2.4,1,85,520,6.1,15,7,3,25,10,95,1,0,1
6503,2016,13,2016-12-17,UTSA,N,New Mexico*,L (20-23),10,26,38.5,118,2,38,246,6.5,0,64,364,5.7,5,13,2,20,8,60,0,1,1
6504,2016,,13 Games,UTSA,,,,216,383,56.4,2777,26,523,2105,4.0,22,906,4882,5.4,123,115,17,255,92,778,7,8,15
6505,2017,1,2017-09-09,UTSA,@,Baylor,W (17-10),15,20,75.0,155,2,45,220,4.9,0,65,375,5.8,6,12,2,20,10,75,1,0,1
6506,2017,2,2017-09-16,UTSA,,Southern,W (51-17),24,30,80.0,335,4,39,167,4.3,3,69,502,7.3,17,8,0,25,9,78,2,2,4
6507,2017,3,2017-09-23,UTSA,@,Texas State,W (44-14),17,25,68.0,212,0,45,357,7.9,4,70,569,8.1,12,11,2,25,13,155,1,0,1
6508,2017,4,2017-10-07,UTSA,,Southern Mississippi,L (29-31),27,43,62.8,367,3,33,102,3.1,0,76,469,6.2,17,8,2,27,3,25,0,1,1
6509,2017,5,2017-10-14,UTSA,@,North Texas,L (26-29),13,25,52.0,215,2,41,174,4.2,0,66,389,5.9,8,9,2,19,7,60,0,0,0
6510,2017,6,2017-10-21,UTSA,,Rice,W (20-7),12,22,54.5,134,1,40,314,7.9,0,62,448,7.2,6,12,1,19,9,63,1,0,1
6511,2017,7,2017-10-28,UTSA,@,Texas-El Paso,W (31-14),18,30,60.0,188,1,42,205,4.9,2,72,393,5.5,10,10,2,22,8,47,1,1,2
6512,2017,8,2017-11-04,UTSA,@,Florida International,L (7-14),13,22,59.1,105,1,40,156,3.9,0,62,261,4.2,6,9,4,19,5,45,2,0,2
6513,2017,9,2017-11-11,UTSA,,Alabama-Birmingham,L (19-24),17,37,45.9,162,1,36,137,3.8,1,73,299,4.1,9,6,3,18,5,35,2,1,3
6514,2017,10,2017-11-18,UTSA,,Marshall,W (9-7),26,39,66.7,267,0,39,88,2.3,0,78,355,4.6,18,4,1,23,4,24,1,0,1
6515,2017,11,2017-11-25,UTSA,@,Louisiana Tech,L (6-20),9,16,56.3,91,0,45,110,2.4,0,61,201,3.3,5,9,1,15,6,34,0,2,2
6516,2017,,11 Games,UTSA,,,,191,309,61.8,2231,15,445,2030,4.6,10,754,4261,5.7,114,98,20,232,79,641,11,7,18
6517,2014,1,2014-08-28,Vanderbilt,,Temple,L (7-37),16,34,47.1,224,0,29,54,1.9,0,63,278,4.4,11,2,0,13,7,66,4,3,7
6518,2014,2,2014-09-06,Vanderbilt,N,Mississippi,L (3-41),6,25,24.0,60,0,25,107,4.3,0,50,167,3.3,4,4,1,9,7,53,0,1,1
6519,2014,3,2014-09-13,Vanderbilt,,Massachusetts,W (34-31),16,23,69.6,150,1,40,160,4.0,2,63,310,4.9,8,8,1,17,9,77,0,1,1
6520,2014,4,2014-09-20,Vanderbilt,,South Carolina,L (34-48),15,25,60.0,223,2,30,156,5.2,0,55,379,6.9,8,9,1,18,7,75,1,1,2
6521,2014,5,2014-09-27,Vanderbilt,@,Kentucky,L (7-17),8,25,32.0,85,0,22,54,2.5,0,47,139,3.0,4,3,1,8,2,10,0,3,3
6522,2014,6,2014-10-04,Vanderbilt,@,Georgia,L (17-44),16,31,51.6,188,0,36,132,3.7,2,67,320,4.8,7,8,0,15,4,29,0,1,1
6523,2014,7,2014-10-11,Vanderbilt,,Charleston Southern,W (21-20),15,23,65.2,189,1,31,106,3.4,1,54,295,5.5,5,5,1,11,10,85,0,1,1
6524,2014,8,2014-10-25,Vanderbilt,@,Missouri,L (14-24),17,31,54.8,196,2,27,44,1.6,0,58,240,4.1,10,3,5,18,5,41,0,1,1
6525,2014,9,2014-11-01,Vanderbilt,,Old Dominion,W (42-28),20,29,69.0,281,5,56,243,4.3,1,85,524,6.2,12,17,4,33,4,38,2,0,2
6526,2014,10,2014-11-08,Vanderbilt,,Florida,L (10-34),21,45,46.7,225,1,24,83,3.5,0,69,308,4.5,11,4,2,17,6,49,2,2,4
6527,2014,11,2014-11-22,Vanderbilt,@,Mississippi State,L (0-51),17,36,47.2,179,0,27,49,1.8,0,63,228,3.6,7,5,3,15,5,57,1,2,3
6528,2014,12,2014-11-29,Vanderbilt,,Tennessee,L (17-24),13,30,43.3,149,1,36,123,3.4,1,66,272,4.1,6,10,3,19,7,50,0,3,3
6529,2014,,12 Games,Vanderbilt,,,,180,357,50.4,2149,13,383,1311,3.4,7,740,3460,4.7,93,78,22,193,73,630,10,19,29
6530,2015,1,2015-09-03,Vanderbilt,,Western Kentucky,L (12-14),18,34,52.9,217,1,42,176,4.2,0,76,393,5.2,9,9,2,20,5,48,1,2,3
6531,2015,2,2015-09-12,Vanderbilt,,Georgia,L (14-31),24,50,48.0,295,1,39,105,2.7,0,89,400,4.5,12,6,3,21,4,20,0,3,3
6532,2015,3,2015-09-19,Vanderbilt,,Austin Peay,W (47-7),30,39,76.9,394,2,35,147,4.2,4,74,541,7.3,17,9,0,26,7,50,1,1,2
6533,2015,4,2015-09-26,Vanderbilt,@,Mississippi,L (16-27),23,42,54.8,194,1,43,128,3.0,0,85,322,3.8,9,8,4,21,8,43,0,0,0
6534,2015,5,2015-10-03,Vanderbilt,@,Middle Tennessee State,W (17-13),18,31,58.1,177,0,41,237,5.8,2,72,414,5.8,10,8,0,18,6,40,1,2,3
6535,2015,6,2015-10-17,Vanderbilt,@,South Carolina,L (10-19),21,42,50.0,177,1,35,155,4.4,0,77,332,4.3,9,10,1,20,6,53,2,3,5
6536,2015,7,2015-10-24,Vanderbilt,,Missouri,W (10-3),17,28,60.7,136,0,49,168,3.4,1,77,304,3.9,8,9,1,18,5,59,1,0,1
6537,2015,8,2015-10-31,Vanderbilt,@,Houston,L (0-34),5,20,25.0,44,0,42,141,3.4,0,62,185,3.0,2,10,0,12,6,39,1,3,4
6538,2015,9,2015-11-07,Vanderbilt,@,Florida,L (7-9),3,14,21.4,30,0,48,145,3.0,1,62,175,2.8,0,8,3,11,7,45,0,0,0
6539,2015,10,2015-11-14,Vanderbilt,,Kentucky,W (21-17),13,26,50.0,166,2,42,135,3.2,0,68,301,4.4,7,6,0,13,3,25,2,0,2
6540,2015,11,2015-11-21,Vanderbilt,,Texas A&M,L (0-25),5,16,31.3,23,0,44,125,2.8,0,60,148,2.5,0,8,2,10,7,68,0,1,1
6541,2015,12,2015-11-28,Vanderbilt,@,Tennessee,L (28-53),15,34,44.1,209,3,36,202,5.6,1,70,411,5.9,11,8,2,21,9,84,0,1,1
6542,2015,,12 Games,Vanderbilt,,,,192,376,51.1,2062,11,496,1864,3.8,9,872,3926,4.5,94,99,18,211,73,574,9,16,25
6543,2016,1,2016-09-01,Vanderbilt,,South Carolina,L (10-13),8,23,34.8,73,0,42,169,4.0,1,65,242,3.7,4,9,1,14,5,33,0,0,0
6544,2016,2,2016-09-10,Vanderbilt,,Middle Tennessee State,W (47-24),15,28,53.6,113,1,45,231,5.1,5,73,344,4.7,6,12,2,20,4,40,1,0,1
6545,2016,3,2016-09-17,Vanderbilt,@,Georgia Tech,L (7-38),20,31,64.5,190,1,30,85,2.8,0,61,275,4.5,12,4,1,17,5,45,0,1,1
6546,2016,4,2016-09-24,Vanderbilt,@,Western Kentucky,W (31-30),18,29,62.1,279,1,42,110,2.6,3,71,389,5.5,10,5,4,19,5,51,0,1,1
6547,2016,5,2016-10-01,Vanderbilt,,Florida,L (6-13),12,32,37.5,118,0,37,147,4.0,0,69,265,3.8,8,10,3,21,6,47,1,2,3
6548,2016,6,2016-10-08,Vanderbilt,@,Kentucky,L (13-20),17,30,56.7,141,0,32,141,4.4,0,62,282,4.5,9,9,0,18,7,35,1,0,1
6549,2016,7,2016-10-15,Vanderbilt,@,Georgia,W (17-16),7,18,38.9,109,0,32,62,1.9,2,50,171,3.4,5,3,1,9,5,45,0,0,0
6550,2016,8,2016-10-22,Vanderbilt,,Tennessee State,W (35-17),15,24,62.5,143,1,42,358,8.5,4,66,501,7.6,9,16,3,28,5,63,0,0,0
6551,2016,9,2016-11-05,Vanderbilt,@,Auburn,L (16-23),24,38,63.2,221,1,33,120,3.6,0,71,341,4.8,15,6,1,22,5,26,0,1,1
6552,2016,10,2016-11-12,Vanderbilt,@,Missouri,L (17-26),17,30,56.7,252,0,43,159,3.7,2,73,411,5.6,10,7,1,18,7,80,0,2,2
6553,2016,11,2016-11-19,Vanderbilt,,Mississippi,W (38-17),17,30,56.7,273,2,46,208,4.5,3,76,481,6.3,12,9,1,22,5,40,1,0,1
6554,2016,12,2016-11-26,Vanderbilt,,Tennessee,W (45-34),21,35,60.0,416,2,38,192,5.1,4,73,608,8.3,18,8,1,27,4,30,0,1,1
6555,2016,13,2016-12-26,Vanderbilt,N,North Carolina State*,L (17-41),19,46,41.3,158,0,35,156,4.5,2,81,314,3.9,11,7,0,18,4,40,0,3,3
6556,2016,,13 Games,Vanderbilt,,,,210,394,53.3,2486,9,497,2138,4.3,26,891,4624,5.2,129,105,19,253,67,575,4,11,15
6557,2017,1,2017-09-02,Vanderbilt,@,Middle Tennessee State,W (28-6),20,28,71.4,296,3,35,76,2.2,1,63,372,5.9,10,5,0,15,6,69,0,0,0
6558,2017,2,2017-09-09,Vanderbilt,,Alabama A&M,W (42-0),19,26,73.1,227,4,35,174,5.0,2,61,401,6.6,10,8,0,18,4,40,0,0,0
6559,2017,3,2017-09-16,Vanderbilt,,Kansas State,W (14-7),14,23,60.9,205,1,32,65,2.0,1,55,270,4.9,9,2,0,11,5,50,1,0,1
6560,2017,4,2017-09-23,Vanderbilt,,Alabama,L (0-59),7,22,31.8,38,0,16,40,2.5,0,38,78,2.1,1,1,1,3,5,20,1,1,2
6561,2017,5,2017-09-30,Vanderbilt,@,Florida,L (24-38),18,40,45.0,264,3,20,46,2.3,0,60,310,5.2,13,3,1,17,4,38,0,0,0
6562,2017,6,2017-10-07,Vanderbilt,,Georgia,L (14-45),17,31,54.8,172,1,22,64,2.9,1,53,236,4.5,8,3,0,11,5,25,0,0,0
6563,2017,7,2017-10-14,Vanderbilt,@,Mississippi,L (35-57),18,37,48.6,229,3,37,188,5.1,2,74,417,5.6,13,7,1,21,6,52,1,1,2
6564,2017,8,2017-10-28,Vanderbilt,@,South Carolina,L (27-34),27,49,55.1,333,4,23,107,4.7,0,72,440,6.1,15,8,4,27,10,100,0,1,1
6565,2017,9,2017-11-04,Vanderbilt,,Western Kentucky,W (31-17),14,21,66.7,220,2,35,174,5.0,2,56,394,7.0,12,7,0,19,6,54,1,0,1
6566,2017,10,2017-11-11,Vanderbilt,,Kentucky,L (21-44),30,43,69.8,308,1,20,60,3.0,2,63,368,5.8,15,3,3,21,4,48,0,4,4
6567,2017,11,2017-11-18,Vanderbilt,,Missouri,L (17-45),28,52,53.8,348,1,30,51,1.7,1,82,399,4.9,16,5,4,25,6,45,0,3,3
6568,2017,12,2017-11-25,Vanderbilt,@,Tennessee,W (42-24),20,31,64.5,283,4,43,246,5.7,2,74,529,7.1,16,15,2,33,8,60,0,0,0
6569,2017,,12 Games,Vanderbilt,,,,232,403,57.6,2923,27,348,1291,3.7,14,751,4214,5.6,138,67,16,221,69,601,4,10,14
6570,2016,1,2016-09-03,Villanova,@,Pittsburgh,L (7-28),16,32,50.0,119,0,33,53,1.6,0,65,172,2.6,8,4,2,14,7,55,1,1,2
6571,2017,1,2017-09-09,Villanova,@,Temple,L (13-16),27,41,65.9,382,1,30,20,0.7,0,71,402,5.7,16,3,0,19,5,35,1,0,1
6572,2014,1,2014-08-30,Virginia,,UCLA,L (20-28),29,45,64.4,266,2,39,120,3.1,0,84,386,4.6,12,3,2,17,4,20,1,2,3
6573,2014,2,2014-09-06,Virginia,,Richmond,W (45-13),18,23,78.3,173,2,40,157,3.9,3,63,330,5.2,8,9,0,17,6,39,1,1,2
6574,2014,3,2014-09-13,Virginia,,Louisville,W (23-21),16,30,53.3,171,1,40,114,2.9,1,70,285,4.1,8,5,0,13,7,46,1,2,3
6575,2014,4,2014-09-20,Virginia,@,Brigham Young,L (33-41),35,58,60.3,327,1,44,192,4.4,2,102,519,5.1,18,11,6,35,8,86,1,1,2
6576,2014,5,2014-09-27,Virginia,,Kent State,W (45-13),19,32,59.4,266,2,45,254,5.6,3,77,520,6.8,13,12,2,27,9,79,1,2,3
6577,2014,6,2014-10-04,Virginia,,Pittsburgh,W (24-19),10,17,58.8,121,1,43,225,5.2,1,60,346,5.8,5,11,2,18,6,65,0,1,1
6578,2014,7,2014-10-18,Virginia,@,Duke,L (13-20),22,47,46.8,325,1,31,140,4.5,0,78,465,6.0,15,7,1,23,6,60,1,0,1
6579,2014,8,2014-10-25,Virginia,,North Carolina,L (27-28),21,41,51.2,284,2,43,159,3.7,1,84,443,5.3,15,12,4,31,8,83,0,2,2
6580,2014,9,2014-11-01,Virginia,@,Georgia Tech,L (10-35),23,41,56.1,262,1,16,22,1.4,0,57,284,5.0,14,1,0,15,6,61,0,2,2
6581,2014,10,2014-11-08,Virginia,@,Florida State,L (20-34),20,35,57.1,220,3,32,37,1.2,0,67,257,3.8,11,5,1,17,6,49,2,1,3
6582,2014,11,2014-11-22,Virginia,,Miami (FL),W (30-13),17,25,68.0,146,1,43,195,4.5,2,68,341,5.0,6,11,1,18,3,30,0,1,1
6583,2014,12,2014-11-28,Virginia,@,Virginia Tech,L (20-24),18,38,47.4,276,1,35,38,1.1,0,73,314,4.3,12,1,2,15,9,75,0,1,1
6584,2014,,12 Games,Virginia,,,,248,432,57.4,2837,18,451,1653,3.7,13,883,4490,5.1,137,88,21,246,78,693,8,16,24
6585,2015,1,2015-09-05,Virginia,@,UCLA,L (16-34),21,35,60.0,238,1,34,98,2.9,0,69,336,4.9,13,3,3,19,7,45,0,1,1
6586,2015,2,2015-09-12,Virginia,,Notre Dame,L (27-34),26,38,68.4,289,2,30,127,4.2,2,68,416,6.1,16,4,2,22,9,55,1,0,1
6587,2015,3,2015-09-19,Virginia,,William & Mary,W (35-29),17,23,73.9,263,3,29,110,3.8,1,52,373,7.2,8,7,0,15,5,60,0,2,2
6588,2015,4,2015-09-25,Virginia,,Boise State,L (14-56),16,33,48.5,233,2,33,40,1.2,0,66,273,4.1,9,1,0,10,9,80,1,4,5
6589,2015,5,2015-10-10,Virginia,@,Pittsburgh,L (19-26),17,34,50.0,209,1,31,139,4.5,0,65,348,5.4,9,7,0,16,4,22,0,1,1
6590,2015,6,2015-10-17,Virginia,,Syracuse,W (44-38),24,37,64.9,234,2,44,159,3.6,3,81,393,4.9,14,10,1,25,7,78,1,1,2
6591,2015,7,2015-10-24,Virginia,@,North Carolina,L (13-26),17,30,56.7,148,1,39,205,5.3,0,69,353,5.1,10,7,6,23,10,62,1,4,5
6592,2015,8,2015-10-31,Virginia,,Georgia Tech,W (27-21),17,28,60.7,175,1,42,233,5.5,2,70,408,5.8,10,10,1,21,7,45,0,1,1
6593,2015,9,2015-11-07,Virginia,@,Miami (FL),L (21-27),29,42,69.0,280,0,32,127,4.0,1,74,407,5.5,14,8,2,24,8,80,0,1,1
6594,2015,10,2015-11-14,Virginia,@,Louisville,L (31-38),25,41,61.0,260,4,31,94,3.0,0,72,354,4.9,12,7,3,22,8,69,1,0,1
6595,2015,11,2015-11-21,Virginia,,Duke,W (42-34),25,34,73.5,359,3,39,143,3.7,3,73,502,6.9,15,8,2,25,8,105,1,1,2
6596,2015,12,2015-11-28,Virginia,,Virginia Tech,L (20-23),18,38,47.4,171,1,40,262,6.6,1,78,433,5.6,9,11,1,21,9,65,0,2,2
6597,2015,,12 Games,Virginia,,,,252,413,61.0,2859,21,424,1737,4.1,13,837,4596,5.5,139,83,21,243,91,766,6,18,24
6598,2016,1,2016-09-03,Virginia,,Richmond,L (20-37),26,34,76.5,264,3,21,38,1.8,0,55,302,5.5,12,5,2,19,0,0,3,1,4
6599,2016,2,2016-09-10,Virginia,@,Oregon,L (26-44),21,40,52.5,195,2,40,193,4.8,2,80,388,4.9,9,14,5,28,10,102,0,2,2
6600,2016,3,2016-09-17,Virginia,@,Connecticut,L (10-13),23,43,53.5,241,0,30,140,4.7,1,73,381,5.2,11,6,4,21,10,91,0,1,1
6601,2016,4,2016-09-24,Virginia,,Central Michigan,W (49-35),27,43,62.8,421,5,26,148,5.7,2,69,569,8.2,16,8,1,25,4,45,0,1,1
6602,2016,5,2016-10-01,Virginia,@,Duke,W (34-20),23,41,56.1,336,3,36,80,2.2,1,77,416,5.4,12,4,0,16,7,59,0,1,1
6603,2016,6,2016-10-15,Virginia,,Pittsburgh,L (31-45),20,45,44.4,278,1,26,86,3.3,3,71,364,5.1,11,6,2,19,10,67,0,1,1
6604,2016,7,2016-10-22,Virginia,,North Carolina,L (14-35),22,45,48.9,143,1,39,110,2.8,1,84,253,3.0,10,8,1,19,9,82,1,0,1
6605,2016,8,2016-10-29,Virginia,,Louisville,L (25-32),25,40,62.5,238,3,28,84,3.0,0,68,322,4.7,10,6,1,17,5,48,0,2,2
6606,2016,9,2016-11-05,Virginia,@,Wake Forest,L (20-27),20,40,50.0,190,2,32,105,3.3,1,72,295,4.1,11,8,2,21,3,30,1,2,3
6607,2016,10,2016-11-12,Virginia,,Miami (FL),L (14-34),19,34,55.9,207,1,33,82,2.5,1,67,289,4.3,10,4,0,14,10,110,4,0,4
6608,2016,11,2016-11-19,Virginia,@,Georgia Tech,L (17-31),27,46,58.7,220,1,42,189,4.5,1,88,409,4.6,15,10,0,25,4,30,0,3,3
6609,2016,12,2016-11-26,Virginia,@,Virginia Tech,L (10-52),13,36,36.1,139,1,31,108,3.5,0,67,247,3.7,5,7,2,14,4,31,1,2,3
6610,2016,,12 Games,Virginia,,,,266,487,54.6,2872,23,384,1363,3.5,13,871,4235,4.9,132,86,20,238,76,695,10,16,26
6611,2017,1,2017-09-02,Virginia,,William & Mary,W (28-10),27,40,67.5,262,3,32,92,2.9,1,72,354,4.9,13,6,0,19,3,15,0,0,0
6612,2017,2,2017-09-09,Virginia,,Indiana,L (17-34),39,66,59.1,259,1,25,55,2.2,1,91,314,3.5,11,7,4,22,5,26,0,0,0
6613,2017,3,2017-09-16,Virginia,,Connecticut,W (38-18),30,40,75.0,455,3,31,171,5.5,2,71,626,8.8,18,9,0,27,9,109,0,1,1
6614,2017,4,2017-09-22,Virginia,@,Boise State,W (42-23),19,29,65.5,273,3,40,167,4.2,3,69,440,6.4,13,8,0,21,3,23,0,0,0
6615,2017,5,2017-10-07,Virginia,,Duke,W (28-21),24,43,55.8,182,3,38,128,3.4,0,81,310,3.8,8,8,5,21,7,67,0,2,2
6616,2017,6,2017-10-14,Virginia,@,North Carolina,W (20-14),19,31,61.3,249,2,47,156,3.3,0,78,405,5.2,8,13,2,23,6,54,1,0,1
6617,2017,7,2017-10-21,Virginia,,Boston College,L (10-41),19,42,45.2,152,0,26,95,3.7,1,68,247,3.6,9,7,3,19,1,15,0,3,3
6618,2017,8,2017-10-28,Virginia,@,Pittsburgh,L (14-31),22,42,52.4,212,2,31,102,3.3,0,73,314,4.3,12,4,4,20,3,45,0,1,1
6619,2017,9,2017-11-04,Virginia,,Georgia Tech,W (40-36),21,43,48.8,260,3,25,97,3.9,0,68,357,5.3,11,3,1,15,4,25,1,1,2
6620,2017,10,2017-11-11,Virginia,@,Louisville,L (21-38),19,36,52.8,214,1,28,63,2.3,2,64,277,4.3,11,4,1,16,8,73,1,1,2
6621,2017,11,2017-11-18,Virginia,@,Miami (FL),L (28-44),28,37,75.7,384,4,28,55,2.0,0,65,439,6.8,13,3,2,18,6,40,2,1,3
6622,2017,12,2017-11-24,Virginia,,Virginia Tech,L (0-10),17,34,50.0,186,0,20,5,0.3,0,54,191,3.5,7,2,0,9,4,50,1,0,1
6623,2017,13,2017-12-28,Virginia,@,Navy*,L (7-49),16,36,44.4,145,0,18,30,1.7,0,54,175,3.2,7,4,0,11,4,40,2,1,3
6624,2017,,13 Games,Virginia,,,,300,519,57.8,3233,25,389,1216,3.1,10,908,4449,4.9,141,78,22,241,63,582,8,11,19
6625,2016,1,2016-09-03,Virginia Military Institute,@,Akron,L (24-47),28,37,75.7,300,2,45,86,1.9,1,82,386,4.7,10,6,4,20,5,53,0,0,0
6626,2017,1,2017-09-02,Virginia Military Institute,@,Air Force,L (0-62),10,19,52.6,40,0,28,55,2.0,0,47,95,2.0,2,2,2,6,2,20,0,1,1
6627,2014,1,2014-08-30,Virginia Tech,,William & Mary,W (34-9),24,31,77.4,266,2,42,222,5.3,2,73,488,6.7,9,12,3,24,10,75,1,1,2
6628,2014,2,2014-09-06,Virginia Tech,@,Ohio State,W (35-21),23,36,63.9,199,2,41,125,3.0,2,77,324,4.2,12,7,2,21,10,107,1,2,3
6629,2014,3,2014-09-13,Virginia Tech,,East Carolina,L (21-28),30,56,53.6,298,3,33,91,2.8,0,89,389,4.4,17,6,3,26,8,64,0,2,2
6630,2014,4,2014-09-20,Virginia Tech,,Georgia Tech,L (24-27),28,39,71.8,297,0,33,127,3.8,2,72,424,5.9,17,7,0,24,12,79,0,3,3
6631,2014,5,2014-09-27,Virginia Tech,,Western Michigan,W (35-17),14,32,43.8,178,2,47,308,6.6,1,79,486,6.2,9,13,4,26,9,69,0,2,2
6632,2014,6,2014-10-04,Virginia Tech,@,North Carolina,W (34-17),18,27,66.7,186,1,57,171,3.0,2,84,357,4.3,9,9,2,20,8,45,0,1,1
6633,2014,7,2014-10-16,Virginia Tech,@,Pittsburgh,L (16-21),26,45,57.8,265,1,22,26,1.2,0,67,291,4.3,12,2,2,16,8,45,1,0,1
6634,2014,8,2014-10-23,Virginia Tech,,Miami (FL),L (6-30),18,28,64.3,142,1,31,120,3.9,0,59,262,4.4,6,7,2,15,4,40,3,0,3
6635,2014,9,2014-11-01,Virginia Tech,,Boston College,L (31-33),31,49,63.3,345,2,29,69,2.4,2,78,414,5.3,12,5,0,17,6,40,1,0,1
6636,2014,10,2014-11-15,Virginia Tech,@,Duke,W (17-16),13,24,54.2,148,2,49,145,3.0,0,73,293,4.0,5,10,1,16,7,75,0,1,1
6637,2014,11,2014-11-22,Virginia Tech,@,Wake Forest,L (3-6),16,29,55.2,143,0,39,111,2.8,0,68,254,3.7,7,8,2,17,4,25,2,1,3
6638,2014,12,2014-11-28,Virginia Tech,,Virginia,W (24-20),15,35,42.9,235,2,40,198,5.0,0,75,433,5.8,10,9,2,21,8,71,2,1,3
6639,2014,13,2014-12-27,Virginia Tech,N,Cincinnati*,W (33-17),15,25,60.0,124,1,44,210,4.8,1,69,334,4.8,5,10,3,18,4,35,0,1,1
6640,2014,,13 Games,Virginia Tech,,,,271,456,59.4,2826,19,507,1923,3.8,12,963,4749,4.9,130,105,26,261,98,770,11,15,26
6641,2015,1,2015-09-07,Virginia Tech,,Ohio State,L (24-42),15,25,60.0,192,3,44,128,2.9,0,69,320,4.6,7,10,1,18,5,50,1,1,2
6642,2015,2,2015-09-12,Virginia Tech,,Furman,W (42-3),19,31,61.3,284,2,41,299,7.3,3,72,583,8.1,10,14,1,25,11,114,0,0,0
6643,2015,3,2015-09-19,Virginia Tech,@,Purdue,W (51-24),16,26,61.5,233,2,56,238,4.3,2,82,471,5.7,9,11,0,20,11,87,1,0,1
6644,2015,4,2015-09-26,Virginia Tech,@,East Carolina,L (28-35),20,35,57.1,281,1,42,158,3.8,3,77,439,5.7,10,8,2,20,11,89,0,1,1
6645,2015,5,2015-10-03,Virginia Tech,,Pittsburgh,L (13-17),9,20,45.0,91,1,33,9,0.3,0,53,100,1.9,6,4,2,12,5,40,0,3,3
6646,2015,6,2015-10-09,Virginia Tech,,North Carolina State,W (28-13),14,29,48.3,158,3,36,200,5.6,1,65,358,5.5,6,9,5,20,7,48,0,0,0
6647,2015,7,2015-10-17,Virginia Tech,@,Miami (FL),L (20-30),17,27,63.0,201,2,35,160,4.6,0,62,361,5.8,8,11,1,20,8,69,1,3,4
6648,2015,8,2015-10-24,Virginia Tech,,Duke,L (43-45),24,47,51.1,270,3,53,182,3.4,2,100,452,4.5,15,13,0,28,5,35,0,0,0
6649,2015,9,2015-10-31,Virginia Tech,@,Boston College,W (26-10),16,23,69.6,194,1,46,81,1.8,0,69,275,4.0,9,6,2,17,11,98,1,1,2
6650,2015,10,2015-11-12,Virginia Tech,@,Georgia Tech,W (23-21),15,29,51.7,178,1,39,165,4.2,2,68,343,5.0,7,9,1,17,8,58,1,1,2
6651,2015,11,2015-11-21,Virginia Tech,,North Carolina,L (27-30),20,35,57.1,273,2,47,130,2.8,1,82,403,4.9,13,7,2,22,6,54,1,2,3
6652,2015,12,2015-11-28,Virginia Tech,@,Virginia,W (23-20),15,29,51.7,237,2,30,67,2.2,0,59,304,5.2,7,4,1,12,3,35,0,1,1
6653,2015,13,2015-12-26,Virginia Tech,N,Tulsa*,W (55-52),23,38,60.5,344,1,43,254,5.9,5,81,598,7.4,16,12,2,30,5,40,1,1,2
6654,2015,,13 Games,Virginia Tech,,,,223,394,56.6,2936,24,545,2071,3.8,19,939,5007,5.3,123,118,20,261,96,817,7,14,21
6655,2016,1,2016-09-03,Virginia Tech,,Liberty,W (36-13),25,41,61.0,252,4,48,206,4.3,0,89,458,5.1,15,8,1,24,4,33,4,0,4
6656,2016,2,2016-09-10,Virginia Tech,N,Tennessee,L (24-45),20,28,71.4,214,1,45,186,4.1,2,73,400,5.5,11,7,3,21,8,101,5,0,5
6657,2016,3,2016-09-17,Virginia Tech,,Boston College,W (49-0),16,27,59.3,253,5,50,223,4.5,2,77,476,6.2,10,12,3,25,7,55,0,1,1
6658,2016,4,2016-09-24,Virginia Tech,,East Carolina,W (54-17),15,23,65.2,295,3,45,167,3.7,3,68,462,6.8,11,6,1,18,4,28,0,0,0
6659,2016,5,2016-10-08,Virginia Tech,@,North Carolina,W (34-3),7,17,41.2,75,2,66,189,2.9,2,83,264,3.2,4,12,2,18,5,29,2,0,2
6660,2016,6,2016-10-15,Virginia Tech,@,Syracuse,L (17-31),20,33,60.6,307,2,39,161,4.1,0,72,468,6.5,15,6,0,21,7,53,1,1,2
6661,2016,7,2016-10-20,Virginia Tech,,Miami (FL),W (37-16),22,34,64.7,272,3,44,251,5.7,1,78,523,6.7,14,11,3,28,2,25,0,0,0
6662,2016,8,2016-10-27,Virginia Tech,@,Pittsburgh,W (39-36),24,43,55.8,406,2,39,150,3.8,1,82,556,6.8,19,8,2,29,4,35,0,0,0
6663,2016,9,2016-11-05,Virginia Tech,@,Duke,W (24-21),15,27,55.6,192,0,52,207,4.0,2,79,399,5.1,9,13,1,23,6,58,0,0,0
6664,2016,10,2016-11-12,Virginia Tech,,Georgia Tech,L (20-30),32,47,68.1,316,1,33,121,3.7,2,80,437,5.5,16,9,0,25,4,35,2,2,4
6665,2016,11,2016-11-19,Virginia Tech,@,Notre Dame,W (34-31),22,29,75.9,267,2,47,152,3.2,2,76,419,5.5,9,13,3,25,5,35,1,1,2
6666,2016,12,2016-11-26,Virginia Tech,,Virginia,W (52-10),18,30,60.0,290,3,51,289,5.7,3,81,579,7.1,13,15,1,29,3,35,2,0,2
6667,2016,13,2016-12-03,Virginia Tech,N,Clemson,L (35-42),22,36,61.1,284,1,35,102,2.9,4,71,386,5.4,12,5,2,19,8,89,0,2,2
6668,2016,14,2016-12-29,Virginia Tech,N,Arkansas*,W (35-24),21,34,61.8,243,2,41,170,4.1,3,75,413,5.5,14,9,2,26,4,55,1,1,2
6669,2016,,14 Games,Virginia Tech,,,,279,449,62.1,3666,31,635,2574,4.1,27,1084,6240,5.8,172,134,24,331,71,666,18,8,26
6670,2017,1,2017-09-03,Virginia Tech,N,West Virginia,W (31-24),15,27,55.6,235,1,45,234,5.2,3,72,469,6.5,8,11,2,21,5,34,0,0,0
6671,2017,2,2017-09-09,Virginia Tech,,Delaware,W (27-0),16,28,57.1,222,2,27,81,3.0,0,55,303,5.5,9,4,2,15,2,10,1,0,1
6672,2017,3,2017-09-16,Virginia Tech,@,East Carolina,W (64-17),25,33,75.8,388,5,62,287,4.6,3,95,675,7.1,16,16,2,34,7,69,0,0,0
6673,2017,4,2017-09-23,Virginia Tech,,Old Dominion,W (38-0),21,32,65.6,311,3,57,271,4.8,2,89,582,6.5,16,14,2,32,2,25,0,1,1
6674,2017,5,2017-09-30,Virginia Tech,,Clemson,L (17-31),30,45,66.7,252,1,28,90,3.2,1,73,342,4.7,11,6,0,17,4,31,1,2,3
6675,2017,6,2017-10-07,Virginia Tech,@,Boston College,W (23-10),22,33,66.7,322,1,48,109,2.3,1,81,431,5.3,14,6,0,20,9,67,0,1,1
6676,2017,7,2017-10-21,Virginia Tech,,North Carolina,W (59-7),15,27,55.6,202,4,46,181,3.9,1,73,383,5.2,11,7,3,21,7,60,0,0,0
6677,2017,8,2017-10-28,Virginia Tech,,Duke,W (24-3),13,27,48.1,200,1,48,187,3.9,2,75,387,5.2,9,11,3,23,3,40,0,0,0
6678,2017,9,2017-11-04,Virginia Tech,@,Miami (FL),L (10-28),20,32,62.5,197,0,43,102,2.4,1,75,299,4.0,11,8,3,22,4,60,2,2,4
6679,2017,10,2017-11-11,Virginia Tech,@,Georgia Tech,L (22-28),14,26,53.8,153,0,36,105,2.9,2,62,258,4.2,7,6,1,14,4,42,0,0,0
6680,2017,11,2017-11-18,Virginia Tech,,Pittsburgh,W (20-14),17,37,45.9,218,1,40,157,3.9,1,77,375,4.9,11,7,0,18,4,25,0,1,1
6681,2017,12,2017-11-24,Virginia Tech,@,Virginia,W (10-0),14,21,66.7,143,1,53,202,3.8,0,74,345,4.7,7,12,1,20,4,20,0,1,1
6682,2017,13,2017-12-28,Virginia Tech,N,Oklahoma State*,L (21-30),23,42,54.8,270,1,50,248,5.0,2,92,518,5.6,12,18,1,31,5,65,1,1,2
6683,2017,,13 Games,Virginia Tech,,,,245,410,59.8,3113,21,583,2254,3.9,19,993,5367,5.4,142,126,20,288,60,548,5,9,14
6684,2014,1,2014-08-28,Wake Forest,@,Louisiana-Monroe,L (10-17),12,22,54.5,97,0,27,-3,-0.1,0,49,94,1.9,3,2,0,5,8,51,0,1,1
6685,2014,2,2014-09-06,Wake Forest,,Gardner-Webb,W (23-7),30,39,76.9,291,2,36,96,2.7,0,75,387,5.2,17,7,0,24,7,71,0,3,3
6686,2014,3,2014-09-13,Wake Forest,@,Utah State,L (24-36),20,50,40.0,257,2,24,-25,-1.0,0,74,232,3.1,13,1,2,16,10,103,1,2,3
6687,2014,4,2014-09-20,Wake Forest,,Army,W (24-21),25,35,71.4,238,2,30,100,3.3,1,65,338,5.2,12,8,1,21,4,30,0,1,1
6688,2014,5,2014-09-27,Wake Forest,@,Louisville,L (10-20),19,34,55.9,122,0,23,-22,-1.0,0,57,100,1.8,5,1,1,7,4,45,0,3,3
6689,2014,6,2014-10-04,Wake Forest,@,Florida State,L (3-43),13,22,59.1,86,0,39,40,1.0,0,61,126,2.1,4,4,2,10,7,62,2,1,3
6690,2014,7,2014-10-18,Wake Forest,,Syracuse,L (7-30),15,23,65.2,99,1,36,71,2.0,0,59,170,2.9,6,5,1,12,3,35,1,1,2
6691,2014,8,2014-10-25,Wake Forest,,Boston College,L (17-23),22,30,73.3,242,0,33,19,0.6,2,63,261,4.1,11,3,3,17,6,49,0,1,1
6692,2014,9,2014-11-06,Wake Forest,,Clemson,L (20-34),12,30,40.0,112,2,34,7,0.2,0,64,119,1.9,6,3,6,15,2,29,0,0,0
6693,2014,10,2014-11-15,Wake Forest,@,North Carolina State,L (13-42),15,32,46.9,161,0,35,58,1.7,1,67,219,3.3,6,6,0,12,2,21,1,0,1
6694,2014,11,2014-11-22,Wake Forest,,Virginia Tech,W (6-3),18,32,56.3,160,0,42,74,1.8,0,74,234,3.2,8,6,1,15,4,43,0,1,1
6695,2014,12,2014-11-29,Wake Forest,@,Duke,L (21-41),24,36,66.7,251,3,24,64,2.7,0,60,315,5.3,11,5,2,18,3,35,2,0,2
6696,2014,,12 Games,Wake Forest,,,,225,385,58.4,2116,12,383,479,1.3,4,768,2595,3.4,102,51,19,172,60,574,7,14,21
6697,2015,1,2015-09-03,Wake Forest,,Elon,W (41-3),29,40,72.5,388,3,42,203,4.8,2,82,591,7.2,19,8,2,29,3,30,0,0,0
6698,2015,2,2015-09-12,Wake Forest,@,Syracuse,L (17-30),30,45,66.7,373,1,32,46,1.4,1,77,419,5.4,17,5,1,23,6,52,0,3,3
6699,2015,3,2015-09-19,Wake Forest,@,Army,W (17-14),18,33,54.5,175,0,35,171,4.9,2,68,346,5.1,7,9,3,19,6,47,0,3,3
6700,2015,4,2015-09-26,Wake Forest,,Indiana,L (24-31),20,48,41.7,264,1,32,99,3.1,2,80,363,4.5,15,5,5,25,7,48,0,1,1
6701,2015,5,2015-10-03,Wake Forest,,Florida State,L (16-24),27,43,62.8,215,1,36,142,3.9,0,79,357,4.5,12,10,5,27,5,32,1,1,2
6702,2015,6,2015-10-10,Wake Forest,@,Boston College,W (3-0),11,25,44.0,109,0,28,33,1.2,0,53,142,2.7,4,1,0,5,9,102,1,1,2
6703,2015,7,2015-10-17,Wake Forest,@,North Carolina,L (14-50),20,30,66.7,197,2,43,113,2.6,0,73,310,4.2,9,6,1,16,3,24,1,0,1
6704,2015,8,2015-10-24,Wake Forest,,North Carolina State,L (17-35),14,30,46.7,122,0,38,149,3.9,2,68,271,4.0,7,6,4,17,3,35,0,1,1
6705,2015,9,2015-10-30,Wake Forest,,Louisville,L (19-20),9,30,30.0,226,2,32,40,1.3,0,62,266,4.3,7,2,2,11,3,29,1,4,5
6706,2015,10,2015-11-14,Wake Forest,@,Notre Dame,L (7-28),19,30,63.3,219,0,44,121,2.8,1,74,340,4.6,9,11,3,23,5,58,0,1,1
6707,2015,11,2015-11-21,Wake Forest,@,Clemson,L (13-33),16,28,57.1,113,1,32,39,1.2,1,60,152,2.5,5,4,2,11,6,55,1,1,2
6708,2015,12,2015-11-28,Wake Forest,,Duke,L (21-27),23,35,65.7,338,2,23,112,4.9,1,58,450,7.8,12,7,2,21,5,51,1,2,3
6709,2015,,12 Games,Wake Forest,,,,236,417,56.6,2739,13,417,1268,3.0,12,834,4007,4.8,123,74,30,227,61,563,6,18,24
6710,2016,1,2016-09-01,Wake Forest,,Tulane,W (7-3),12,21,57.1,96,0,34,79,2.3,1,55,175,3.2,4,6,0,10,5,45,0,0,0
6711,2016,2,2016-09-10,Wake Forest,@,Duke,W (24-14),9,16,56.3,150,0,49,239,4.9,3,65,389,6.0,4,9,0,13,4,24,1,1,2
6712,2016,3,2016-09-17,Wake Forest,,Delaware,W (38-21),15,28,53.6,179,1,59,302,5.1,4,87,481,5.5,10,19,0,29,6,60,1,1,2
6713,2016,4,2016-09-24,Wake Forest,@,Indiana,W (33-28),16,29,55.2,172,1,50,180,3.6,2,79,352,4.5,9,9,3,21,5,40,0,0,0
6714,2016,5,2016-10-01,Wake Forest,@,North Carolina State,L (16-33),27,46,58.7,283,1,21,69,3.3,0,67,352,5.3,14,4,5,23,3,38,0,0,0
6715,2016,6,2016-10-08,Wake Forest,,Syracuse,W (28-9),13,22,59.1,140,0,51,190,3.7,3,73,330,4.5,7,12,2,21,1,5,1,1,2
6716,2016,7,2016-10-15,Wake Forest,@,Florida State,L (6-17),16,34,47.1,184,0,32,68,2.1,0,66,252,3.8,8,4,1,13,5,40,1,2,3
6717,2016,8,2016-10-29,Wake Forest,,Army,L (13-21),23,43,53.5,220,1,23,123,5.3,0,66,343,5.2,7,10,0,17,7,45,0,3,3
6718,2016,9,2016-11-05,Wake Forest,,Virginia,W (27-20),9,10,90.0,83,1,51,226,4.4,1,61,309,5.1,5,10,1,16,6,32,0,0,0
6719,2016,10,2016-11-12,Wake Forest,@,Louisville,L (12-44),13,24,54.2,141,0,49,73,1.5,0,73,214,2.9,6,7,3,16,4,25,1,1,2
6720,2016,11,2016-11-19,Wake Forest,,Clemson,L (13-35),7,18,38.9,126,0,36,71,2.0,1,54,197,3.6,2,6,1,9,5,44,0,0,0
6721,2016,12,2016-11-26,Wake Forest,,Boston College,L (14-17),16,33,48.5,137,2,35,150,4.3,0,68,287,4.2,7,5,3,15,3,35,1,2,3
6722,2016,13,2016-12-27,Wake Forest,N,Temple*,W (34-26),14,29,48.3,243,2,43,125,2.9,2,72,368,5.1,11,10,1,22,7,68,0,2,2
6723,2016,,13 Games,Wake Forest,,,,190,353,53.8,2154,9,533,1895,3.6,17,886,4049,4.6,94,111,20,225,61,501,6,13,19
6724,2017,1,2017-08-31,Wake Forest,,Presbyterian,W (51-7),20,27,74.1,239,5,45,248,5.5,2,72,487,6.8,10,16,2,28,4,25,0,1,1
6725,2017,2,2017-09-09,Wake Forest,@,Boston College,W (34-10),13,19,68.4,151,1,52,158,3.0,2,71,309,4.4,7,8,0,15,5,40,0,0,0
6726,2017,3,2017-09-16,Wake Forest,,Utah State,W (46-10),16,27,59.3,297,2,59,291,4.9,3,86,588,6.8,11,13,2,26,8,62,0,0,0
6727,2017,4,2017-09-23,Wake Forest,@,Appalachian State,W (20-19),14,27,51.9,176,2,40,168,4.2,0,67,344,5.1,9,7,2,18,8,66,0,0,0
6728,2017,5,2017-09-30,Wake Forest,,Florida State,L (19-26),24,35,68.6,271,0,34,96,2.8,2,69,367,5.3,13,4,0,17,7,59,1,1,2
6729,2017,6,2017-10-07,Wake Forest,@,Clemson,L (14-28),14,30,46.7,203,2,35,133,3.8,0,65,336,5.2,8,7,1,16,4,25,0,0,0
6730,2017,7,2017-10-21,Wake Forest,@,Georgia Tech,L (24-38),17,30,56.7,252,2,31,110,3.5,1,61,362,5.9,12,6,2,20,4,40,0,1,1
6731,2017,8,2017-10-28,Wake Forest,,Louisville,W (42-32),28,34,82.4,461,5,39,164,4.2,1,73,625,8.6,16,10,0,26,6,55,1,0,1
6732,2017,9,2017-11-04,Wake Forest,@,Notre Dame,L (37-48),30,48,62.5,348,2,40,239,6.0,3,88,587,6.7,20,13,1,34,3,15,0,1,1
6733,2017,10,2017-11-11,Wake Forest,@,Syracuse,W (64-43),25,38,65.8,363,3,51,371,7.3,5,89,734,8.2,14,18,1,33,10,62,1,0,1
6734,2017,11,2017-11-18,Wake Forest,,North Carolina State,W (30-24),19,28,67.9,247,3,28,87,3.1,1,56,334,6.0,10,7,1,18,4,40,0,1,1
6735,2017,12,2017-11-25,Wake Forest,,Duke,L (23-31),16,34,47.1,191,2,35,145,4.1,0,69,336,4.9,6,6,2,14,2,10,1,2,3
6736,2017,13,2017-12-29,Wake Forest,N,Texas A&M*,W (55-52),32,49,65.3,400,4,46,248,5.4,2,95,648,6.8,18,10,3,31,4,45,2,0,2
6737,2017,,13 Games,Wake Forest,,,,268,426,62.9,3599,33,535,2458,4.6,22,961,6057,6.3,154,125,17,296,69,544,6,7,13
6738,2014,1,2014-08-30,Washington,@,Hawaii,W (17-16),10,26,38.5,162,1,48,174,3.6,1,74,336,4.5,5,12,2,19,5,35,0,0,0
6739,2014,2,2014-09-06,Washington,,Eastern Washington,W (59-52),14,24,58.3,180,1,57,356,6.2,7,81,536,6.6,10,14,2,26,10,100,0,0,0
6740,2014,3,2014-09-13,Washington,,Illinois,W (44-19),16,22,72.7,219,1,58,245,4.2,2,80,464,5.8,7,14,4,25,8,73,1,0,1
6741,2014,4,2014-09-20,Washington,,Georgia State,W (45-14),19,27,70.4,154,3,41,182,4.4,2,68,336,4.9,8,9,0,17,6,53,0,0,0
6742,2014,5,2014-09-27,Washington,,Stanford,L (13-20),15,30,50.0,98,1,38,81,2.1,0,68,179,2.6,4,7,4,15,10,84,0,0,0
6743,2014,6,2014-10-11,Washington,@,California,W (31-7),22,29,75.9,273,3,38,111,2.9,0,67,384,5.7,11,7,0,18,8,76,0,0,0
6744,2014,7,2014-10-18,Washington,@,Oregon,L (20-45),24,38,63.2,184,1,36,133,3.7,1,74,317,4.3,10,8,2,20,4,24,1,1,2
6745,2014,8,2014-10-25,Washington,,Arizona State,L (10-24),18,26,69.2,139,0,46,151,3.3,0,72,290,4.0,7,12,0,19,4,30,1,2,3
6746,2014,9,2014-11-01,Washington,@,Colorado,W (38-23),13,19,68.4,206,2,40,236,5.9,1,59,442,7.5,6,8,0,14,3,24,3,0,3
6747,2014,10,2014-11-08,Washington,,UCLA,L (30-44),14,24,58.3,155,0,48,211,4.4,2,72,366,5.1,6,15,1,22,7,65,0,1,1
6748,2014,11,2014-11-15,Washington,@,Arizona,L (26-27),21,30,70.0,259,1,60,245,4.1,2,90,504,5.6,12,13,0,25,13,111,3,0,3
6749,2014,12,2014-11-22,Washington,,Oregon State,W (37-13),19,24,79.2,255,2,35,226,6.5,2,59,481,8.2,8,8,0,16,6,60,1,0,1
6750,2014,13,2014-11-29,Washington,@,Washington State,W (31-13),25,41,61.0,249,2,37,188,5.1,2,78,437,5.6,13,5,4,22,7,60,0,1,1
6751,2014,14,2015-01-02,Washington,N,Oklahoma State*,L (22-30),25,40,62.5,268,1,25,101,4.0,1,65,369,5.7,14,7,1,22,7,70,1,1,2
6752,2014,,14 Games,Washington,,,,255,400,63.8,2801,19,607,2640,4.3,23,1007,5441,5.4,121,139,20,280,98,865,11,6,17
6753,2015,1,2015-09-04,Washington,@,Boise State,L (13-16),20,35,57.1,150,0,22,29,1.3,0,57,179,3.1,8,1,3,12,5,32,0,1,1
6754,2015,2,2015-09-12,Washington,,Sacramento State,W (49-0),17,25,68.0,326,2,36,218,6.1,5,61,544,8.9,10,10,3,23,3,30,1,0,1
6755,2015,3,2015-09-19,Washington,,Utah State,W (31-17),22,31,71.0,368,3,35,74,2.1,1,66,442,6.7,17,3,0,20,3,38,2,1,3
6756,2015,4,2015-09-26,Washington,,California,L (24-30),17,28,60.7,152,0,27,107,4.0,2,55,259,4.7,9,6,0,15,5,53,3,2,5
6757,2015,5,2015-10-08,Washington,@,Southern California,W (17-12),17,33,51.5,164,1,36,135,3.8,1,69,299,4.3,7,9,1,17,7,60,0,1,1
6758,2015,6,2015-10-17,Washington,,Oregon,L (20-26),20,32,62.5,205,1,30,180,6.0,1,62,385,6.2,8,7,2,17,8,64,0,1,1
6759,2015,7,2015-10-24,Washington,@,Stanford,L (14-31),9,21,42.9,118,0,24,113,4.7,2,45,231,5.1,5,6,0,11,3,30,0,0,0
6760,2015,8,2015-10-31,Washington,,Arizona,W (49-3),17,25,68.0,267,4,36,201,5.6,3,61,468,7.7,14,8,0,22,4,49,0,0,0
6761,2015,9,2015-11-07,Washington,,Utah,L (23-34),23,39,59.0,257,1,39,124,3.2,1,78,381,4.9,12,7,1,20,6,65,3,1,4
6762,2015,10,2015-11-14,Washington,@,Arizona State,L (17-27),28,52,53.8,405,1,34,142,4.2,1,86,547,6.4,19,8,0,27,7,60,1,3,4
6763,2015,11,2015-11-21,Washington,@,Oregon State,W (52-7),18,21,85.7,211,4,59,271,4.6,2,80,482,6.0,12,16,0,28,5,40,0,0,0
6764,2015,12,2015-11-27,Washington,,Washington State,W (45-10),14,20,70.0,203,0,55,240,4.4,3,75,443,5.9,7,14,1,22,10,80,0,1,1
6765,2015,13,2015-12-26,Washington,N,Southern Mississippi*,W (44-31),23,34,67.6,284,0,44,296,6.7,5,78,580,7.4,12,13,2,27,5,50,1,0,1
6766,2015,,13 Games,Washington,,,,245,396,61.9,3110,17,477,2130,4.5,27,873,5240,6.0,140,108,13,261,71,651,11,11,22
6767,2016,1,2016-09-03,Washington,,Rutgers,W (48-13),20,29,69.0,289,4,30,91,3.0,0,59,380,6.4,11,5,1,17,3,30,0,1,1
6768,2016,2,2016-09-10,Washington,,Idaho,W (59-14),27,33,81.8,356,6,30,126,4.2,1,63,482,7.7,20,6,1,27,4,30,1,0,1
6769,2016,3,2016-09-17,Washington,,Portland State,W (41-3),14,22,63.6,194,5,35,213,6.1,1,57,407,7.1,8,11,1,20,5,65,1,0,1
6770,2016,4,2016-09-24,Washington,@,Arizona,W (35-28),14,21,66.7,160,2,51,352,6.9,3,72,512,7.1,7,16,1,24,8,63,0,1,1
6771,2016,5,2016-09-30,Washington,,Stanford,W (44-6),15,21,71.4,210,3,41,214,5.2,3,62,424,6.8,9,10,3,22,5,60,0,0,0
6772,2016,6,2016-10-08,Washington,@,Oregon,W (70-21),22,28,78.6,304,6,45,378,8.4,4,73,682,9.3,13,14,3,30,12,89,0,0,0
6773,2016,7,2016-10-22,Washington,,Oregon State,W (41-17),15,31,48.4,300,3,39,219,5.6,2,70,519,7.4,13,12,1,26,2,10,1,0,1
6774,2016,8,2016-10-29,Washington,@,Utah,W (31-24),12,20,60.0,186,2,36,199,5.5,1,56,385,6.9,12,9,1,22,4,21,0,1,1
6775,2016,9,2016-11-05,Washington,@,California,W (66-27),20,29,69.0,417,7,44,287,6.5,2,73,704,9.6,13,13,5,31,5,35,1,0,1
6776,2016,10,2016-11-12,Washington,,Southern California,L (13-26),17,37,45.9,259,1,27,17,0.6,0,64,276,4.3,9,4,0,13,3,35,0,2,2
6777,2016,11,2016-11-19,Washington,,Arizona State,W (44-18),27,44,61.4,338,2,33,201,6.1,2,77,539,7.0,14,11,1,26,7,70,0,2,2
6778,2016,12,2016-11-25,Washington,@,Washington State,W (45-17),22,31,71.0,342,3,35,168,4.8,3,66,510,7.7,13,8,1,22,9,75,1,0,1
6779,2016,13,2016-12-02,Washington,N,Colorado,W (41-10),9,24,37.5,118,2,54,265,4.9,2,78,383,4.9,4,17,1,22,3,35,0,0,0
6780,2016,14,2016-12-31,Washington,N,Alabama,L (7-24),20,38,52.6,150,1,29,44,1.5,0,67,194,2.9,8,6,0,14,3,10,1,2,3
6781,2016,,14 Games,Washington,,,,254,408,62.3,3623,47,529,2774,5.2,24,937,6397,6.8,154,142,20,316,73,628,6,9,15
6782,2017,1,2017-09-01,Washington,@,Rutgers,W (30-14),17,30,56.7,284,2,24,84,3.5,0,54,368,6.8,12,5,0,17,6,56,0,0,0
6783,2017,2,2017-09-09,Washington,,Montana,W (63-7),24,28,85.7,293,2,37,213,5.8,5,65,506,7.8,15,10,0,25,6,50,0,1,1
6784,2017,3,2017-09-16,Washington,,Fresno State,W (48-16),25,28,89.3,328,4,30,92,3.1,2,58,420,7.2,14,4,3,21,4,41,2,0,2
6785,2017,4,2017-09-23,Washington,@,Colorado,W (37-10),11,21,52.4,160,1,39,254,6.5,3,60,414,6.9,8,11,1,20,3,20,0,1,1
6786,2017,5,2017-09-30,Washington,@,Oregon State,W (42-7),26,34,76.5,293,3,41,216,5.3,3,75,509,6.8,13,13,6,32,3,21,0,1,1
6787,2017,6,2017-10-07,Washington,,California,W (38-7),27,42,64.3,215,2,38,162,4.3,3,80,377,4.7,13,8,1,22,6,40,1,0,1
6788,2017,7,2017-10-14,Washington,@,Arizona State,L (7-13),17,30,56.7,139,0,31,91,2.9,1,61,230,3.8,9,5,0,14,3,15,0,0,0
6789,2017,8,2017-10-28,Washington,,UCLA,W (44-23),9,12,75.0,109,0,58,333,5.7,5,70,442,6.3,6,15,3,24,4,47,1,1,2
6790,2017,9,2017-11-04,Washington,,Oregon,W (38-3),11,19,57.9,204,2,39,247,6.3,2,58,451,7.8,7,11,1,19,4,35,0,1,1
6791,2017,10,2017-11-10,Washington,@,Stanford,L (22-30),17,23,73.9,190,0,33,135,4.1,3,56,325,5.8,8,9,3,20,7,73,1,0,1
6792,2017,11,2017-11-18,Washington,,Utah,W (33-30),26,35,74.3,354,2,32,123,3.8,2,67,477,7.1,16,6,1,23,2,10,0,0,0
6793,2017,12,2017-11-25,Washington,,Washington State,W (41-14),11,17,64.7,93,0,45,328,7.3,5,62,421,6.8,5,14,1,20,2,15,0,0,0
6794,2017,13,2017-12-30,Washington,N,Penn State*,L (28-35),19,29,65.5,227,1,26,104,4.0,3,55,331,6.0,8,5,1,14,4,22,1,0,1
6795,2017,,13 Games,Washington,,,,240,348,69.0,2889,19,473,2382,5.0,37,821,5271,6.4,134,116,21,271,54,445,6,5,11
6796,2014,1,2014-08-28,Washington State,N,Rutgers,L (38-41),40,56,71.4,532,5,14,6,0.4,0,70,538,7.7,18,1,3,22,9,77,1,1,2
6797,2014,2,2014-09-05,Washington State,@,Nevada,L (13-24),38,57,66.7,389,1,18,38,2.1,0,75,427,5.7,20,2,3,25,10,72,0,2,2
6798,2014,3,2014-09-13,Washington State,,Portland State,W (59-21),43,64,67.2,630,7,23,76,3.3,1,87,706,8.1,27,5,1,33,7,70,0,2,2
6799,2014,4,2014-09-20,Washington State,,Oregon,L (31-38),43,63,68.3,436,4,17,63,3.7,0,80,499,6.2,21,4,4,29,5,54,2,0,2
6800,2014,5,2014-09-27,Washington State,@,Utah,W (28-27),39,61,63.9,417,4,25,78,3.1,0,86,495,5.8,19,6,2,27,4,40,1,2,3
6801,2014,6,2014-10-04,Washington State,,California,L (59-60),49,70,70.0,734,6,25,78,3.1,2,95,812,8.5,26,4,3,33,12,121,0,0,0
6802,2014,7,2014-10-10,Washington State,@,Stanford,L (17-34),42,69,60.9,292,2,11,-26,-2.4,0,80,266,3.3,12,4,2,18,10,75,0,1,1
6803,2014,8,2014-10-25,Washington State,,Arizona,L (37-59),56,79,70.9,489,4,20,54,2.7,1,99,543,5.5,25,4,4,33,11,85,0,2,2
6804,2014,9,2014-11-01,Washington State,,Southern California,L (17-44),44,66,66.7,386,2,26,34,1.3,0,92,420,4.6,14,7,2,23,5,48,1,2,3
6805,2014,10,2014-11-08,Washington State,@,Oregon State,W (39-32),44,61,72.1,471,5,22,35,1.6,0,83,506,6.1,26,4,3,33,5,51,0,0,0
6806,2014,11,2014-11-22,Washington State,@,Arizona State,L (31-52),45,76,59.2,601,3,24,21,0.9,1,100,622,6.2,27,2,1,30,7,49,1,4,5
6807,2014,12,2014-11-29,Washington State,,Washington,L (13-31),27,49,55.1,355,2,18,21,1.2,0,67,376,5.6,16,2,2,20,9,70,1,2,3
6808,2014,,12 Games,Washington State,,,,510,771,66.1,5732,45,243,478,2.0,5,1014,6210,6.1,251,45,30,326,94,812,7,18,25
6809,2015,1,2015-09-05,Washington State,,Portland State,L (17-24),28,45,62.2,307,2,30,104,3.5,0,75,411,5.5,13,7,1,21,5,32,1,1,2
6810,2015,2,2015-09-12,Washington State,@,Rutgers,W (37-34),47,66,71.2,478,4,16,81,5.1,0,82,559,6.8,21,6,1,28,5,50,0,0,0
6811,2015,3,2015-09-19,Washington State,,Wyoming,W (31-14),37,45,82.2,303,2,20,75,3.8,2,65,378,5.8,14,4,1,19,5,43,0,1,1
6812,2015,4,2015-10-03,Washington State,@,California,L (28-34),35,49,71.4,389,2,25,14,0.6,2,74,403,5.4,16,4,0,20,2,13,3,1,4
6813,2015,5,2015-10-10,Washington State,@,Oregon,W (45-38),50,75,66.7,505,5,30,136,4.5,1,105,641,6.1,22,8,1,31,7,45,2,0,2
6814,2015,6,2015-10-17,Washington State,,Oregon State,W (52-31),40,52,76.9,409,6,22,111,5.0,0,74,520,7.0,22,10,0,32,6,60,1,2,3
6815,2015,7,2015-10-24,Washington State,@,Arizona,W (45-42),47,62,75.8,514,5,31,117,3.8,1,93,631,6.8,23,9,2,34,9,51,0,0,0
6816,2015,8,2015-10-31,Washington State,,Stanford,L (28-30),35,63,55.6,354,2,23,88,3.8,0,86,442,5.1,19,5,2,26,4,30,0,2,2
6817,2015,9,2015-11-07,Washington State,,Arizona State,W (38-24),36,55,65.5,497,5,17,15,0.9,0,72,512,7.1,18,3,0,21,2,20,0,1,1
6818,2015,10,2015-11-14,Washington State,@,UCLA,W (31-27),40,58,69.0,388,3,22,38,1.7,1,80,426,5.3,18,5,3,26,9,45,0,1,1
6819,2015,11,2015-11-21,Washington State,,Colorado,W (27-3),40,57,70.2,332,2,21,149,7.1,1,78,481,6.2,21,7,2,30,6,40,0,1,1
6820,2015,12,2015-11-27,Washington State,@,Washington,L (10-45),36,58,62.1,288,1,12,31,2.6,0,70,319,4.6,16,1,2,19,4,28,5,2,7
6821,2015,13,2015-12-26,Washington State,N,Miami (FL)*,W (20-14),29,53,54.7,295,2,25,87,3.5,0,78,382,4.9,12,7,4,23,5,63,1,0,1
6822,2015,,13 Games,Washington State,,,,500,738,67.8,5059,41,294,1046,3.6,8,1032,6105,5.9,235,76,19,330,69,520,13,12,25
6823,2016,1,2016-09-03,Washington State,,Eastern Washington,L (42-45),41,52,78.8,418,4,25,97,3.9,2,77,515,6.7,23,5,4,32,12,101,0,1,1
6824,2016,2,2016-09-10,Washington State,@,Boise State,L (28-31),55,71,77.5,480,4,20,40,2.0,0,91,520,5.7,21,4,1,26,10,79,0,1,1
6825,2016,3,2016-09-17,Washington State,,Idaho,W (56-6),27,44,61.4,281,3,35,228,6.5,3,79,509,6.4,12,12,2,26,11,108,0,1,1
6826,2016,4,2016-10-01,Washington State,,Oregon,W (51-33),36,48,75.0,371,1,40,280,7.0,6,88,651,7.4,23,12,1,36,5,37,0,0,0
6827,2016,5,2016-10-08,Washington State,@,Stanford,W (42-16),30,41,73.2,357,4,30,101,3.4,2,71,458,6.5,15,5,1,21,10,81,0,2,2
6828,2016,6,2016-10-15,Washington State,,UCLA,W (27-21),28,48,58.3,261,0,35,95,2.7,3,83,356,4.3,15,6,4,25,8,60,1,1,2
6829,2016,7,2016-10-22,Washington State,@,Arizona State,W (37-32),42,53,79.2,398,3,17,-38,-2.2,1,70,360,5.1,21,1,2,24,3,25,0,0,0
6830,2016,8,2016-10-29,Washington State,@,Oregon State,W (35-31),33,46,71.7,415,5,26,137,5.3,0,72,552,7.7,17,7,3,27,6,65,2,0,2
6831,2016,9,2016-11-05,Washington State,,Arizona,W (69-7),47,52,90.4,474,6,32,140,4.4,3,84,614,7.3,22,7,5,34,9,85,0,0,0
6832,2016,10,2016-11-12,Washington State,,California,W (56-21),39,55,70.9,400,5,31,254,8.2,2,86,654,7.6,18,13,3,34,12,120,0,1,1
6833,2016,11,2016-11-19,Washington State,@,Colorado,L (24-38),26,53,49.1,325,3,22,137,6.2,0,75,462,6.2,14,5,2,21,5,35,1,1,2
6834,2016,12,2016-11-25,Washington State,,Washington,L (17-45),33,50,66.0,269,1,24,65,2.7,1,74,334,4.5,13,3,2,18,5,44,1,3,4
6835,2016,13,2016-12-27,Washington State,N,Minnesota*,L (12-17),30,51,58.8,264,1,23,39,1.7,0,74,303,4.1,11,4,1,16,7,56,0,1,1
6836,2016,,13 Games,Washington State,,,,467,664,70.3,4713,40,360,1575,4.4,23,1024,6288,6.1,225,84,31,340,103,896,5,12,17
6837,2017,1,2017-09-02,Washington State,,Montana State,W (31-0),40,48,83.3,361,3,25,150,6.0,1,73,511,7.0,18,9,0,27,4,32,1,0,1
6838,2017,2,2017-09-09,Washington State,,Boise State,W (47-44),49,67,73.1,433,3,27,22,0.8,1,94,455,4.8,22,3,0,25,5,55,1,2,3
6839,2017,3,2017-09-16,Washington State,,Oregon State,W (52-23),42,58,72.4,431,6,16,60,3.8,0,74,491,6.6,23,2,2,27,7,50,0,0,0
6840,2017,4,2017-09-23,Washington State,,Nevada,W (45-7),38,50,76.0,505,5,34,55,1.6,1,84,560,6.7,20,8,3,31,5,55,1,1,2
6841,2017,5,2017-09-29,Washington State,,Southern California,W (30-27),34,51,66.7,340,2,30,122,4.1,1,81,462,5.7,13,7,3,23,6,59,0,1,1
6842,2017,6,2017-10-07,Washington State,@,Oregon,W (33-10),24,42,57.1,282,3,25,87,3.5,0,67,369,5.5,10,4,6,19,6,74,2,0,2
6843,2017,7,2017-10-13,Washington State,@,California,L (3-37),32,48,66.7,314,0,26,23,0.9,0,74,337,4.6,10,3,1,16,5,50,2,5,7
6844,2017,8,2017-10-21,Washington State,,Colorado,W (28-0),20,43,46.5,212,3,35,194,5.5,1,78,406,5.2,10,10,1,21,6,70,2,0,2
6845,2017,9,2017-10-28,Washington State,@,Arizona,L (37-58),58,84,69.0,602,3,17,44,2.6,2,101,646,6.4,28,3,1,32,7,50,0,4,4
6846,2017,10,2017-11-04,Washington State,,Stanford,W (24-21),34,48,70.8,337,3,29,93,3.2,0,77,430,5.6,17,7,1,25,4,25,0,1,1
6847,2017,11,2017-11-11,Washington State,@,Utah,W (33-25),40,69,58.0,311,3,17,27,1.6,0,86,338,3.9,15,3,2,20,10,66,0,2,2
6848,2017,12,2017-11-25,Washington State,@,Washington,L (14-41),37,55,67.3,369,1,14,-24,-1.7,1,69,345,5.0,18,1,0,19,4,34,1,3,4
6849,2017,13,2017-12-28,Washington State,N,Michigan State*,L (17-42),39,50,78.0,272,2,8,24,3.0,0,58,296,5.1,13,2,2,17,4,46,1,1,2
6850,2017,,13 Games,Washington State,,,,487,713,68.3,4769,37,303,877,2.9,8,1016,5646,5.6,217,62,22,302,73,666,11,20,31
6851,2014,1,2014-08-30,West Virginia,N,Alabama,L (23-33),29,45,64.4,365,1,24,28,1.2,0,69,393,5.7,17,5,0,22,6,55,0,0,0
6852,2014,2,2014-09-06,West Virginia,,Towson,W (54-0),38,44,86.4,355,2,52,251,4.8,5,96,606,6.3,18,14,1,33,3,35,1,0,1
6853,2014,3,2014-09-13,West Virginia,@,Maryland,W (40-37),37,49,75.5,511,4,59,183,3.1,1,108,694,6.4,18,13,2,33,4,40,3,1,4
6854,2014,4,2014-09-20,West Virginia,,Oklahoma,L (33-45),25,41,61.0,376,2,40,137,3.4,2,81,513,6.3,14,9,3,26,5,55,1,2,3
6855,2014,5,2014-10-04,West Virginia,,Kansas,W (33-14),20,37,54.1,302,1,42,255,6.1,1,79,557,7.1,11,9,5,25,5,45,2,1,3
6856,2014,6,2014-10-11,West Virginia,@,Texas Tech,W (37-34),28,44,63.6,301,2,50,249,5.0,2,94,550,5.9,14,11,4,29,7,63,1,0,1
6857,2014,7,2014-10-18,West Virginia,,Baylor,W (41-27),23,35,65.7,322,3,50,134,2.7,2,85,456,5.4,13,10,10,33,14,138,2,1,3
6858,2014,8,2014-10-25,West Virginia,@,Oklahoma State,W (34-10),21,30,70.0,238,2,44,210,4.8,1,74,448,6.1,9,11,2,22,7,57,0,0,0
6859,2014,9,2014-11-01,West Virginia,,Texas Christian,L (30-31),15,26,57.7,162,1,54,195,3.6,1,80,357,4.5,8,9,0,17,6,40,3,2,5
6860,2014,10,2014-11-08,West Virginia,@,Texas,L (16-33),36,49,73.5,248,0,41,200,4.9,2,90,448,5.0,13,10,1,24,8,57,1,1,2
6861,2014,11,2014-11-20,West Virginia,,Kansas State,L (20-26),27,48,56.3,310,2,37,123,3.3,0,85,433,5.1,14,9,4,27,8,77,2,2,4
6862,2014,12,2014-11-29,West Virginia,@,Iowa State,W (37-24),21,41,51.2,285,3,38,285,7.5,1,79,570,7.2,15,9,1,25,5,50,2,0,2
6863,2014,13,2014-12-29,West Virginia,N,Texas A&M*,L (37-45),20,45,44.4,346,3,32,126,3.9,0,77,472,6.1,11,6,4,21,7,45,1,0,1
6864,2014,,13 Games,West Virginia,,,,340,534,63.7,4121,26,563,2376,4.2,18,1097,6497,5.9,175,125,37,337,85,757,19,10,29
6865,2015,1,2015-09-05,West Virginia,,Georgia Southern,W (44-0),16,26,61.5,359,2,40,185,4.6,3,66,544,8.2,11,10,0,21,5,37,0,0,0
6866,2015,2,2015-09-12,West Virginia,,Liberty,W (41-17),27,32,84.4,313,3,45,172,3.8,2,77,485,6.3,15,9,1,25,6,58,0,0,0
6867,2015,3,2015-09-26,West Virginia,,Maryland,W (45-6),23,37,62.2,297,4,59,304,5.2,2,96,601,6.3,16,15,6,37,10,124,1,1,2
6868,2015,4,2015-10-03,West Virginia,@,Oklahoma,L (24-44),17,32,53.1,173,1,54,196,3.6,2,86,369,4.3,9,10,8,27,11,111,2,3,5
6869,2015,5,2015-10-10,West Virginia,,Oklahoma State,L (26-33),18,37,48.6,188,1,61,255,4.2,2,98,443,4.5,9,14,3,26,11,107,3,1,4
6870,2015,6,2015-10-17,West Virginia,@,Baylor,L (38-62),18,39,46.2,289,4,44,182,4.1,0,83,471,5.7,8,9,5,22,8,80,0,1,1
6871,2015,7,2015-10-29,West Virginia,@,Texas Christian,L (10-40),16,39,41.0,160,1,37,167,4.5,0,76,327,4.3,7,10,4,21,9,114,0,1,1
6872,2015,8,2015-11-07,West Virginia,,Texas Tech,W (31-26),12,24,50.0,149,0,57,300,5.3,4,81,449,5.5,7,17,4,28,4,40,0,2,2
6873,2015,9,2015-11-14,West Virginia,,Texas,W (38-20),10,12,83.3,122,2,51,257,5.0,2,63,379,6.0,6,12,0,18,5,48,0,1,1
6874,2015,10,2015-11-21,West Virginia,@,Kansas,W (49-0),16,32,50.0,204,1,55,426,7.7,5,87,630,7.2,11,18,1,30,5,52,0,2,2
6875,2015,11,2015-11-28,West Virginia,,Iowa State,W (30-6),12,26,46.2,202,1,45,213,4.7,2,71,415,5.8,6,13,0,19,5,45,0,1,1
6876,2015,12,2015-12-05,West Virginia,@,Kansas State,L (23-24),19,42,45.2,281,1,42,166,4.0,1,84,447,5.3,14,8,0,22,3,40,1,0,1
6877,2015,13,2016-01-02,West Virginia,N,Arizona State*,W (43-42),28,51,54.9,532,5,33,144,4.4,0,84,676,8.0,20,8,1,29,5,54,0,2,2
6878,2015,,13 Games,West Virginia,,,,232,429,54.1,3269,26,623,2967,4.8,25,1052,6236,5.9,139,153,33,325,87,910,7,15,22
6879,2016,1,2016-09-03,West Virginia,,Missouri,W (26-11),23,37,62.2,253,0,48,241,5.0,2,85,494,5.8,13,9,2,24,4,45,1,2,3
6880,2016,2,2016-09-10,West Virginia,,Youngstown State,W (38-21),20,33,60.6,389,5,46,235,5.1,0,79,624,7.9,16,11,3,30,6,49,0,1,1
6881,2016,3,2016-09-24,West Virginia,N,Brigham Young,W (35-32),31,40,77.5,332,1,35,149,4.3,3,75,481,6.4,17,7,2,26,4,38,1,1,2
6882,2016,4,2016-10-01,West Virginia,,Kansas State,W (17-16),24,41,58.5,298,1,35,124,3.5,1,76,422,5.6,15,6,0,21,6,60,1,1,2
6883,2016,5,2016-10-15,West Virginia,@,Texas Tech,W (48-17),21,31,67.7,318,1,46,332,7.2,5,77,650,8.4,12,15,1,28,9,95,0,0,0
6884,2016,6,2016-10-22,West Virginia,,Texas Christian,W (34-10),16,23,69.6,231,4,48,158,3.3,0,71,389,5.5,12,11,2,25,7,45,0,0,0
6885,2016,7,2016-10-29,West Virginia,@,Oklahoma State,L (20-37),24,39,61.5,212,1,41,209,5.1,1,80,421,5.3,14,12,1,27,6,46,1,2,3
6886,2016,8,2016-11-05,West Virginia,,Kansas,W (48-21),17,28,60.7,264,3,47,341,7.3,3,75,605,8.1,11,13,4,28,6,59,1,0,1
6887,2016,9,2016-11-12,West Virginia,@,Texas,W (24-20),21,35,60.0,269,1,38,114,3.0,2,73,383,5.2,15,7,0,22,5,55,1,3,4
6888,2016,10,2016-11-19,West Virginia,,Oklahoma,L (28-56),12,27,44.4,191,2,38,388,10.2,2,65,579,8.9,6,14,2,22,7,91,3,1,4
6889,2016,11,2016-11-26,West Virginia,@,Iowa State,W (49-19),13,23,56.5,341,5,51,272,5.3,2,74,613,8.3,10,13,2,25,8,70,0,0,0
6890,2016,12,2016-12-03,West Virginia,,Baylor,W (24-21),10,26,38.5,111,2,62,311,5.0,1,88,422,4.8,5,14,6,25,6,62,0,0,0
6891,2016,13,2016-12-28,West Virginia,N,Miami (FL)*,L (14-31),17,26,65.4,134,0,39,95,2.4,2,65,229,3.5,6,3,2,11,11,108,1,0,1
6892,2016,,13 Games,West Virginia,,,,249,409,60.9,3343,26,574,2969,5.2,24,983,6312,6.4,152,135,27,314,85,823,10,11,21
6893,2017,1,2017-09-03,West Virginia,N,Virginia Tech,L (24-31),31,54,57.4,371,3,35,221,6.3,0,89,592,6.7,17,12,0,29,9,81,0,1,1
6894,2017,2,2017-09-09,West Virginia,,East Carolina,W (56-20),24,34,70.6,403,5,47,211,4.5,3,81,614,7.6,15,13,3,31,4,55,0,0,0
6895,2017,3,2017-09-16,West Virginia,,Delaware State,W (59-16),24,34,70.6,334,4,35,204,5.8,4,69,538,7.8,10,11,2,23,6,60,2,1,3
6896,2017,4,2017-09-23,West Virginia,@,Kansas,W (56-34),25,39,64.1,347,2,43,288,6.7,5,82,635,7.7,15,14,2,31,4,42,0,1,1
6897,2017,5,2017-10-07,West Virginia,@,Texas Christian,L (24-31),25,45,55.6,366,3,39,142,3.6,0,84,508,6.0,15,9,4,28,2,25,1,1,2
6898,2017,6,2017-10-14,West Virginia,,Texas Tech,W (46-35),32,41,78.0,352,5,29,44,1.5,1,70,396,5.7,16,5,7,28,9,93,0,1,1
6899,2017,7,2017-10-21,West Virginia,@,Baylor,W (38-36),26,37,70.3,375,5,29,118,4.1,0,66,493,7.5,15,7,1,23,11,134,0,0,0
6900,2017,8,2017-10-28,West Virginia,,Oklahoma State,L (39-50),20,42,47.6,285,2,30,62,2.1,1,72,347,4.8,10,6,3,19,6,41,1,4,5
6901,2017,9,2017-11-04,West Virginia,,Iowa State,W (20-16),20,25,80.0,316,2,47,208,4.4,0,72,524,7.3,12,11,0,23,8,85,0,1,1
6902,2017,10,2017-11-11,West Virginia,@,Kansas State,W (28-23),27,46,58.7,372,4,26,120,4.6,0,72,492,6.8,13,7,0,20,3,21,2,2,4
6903,2017,11,2017-11-18,West Virginia,,Texas,L (14-28),20,34,58.8,239,1,29,56,1.9,0,63,295,4.7,12,3,2,17,6,49,2,0,2
6904,2017,12,2017-11-25,West Virginia,@,Oklahoma,L (31-59),10,20,50.0,137,0,51,250,4.9,4,71,387,5.5,4,14,6,24,6,39,2,0,2
6905,2017,13,2017-12-26,West Virginia,N,Utah*,L (14-30),10,30,33.3,124,1,21,29,1.4,0,51,153,3.0,5,1,0,6,5,51,2,2,4
6906,2017,,13 Games,West Virginia,,,,294,481,61.1,4021,37,461,1953,4.2,18,942,5974,6.3,159,113,30,302,79,776,12,14,26
6907,2016,1,2016-09-03,Western Carolina,@,East Carolina,L (7-52),13,27,48.1,172,0,38,148,3.9,1,65,320,4.9,7,7,1,15,5,31,0,1,1
6908,2016,2,2016-11-19,Western Carolina,@,South Carolina,L (31-44),7,18,38.9,131,0,43,236,5.5,3,61,367,6.0,4,13,0,17,3,22,1,0,1
6909,2016,,2 Games,Western Carolina,,,,20,45,44.4,303,0,81,384,4.7,4,126,687,5.5,11,20,1,32,8,53,1,1,2
6910,2017,1,2017-09-02,Western Carolina,@,Hawaii,L (18-41),23,41,56.1,270,1,48,212,4.4,1,89,482,5.4,11,16,3,30,8,74,2,1,3
6911,2017,2,2017-11-18,Western Carolina,@,North Carolina,L (10-65),16,33,48.5,153,1,37,151,4.1,0,70,304,4.3,6,10,1,17,3,27,2,0,2
6912,2017,,2 Games,Western Carolina,,,,39,74,52.7,423,2,85,363,4.3,1,159,786,4.9,17,26,4,47,11,101,4,1,5
6913,2014,1,2014-08-29,Western Kentucky,,Bowling Green State,W (59-31),46,56,82.1,569,6,40,139,3.5,2,96,708,7.4,29,9,2,40,7,66,0,0,0
6914,2014,2,2014-09-06,Western Kentucky,@,Illinois,L (34-42),28,48,58.3,297,2,30,103,3.4,1,78,400,5.1,17,5,1,23,5,24,2,1,3
6915,2014,3,2014-09-13,Western Kentucky,@,Middle Tennessee State,L (47-50),43,66,65.2,593,4,36,125,3.5,1,102,718,7.0,22,9,2,33,10,92,0,1,1
6916,2014,4,2014-09-27,Western Kentucky,@,Navy,W (36-27),38,54,70.4,387,2,34,164,4.8,1,88,551,6.3,19,11,0,30,7,66,0,1,1
6917,2014,5,2014-10-04,Western Kentucky,,Alabama-Birmingham,L (39-42),25,37,67.6,319,2,28,184,6.6,3,65,503,7.7,14,9,2,25,6,50,0,0,0
6918,2014,6,2014-10-18,Western Kentucky,@,Florida Atlantic,L (38-45),28,44,63.6,335,3,26,67,2.6,2,70,402,5.7,16,4,3,23,3,25,1,1,2
6919,2014,7,2014-10-25,Western Kentucky,,Old Dominion,W (66-51),23,26,88.5,371,5,45,230,5.1,2,71,601,8.5,17,13,2,32,3,40,2,0,2
6920,2014,8,2014-11-01,Western Kentucky,@,Louisiana Tech,L (10-59),16,39,41.0,145,1,33,152,4.6,0,72,297,4.1,6,9,0,15,8,93,1,4,5
6921,2014,9,2014-11-08,Western Kentucky,,Texas-El Paso,W (35-27),23,34,67.6,324,3,21,34,1.6,1,55,358,6.5,13,2,1,16,3,24,0,0,0
6922,2014,10,2014-11-15,Western Kentucky,,Army,W (52-24),16,25,64.0,178,3,41,383,9.3,4,66,561,8.5,6,16,0,22,7,80,0,0,0
6923,2014,11,2014-11-22,Western Kentucky,,Texas-San Antonio,W (45-7),26,35,74.3,346,5,28,120,4.3,1,63,466,7.4,13,6,6,25,4,40,0,0,0
6924,2014,12,2014-11-28,Western Kentucky,@,Marshall,W (67-66),35,51,68.6,516,8,35,222,6.3,1,86,738,8.6,22,13,2,37,4,38,0,2,2
6925,2014,13,2014-12-24,Western Kentucky,N,Central Michigan*,W (49-48),31,42,73.8,486,5,32,161,5.0,2,74,647,8.7,22,6,2,30,9,105,2,0,2
6926,2014,,13 Games,Western Kentucky,,,,378,557,67.9,4866,49,429,2084,4.9,21,986,6950,7.0,216,112,23,351,76,743,8,10,18
6927,2015,1,2015-09-03,Western Kentucky,@,Vanderbilt,W (14-12),19,30,63.3,209,1,23,37,1.6,1,53,246,4.6,7,4,0,11,9,70,0,0,0
6928,2015,2,2015-09-10,Western Kentucky,,Louisiana Tech,W (41-38),28,38,73.7,441,1,33,149,4.5,2,71,590,8.3,18,6,0,24,10,109,1,0,1
6929,2015,3,2015-09-19,Western Kentucky,@,Indiana,L (35-38),35,46,76.1,484,3,26,84,3.2,2,72,568,7.9,21,5,2,28,6,65,0,2,2
6930,2015,4,2015-09-26,Western Kentucky,,Miami (OH),W (56-14),34,42,81.0,464,6,32,105,3.3,2,74,569,7.7,20,6,1,27,6,50,0,0,0
6931,2015,5,2015-10-03,Western Kentucky,@,Rice,W (49-10),29,39,74.4,424,4,32,80,2.5,3,71,504,7.1,16,4,4,24,3,20,0,0,0
6932,2015,6,2015-10-10,Western Kentucky,,Middle Tennessee State,W (58-28),29,37,78.4,428,6,40,165,4.1,1,77,593,7.7,14,8,2,24,3,35,1,1,2
6933,2015,7,2015-10-15,Western Kentucky,@,North Texas,W (55-28),31,43,72.1,400,4,40,283,7.1,3,83,683,8.2,17,17,1,35,7,55,0,1,1
6934,2015,8,2015-10-24,Western Kentucky,@,Louisiana State,L (20-48),37,61,60.7,325,3,23,103,4.5,0,84,428,5.1,16,7,1,24,7,62,1,1,2
6935,2015,9,2015-10-31,Western Kentucky,@,Old Dominion,W (55-30),22,29,75.9,284,3,31,239,7.7,4,60,523,8.7,12,9,1,22,1,5,0,0,0
6936,2015,10,2015-11-07,Western Kentucky,,Florida Atlantic,W (35-19),25,30,83.3,287,5,34,229,6.7,0,64,516,8.1,10,14,1,25,7,85,0,1,1
6937,2015,11,2015-11-21,Western Kentucky,@,Florida International,W (63-7),16,21,76.2,224,3,37,253,6.8,5,58,477,8.2,8,14,1,23,5,70,3,0,3
6938,2015,12,2015-11-27,Western Kentucky,,Marshall,W (49-28),27,40,67.5,370,5,43,176,4.1,1,83,546,6.6,18,10,3,31,8,102,2,0,2
6939,2015,13,2015-12-05,Western Kentucky,,Southern Mississippi,W (45-28),34,52,65.4,410,3,36,111,3.1,3,88,521,5.9,16,7,1,24,2,15,0,1,1
6940,2015,14,2015-12-21,Western Kentucky,N,South Florida*,W (45-35),32,46,69.6,461,3,33,151,4.6,3,79,612,7.7,17,9,1,27,9,66,0,2,2
6941,2015,,14 Games,Western Kentucky,,,,398,554,71.8,5211,50,463,2165,4.7,30,1017,7376,7.3,210,120,19,349,83,809,8,9,17
6942,2016,1,2016-09-01,Western Kentucky,,Rice,W (46-14),26,35,74.3,552,3,30,97,3.2,2,65,649,10.0,17,4,2,23,8,77,0,0,0
6943,2016,2,2016-09-10,Western Kentucky,@,Alabama,L (10-38),19,38,50.0,216,1,22,23,1.0,0,60,239,4.0,9,2,1,12,2,16,0,2,2
6944,2016,3,2016-09-17,Western Kentucky,@,Miami (OH),W (31-24),19,31,61.3,268,2,35,136,3.9,1,66,404,6.1,10,7,2,19,9,126,2,1,3
6945,2016,4,2016-09-24,Western Kentucky,,Vanderbilt,L (30-31),24,40,60.0,291,2,33,205,6.2,2,73,496,6.8,12,12,3,27,11,88,2,1,3
6946,2016,5,2016-10-01,Western Kentucky,,,W (50-3),16,22,72.7,283,3,30,252,8.4,3,52,535,10.3,12,11,0,23,3,35,0,0,0
6947,2016,6,2016-10-06,Western Kentucky,@,Louisiana Tech,L (52-55),36,50,72.0,340,5,23,87,3.8,1,73,427,5.8,18,7,1,26,5,58,2,0,2
6948,2016,7,2016-10-15,Western Kentucky,@,Middle Tennessee State,W (44-43),29,40,72.5,391,2,37,130,3.5,3,77,521,6.8,15,12,1,28,7,64,0,1,1
6949,2016,8,2016-10-22,Western Kentucky,,Old Dominion,W (59-24),28,33,84.8,378,4,35,246,7.0,4,68,624,9.2,17,11,1,29,7,81,0,1,1
6950,2016,9,2016-10-29,Western Kentucky,@,Florida Atlantic,W (52-3),16,25,64.0,393,5,45,268,6.0,2,70,661,9.4,11,11,0,22,8,80,1,0,1
6951,2016,10,2016-11-05,Western Kentucky,,Florida International,W (49-21),18,32,56.3,284,1,37,225,6.1,5,69,509,7.4,14,10,0,24,3,15,2,0,2
6952,2016,11,2016-11-12,Western Kentucky,,North Texas,W (45-7),17,33,51.5,329,5,41,214,5.2,1,74,543,7.3,12,11,2,25,9,55,0,0,0
6953,2016,12,2016-11-26,Western Kentucky,@,Marshall,W (60-6),16,31,51.6,233,3,30,229,7.6,3,61,462,7.6,11,14,2,27,6,80,0,0,0
6954,2016,13,2016-12-03,Western Kentucky,,Louisiana Tech,W (58-44),21,31,67.7,421,3,41,235,5.7,4,72,656,9.1,15,13,3,31,7,75,2,1,3
6955,2016,14,2016-12-20,Western Kentucky,N,Memphis*,W (51-31),20,30,66.7,336,3,48,262,5.5,4,78,598,7.7,11,14,3,28,8,84,0,1,1
6956,2016,,14 Games,Western Kentucky,,,,305,471,64.8,4715,42,487,2609,5.4,35,958,7324,7.6,184,139,21,344,93,934,11,8,19
6957,2017,1,2017-09-02,Western Kentucky,,Eastern Kentucky,W (31-17),20,31,64.5,264,1,40,100,2.5,3,71,364,5.1,10,8,2,20,3,25,1,0,1
6958,2017,2,2017-09-09,Western Kentucky,@,Illinois,L (7-20),28,43,65.1,238,0,16,6,0.4,1,59,244,4.1,8,2,4,14,11,100,1,1,2
6959,2017,3,2017-09-16,Western Kentucky,,Louisiana Tech,L (22-23),25,35,71.4,226,0,41,141,3.4,3,76,367,4.8,13,9,1,23,3,22,0,0,0
6960,2017,4,2017-09-23,Western Kentucky,,Ball State,W (33-21),28,44,63.6,319,1,30,52,1.7,2,74,371,5.0,16,5,1,22,4,35,0,2,2
6961,2017,5,2017-10-07,Western Kentucky,@,Texas-El Paso,W (15-14),24,37,64.9,208,0,33,74,2.2,2,70,282,4.0,12,4,2,18,6,49,0,0,0
6962,2017,6,2017-10-14,Western Kentucky,,UNC Charlotte,W (45-14),43,58,74.1,506,5,34,121,3.6,1,92,627,6.8,22,10,2,34,7,58,1,0,1
6963,2017,7,2017-10-20,Western Kentucky,@,Old Dominion,W (35-31),25,35,71.4,343,5,33,73,2.2,0,68,416,6.1,15,7,1,23,5,25,1,1,2
6964,2017,8,2017-10-28,Western Kentucky,,Florida Atlantic,L (28-42),32,56,57.1,371,2,33,99,3.0,2,89,470,5.3,21,8,3,32,3,35,2,2,4
6965,2017,9,2017-11-04,Western Kentucky,@,Vanderbilt,L (17-31),33,53,62.3,355,1,30,-6,-0.2,1,83,349,4.2,15,4,3,22,5,31,0,1,1
6966,2017,10,2017-11-11,Western Kentucky,@,Marshall,L (23-30),28,42,66.7,334,3,19,34,1.8,0,61,368,6.0,14,6,1,21,6,63,1,1,2
6967,2017,11,2017-11-17,Western Kentucky,,Middle Tennessee State,W (41-38),39,54,72.2,485,5,33,53,1.6,0,87,538,6.2,16,6,3,25,7,69,2,0,2
6968,2017,12,2017-11-24,Western Kentucky,@,Florida International,L (17-41),30,49,61.2,355,2,28,46,1.6,0,77,401,5.2,17,5,1,23,4,32,3,0,3
6969,2017,13,2017-12-16,Western Kentucky,N,Georgia State*,L (17-27),26,40,65.0,351,2,21,-2,-0.1,0,61,349,5.7,14,3,0,17,10,89,1,2,3
6970,2017,,13 Games,Western Kentucky,,,,381,577,66.0,4355,27,391,791,2.0,15,968,5146,5.3,193,77,24,294,74,633,13,10,23
6971,2014,1,2014-08-30,Western Michigan,@,Purdue,L (34-43),23,41,56.1,243,2,32,213,6.7,3,73,456,6.2,13,10,1,24,5,35,0,1,1
6972,2014,2,2014-09-13,Western Michigan,@,Idaho,W (45-33),10,15,66.7,241,3,44,243,5.5,3,59,484,8.2,8,11,3,22,10,93,0,0,0
6973,2014,3,2014-09-20,Western Michigan,,Murray State,W (45-14),20,29,69.0,228,1,54,377,7.0,5,83,605,7.3,13,17,0,30,7,50,0,1,1
6974,2014,4,2014-09-27,Western Michigan,@,Virginia Tech,L (17-35),18,33,54.5,212,0,24,19,0.8,2,57,231,4.1,6,3,1,10,7,85,1,1,2
6975,2014,5,2014-10-04,Western Michigan,,Toledo,L (19-20),31,38,81.6,388,1,32,62,1.9,1,70,450,6.4,16,4,0,20,3,30,0,0,0
6976,2014,6,2014-10-11,Western Michigan,@,Ball State,W (42-38),20,29,69.0,290,3,30,208,6.9,3,59,498,8.4,12,7,1,20,4,45,1,1,2
6977,2014,7,2014-10-18,Western Michigan,@,Bowling Green State,W (26-14),15,24,62.5,166,2,50,195,3.9,1,74,361,4.9,6,13,1,20,5,49,0,0,0
6978,2014,8,2014-10-25,Western Michigan,,Ohio,W (42-21),22,28,78.6,344,2,42,186,4.4,3,70,530,7.6,11,11,2,24,3,36,1,2,3
6979,2014,9,2014-11-01,Western Michigan,@,Miami (OH),W (41-10),18,23,78.3,217,1,47,282,6.0,4,70,499,7.1,9,13,1,23,5,65,1,0,1
6980,2014,10,2014-11-15,Western Michigan,,Eastern Michigan,W (51-7),18,20,90.0,360,4,42,137,3.3,2,62,497,8.0,11,9,1,21,1,10,0,0,0
6981,2014,11,2014-11-22,Western Michigan,@,Central Michigan,W (32-20),16,21,76.2,233,3,37,129,3.5,1,58,362,6.2,9,7,1,17,6,67,1,2,3
6982,2014,12,2014-11-28,Western Michigan,,Northern Illinois,L (21-31),23,33,69.7,256,1,43,91,2.1,1,76,347,4.6,12,8,1,21,4,30,4,2,6
6983,2014,13,2014-12-20,Western Michigan,N,Air Force*,L (24-38),19,38,50.0,297,3,26,79,3.0,0,64,376,5.9,12,4,1,17,9,70,1,0,1
6984,2014,,13 Games,Western Michigan,,,,253,372,68.0,3475,26,503,2221,4.4,29,875,5696,6.5,138,117,14,269,69,665,10,10,20
6985,2015,1,2015-09-04,Western Michigan,,Michigan State,L (24-37),33,50,66.0,365,2,23,18,0.8,0,73,383,5.2,18,2,2,22,8,77,0,2,2
6986,2015,2,2015-09-12,Western Michigan,@,Georgia Southern,L (17-43),24,36,66.7,227,2,26,25,1.0,0,62,252,4.1,14,5,0,19,6,37,1,3,4
6987,2015,3,2015-09-19,Western Michigan,,Murray State,W (52-20),28,33,84.8,391,4,42,237,5.6,2,75,628,8.4,16,16,1,33,6,69,2,0,2
6988,2015,4,2015-09-26,Western Michigan,@,Ohio State,L (12-38),18,33,54.5,169,2,41,169,4.1,0,74,338,4.6,7,11,2,20,8,74,0,1,1
6989,2015,5,2015-10-10,Western Michigan,,Central Michigan,W (41-39),15,22,68.2,262,4,41,215,5.2,1,63,477,7.6,11,11,2,24,5,46,1,0,1
6990,2015,6,2015-10-17,Western Michigan,@,Ohio,W (49-14),14,20,70.0,137,3,44,430,9.8,4,64,567,8.9,6,16,1,23,6,70,0,0,0
6991,2015,7,2015-10-24,Western Michigan,,Miami (OH),W (35-13),25,32,78.1,278,3,47,143,3.0,2,79,421,5.3,14,9,2,25,5,38,0,0,0
6992,2015,8,2015-10-29,Western Michigan,@,Eastern Michigan,W (58-28),18,24,75.0,316,1,36,279,7.8,6,60,595,9.9,13,13,0,26,3,27,0,0,0
6993,2015,9,2015-11-05,Western Michigan,,Ball State,W (54-7),20,27,74.1,353,3,56,358,6.4,4,83,711,8.6,15,15,1,31,6,62,1,0,1
6994,2015,10,2015-11-11,Western Michigan,,Bowling Green State,L (27-41),24,40,60.0,282,0,45,205,4.6,3,85,487,5.7,12,15,0,27,5,45,1,1,2
6995,2015,11,2015-11-18,Western Michigan,@,Northern Illinois,L (19-27),22,39,56.4,353,2,44,139,3.2,0,83,492,5.9,14,10,0,24,8,81,1,1,2
6996,2015,12,2015-11-27,Western Michigan,@,Toledo,W (35-30),13,21,61.9,268,2,40,148,3.7,2,61,416,6.8,8,6,2,16,6,65,1,0,1
6997,2015,13,2015-12-24,Western Michigan,N,Middle Tennessee State*,W (45-31),19,27,70.4,331,2,41,282,6.9,4,68,613,9.0,8,10,0,18,9,62,0,1,1
6998,2015,,13 Games,Western Michigan,,,,273,404,67.6,3732,30,526,2648,5.0,28,930,6380,6.9,156,139,13,308,81,753,8,9,17
6999,2016,1,2016-09-03,Western Michigan,@,Northwestern,W (22-21),26,36,72.2,218,1,48,198,4.1,1,84,416,5.0,12,15,0,27,3,30,0,0,0
7000,2016,2,2016-09-10,Western Michigan,,North Carolina Central,W (70-21),15,23,65.2,255,4,61,359,5.9,5,84,614,7.3,8,22,1,31,7,82,0,0,0
7001,2016,3,2016-09-17,Western Michigan,@,Illinois,W (34-10),9,13,69.2,150,0,54,287,5.3,4,67,437,6.5,6,11,3,20,5,36,0,0,0
7002,2016,4,2016-09-24,Western Michigan,,Georgia Southern,W (49-31),18,27,66.7,270,4,37,137,3.7,1,64,407,6.4,9,10,2,21,7,68,0,0,0
7003,2016,5,2016-10-01,Western Michigan,@,Central Michigan,W (49-10),15,21,71.4,170,3,41,254,6.2,3,62,424,6.8,7,13,2,22,3,30,0,0,0
7004,2016,6,2016-10-08,Western Michigan,,Northern Illinois,W (45-30),18,24,75.0,327,3,50,246,4.9,3,74,573,7.7,11,15,2,28,6,62,0,0,0
7005,2016,7,2016-10-15,Western Michigan,@,Akron,W (41-0),21,31,67.7,207,2,56,378,6.8,4,87,585,6.7,10,20,1,31,4,41,1,0,1
7006,2016,8,2016-10-22,Western Michigan,,Eastern Michigan,W (45-31),29,35,82.9,398,3,38,163,4.3,3,73,561,7.7,18,10,1,29,6,65,1,1,2
7007,2016,9,2016-11-01,Western Michigan,@,Ball State,W (52-20),23,34,67.6,367,3,28,186,6.6,3,62,553,8.9,16,10,0,26,2,10,0,0,0
7008,2016,10,2016-11-08,Western Michigan,@,Kent State,W (37-21),6,13,46.2,83,0,64,329,5.1,4,77,412,5.4,4,20,2,26,4,24,1,0,1
7009,2016,11,2016-11-19,Western Michigan,,Buffalo,W (38-0),29,37,78.4,445,4,34,181,5.3,1,71,626,8.8,17,11,1,29,3,20,1,0,1
7010,2016,12,2016-11-25,Western Michigan,,Toledo,W (55-35),19,25,76.0,196,3,48,249,5.2,3,73,445,6.1,12,11,2,25,7,88,0,0,0
7011,2016,13,2016-12-02,Western Michigan,N,Ohio,W (29-23),19,31,61.3,290,2,44,114,2.6,0,75,404,5.4,10,10,0,20,10,76,0,2,2
7012,2016,14,2017-01-02,Western Michigan,N,Wisconsin*,L (16-24),16,28,57.1,157,1,31,123,4.0,1,59,280,4.7,9,9,0,18,2,15,0,1,1
7013,2016,,14 Games,Western Michigan,,,,263,378,69.6,3533,33,634,3204,5.1,36,1012,6737,6.7,149,187,17,353,69,647,4,4,8
7014,2017,1,2017-09-02,Western Michigan,@,Southern California,L (31-49),12,23,52.2,94,1,48,263,5.5,2,71,357,5.0,5,15,4,24,6,34,0,1,1
7015,2017,2,2017-09-09,Western Michigan,@,Michigan State,L (14-28),12,27,44.4,79,0,36,116,3.2,0,63,195,3.1,4,7,0,11,3,20,0,1,1
7016,2017,3,2017-09-16,Western Michigan,,Idaho,W (37-28),21,31,67.7,212,1,42,135,3.2,3,73,347,4.8,10,10,0,20,6,70,1,0,1
7017,2017,4,2017-09-23,Western Michigan,,Wagner,W (49-14),11,12,91.7,165,3,51,362,7.1,4,63,527,8.4,6,16,1,23,10,92,2,0,2
7018,2017,5,2017-09-30,Western Michigan,,Ball State,W (55-3),15,21,71.4,245,3,43,169,3.9,3,64,414,6.5,12,9,0,21,5,50,0,0,0
7019,2017,6,2017-10-07,Western Michigan,@,Buffalo,W (71-68),24,31,77.4,269,6,68,376,5.5,4,99,645,6.5,13,20,0,33,10,95,0,2,2
7020,2017,7,2017-10-15,Western Michigan,,Akron,L (13-14),17,29,58.6,182,1,53,244,4.6,0,82,426,5.2,7,17,2,26,6,62,0,1,1
7021,2017,8,2017-10-21,Western Michigan,@,Eastern Michigan,W (20-17),18,27,66.7,202,1,42,220,5.2,1,69,422,6.1,12,10,3,25,6,47,2,0,2
7022,2017,9,2017-11-01,Western Michigan,,Central Michigan,L (28-35),6,18,33.3,42,0,54,315,5.8,4,72,357,5.0,2,14,1,17,6,54,3,1,4
7023,2017,10,2017-11-08,Western Michigan,,Kent State,W (48-20),8,19,42.1,97,0,50,292,5.8,3,69,389,5.6,7,9,2,18,3,29,1,0,1
7024,2017,11,2017-11-15,Western Michigan,@,Northern Illinois,L (31-35),15,27,55.6,211,2,44,110,2.5,2,71,321,4.5,7,9,1,17,3,35,1,0,1
7025,2017,12,2017-11-24,Western Michigan,@,Toledo,L (10-37),13,29,44.8,180,1,31,95,3.1,0,60,275,4.6,9,5,1,15,4,53,0,2,2
7026,2017,,12 Games,Western Michigan,,,,172,294,58.5,1978,19,562,2697,4.8,26,856,4675,5.5,94,141,15,250,68,641,10,8,18
7027,2016,1,2016-09-01,William & Mary,@,North Carolina State,L (14-48),10,19,52.6,106,1,28,62,2.2,1,47,168,3.6,5,2,3,10,8,70,0,2,2
7028,2017,1,2017-09-02,William & Mary,@,Virginia,L (10-28),7,13,53.8,72,0,41,168,4.1,1,54,240,4.4,3,9,0,12,2,10,0,1,1
7029,2014,1,2014-08-30,Wisconsin,N,Louisiana State,L (24-28),8,24,33.3,50,0,39,268,6.9,3,63,318,5.0,3,10,1,14,3,26,0,2,2
7030,2014,2,2014-09-06,Wisconsin,,Western Illinois,W (37-3),24,29,82.8,289,4,39,167,4.3,1,68,456,6.7,17,8,0,25,4,38,0,1,1
7031,2014,3,2014-09-20,Wisconsin,,Bowling Green State,W (68-17),9,18,50.0,112,1,60,644,10.7,8,78,756,9.7,3,26,0,29,5,55,2,1,3
7032,2014,4,2014-09-27,Wisconsin,,South Florida,W (27-10),11,18,61.1,160,1,57,294,5.2,2,75,454,6.1,8,14,4,26,4,35,1,0,1
7033,2014,5,2014-10-04,Wisconsin,@,Northwestern,L (14-20),12,29,41.4,138,1,37,284,7.7,1,66,422,6.4,6,13,0,19,6,49,0,4,4
7034,2014,6,2014-10-11,Wisconsin,,Illinois,W (38-28),10,18,55.6,97,0,47,401,8.5,5,65,498,7.7,5,15,2,22,4,53,0,0,0
7035,2014,7,2014-10-25,Wisconsin,,Maryland,W (52-7),15,23,65.2,216,2,49,311,6.3,5,72,527,7.3,10,14,1,25,2,20,0,0,0
7036,2014,8,2014-11-01,Wisconsin,@,Rutgers,W (37-0),8,20,40.0,87,0,46,298,6.5,4,66,385,5.8,3,13,0,16,7,56,0,1,1
7037,2014,9,2014-11-08,Wisconsin,@,Purdue,W (34-16),20,30,66.7,225,2,42,264,6.3,2,72,489,6.8,13,12,0,25,4,40,1,1,2
7038,2014,10,2014-11-15,Wisconsin,,Nebraska,W (59-24),7,11,63.6,46,1,53,581,11.0,7,64,627,9.8,3,17,0,20,6,55,4,0,4
7039,2014,11,2014-11-22,Wisconsin,@,Iowa,W (26-24),11,14,78.6,139,0,42,266,6.3,3,56,405,7.2,7,11,0,18,7,60,0,0,0
7040,2014,12,2014-11-29,Wisconsin,,Minnesota,W (34-24),11,18,61.1,215,2,46,233,5.1,2,64,448,7.0,7,10,3,20,7,69,1,0,1
7041,2014,13,2014-12-06,Wisconsin,N,Ohio State,L (0-59),17,43,39.5,187,0,37,71,1.9,0,80,258,3.2,11,6,1,18,3,23,1,3,4
7042,2014,14,2015-01-01,Wisconsin,N,Auburn*,W (34-31),14,27,51.9,121,1,54,400,7.4,3,81,521,6.4,7,20,4,31,3,28,0,3,3
7043,2014,,14 Games,Wisconsin,,,,177,322,55.0,2082,15,648,4482,6.9,46,970,6564,6.8,103,189,16,308,65,607,10,16,26
7044,2015,1,2015-09-05,Wisconsin,N,Alabama,L (17-35),26,39,66.7,228,2,21,40,1.9,0,60,268,4.5,12,2,3,17,5,50,0,1,1
7045,2015,2,2015-09-12,Wisconsin,,Miami (OH),W (58-0),23,36,63.9,263,4,45,188,4.2,3,81,451,5.6,14,11,1,26,8,65,0,1,1
7046,2015,3,2015-09-19,Wisconsin,,Troy,W (28-3),13,18,72.2,202,1,35,199,5.7,3,53,401,7.6,6,11,0,17,6,63,0,0,0
7047,2015,4,2015-09-26,Wisconsin,,Hawaii,W (28-0),15,25,60.0,186,1,54,326,6.0,3,79,512,6.5,11,18,2,31,6,52,0,0,0
7048,2015,5,2015-10-03,Wisconsin,,Iowa,L (6-10),21,38,55.3,234,0,34,86,2.5,0,72,320,4.4,15,3,3,21,8,90,2,2,4
7049,2015,6,2015-10-10,Wisconsin,@,Nebraska,W (23-21),24,50,48.0,322,1,34,147,4.3,1,84,469,5.6,16,6,4,26,6,45,0,0,0
7050,2015,7,2015-10-17,Wisconsin,,Purdue,W (24-7),30,39,76.9,322,0,37,96,2.6,3,76,418,5.5,17,6,3,26,7,65,0,1,1
7051,2015,8,2015-10-24,Wisconsin,@,Illinois,W (24-13),25,40,62.5,281,2,40,138,3.5,1,80,419,5.2,16,5,2,23,4,45,0,2,2
7052,2015,9,2015-10-31,Wisconsin,,Rutgers,W (48-10),13,28,46.4,217,1,38,209,5.5,5,66,426,6.5,9,6,0,15,5,40,0,2,2
7053,2015,10,2015-11-07,Wisconsin,@,Maryland,W (31-24),15,24,62.5,188,1,40,117,2.9,2,64,305,4.8,10,5,3,18,7,54,0,1,1
7054,2015,11,2015-11-21,Wisconsin,,Northwestern,L (7-13),20,36,55.6,229,0,26,-26,-1.0,1,62,203,3.3,11,3,0,14,2,25,3,2,5
7055,2015,12,2015-11-28,Wisconsin,@,Minnesota,W (31-21),9,17,52.9,79,0,62,257,4.1,4,79,336,4.3,6,13,1,20,6,59,0,1,1
7056,2015,13,2015-12-30,Wisconsin,N,Southern California*,W (23-21),18,29,62.1,217,1,46,177,3.8,1,75,394,5.3,14,6,2,22,5,36,0,0,0
7057,2015,,13 Games,Wisconsin,,,,252,419,60.1,2968,14,512,1954,3.8,27,931,4922,5.3,157,95,24,276,75,689,5,13,18
7058,2016,1,2016-09-03,Wisconsin,N,Louisiana State,W (16-14),19,31,61.3,205,0,42,134,3.2,1,73,339,4.6,11,8,2,21,5,55,1,2,3
7059,2016,2,2016-09-10,Wisconsin,,Akron,W (54-10),20,27,74.1,292,3,55,294,5.3,4,82,586,7.1,18,12,2,32,3,40,0,0,0
7060,2016,3,2016-09-17,Wisconsin,,Georgia State,W (23-17),18,30,60.0,213,1,49,187,3.8,1,79,400,5.1,13,11,1,25,0,0,1,1,2
7061,2016,4,2016-09-24,Wisconsin,@,Michigan State,W (30-6),16,26,61.5,195,1,41,122,3.0,2,67,317,4.7,9,5,1,15,7,67,1,1,2
7062,2016,5,2016-10-01,Wisconsin,@,Michigan,L (7-14),9,25,36.0,88,1,28,71,2.5,0,53,159,3.0,4,4,0,8,3,30,0,3,3
7063,2016,6,2016-10-15,Wisconsin,,Ohio State,L (23-30),16,28,57.1,214,1,46,236,5.1,1,74,450,6.1,9,13,0,22,4,35,0,1,1
7064,2016,7,2016-10-22,Wisconsin,@,Iowa,W (17-9),15,25,60.0,256,1,48,167,3.5,1,73,423,5.8,10,9,1,20,0,0,1,0,1
7065,2016,8,2016-10-29,Wisconsin,,Nebraska,W (23-17),14,23,60.9,114,1,38,223,5.9,2,61,337,5.5,7,9,0,16,1,5,0,2,2
7066,2016,9,2016-11-05,Wisconsin,@,Northwestern,W (21-7),13,22,59.1,143,0,57,190,3.3,2,79,333,4.2,8,11,1,20,1,10,0,0,0
7067,2016,10,2016-11-12,Wisconsin,,Illinois,W (48-3),8,14,57.1,92,2,64,363,5.7,4,78,455,5.8,5,18,0,23,4,34,0,0,0
7068,2016,11,2016-11-19,Wisconsin,@,Purdue,W (49-20),12,15,80.0,191,2,56,221,3.9,4,71,412,5.8,10,12,1,23,8,69,1,0,1
7069,2016,12,2016-11-26,Wisconsin,,Minnesota,W (31-17),13,22,59.1,152,0,47,210,4.5,4,69,362,5.2,8,10,1,19,3,35,1,0,1
7070,2016,13,2016-12-03,Wisconsin,N,Penn State,L (31-38),16,21,76.2,174,0,49,241,4.9,3,70,415,5.9,9,11,2,22,4,40,0,0,0
7071,2016,14,2017-01-02,Wisconsin,N,Western Michigan*,W (24-16),13,14,92.9,178,1,38,184,4.8,2,52,362,7.0,9,9,0,18,5,35,0,0,0
7072,2016,,14 Games,Wisconsin,,,,202,323,62.5,2507,14,658,2843,4.3,31,981,5350,5.5,130,142,12,284,48,455,6,10,16
7073,2017,1,2017-09-01,Wisconsin,,Utah State,W (59-10),15,23,65.2,244,3,45,234,5.2,4,68,478,7.0,12,9,4,25,9,73,2,0,2
7074,2017,2,2017-09-09,Wisconsin,,Florida Atlantic,W (31-14),17,30,56.7,207,1,54,357,6.6,3,84,564,6.7,10,18,1,29,1,10,1,1,2
7075,2017,3,2017-09-16,Wisconsin,@,Brigham Young,W (40-6),18,19,94.7,256,4,49,235,4.8,1,68,491,7.2,9,19,0,28,6,56,0,0,0
7076,2017,4,2017-09-30,Wisconsin,,Northwestern,W (33-24),11,20,55.0,197,1,37,109,2.9,2,57,306,5.4,6,7,0,13,5,47,1,2,3
7077,2017,5,2017-10-07,Wisconsin,@,Nebraska,W (38-17),9,17,52.9,113,1,49,353,7.2,3,66,466,7.1,4,14,1,19,8,78,0,1,1
7078,2017,6,2017-10-14,Wisconsin,,Purdue,W (17-9),13,18,72.2,199,1,50,299,6.0,1,68,498,7.3,10,13,1,24,8,65,1,2,3
7079,2017,7,2017-10-21,Wisconsin,,Maryland,W (38-13),16,24,66.7,225,2,41,215,5.2,2,65,440,6.8,12,10,1,23,6,49,1,1,2
7080,2017,8,2017-10-28,Wisconsin,@,Illinois,W (24-10),10,19,52.6,135,0,45,168,3.7,3,64,303,4.7,8,9,2,19,4,50,0,1,1
7081,2017,9,2017-11-04,Wisconsin,@,Indiana,W (45-17),15,22,68.2,170,2,52,237,4.6,4,74,407,5.5,9,12,3,24,6,62,0,1,1
7082,2017,10,2017-11-11,Wisconsin,,Iowa,W (38-14),11,18,61.1,135,2,49,247,5.0,2,67,382,5.7,8,8,2,18,6,54,1,3,4
7083,2017,11,2017-11-18,Wisconsin,,Michigan,W (24-10),9,19,47.4,143,1,40,182,4.6,1,59,325,5.5,5,7,2,14,4,35,0,1,1
7084,2017,12,2017-11-25,Wisconsin,@,Minnesota,W (31-0),17,21,81.0,169,3,39,287,7.4,1,60,456,7.6,10,10,0,20,3,34,1,0,1
7085,2017,13,2017-12-02,Wisconsin,N,Ohio State,L (21-27),20,41,48.8,238,0,32,60,1.9,1,73,298,4.1,10,5,1,16,6,55,0,2,2
7086,2017,14,2017-12-30,Wisconsin,@,Miami (FL)*,W (34-24),23,34,67.6,258,4,44,142,3.2,0,78,400,5.1,15,7,2,24,3,35,1,0,1
7087,2017,,14 Games,Wisconsin,,,,204,325,62.8,2689,25,626,3125,5.0,28,951,5814,6.1,128,148,20,296,75,703,9,15,24
7088,2016,1,2016-09-10,Wofford,@,Mississippi,L (13-38),5,9,55.6,72,0,57,233,4.1,1,66,305,4.6,3,14,1,18,2,25,1,0,1
7089,2017,1,2017-11-18,Wofford,@,South Carolina,L (10-31),5,9,55.6,72,0,41,155,3.8,1,50,227,4.5,2,9,3,14,3,21,1,2,3
7090,2014,1,2014-08-30,Wyoming,,Montana,W (17-12),13,21,61.9,92,0,46,209,4.5,2,67,301,4.5,6,10,2,18,1,4,1,1,2
7091,2014,2,2014-09-06,Wyoming,,Air Force,W (17-13),23,37,62.2,282,2,26,51,2.0,0,63,333,5.3,14,1,0,15,2,15,0,0,0
7092,2014,3,2014-09-13,Wyoming,@,Oregon,L (14-48),19,33,57.6,284,2,41,155,3.8,0,74,439,5.9,16,7,1,24,5,48,1,2,3
7093,2014,4,2014-09-20,Wyoming,,Florida Atlantic,W (20-19),10,23,43.5,161,0,41,173,4.2,2,64,334,5.2,5,10,2,17,4,36,1,0,1
7094,2014,5,2014-09-27,Wyoming,@,Michigan State,L (14-56),16,24,66.7,188,1,27,98,3.6,1,51,286,5.6,6,5,0,11,5,43,2,1,3
7095,2014,6,2014-10-11,Wyoming,@,Hawaii,L (28-38),19,30,63.3,221,2,33,101,3.1,1,63,322,5.1,9,7,1,17,5,40,0,2,2
7096,2014,7,2014-10-18,Wyoming,,San Jose State,L (20-27),11,28,39.3,119,0,30,158,5.3,1,58,277,4.8,5,6,0,11,7,72,0,0,0
7097,2014,8,2014-10-25,Wyoming,@,Colorado State,L (31-45),24,38,63.2,335,2,38,119,3.1,2,76,454,6.0,13,8,4,25,7,53,0,0,0
7098,2014,9,2014-11-01,Wyoming,@,Fresno State,W (45-17),19,28,67.9,320,2,43,374,8.7,4,71,694,9.8,14,10,0,24,8,64,1,0,1
7099,2014,10,2014-11-07,Wyoming,,Utah State,L (3-20),20,40,50.0,212,0,35,151,4.3,0,75,363,4.8,10,7,1,18,10,95,0,2,2
7100,2014,11,2014-11-22,Wyoming,,Boise State,L (14-63),16,29,55.2,147,0,38,80,2.1,2,67,227,3.4,7,5,0,12,3,20,2,1,3
7101,2014,12,2014-11-29,Wyoming,@,New Mexico,L (30-36),21,43,48.8,366,1,51,175,3.4,2,94,541,5.8,19,7,3,29,6,30,0,1,1
7102,2014,,12 Games,Wyoming,,,,211,374,56.4,2727,12,449,1844,4.1,17,823,4571,5.6,124,83,14,221,63,520,8,10,18
7103,2015,1,2015-09-05,Wyoming,,North Dakota,L (13-24),20,39,51.3,289,2,19,41,2.2,0,58,330,5.7,10,3,1,14,8,96,0,0,0
7104,2015,2,2015-09-12,Wyoming,,Eastern Michigan,L (29-48),6,17,35.3,32,0,58,430,7.4,4,75,462,6.2,3,22,4,29,4,30,1,0,1
7105,2015,3,2015-09-19,Wyoming,@,Washington State,L (14-31),25,36,69.4,296,2,40,113,2.8,0,76,409,5.4,10,11,1,22,8,57,1,1,2
7106,2015,4,2015-09-26,Wyoming,,New Mexico,L (28-38),30,42,71.4,366,4,30,42,1.4,0,72,408,5.7,16,5,5,26,10,98,0,2,2
7107,2015,5,2015-10-03,Wyoming,@,Appalachian State,L (13-31),14,19,73.7,155,1,51,218,4.3,1,70,373,5.3,7,11,0,18,7,65,2,1,3
7108,2015,6,2015-10-10,Wyoming,@,Air Force,L (17-31),15,29,51.7,192,2,35,115,3.3,0,64,307,4.8,8,9,2,19,1,10,2,2,4
7109,2015,7,2015-10-17,Wyoming,,Nevada,W (28-21),18,20,90.0,213,3,51,272,5.3,1,71,485,6.8,9,15,1,25,7,71,0,0,0
7110,2015,8,2015-10-24,Wyoming,@,Boise State,L (14-34),12,21,57.1,123,1,33,110,3.3,1,54,233,4.3,6,6,4,16,5,35,0,1,1
7111,2015,9,2015-10-30,Wyoming,@,Utah State,L (27-58),10,18,55.6,83,2,49,270,5.5,2,67,353,5.3,7,14,1,22,4,33,0,0,0
7112,2015,10,2015-11-07,Wyoming,,Colorado State,L (7-26),10,21,47.6,109,0,34,130,3.8,1,55,239,4.3,6,8,1,15,9,66,3,1,4
7113,2015,11,2015-11-14,Wyoming,@,San Diego State,L (3-38),9,21,42.9,129,0,32,62,1.9,0,53,191,3.6,5,5,2,12,7,63,1,2,3
7114,2015,12,2015-11-28,Wyoming,,Nevada-Las Vegas,W (35-28),14,25,56.0,248,3,46,290,6.3,2,71,538,7.6,8,14,1,23,5,57,0,1,1
7115,2015,,12 Games,Wyoming,,,,183,308,59.4,2235,20,478,2093,4.4,12,786,4328,5.5,95,123,23,241,75,681,10,11,21
7116,2016,1,2016-09-03,Wyoming,,Northern Illinois,W (40-34),19,29,65.5,245,2,56,243,4.3,3,85,488,5.7,13,9,6,28,10,100,0,0,0
7117,2016,2,2016-09-10,Wyoming,@,Nebraska,L (17-52),16,32,50.0,189,1,31,131,4.2,1,63,320,5.1,8,5,3,16,5,42,1,5,6
7118,2016,3,2016-09-17,Wyoming,,California-Davis,W (45-22),11,15,73.3,198,3,48,274,5.7,3,63,472,7.5,10,12,0,22,5,41,1,0,1
7119,2016,4,2016-09-23,Wyoming,@,Eastern Michigan,L (24-27),19,29,65.5,234,0,38,79,2.1,1,67,313,4.7,12,4,3,19,3,35,2,1,3
7120,2016,5,2016-10-01,Wyoming,@,Colorado State,W (38-17),7,18,38.9,165,1,49,269,5.5,3,67,434,6.5,7,12,0,19,4,30,0,0,0
7121,2016,6,2016-10-08,Wyoming,,Air Force,W (35-26),15,27,55.6,173,3,48,189,3.9,1,75,362,4.8,10,9,2,21,5,50,1,0,1
7122,2016,7,2016-10-22,Wyoming,@,Nevada,W (42-34),10,14,71.4,149,1,54,393,7.3,5,68,542,8.0,6,20,1,27,6,67,0,0,0
7123,2016,8,2016-10-29,Wyoming,,Boise State,W (30-28),18,31,58.1,274,3,49,215,4.4,0,80,489,6.1,12,13,0,25,0,0,0,1,1
7124,2016,9,2016-11-05,Wyoming,,Utah State,W (52-28),16,26,61.5,261,4,46,267,5.8,3,72,528,7.3,10,14,1,25,7,70,0,1,1
7125,2016,10,2016-11-12,Wyoming,@,Nevada-Las Vegas,L (66-69),14,34,41.2,334,4,32,151,4.7,3,66,485,7.3,11,8,1,20,2,12,2,2,4
7126,2016,11,2016-11-19,Wyoming,,San Diego State,W (34-33),16,31,51.6,282,2,53,205,3.9,2,84,487,5.8,12,15,2,29,2,20,0,1,1
7127,2016,12,2016-11-26,Wyoming,@,New Mexico,L (35-56),18,28,64.3,248,0,45,201,4.5,5,73,449,6.2,11,12,2,25,4,44,1,0,1
7128,2016,13,2016-12-03,Wyoming,,San Diego State,L (24-27),14,31,45.2,248,3,31,95,3.1,0,62,343,5.5,10,3,0,13,6,45,1,2,3
7129,2016,14,2016-12-21,Wyoming,N,Brigham Young*,L (21-24),17,33,51.5,207,2,45,186,4.1,1,78,393,5.0,9,10,3,22,7,59,0,2,2
7130,2016,,14 Games,Wyoming,,,,210,378,55.6,3207,29,625,2898,4.6,31,1003,6105,6.1,141,146,24,311,66,615,9,15,24
7131,2017,1,2017-09-02,Wyoming,@,Iowa,L (3-24),23,40,57.5,174,0,30,59,2.0,0,70,233,3.3,10,4,1,15,5,40,0,2,2
7132,2017,2,2017-09-09,Wyoming,,Gardner-Webb,W (27-0),22,32,68.8,328,2,28,65,2.3,1,60,393,6.6,15,3,1,19,4,45,0,0,0
7133,2017,3,2017-09-16,Wyoming,,Oregon,L (13-49),10,25,40.0,66,0,32,117,3.7,1,57,183,3.2,2,6,2,10,6,62,1,1,2
7134,2017,4,2017-09-23,Wyoming,,Hawaii,W (28-21),9,19,47.4,92,1,29,177,6.1,2,48,269,5.6,3,8,0,11,4,51,0,0,0
7135,2017,5,2017-09-30,Wyoming,,Texas State,W (45-10),15,26,57.7,249,3,35,84,2.4,0,61,333,5.5,12,5,1,18,4,33,1,0,1
7136,2017,6,2017-10-14,Wyoming,@,Utah State,W (28-23),18,26,69.2,208,1,36,85,2.4,1,62,293,4.7,8,5,1,14,8,75,0,1,1
7137,2017,7,2017-10-21,Wyoming,@,Boise State,L (14-24),12,27,44.4,131,1,34,111,3.3,1,61,242,4.0,6,7,2,15,1,12,0,2,2
7138,2017,8,2017-10-28,Wyoming,,New Mexico,W (42-3),16,28,57.1,234,4,32,75,2.3,2,60,309,5.2,12,3,3,18,5,50,0,0,0
7139,2017,9,2017-11-04,Wyoming,,Colorado State,W (16-13),10,20,50.0,138,0,34,156,4.6,1,54,294,5.4,9,8,1,18,1,5,1,0,1
7140,2017,10,2017-11-11,Wyoming,@,Air Force,W (28-14),11,15,73.3,129,1,43,100,2.3,3,58,229,3.9,6,8,2,16,5,50,1,0,1
7141,2017,11,2017-11-18,Wyoming,,Fresno State,L (7-13),20,33,60.6,231,1,28,77,2.8,0,61,308,5.0,9,3,0,12,3,15,2,0,2
7142,2017,12,2017-11-25,Wyoming,@,San Jose State,L (17-20),18,38,47.4,170,1,43,187,4.3,1,81,357,4.4,5,10,2,17,4,35,0,2,2
7143,2017,13,2017-12-22,Wyoming,N,Central Michigan*,W (37-14),11,19,57.9,154,3,42,121,2.9,0,61,275,4.5,8,6,1,15,5,49,0,0,0
7144,2017,,13 Games,Wyoming,,,,195,348,56.0,2304,18,446,1414,3.2,13,794,3718,4.7,105,76,17,198,55,522,6,8,14
